,Year,Country of origin,Country of asylum,Refugees under UNHCR's mandate,Asylum-seekers,IDPs of concern to UNHCR,International total
5120,2018,Afghanistan,Afghanistan,0,0,2106893,0
5121,2018,Bangladesh,Afghanistan,0,5,0,5
5122,2018,Iran (Islamic Rep. of),Afghanistan,34,9,0,43
5123,2018,Pakistan,Afghanistan,72194,121,0,72315
5124,2018,Tajikistan,Afghanistan,0,7,0,7
5125,2018,Türkiye,Afghanistan,0,139,0,139
5126,2018,Algeria,Albania,0,16,0,16
5127,2018,Egypt,Albania,5,0,0,5
5128,2018,China,Albania,12,0,0,12
5129,2018,Dem. Rep. of the Congo,Albania,5,0,0,5
5130,2018,Palestinian,Albania,14,8,0,22
5131,2018,Iran (Islamic Rep. of),Albania,12,5,0,17
5132,2018,Iraq,Albania,5,25,0,30
5133,2018,Libya,Albania,0,28,0,28
5134,2018,Morocco,Albania,0,28,0,28
5135,2018,Serbia and Kosovo: S/RES/1244 (1999),Albania,58,5,0,63
5136,2018,Syrian Arab Rep.,Albania,6,44,0,50
5137,2018,Türkiye,Albania,5,0,0,5
5138,2018,Uzbekistan,Albania,5,0,0,5
5139,2018,Venezuela (Bolivarian Republic of),Albania,5,0,0,5
5140,2018,Stateless,Albania,0,0,0,0
5141,2018,Benin,Algeria,5,5,0,10
5142,2018,Burkina Faso,Algeria,0,5,0,5
5143,2018,Central African Rep.,Algeria,49,33,0,82
5144,2018,Chad,Algeria,6,11,0,17
5145,2018,Cameroon,Algeria,35,163,0,198
5146,2018,Dem. Rep. of the Congo,Algeria,59,80,0,139
5147,2018,Palestinian,Algeria,4013,128,0,4141
5148,2018,Ghana,Algeria,0,5,0,5
5149,2018,Guinea,Algeria,13,224,0,237
5150,2018,Cote d'Ivoire,Algeria,40,152,0,192
5151,2018,Iraq,Algeria,13,0,0,13
5152,2018,Liberia,Algeria,0,14,0,14
5153,2018,Libya,Algeria,19,13,0,32
5154,2018,Lebanon,Algeria,0,5,0,5
5155,2018,Mali,Algeria,55,179,0,234
5156,2018,Niger,Algeria,0,25,0,25
5157,2018,Nigeria,Algeria,0,119,0,119
5158,2018,Sierra Leone,Algeria,0,5,0,5
5159,2018,Somalia,Algeria,0,5,0,5
5160,2018,Sudan,Algeria,5,15,0,20
5161,2018,Syrian Arab Rep.,Algeria,14,7485,0,7499
5162,2018,Togo,Algeria,5,0,0,5
5163,2018,Western Sahara,Algeria,90000,0,0,90000
5164,2018,Yemen,Algeria,10,239,0,249
5165,2018,Burundi,Angola,18,94,0,112
5166,2018,Central African Rep.,Angola,7,76,0,83
5167,2018,Chad,Angola,191,779,0,970
5168,2018,Congo,Angola,65,58,0,123
5169,2018,Dem. Rep. of the Congo,Angola,37077,498,0,37575
5170,2018,Eritrea,Angola,17,1767,0,1784
5171,2018,Ethiopia,Angola,0,57,0,57
5172,2018,Guinea-Bissau,Angola,7,268,0,275
5173,2018,Guinea,Angola,84,9144,0,9228
5174,2018,Cote d'Ivoire,Angola,417,5940,0,6357
5175,2018,Liberia,Angola,164,478,0,642
5176,2018,Mauritania,Angola,324,5402,0,5726
5177,2018,Rwanda,Angola,501,67,0,568
5178,2018,Sierra Leone,Angola,413,1497,0,1910
5179,2018,Somalia,Angola,270,1731,0,2001
5180,2018,Sudan,Angola,280,1670,0,1950
5181,2018,United Rep. of Tanzania,Angola,5,0,0,5
5182,2018,Uganda,Angola,0,6,0,6
5183,2018,Western Sahara,Angola,16,596,0,612
5184,2018,Afghanistan,Egypt,20,23,0,43
5185,2018,Burundi,Egypt,27,43,0,70
5186,2018,Benin,Egypt,0,5,0,5
5187,2018,Bangladesh,Egypt,0,5,0,5
5188,2018,Central African Rep.,Egypt,22,25,0,47
5189,2018,Chad,Egypt,47,20,0,67
5190,2018,China,Egypt,0,69,0,69
5191,2018,Cameroon,Egypt,5,32,0,37
5192,2018,Congo,Egypt,5,23,0,28
5193,2018,Dem. Rep. of the Congo,Egypt,45,24,0,69
5194,2018,Djibouti,Egypt,5,10,0,15
5195,2018,Eritrea,Egypt,4340,11102,0,15442
5196,2018,Ethiopia,Egypt,3814,12117,0,15931
5197,2018,Gambia,Egypt,0,5,0,5
5198,2018,Palestinian,Egypt,70021,0,0,70021
5199,2018,Ghana,Egypt,0,9,0,9
5200,2018,Guinea,Egypt,5,41,0,46
5201,2018,Cote d'Ivoire,Egypt,109,5,0,114
5202,2018,India,Egypt,0,5,0,5
5203,2018,Iraq,Egypt,4346,2648,0,6994
5204,2018,Jordan,Egypt,5,12,0,17
5205,2018,Kenya,Egypt,6,5,0,11
5206,2018,Liberia,Egypt,0,13,0,13
5207,2018,Libya,Egypt,5,0,0,5
5208,2018,Mali,Egypt,5,6,0,11
5209,2018,Niger,Egypt,0,5,0,5
5210,2018,Nigeria,Egypt,18,343,0,361
5211,2018,Russian Federation,Egypt,7,52,0,59
5212,2018,Saudi Arabia,Egypt,0,6,0,6
5213,2018,Sierra Leone,Egypt,5,16,0,21
5214,2018,Somalia,Egypt,3588,3576,0,7164
5215,2018,Sudan,Egypt,19540,22231,0,41771
5216,2018,South Sudan,Egypt,7737,6885,0,14622
5217,2018,Syrian Arab Rep.,Egypt,132871,0,0,132871
5218,2018,Tajikistan,Egypt,12,37,0,49
5219,2018,Turkmenistan,Egypt,5,0,0,5
5220,2018,Togo,Egypt,0,7,0,7
5221,2018,Tunisia,Egypt,0,5,0,5
5222,2018,Türkiye,Egypt,0,401,0,401
5223,2018,Uganda,Egypt,11,19,0,30
5224,2018,Uzbekistan,Egypt,0,56,0,56
5225,2018,Yemen,Egypt,100,8222,0,8322
5226,2018,Zimbabwe,Egypt,15,55,0,70
5227,2018,Stateless,Egypt,5,0,0,5
5228,2018,Unknown ,Egypt,0,5,0,5
5229,2018,Afghanistan,Argentina,5,8,0,13
5230,2018,Albania,Argentina,18,0,0,18
5231,2018,Algeria,Argentina,30,12,0,42
5232,2018,Angola,Argentina,14,14,0,28
5233,2018,Egypt,Argentina,5,8,0,13
5234,2018,Armenia,Argentina,77,187,0,264
5235,2018,Burundi,Argentina,5,0,0,5
5236,2018,Bangladesh,Argentina,5,79,0,84
5237,2018,Bolivia (Plurinational State of),Argentina,5,0,0,5
5238,2018,Brazil,Argentina,0,9,0,9
5239,2018,Bosnia and Herzegovina,Argentina,6,0,0,6
5240,2018,China,Argentina,0,103,0,103
5241,2018,Chile,Argentina,34,0,0,34
5242,2018,Cameroon,Argentina,6,39,0,45
5243,2018,Dem. Rep. of the Congo,Argentina,21,16,0,37
5244,2018,Colombia,Argentina,547,205,0,752
5245,2018,Costa Rica,Argentina,5,0,0,5
5246,2018,Cuba,Argentina,253,723,0,976
5247,2018,Cabo Verde,Argentina,0,5,0,5
5248,2018,Czechia,Argentina,0,5,0,5
5249,2018,Dominican Rep.,Argentina,0,447,0,447
5250,2018,Ecuador,Argentina,16,5,0,21
5251,2018,Ethiopia,Argentina,5,0,0,5
5252,2018,France,Argentina,0,5,0,5
5253,2018,Gambia,Argentina,0,5,0,5
5254,2018,Palestinian,Argentina,16,6,0,22
5255,2018,Georgia,Argentina,5,0,0,5
5256,2018,Ghana,Argentina,38,139,0,177
5257,2018,Guinea-Bissau,Argentina,8,5,0,13
5258,2018,Guatemala,Argentina,0,6,0,6
5259,2018,Guinea,Argentina,9,9,0,18
5260,2018,Haiti,Argentina,66,859,0,925
5261,2018,Honduras,Argentina,5,11,0,16
5262,2018,Hungary,Argentina,0,5,0,5
5263,2018,Cote d'Ivoire,Argentina,20,0,0,20
5264,2018,India,Argentina,22,116,0,138
5265,2018,Iran (Islamic Rep. of),Argentina,23,5,0,28
5266,2018,Iraq,Argentina,22,5,0,27
5267,2018,Jamaica,Argentina,6,5,0,11
5268,2018,Kazakhstan,Argentina,18,5,0,23
5269,2018,Kyrgyzstan,Argentina,5,0,0,5
5270,2018,Liberia,Argentina,44,0,0,44
5271,2018,Libya,Argentina,0,5,0,5
5272,2018,Sri Lanka,Argentina,36,0,0,36
5273,2018,Mauritania,Argentina,0,5,0,5
5274,2018,North Macedonia,Argentina,9,0,0,9
5275,2018,Mexico,Argentina,0,6,0,6
5276,2018,Mali,Argentina,9,5,0,14
5277,2018,Morocco,Argentina,0,10,0,10
5278,2018,Nepal,Argentina,0,5,0,5
5279,2018,Nicaragua,Argentina,0,14,0,14
5280,2018,Nigeria,Argentina,41,67,0,108
5281,2018,Pakistan,Argentina,32,25,0,57
5282,2018,Paraguay,Argentina,8,9,0,17
5283,2018,Peru,Argentina,545,34,0,579
5284,2018,Romania,Argentina,51,0,0,51
5285,2018,South Africa,Argentina,0,10,0,10
5286,2018,Russian Federation,Argentina,70,85,0,155
5287,2018,El Salvador,Argentina,23,42,0,65
5288,2018,Senegal,Argentina,42,1416,0,1458
5289,2018,Sierra Leone,Argentina,37,5,0,42
5290,2018,Somalia,Argentina,5,0,0,5
5291,2018,Spain,Argentina,0,5,0,5
5292,2018,Viet Nam,Argentina,0,5,0,5
5293,2018,Sudan,Argentina,5,0,0,5
5294,2018,Syrian Arab Rep.,Argentina,385,95,0,480
5295,2018,Türkiye,Argentina,10,0,0,10
5296,2018,Ukraine,Argentina,106,125,0,231
5297,2018,United States of America,Argentina,5,10,0,15
5298,2018,Venezuela (Bolivarian Republic of),Argentina,16,1015,0,1031
5299,2018,Yemen,Argentina,15,7,0,22
5300,2018,Stateless,Argentina,11,8,0,19
5301,2018,Unknown ,Argentina,617,38,0,655
5302,2018,Afghanistan,Armenia,0,16,0,16
5303,2018,Azerbaijan,Armenia,1961,0,0,1961
5304,2018,Cuba,Armenia,0,5,0,5
5305,2018,Palestinian,Armenia,7,0,0,7
5306,2018,Georgia,Armenia,8,0,0,8
5307,2018,Cote d'Ivoire,Armenia,6,0,0,6
5308,2018,Iran (Islamic Rep. of),Armenia,36,41,0,77
5309,2018,Iraq,Armenia,1083,9,0,1092
5310,2018,Lebanon,Armenia,19,5,0,24
5311,2018,Nigeria,Armenia,5,0,0,5
5312,2018,Syrian Arab Rep.,Armenia,14701,8,0,14709
5313,2018,Türkiye,Armenia,5,16,0,21
5314,2018,Ukraine,Armenia,115,5,0,120
5315,2018,Yemen,Armenia,20,0,0,20
5316,2018,Stateless,Armenia,0,0,0,0
5317,2018,Afghanistan,Australia,11932,1600,0,13532
5318,2018,Albania,Australia,55,85,0,140
5319,2018,Algeria,Australia,8,16,0,24
5320,2018,Egypt,Australia,1564,283,0,1847
5321,2018,Argentina,Australia,0,21,0,21
5322,2018,Austria,Australia,0,5,0,5
5323,2018,Azerbaijan,Australia,9,15,0,24
5324,2018,Bahrain,Australia,95,21,0,116
5325,2018,Burundi,Australia,43,28,0,71
5326,2018,Bangladesh,Australia,412,1050,0,1462
5327,2018,Bhutan,Australia,5,10,0,15
5328,2018,Belarus,Australia,7,0,0,7
5329,2018,Brazil,Australia,5,54,0,59
5330,2018,Bosnia and Herzegovina,Australia,0,9,0,9
5331,2018,Cambodia,Australia,35,326,0,361
5332,2018,Canada,Australia,0,5,0,5
5333,2018,China,Australia,2304,13647,0,15951
5334,2018,Chile,Australia,0,17,0,17
5335,2018,Cameroon,Australia,30,56,0,86
5336,2018,Congo,Australia,13,13,0,26
5337,2018,Dem. Rep. of the Congo,Australia,60,53,0,113
5338,2018,Colombia,Australia,110,157,0,267
5339,2018,Czechia,Australia,0,5,0,5
5340,2018,Djibouti,Australia,5,0,0,5
5341,2018,Eritrea,Australia,127,26,0,153
5342,2018,Ethiopia,Australia,315,280,0,595
5343,2018,Fiji,Australia,400,1022,0,1422
5344,2018,France,Australia,0,5,0,5
5345,2018,Gambia,Australia,7,13,0,20
5346,2018,Palestinian,Australia,458,107,0,565
5347,2018,United Kingdom of Great Britain and Northern Ireland,Australia,5,64,0,69
5348,2018,Georgia,Australia,16,26,0,42
5349,2018,Germany,Australia,5,9,0,14
5350,2018,Ghana,Australia,27,168,0,195
5351,2018,Greece,Australia,6,26,0,32
5352,2018,Guinea,Australia,11,10,0,21
5353,2018,"China, Hong Kong SAR",Australia,5,0,0,5
5354,2018,Honduras,Australia,5,5,0,10
5355,2018,Croatia,Australia,0,5,0,5
5356,2018,Hungary,Australia,0,5,0,5
5357,2018,Cote d'Ivoire,Australia,5,0,0,5
5358,2018,India,Australia,423,3584,0,4007
5359,2018,Indonesia,Australia,255,1138,0,1393
5360,2018,Ireland,Australia,0,5,0,5
5361,2018,Iran (Islamic Rep. of),Australia,10702,4699,0,15401
5362,2018,Iraq,Australia,4911,1233,0,6144
5363,2018,Israel,Australia,12,20,0,32
5364,2018,Italy,Australia,5,23,0,28
5365,2018,Jamaica,Australia,5,0,0,5
5366,2018,Jordan,Australia,149,175,0,324
5367,2018,Japan,Australia,10,14,0,24
5368,2018,Kazakhstan,Australia,7,12,0,19
5369,2018,Kenya,Australia,105,167,0,272
5370,2018,Kyrgyzstan,Australia,13,18,0,31
5371,2018,Rep. of Korea,Australia,40,164,0,204
5372,2018,Dem. People's Rep. of Korea,Australia,19,0,0,19
5373,2018,Kuwait,Australia,55,0,0,55
5374,2018,Lao People's Dem. Rep.,Australia,5,116,0,121
5375,2018,Liberia,Australia,47,28,0,75
5376,2018,Libya,Australia,1081,186,0,1267
5377,2018,Lebanon,Australia,537,688,0,1225
5378,2018,Sri Lanka,Australia,4787,2505,0,7292
5379,2018,Latvia,Australia,0,5,0,5
5380,2018,North Macedonia,Australia,5,37,0,42
5381,2018,Maldives,Australia,10,15,0,25
5382,2018,Mexico,Australia,10,22,0,32
5383,2018,Malaysia,Australia,432,12995,0,13427
5384,2018,Malawi,Australia,0,7,0,7
5385,2018,Mongolia,Australia,24,106,0,130
5386,2018,Morocco,Australia,12,12,0,24
5387,2018,Mozambique,Australia,5,0,0,5
5388,2018,Mauritius,Australia,7,91,0,98
5389,2018,Myanmar,Australia,550,224,0,774
5390,2018,Nepal,Australia,159,442,0,601
5391,2018,Netherlands,Australia,0,5,0,5
5392,2018,Nigeria,Australia,201,440,0,641
5393,2018,New Zealand,Australia,26,14,0,40
5394,2018,Oman,Australia,5,0,0,5
5395,2018,Pakistan,Australia,5061,2618,0,7679
5396,2018,Peru,Australia,9,54,0,63
5397,2018,Philippines,Australia,45,565,0,610
5398,2018,Papua New Guinea,Australia,419,445,0,864
5399,2018,Poland,Australia,0,15,0,15
5400,2018,Portugal,Australia,0,5,0,5
5401,2018,Romania,Australia,7,6,0,13
5402,2018,South Africa,Australia,34,254,0,288
5403,2018,Russian Federation,Australia,54,62,0,116
5404,2018,Rwanda,Australia,75,66,0,141
5405,2018,El Salvador,Australia,10,25,0,35
5406,2018,Saudi Arabia,Australia,94,135,0,229
5407,2018,Serbia and Kosovo: S/RES/1244 (1999),Australia,5,24,0,29
5408,2018,Singapore,Australia,6,28,0,34
5409,2018,Sierra Leone,Australia,30,144,0,174
5410,2018,Solomon Islands,Australia,21,145,0,166
5411,2018,Somalia,Australia,475,135,0,610
5412,2018,Viet Nam,Australia,259,1659,0,1918
5413,2018,Sudan,Australia,484,192,0,676
5414,2018,South Sudan,Australia,8,29,0,37
5415,2018,Eswatini,Australia,0,16,0,16
5416,2018,Syrian Arab Rep.,Australia,582,100,0,682
5417,2018,United Rep. of Tanzania,Australia,13,18,0,31
5418,2018,Thailand,Australia,16,1741,0,1757
5419,2018,Timor-Leste,Australia,7,0,0,7
5420,2018,Togo,Australia,5,0,0,5
5421,2018,Tonga,Australia,32,164,0,196
5422,2018,Tunisia,Australia,5,12,0,17
5423,2018,Türkiye,Australia,603,570,0,1173
5424,2018,United Arab Emirates,Australia,7,0,0,7
5425,2018,Uganda,Australia,58,86,0,144
5426,2018,Ukraine,Australia,22,87,0,109
5427,2018,United States of America,Australia,16,29,0,45
5428,2018,Uzbekistan,Australia,29,16,0,45
5429,2018,Venezuela (Bolivarian Republic of),Australia,28,153,0,181
5430,2018,Samoa,Australia,0,42,0,42
5431,2018,Yemen,Australia,27,53,0,80
5432,2018,Zambia,Australia,8,28,0,36
5433,2018,Zimbabwe,Australia,851,173,0,1024
5434,2018,Stateless,Australia,4327,1373,0,5700
5435,2018,Tibetan,Australia,13,0,0,13
5436,2018,Unknown ,Australia,491,941,0,1432
5437,2018,Afghanistan,Austria,33103,16093,0,49196
5438,2018,Albania,Austria,81,48,0,129
5439,2018,Algeria,Austria,42,130,0,172
5440,2018,Angola,Austria,77,15,0,92
5441,2018,Egypt,Austria,208,212,0,420
5442,2018,Armenia,Austria,509,462,0,971
5443,2018,Azerbaijan,Austria,265,176,0,441
5444,2018,Burundi,Austria,18,0,0,18
5445,2018,Benin,Austria,5,34,0,39
5446,2018,Bangladesh,Austria,308,393,0,701
5447,2018,Bhutan,Austria,5,0,0,5
5448,2018,Burkina Faso,Austria,9,0,0,9
5449,2018,Belarus,Austria,70,27,0,97
5450,2018,Bolivia (Plurinational State of),Austria,11,0,0,11
5451,2018,Bosnia and Herzegovina,Austria,94,18,0,112
5452,2018,Canada,Austria,5,0,0,5
5453,2018,Chad,Austria,5,0,0,5
5454,2018,China,Austria,610,218,0,828
5455,2018,Cameroon,Austria,221,71,0,292
5456,2018,Congo,Austria,122,20,0,142
5457,2018,Dem. Rep. of the Congo,Austria,401,85,0,486
5458,2018,Colombia,Austria,0,5,0,5
5459,2018,Cuba,Austria,12,14,0,26
5460,2018,Eritrea,Austria,362,73,0,435
5461,2018,Ethiopia,Austria,218,118,0,336
5462,2018,Gabon,Austria,5,0,0,5
5463,2018,Gambia,Austria,138,153,0,291
5464,2018,Georgia,Austria,478,581,0,1059
5465,2018,Ghana,Austria,25,51,0,76
5466,2018,Guinea-Bissau,Austria,5,7,0,12
5467,2018,Guatemala,Austria,5,0,0,5
5468,2018,Guinea,Austria,139,60,0,199
5469,2018,Croatia,Austria,5,0,0,5
5470,2018,Hungary,Austria,0,8,0,8
5471,2018,Cote d'Ivoire,Austria,70,33,0,103
5472,2018,India,Austria,56,390,0,446
5473,2018,Iran (Islamic Rep. of),Austria,5772,2490,0,8262
5474,2018,Iraq,Austria,8295,5769,0,14064
5475,2018,Israel,Austria,11,5,0,16
5476,2018,Jordan,Austria,76,28,0,104
5477,2018,Kazakhstan,Austria,107,79,0,186
5478,2018,Kenya,Austria,30,17,0,47
5479,2018,Kyrgyzstan,Austria,208,34,0,242
5480,2018,Kuwait,Austria,5,7,0,12
5481,2018,Liberia,Austria,16,14,0,30
5482,2018,Libya,Austria,92,83,0,175
5483,2018,Lebanon,Austria,105,134,0,239
5484,2018,Sri Lanka,Austria,71,25,0,96
5485,2018,Madagascar,Austria,5,0,0,5
5486,2018,Mauritania,Austria,5,5,0,10
5487,2018,North Macedonia,Austria,56,65,0,121
5488,2018,Rep. of Moldova,Austria,51,45,0,96
5489,2018,Mali,Austria,11,16,0,27
5490,2018,Mongolia,Austria,141,242,0,383
5491,2018,Morocco,Austria,34,112,0,146
5492,2018,Montenegro,Austria,5,5,0,10
5493,2018,Myanmar,Austria,32,12,0,44
5494,2018,Nepal,Austria,35,71,0,106
5495,2018,Niger,Austria,0,5,0,5
5496,2018,Nicaragua,Austria,5,0,0,5
5497,2018,Nigeria,Austria,422,994,0,1416
5498,2018,Pakistan,Austria,296,754,0,1050
5499,2018,Philippines,Austria,13,19,0,32
5500,2018,Romania,Austria,7,5,0,12
5501,2018,South Africa,Austria,5,0,0,5
5502,2018,Russian Federation,Austria,9946,1635,0,11581
5503,2018,Rwanda,Austria,25,9,0,34
5504,2018,Saudi Arabia,Austria,5,0,0,5
5505,2018,Serbia and Kosovo: S/RES/1244 (1999),Austria,912,280,0,1192
5506,2018,Senegal,Austria,14,13,0,27
5507,2018,Sierra Leone,Austria,24,29,0,53
5508,2018,Somalia,Austria,6949,1423,0,8372
5509,2018,Viet Nam,Austria,9,17,0,26
5510,2018,Sudan,Austria,321,73,0,394
5511,2018,South Sudan,Austria,6,5,0,11
5512,2018,Syrian Arab Rep.,Austria,49179,1538,0,50717
5513,2018,Tajikistan,Austria,220,82,0,302
5514,2018,Turkmenistan,Austria,8,0,0,8
5515,2018,Togo,Austria,12,6,0,18
5516,2018,Tunisia,Austria,6,54,0,60
5517,2018,Türkiye,Austria,622,474,0,1096
5518,2018,Uganda,Austria,28,13,0,41
5519,2018,Ukraine,Austria,282,537,0,819
5520,2018,United States of America,Austria,5,0,0,5
5521,2018,Uzbekistan,Austria,77,116,0,193
5522,2018,Venezuela (Bolivarian Republic of),Austria,5,25,0,30
5523,2018,Yemen,Austria,258,74,0,332
5524,2018,Zambia,Austria,5,0,0,5
5525,2018,Zimbabwe,Austria,14,5,0,19
5526,2018,Stateless,Austria,2242,0,0,2242
5527,2018,Unknown ,Austria,4007,409,0,4416
5528,2018,Afghanistan,Azerbaijan,636,100,0,736
5529,2018,Azerbaijan,Azerbaijan,0,0,620423,0
5530,2018,Palestinian,Azerbaijan,5,0,0,5
5531,2018,Iran (Islamic Rep. of),Azerbaijan,43,9,0,52
5532,2018,Iraq,Azerbaijan,5,9,0,14
5533,2018,Libya,Azerbaijan,5,0,0,5
5534,2018,Nepal,Azerbaijan,0,7,0,7
5535,2018,Pakistan,Azerbaijan,15,44,0,59
5536,2018,Russian Federation,Azerbaijan,392,30,0,422
5537,2018,Syrian Arab Rep.,Azerbaijan,15,5,0,20
5538,2018,Ukraine,Azerbaijan,5,0,0,5
5539,2018,Yemen,Azerbaijan,9,5,0,14
5540,2018,Stateless,Azerbaijan,0,0,0,0
5541,2018,Egypt,Bahrain,0,5,0,5
5542,2018,Iraq,Bahrain,253,48,0,301
5543,2018,Yemen,Bahrain,9,5,0,14
5544,2018,Trinidad and Tobago,Barbados,0,5,0,5
5545,2018,Angola,Burundi,0,5,0,5
5546,2018,Burundi,Burundi,0,0,31909,0
5547,2018,Benin,Burundi,0,0,0,0
5548,2018,Central African Rep.,Burundi,7,0,0,7
5549,2018,Dem. Rep. of the Congo,Burundi,70941,4847,0,75788
5550,2018,Mali,Burundi,14,0,0,14
5551,2018,Rwanda,Burundi,479,801,0,1280
5552,2018,Somalia,Burundi,23,0,0,23
5553,2018,United Rep. of Tanzania,Burundi,5,0,0,5
5554,2018,Türkiye,Burundi,21,5,0,26
5555,2018,Uganda,Burundi,11,0,0,11
5556,2018,Stateless,Burundi,0,0,0,0
5557,2018,Afghanistan,Belgium,3201,2105,0,5306
5558,2018,Albania,Belgium,534,395,0,929
5559,2018,Algeria,Belgium,46,125,0,171
5560,2018,Angola,Belgium,91,125,0,216
5561,2018,Egypt,Belgium,50,70,0,120
5562,2018,Armenia,Belgium,127,175,0,302
5563,2018,Azerbaijan,Belgium,75,60,0,135
5564,2018,Burundi,Belgium,454,325,0,779
5565,2018,Benin,Belgium,30,50,0,80
5566,2018,Bangladesh,Belgium,18,15,0,33
5567,2018,Burkina Faso,Belgium,76,85,0,161
5568,2018,Belarus,Belgium,41,30,0,71
5569,2018,Brazil,Belgium,0,20,0,20
5570,2018,Bosnia and Herzegovina,Belgium,50,25,0,75
5571,2018,Bulgaria,Belgium,14,10,0,24
5572,2018,Cambodia,Belgium,8,0,0,8
5573,2018,Central African Rep.,Belgium,41,25,0,66
5574,2018,Chad,Belgium,34,30,0,64
5575,2018,China,Belgium,1197,60,0,1257
5576,2018,Chile,Belgium,48,10,0,58
5577,2018,Cameroon,Belgium,404,480,0,884
5578,2018,Congo,Belgium,31,20,0,51
5579,2018,Dem. Rep. of the Congo,Belgium,1015,575,0,1590
5580,2018,Colombia,Belgium,33,170,0,203
5581,2018,Cuba,Belgium,8,0,0,8
5582,2018,Czechia,Belgium,6,0,0,6
5583,2018,Djibouti,Belgium,267,80,0,347
5584,2018,Ecuador,Belgium,0,5,0,5
5585,2018,Eritrea,Belgium,1000,500,0,1500
5586,2018,Ethiopia,Belgium,121,50,0,171
5587,2018,Gabon,Belgium,16,25,0,41
5588,2018,Gambia,Belgium,15,55,0,70
5589,2018,Palestinian,Belgium,117,2250,0,2367
5590,2018,Georgia,Belgium,49,235,0,284
5591,2018,Ghana,Belgium,36,25,0,61
5592,2018,Guinea-Bissau,Belgium,11,10,0,21
5593,2018,Guatemala,Belgium,6,10,0,16
5594,2018,Guinea,Belgium,2690,1275,0,3965
5595,2018,Haiti,Belgium,5,0,0,5
5596,2018,Honduras,Belgium,0,5,0,5
5597,2018,Croatia,Belgium,5,0,0,5
5598,2018,Hungary,Belgium,49,0,0,49
5599,2018,Cote d'Ivoire,Belgium,153,205,0,358
5600,2018,India,Belgium,20,25,0,45
5601,2018,Iran (Islamic Rep. of),Belgium,960,470,0,1430
5602,2018,Iraq,Belgium,4000,1555,0,5555
5603,2018,Israel,Belgium,13,0,0,13
5604,2018,Jordan,Belgium,24,45,0,69
5605,2018,Kazakhstan,Belgium,38,10,0,48
5606,2018,Kenya,Belgium,22,10,0,32
5607,2018,Kyrgyzstan,Belgium,64,30,0,94
5608,2018,Dem. People's Rep. of Korea,Belgium,36,0,0,36
5609,2018,Kuwait,Belgium,7,0,0,7
5610,2018,Lao People's Dem. Rep.,Belgium,13,0,0,13
5611,2018,Liberia,Belgium,15,15,0,30
5612,2018,Libya,Belgium,60,125,0,185
5613,2018,Lebanon,Belgium,99,125,0,224
5614,2018,Sri Lanka,Belgium,394,40,0,434
5615,2018,Lithuania,Belgium,7,5,0,12
5616,2018,Madagascar,Belgium,5,5,0,10
5617,2018,Mauritania,Belgium,206,130,0,336
5618,2018,North Macedonia,Belgium,113,95,0,208
5619,2018,Rep. of Moldova,Belgium,5,5,0,10
5620,2018,Mexico,Belgium,0,10,0,10
5621,2018,Mali,Belgium,61,65,0,126
5622,2018,Mongolia,Belgium,0,10,0,10
5623,2018,Morocco,Belgium,70,165,0,235
5624,2018,Montenegro,Belgium,0,5,0,5
5625,2018,Myanmar,Belgium,9,0,0,9
5626,2018,Namibia,Belgium,0,5,0,5
5627,2018,Nepal,Belgium,13,5,0,18
5628,2018,Niger,Belgium,91,115,0,206
5629,2018,Nicaragua,Belgium,0,35,0,35
5630,2018,Nigeria,Belgium,43,85,0,128
5631,2018,Pakistan,Belgium,222,115,0,337
5632,2018,Peru,Belgium,0,10,0,10
5633,2018,Poland,Belgium,154,0,0,154
5634,2018,Romania,Belgium,38,10,0,48
5635,2018,South Africa,Belgium,5,5,0,10
5636,2018,Russian Federation,Belgium,2558,665,0,3223
5637,2018,Rwanda,Belgium,803,370,0,1173
5638,2018,El Salvador,Belgium,7,145,0,152
5639,2018,Saudi Arabia,Belgium,5,0,0,5
5640,2018,Serbia and Kosovo: S/RES/1244 (1999),Belgium,155,290,0,445
5641,2018,Senegal,Belgium,435,245,0,680
5642,2018,Sierra Leone,Belgium,26,40,0,66
5643,2018,Somalia,Belgium,1280,370,0,1650
5644,2018,Viet Nam,Belgium,40,5,0,45
5645,2018,Sudan,Belgium,174,210,0,384
5646,2018,Suriname,Belgium,0,5,0,5
5647,2018,South Sudan,Belgium,0,5,0,5
5648,2018,Slovakia,Belgium,0,5,0,5
5649,2018,Syrian Arab Rep.,Belgium,9080,2005,0,11085
5650,2018,United Rep. of Tanzania,Belgium,50,30,0,80
5651,2018,Tajikistan,Belgium,10,5,0,15
5652,2018,Turkmenistan,Belgium,5,5,0,10
5653,2018,Togo,Belgium,176,110,0,286
5654,2018,Tunisia,Belgium,37,35,0,72
5655,2018,Türkiye,Belgium,587,810,0,1397
5656,2018,Uganda,Belgium,20,5,0,25
5657,2018,Ukraine,Belgium,166,185,0,351
5658,2018,United States of America,Belgium,0,10,0,10
5659,2018,Uzbekistan,Belgium,32,5,0,37
5660,2018,Venezuela (Bolivarian Republic of),Belgium,6,385,0,391
5661,2018,Yemen,Belgium,24,95,0,119
5662,2018,Zimbabwe,Belgium,0,5,0,5
5663,2018,Stateless,Belgium,0,0,0,0
5664,2018,Unknown ,Belgium,7503,460,0,7963
5665,2018,Burundi,Benin,5,0,0,5
5666,2018,Central African Rep.,Benin,915,158,0,1073
5667,2018,Chad,Benin,5,18,0,23
5668,2018,Cameroon,Benin,0,25,0,25
5669,2018,Congo,Benin,0,6,0,6
5670,2018,Dem. Rep. of the Congo,Benin,11,26,0,37
5671,2018,Eritrea,Benin,5,0,0,5
5672,2018,Cote d'Ivoire,Benin,166,17,0,183
5673,2018,Liberia,Benin,0,5,0,5
5674,2018,Sri Lanka,Benin,7,0,0,7
5675,2018,Mali,Benin,20,0,0,20
5676,2018,Niger,Benin,0,5,0,5
5677,2018,Nigeria,Benin,0,9,0,9
5678,2018,Pakistan,Benin,5,0,0,5
5679,2018,Syrian Arab Rep.,Benin,12,0,0,12
5680,2018,Togo,Benin,0,34,0,34
5681,2018,Türkiye,Benin,8,0,0,8
5682,2018,Yemen,Benin,8,5,0,13
5683,2018,Myanmar,Bangladesh,906635,0,0,906635
5684,2018,Somalia,Bangladesh,5,15,0,20
5685,2018,Türkiye,Bangladesh,0,24,0,24
5686,2018,Stateless,Bangladesh,0,0,0,0
5687,2018,Colombia,Bahamas,5,0,0,5
5688,2018,Cuba,Bahamas,9,12,0,21
5689,2018,Haiti,Bahamas,0,5,0,5
5690,2018,South Africa,Bahamas,0,7,0,7
5691,2018,Burundi,Burkina Faso,28,0,0,28
5692,2018,Burkina Faso,Burkina Faso,0,0,47030,0
5693,2018,Central African Rep.,Burkina Faso,187,35,0,222
5694,2018,Chad,Burkina Faso,83,0,0,83
5695,2018,Cameroon,Burkina Faso,7,0,0,7
5696,2018,Congo,Burkina Faso,28,0,0,28
5697,2018,Dem. Rep. of the Congo,Burkina Faso,33,0,0,33
5698,2018,Cote d'Ivoire,Burkina Faso,5,0,0,5
5699,2018,Mali,Burkina Faso,24710,0,0,24710
5700,2018,Rwanda,Burkina Faso,20,0,0,20
5701,2018,Togo,Burkina Faso,14,0,0,14
5702,2018,Türkiye,Burkina Faso,5,5,0,10
5703,2018,Afghanistan,Belarus,208,31,0,239
5704,2018,Egypt,Belarus,5,0,0,5
5705,2018,Armenia,Belarus,5,0,0,5
5706,2018,Azerbaijan,Belarus,5,0,0,5
5707,2018,Cuba,Belarus,0,5,0,5
5708,2018,Ethiopia,Belarus,5,0,0,5
5709,2018,Georgia,Belarus,59,0,0,59
5710,2018,Iran (Islamic Rep. of),Belarus,6,0,0,6
5711,2018,Iraq,Belarus,13,5,0,18
5712,2018,Libya,Belarus,9,0,0,9
5713,2018,Syrian Arab Rep.,Belarus,66,5,0,71
5714,2018,Tajikistan,Belarus,12,0,0,12
5715,2018,Türkiye,Belarus,5,5,0,10
5716,2018,Ukraine,Belarus,1804,133,0,1937
5717,2018,Yemen,Belarus,23,0,0,23
5718,2018,Stateless,Belarus,0,0,0,0
5719,2018,Chile,Bolivia (Plurinational State of),8,0,0,8
5720,2018,Colombia,Bolivia (Plurinational State of),213,21,0,234
5721,2018,Cuba,Bolivia (Plurinational State of),9,0,0,9
5722,2018,Ecuador,Bolivia (Plurinational State of),5,0,0,5
5723,2018,Cote d'Ivoire,Bolivia (Plurinational State of),5,0,0,5
5724,2018,Iraq,Bolivia (Plurinational State of),16,0,0,16
5725,2018,Nigeria,Bolivia (Plurinational State of),0,5,0,5
5726,2018,Pakistan,Bolivia (Plurinational State of),5,0,0,5
5727,2018,Peru,Bolivia (Plurinational State of),515,0,0,515
5728,2018,Russian Federation,Bolivia (Plurinational State of),5,0,0,5
5729,2018,Syrian Arab Rep.,Bolivia (Plurinational State of),21,8,0,29
5730,2018,Angola,Botswana,0,0,0,0
5731,2018,Burundi,Botswana,50,34,0,84
5732,2018,Dem. Rep. of the Congo,Botswana,137,137,0,274
5733,2018,Eritrea,Botswana,10,0,0,10
5734,2018,Ethiopia,Botswana,5,0,0,5
5735,2018,Kenya,Botswana,5,0,0,5
5736,2018,Namibia,Botswana,846,15,0,861
5737,2018,Rwanda,Botswana,20,5,0,25
5738,2018,Somalia,Botswana,303,34,0,337
5739,2018,Sudan,Botswana,5,0,0,5
5740,2018,Uganda,Botswana,20,0,0,20
5741,2018,Zimbabwe,Botswana,643,43,0,686
5742,2018,Afghanistan,Brazil,121,178,0,299
5743,2018,Albania,Brazil,0,7,0,7
5744,2018,Algeria,Brazil,7,24,0,31
5745,2018,Angola,Brazil,1133,4737,0,5870
5746,2018,Egypt,Brazil,39,379,0,418
5747,2018,Argentina,Brazil,6,79,0,85
5748,2018,Armenia,Brazil,5,5,0,10
5749,2018,Burundi,Brazil,46,22,0,68
5750,2018,Belgium,Brazil,0,5,0,5
5751,2018,Benin,Brazil,0,244,0,244
5752,2018,Bangladesh,Brazil,11,4732,0,4743
5753,2018,Bhutan,Brazil,30,35,0,65
5754,2018,Burkina Faso,Brazil,5,257,0,262
5755,2018,Bolivia (Plurinational State of),Brazil,153,404,0,557
5756,2018,Bosnia and Herzegovina,Brazil,5,0,0,5
5757,2018,Bulgaria,Brazil,0,5,0,5
5758,2018,Canada,Brazil,0,5,0,5
5759,2018,Central African Rep.,Brazil,5,7,0,12
5760,2018,China,Brazil,7,3379,0,3386
5761,2018,Chile,Brazil,21,52,0,73
5762,2018,Cameroon,Brazil,61,492,0,553
5763,2018,Congo,Brazil,20,0,0,20
5764,2018,Dem. Rep. of the Congo,Brazil,1550,2734,0,4284
5765,2018,Colombia,Brazil,1297,1570,0,2867
5766,2018,Costa Rica,Brazil,0,10,0,10
5767,2018,Cuba,Brazil,199,6969,0,7168
5768,2018,Cabo Verde,Brazil,0,173,0,173
5769,2018,Czechia,Brazil,0,5,0,5
5770,2018,Denmark,Brazil,0,12,0,12
5771,2018,Djibouti,Brazil,0,11,0,11
5772,2018,Dominica,Brazil,0,14,0,14
5773,2018,Dominican Rep.,Brazil,5,1156,0,1161
5774,2018,Ecuador,Brazil,57,76,0,133
5775,2018,Equatorial Guinea,Brazil,0,6,0,6
5776,2018,Eritrea,Brazil,25,100,0,125
5777,2018,Ethiopia,Brazil,27,88,0,115
5778,2018,French Guiana,Brazil,0,18,0,18
5779,2018,Fiji,Brazil,0,17,0,17
5780,2018,France,Brazil,0,32,0,32
5781,2018,Gambia,Brazil,6,371,0,377
5782,2018,Palestinian,Brazil,545,321,0,866
5783,2018,United Kingdom of Great Britain and Northern Ireland,Brazil,0,6,0,6
5784,2018,Georgia,Brazil,10,0,0,10
5785,2018,Germany,Brazil,0,7,0,7
5786,2018,Ghana,Brazil,34,2320,0,2354
5787,2018,Guinea-Bissau,Brazil,21,1576,0,1597
5788,2018,Greece,Brazil,0,6,0,6
5789,2018,Guatemala,Brazil,0,14,0,14
5790,2018,Guinea,Brazil,94,862,0,956
5791,2018,Guyana,Brazil,5,75,0,80
5792,2018,Haiti,Brazil,8,13890,0,13898
5793,2018,Honduras,Brazil,0,14,0,14
5794,2018,Croatia,Brazil,5,0,0,5
5795,2018,Hungary,Brazil,0,5,0,5
5796,2018,Cote d'Ivoire,Brazil,51,180,0,231
5797,2018,India,Brazil,7,709,0,716
5798,2018,Indonesia,Brazil,0,7,0,7
5799,2018,Iran (Islamic Rep. of),Brazil,64,159,0,223
5800,2018,Iraq,Brazil,299,369,0,668
5801,2018,Israel,Brazil,0,30,0,30
5802,2018,Italy,Brazil,0,18,0,18
5803,2018,Jamaica,Brazil,0,11,0,11
5804,2018,Jordan,Brazil,10,82,0,92
5805,2018,Japan,Brazil,0,5,0,5
5806,2018,Kazakhstan,Brazil,0,5,0,5
5807,2018,Kenya,Brazil,0,80,0,80
5808,2018,Rep. of Korea,Brazil,0,119,0,119
5809,2018,Kuwait,Brazil,0,6,0,6
5810,2018,Liberia,Brazil,259,30,0,289
5811,2018,Libya,Brazil,5,40,0,45
5812,2018,Lebanon,Brazil,409,1767,0,2176
5813,2018,Lesotho,Brazil,0,5,0,5
5814,2018,Sri Lanka,Brazil,18,43,0,61
5815,2018,Lithuania,Brazil,0,5,0,5
5816,2018,"China, Macao SAR",Brazil,0,25,0,25
5817,2018,Mauritania,Brazil,0,200,0,200
5818,2018,North Macedonia,Brazil,6,5,0,11
5819,2018,Mexico,Brazil,6,33,0,39
5820,2018,Mali,Brazil,78,423,0,501
5821,2018,Malaysia,Brazil,0,5,0,5
5822,2018,Morocco,Brazil,15,508,0,523
5823,2018,Mozambique,Brazil,0,70,0,70
5824,2018,Malta,Brazil,0,5,0,5
5825,2018,Myanmar,Brazil,0,8,0,8
5826,2018,Namibia,Brazil,0,36,0,36
5827,2018,Nepal,Brazil,10,264,0,274
5828,2018,Netherlands,Brazil,0,5,0,5
5829,2018,Niger,Brazil,0,6,0,6
5830,2018,Nicaragua,Brazil,0,26,0,26
5831,2018,Nigeria,Brazil,133,3166,0,3299
5832,2018,Norway,Brazil,0,6,0,6
5833,2018,Pakistan,Brazil,315,1656,0,1971
5834,2018,Panama,Brazil,0,5,0,5
5835,2018,Paraguay,Brazil,8,89,0,97
5836,2018,Peru,Brazil,45,120,0,165
5837,2018,Philippines,Brazil,0,452,0,452
5838,2018,Poland,Brazil,0,9,0,9
5839,2018,Portugal,Brazil,0,82,0,82
5840,2018,Romania,Brazil,0,15,0,15
5841,2018,South Africa,Brazil,5,382,0,387
5842,2018,Russian Federation,Brazil,13,29,0,42
5843,2018,Rwanda,Brazil,18,5,0,23
5844,2018,El Salvador,Brazil,15,24,0,39
5845,2018,Saudi Arabia,Brazil,0,16,0,16
5846,2018,Serbia and Kosovo: S/RES/1244 (1999),Brazil,92,5,0,97
5847,2018,Senegal,Brazil,14,6069,0,6083
5848,2018,Sierra Leone,Brazil,158,357,0,515
5849,2018,Somalia,Brazil,47,556,0,603
5850,2018,Spain,Brazil,0,42,0,42
5851,2018,Viet Nam,Brazil,5,0,0,5
5852,2018,Sao Tome and Principe,Brazil,0,25,0,25
5853,2018,Sudan,Brazil,73,116,0,189
5854,2018,Suriname,Brazil,0,12,0,12
5855,2018,Sweden,Brazil,0,5,0,5
5856,2018,Syrian Arab Rep.,Brazil,3455,4270,0,7725
5857,2018,United Rep. of Tanzania,Brazil,7,108,0,115
5858,2018,Thailand,Brazil,0,31,0,31
5859,2018,Togo,Brazil,36,587,0,623
5860,2018,Tunisia,Brazil,0,101,0,101
5861,2018,Türkiye,Brazil,6,199,0,205
5862,2018,Uganda,Brazil,5,26,0,31
5863,2018,Ukraine,Brazil,14,65,0,79
5864,2018,Uruguay,Brazil,0,23,0,23
5865,2018,United States of America,Brazil,0,38,0,38
5866,2018,Uzbekistan,Brazil,0,5,0,5
5867,2018,Vanuatu,Brazil,0,40,0,40
5868,2018,Venezuela (Bolivarian Republic of),Brazil,35,81001,0,81036
5869,2018,Yemen,Brazil,0,86,0,86
5870,2018,Zambia,Brazil,0,5,0,5
5871,2018,Zimbabwe,Brazil,5,10,0,15
5872,2018,Unknown ,Brazil,0,37,0,37
5873,2018,Stateless,Brunei Darussalam,0,0,0,0
5874,2018,Afghanistan,Bosnia and Herzegovina,0,246,0,246
5875,2018,Algeria,Bosnia and Herzegovina,0,5,0,5
5876,2018,Bosnia and Herzegovina,Bosnia and Herzegovina,0,0,96830,0
5877,2018,Palestinian,Bosnia and Herzegovina,5,11,0,16
5878,2018,Croatia,Bosnia and Herzegovina,5120,0,0,5120
5879,2018,India,Bosnia and Herzegovina,0,13,0,13
5880,2018,Iran (Islamic Rep. of),Bosnia and Herzegovina,0,316,0,316
5881,2018,Iraq,Bosnia and Herzegovina,5,65,0,70
5882,2018,Libya,Bosnia and Herzegovina,0,7,0,7
5883,2018,North Macedonia,Bosnia and Herzegovina,5,0,0,5
5884,2018,Morocco,Bosnia and Herzegovina,0,7,0,7
5885,2018,Nepal,Bosnia and Herzegovina,0,8,0,8
5886,2018,Pakistan,Bosnia and Herzegovina,0,196,0,196
5887,2018,Russian Federation,Bosnia and Herzegovina,0,5,0,5
5888,2018,Serbia and Kosovo: S/RES/1244 (1999),Bosnia and Herzegovina,62,0,0,62
5889,2018,Somalia,Bosnia and Herzegovina,0,6,0,6
5890,2018,Syrian Arab Rep.,Bosnia and Herzegovina,15,67,0,82
5891,2018,Türkiye,Bosnia and Herzegovina,15,37,0,52
5892,2018,Yemen,Bosnia and Herzegovina,0,14,0,14
5893,2018,Stateless,Bosnia and Herzegovina,0,0,0,0
5894,2018,Afghanistan,Bulgaria,205,584,0,789
5895,2018,Algeria,Bulgaria,0,20,0,20
5896,2018,Egypt,Bulgaria,15,5,0,20
5897,2018,Armenia,Bulgaria,15,13,0,28
5898,2018,Bangladesh,Bulgaria,9,14,0,23
5899,2018,China,Bulgaria,0,15,0,15
5900,2018,Congo,Bulgaria,9,0,0,9
5901,2018,Dem. Rep. of the Congo,Bulgaria,5,5,0,10
5902,2018,Eritrea,Bulgaria,13,0,0,13
5903,2018,Ethiopia,Bulgaria,13,0,0,13
5904,2018,Ghana,Bulgaria,0,7,0,7
5905,2018,Cote d'Ivoire,Bulgaria,5,5,0,10
5906,2018,India,Bulgaria,5,5,0,10
5907,2018,Iran (Islamic Rep. of),Bulgaria,64,84,0,148
5908,2018,Iraq,Bulgaria,1253,362,0,1615
5909,2018,Jordan,Bulgaria,7,0,0,7
5910,2018,Kyrgyzstan,Bulgaria,0,7,0,7
5911,2018,Lebanon,Bulgaria,24,5,0,29
5912,2018,Mali,Bulgaria,5,8,0,13
5913,2018,Morocco,Bulgaria,5,0,0,5
5914,2018,Myanmar,Bulgaria,0,5,0,5
5915,2018,Nigeria,Bulgaria,0,7,0,7
5916,2018,Pakistan,Bulgaria,20,87,0,107
5917,2018,Russian Federation,Bulgaria,0,26,0,26
5918,2018,Somalia,Bulgaria,50,5,0,55
5919,2018,Sudan,Bulgaria,16,0,0,16
5920,2018,Syrian Arab Rep.,Bulgaria,17161,215,0,17376
5921,2018,Tunisia,Bulgaria,5,0,0,5
5922,2018,Türkiye,Bulgaria,12,8,0,20
5923,2018,Ukraine,Bulgaria,0,40,0,40
5924,2018,Yemen,Bulgaria,12,0,0,12
5925,2018,Stateless,Bulgaria,978,28,0,1006
5926,2018,Cuba,Belize,0,5,0,5
5927,2018,Guatemala,Belize,0,453,0,453
5928,2018,Honduras,Belize,5,617,0,622
5929,2018,Nicaragua,Belize,0,24,0,24
5930,2018,Peru,Belize,0,5,0,5
5931,2018,El Salvador,Belize,24,2201,0,2225
5932,2018,Unknown ,Belize,0,0,0,0
5933,2018,Stateless,Cambodia,0,0,0,0
5934,2018,Afghanistan,Canada,3603,769,0,4372
5935,2018,Albania,Canada,911,239,0,1150
5936,2018,Algeria,Canada,443,557,0,1000
5937,2018,Angola,Canada,132,709,0,841
5938,2018,Antigua and Barbuda,Canada,97,42,0,139
5939,2018,Egypt,Canada,1764,1411,0,3175
5940,2018,Argentina,Canada,20,35,0,55
5941,2018,Armenia,Canada,83,21,0,104
5942,2018,Austria,Canada,0,5,0,5
5943,2018,Azerbaijan,Canada,427,373,0,800
5944,2018,Bahrain,Canada,59,20,0,79
5945,2018,Barbados,Canada,200,71,0,271
5946,2018,Burundi,Canada,2194,893,0,3087
5947,2018,Belgium,Canada,16,25,0,41
5948,2018,Benin,Canada,65,50,0,115
5949,2018,Bangladesh,Canada,1020,1098,0,2118
5950,2018,Bahamas,Canada,231,295,0,526
5951,2018,Bhutan,Canada,5,5,0,10
5952,2018,Burkina Faso,Canada,95,110,0,205
5953,2018,Belarus,Canada,94,11,0,105
5954,2018,Bolivia (Plurinational State of),Canada,43,17,0,60
5955,2018,Botswana,Canada,262,8,0,270
5956,2018,Brazil,Canada,75,392,0,467
5957,2018,Bosnia and Herzegovina,Canada,34,5,0,39
5958,2018,Bulgaria,Canada,141,68,0,209
5959,2018,Belize,Canada,19,10,0,29
5960,2018,Cambodia,Canada,71,33,0,104
5961,2018,Central African Rep.,Canada,73,31,0,104
5962,2018,Chad,Canada,458,439,0,897
5963,2018,China,Canada,7192,2378,0,9570
5964,2018,Chile,Canada,51,144,0,195
5965,2018,Cameroon,Canada,1116,491,0,1607
5966,2018,Congo,Canada,300,169,0,469
5967,2018,Dem. Rep. of the Congo,Canada,1846,1494,0,3340
5968,2018,Comoros,Canada,5,5,0,10
5969,2018,Colombia,Canada,7356,3206,0,10562
5970,2018,Costa Rica,Canada,15,17,0,32
5971,2018,Cuba,Canada,767,132,0,899
5972,2018,Cyprus,Canada,7,10,0,17
5973,2018,Czechia,Canada,414,174,0,588
5974,2018,Denmark,Canada,0,18,0,18
5975,2018,Djibouti,Canada,1083,291,0,1374
5976,2018,Dominica,Canada,8,10,0,18
5977,2018,Dominican Rep.,Canada,124,134,0,258
5978,2018,Ecuador,Canada,54,56,0,110
5979,2018,Equatorial Guinea,Canada,18,6,0,24
5980,2018,Eritrea,Canada,2715,789,0,3504
5981,2018,Estonia,Canada,5,0,0,5
5982,2018,Ethiopia,Canada,1900,920,0,2820
5983,2018,Fiji,Canada,54,5,0,59
5984,2018,Finland,Canada,0,5,0,5
5985,2018,France,Canada,10,49,0,59
5986,2018,Gabon,Canada,36,34,0,70
5987,2018,Gambia,Canada,91,96,0,187
5988,2018,Palestinian,Canada,1120,998,0,2118
5989,2018,United Kingdom of Great Britain and Northern Ireland,Canada,11,0,0,11
5990,2018,Georgia,Canada,345,301,0,646
5991,2018,Germany,Canada,0,25,0,25
5992,2018,Ghana,Canada,352,293,0,645
5993,2018,Guinea-Bissau,Canada,9,10,0,19
5994,2018,Greece,Canada,14,23,0,37
5995,2018,Grenada,Canada,54,5,0,59
5996,2018,Guatemala,Canada,540,217,0,757
5997,2018,Guinea,Canada,446,273,0,719
5998,2018,Guyana,Canada,138,78,0,216
5999,2018,Haiti,Canada,7141,7046,0,14187
6000,2018,"China, Hong Kong SAR",Canada,6,5,0,11
6001,2018,Honduras,Canada,996,334,0,1330
6002,2018,Croatia,Canada,282,27,0,309
6003,2018,Hungary,Canada,3524,569,0,4093
6004,2018,Iceland,Canada,0,5,0,5
6005,2018,Cote d'Ivoire,Canada,251,159,0,410
6006,2018,India,Canada,1457,5522,0,6979
6007,2018,Indonesia,Canada,130,52,0,182
6008,2018,Ireland,Canada,0,28,0,28
6009,2018,Iran (Islamic Rep. of),Canada,2538,2547,0,5085
6010,2018,Iraq,Canada,3025,858,0,3883
6011,2018,Israel,Canada,207,63,0,270
6012,2018,Italy,Canada,5,110,0,115
6013,2018,Jamaica,Canada,933,270,0,1203
6014,2018,Jordan,Canada,453,567,0,1020
6015,2018,Japan,Canada,0,8,0,8
6016,2018,Kazakhstan,Canada,173,46,0,219
6017,2018,Kenya,Canada,475,364,0,839
6018,2018,Kyrgyzstan,Canada,71,15,0,86
6019,2018,Rep. of Korea,Canada,98,20,0,118
6020,2018,Dem. People's Rep. of Korea,Canada,478,0,0,478
6021,2018,Kuwait,Canada,85,32,0,117
6022,2018,Lao People's Dem. Rep.,Canada,5,0,0,5
6023,2018,Liberia,Canada,91,56,0,147
6024,2018,Libya,Canada,1330,483,0,1813
6025,2018,Saint Lucia,Canada,994,25,0,1019
6026,2018,Lebanon,Canada,886,479,0,1365
6027,2018,Sri Lanka,Canada,3624,702,0,4326
6028,2018,Lithuania,Canada,21,5,0,26
6029,2018,Luxembourg,Canada,0,5,0,5
6030,2018,Latvia,Canada,77,6,0,83
6031,2018,Madagascar,Canada,19,16,0,35
6032,2018,Mauritania,Canada,159,186,0,345
6033,2018,North Macedonia,Canada,47,0,0,47
6034,2018,Rep. of Moldova,Canada,126,5,0,131
6035,2018,Mexico,Canada,3457,3813,0,7270
6036,2018,Mali,Canada,163,145,0,308
6037,2018,Malaysia,Canada,29,16,0,45
6038,2018,Malawi,Canada,18,33,0,51
6039,2018,Mongolia,Canada,160,45,0,205
6040,2018,Morocco,Canada,153,103,0,256
6041,2018,Mozambique,Canada,0,8,0,8
6042,2018,Malta,Canada,5,0,0,5
6043,2018,Montenegro,Canada,21,0,0,21
6044,2018,Mauritius,Canada,8,11,0,19
6045,2018,Myanmar,Canada,55,23,0,78
6046,2018,Namibia,Canada,376,5,0,381
6047,2018,Nepal,Canada,611,213,0,824
6048,2018,Netherlands,Canada,5,30,0,35
6049,2018,Niger,Canada,59,74,0,133
6050,2018,Nicaragua,Canada,83,348,0,431
6051,2018,Nigeria,Canada,5483,13049,0,18532
6052,2018,Norway,Canada,0,5,0,5
6053,2018,Oman,Canada,7,0,0,7
6054,2018,Pakistan,Canada,5607,2901,0,8508
6055,2018,Panama,Canada,20,24,0,44
6056,2018,Paraguay,Canada,14,7,0,21
6057,2018,Peru,Canada,224,185,0,409
6058,2018,Philippines,Canada,94,75,0,169
6059,2018,Papua New Guinea,Canada,5,0,0,5
6060,2018,Poland,Canada,129,113,0,242
6061,2018,Portugal,Canada,0,18,0,18
6062,2018,Qatar,Canada,12,0,0,12
6063,2018,Romania,Canada,216,1040,0,1256
6064,2018,South Africa,Canada,67,216,0,283
6065,2018,Russian Federation,Canada,904,222,0,1126
6066,2018,Rwanda,Canada,936,464,0,1400
6067,2018,El Salvador,Canada,1559,708,0,2267
6068,2018,Saudi Arabia,Canada,375,269,0,644
6069,2018,Serbia and Kosovo: S/RES/1244 (1999),Canada,322,64,0,386
6070,2018,Senegal,Canada,248,210,0,458
6071,2018,Seychelles,Canada,5,0,0,5
6072,2018,Singapore,Canada,14,5,0,19
6073,2018,Sierra Leone,Canada,82,38,0,120
6074,2018,Solomon Islands,Canada,6,0,0,6
6075,2018,Somalia,Canada,3245,766,0,4011
6076,2018,Spain,Canada,6,59,0,65
6077,2018,Viet Nam,Canada,53,58,0,111
6078,2018,Saint Kitts and Nevis,Canada,45,0,0,45
6079,2018,Sudan,Canada,1173,735,0,1908
6080,2018,Suriname,Canada,5,7,0,12
6081,2018,South Sudan,Canada,13,17,0,30
6082,2018,Slovakia,Canada,1004,365,0,1369
6083,2018,Slovenia,Canada,7,5,0,12
6084,2018,Eswatini,Canada,148,0,0,148
6085,2018,Sweden,Canada,0,14,0,14
6086,2018,Syrian Arab Rep.,Canada,3558,803,0,4361
6087,2018,United Rep. of Tanzania,Canada,162,121,0,283
6088,2018,Thailand,Canada,14,7,0,21
6089,2018,Tajikistan,Canada,52,20,0,72
6090,2018,Turkmenistan,Canada,19,8,0,27
6091,2018,Timor-Leste,Canada,0,5,0,5
6092,2018,Togo,Canada,121,73,0,194
6093,2018,Trinidad and Tobago,Canada,111,40,0,151
6094,2018,Tunisia,Canada,189,120,0,309
6095,2018,Türkiye,Canada,4241,1928,0,6169
6096,2018,United Arab Emirates,Canada,39,10,0,49
6097,2018,Uganda,Canada,559,518,0,1077
6098,2018,Ukraine,Canada,1319,298,0,1617
6099,2018,Uruguay,Canada,7,9,0,16
6100,2018,United States of America,Canada,63,2507,0,2570
6101,2018,Uzbekistan,Canada,181,32,0,213
6102,2018,Saint Vincent and the Grenadines,Canada,1191,21,0,1212
6103,2018,Venezuela (Bolivarian Republic of),Canada,1876,1674,0,3550
6104,2018,Yemen,Canada,1089,689,0,1778
6105,2018,Zambia,Canada,29,22,0,51
6106,2018,Zimbabwe,Canada,1018,249,0,1267
6107,2018,Stateless,Canada,417,307,0,724
6108,2018,Unknown ,Canada,77,1586,0,1663
6109,2018,Angola,Central African Rep.,14,0,0,14
6110,2018,Burundi,Central African Rep.,25,0,0,25
6111,2018,Central African Rep.,Central African Rep.,0,0,640970,0
6112,2018,Chad,Central African Rep.,1695,37,0,1732
6113,2018,Cameroon,Central African Rep.,12,11,0,23
6114,2018,Congo,Central African Rep.,13,10,0,23
6115,2018,Dem. Rep. of the Congo,Central African Rep.,1547,301,0,1848
6116,2018,Guinea,Central African Rep.,7,0,0,7
6117,2018,Cote d'Ivoire,Central African Rep.,9,0,0,9
6118,2018,Liberia,Central African Rep.,9,5,0,14
6119,2018,Mali,Central African Rep.,5,0,0,5
6120,2018,Rwanda,Central African Rep.,199,0,0,199
6121,2018,Sudan,Central African Rep.,518,13,0,531
6122,2018,South Sudan,Central African Rep.,2573,5,0,2578
6123,2018,Togo,Central African Rep.,0,10,0,10
6124,2018,Türkiye,Central African Rep.,21,0,0,21
6125,2018,Uganda,Central African Rep.,5,5,0,10
6126,2018,Cuba,Cayman Islands,29,27,0,56
6127,2018,Mexico,Cayman Islands,5,0,0,5
6128,2018,Burundi,Chad,6,0,0,6
6129,2018,Central African Rep.,Chad,102087,1490,0,103577
6130,2018,Chad,Chad,0,0,165314,0
6131,2018,Cameroon,Chad,10,8,0,18
6132,2018,Congo,Chad,11,5,0,16
6133,2018,Dem. Rep. of the Congo,Chad,307,22,0,329
6134,2018,Eritrea,Chad,11,11,0,22
6135,2018,Ethiopia,Chad,24,14,0,38
6136,2018,Cote d'Ivoire,Chad,5,0,0,5
6137,2018,Libya,Chad,17,13,0,30
6138,2018,Niger,Chad,642,0,0,642
6139,2018,Nigeria,Chad,11310,23,0,11333
6140,2018,Rwanda,Chad,13,0,0,13
6141,2018,Somalia,Chad,10,0,0,10
6142,2018,Sudan,Chad,336674,1855,0,338529
6143,2018,South Sudan,Chad,8,7,0,15
6144,2018,Syrian Arab Rep.,Chad,57,14,0,71
6145,2018,Türkiye,Chad,6,0,0,6
6146,2018,Yemen,Chad,5,5,0,10
6147,2018,Afghanistan,China,9,23,0,32
6148,2018,Burundi,China,5,6,0,11
6149,2018,Cameroon,China,5,168,0,173
6150,2018,Dem. Rep. of the Congo,China,5,13,0,18
6151,2018,Eritrea,China,5,0,0,5
6152,2018,Palestinian,China,13,0,0,13
6153,2018,Ghana,China,5,12,0,17
6154,2018,Iraq,China,15,12,0,27
6155,2018,Kenya,China,0,60,0,60
6156,2018,Liberia,China,0,8,0,8
6157,2018,Mozambique,China,0,11,0,11
6158,2018,Nigeria,China,0,18,0,18
6159,2018,Pakistan,China,18,24,0,42
6160,2018,Rwanda,China,0,8,0,8
6161,2018,Sierra Leone,China,0,5,0,5
6162,2018,Somalia,China,100,17,0,117
6163,2018,Viet Nam,China,321502,0,0,321502
6164,2018,Syrian Arab Rep.,China,53,19,0,72
6165,2018,Türkiye,China,0,9,0,9
6166,2018,Uganda,China,5,55,0,60
6167,2018,Yemen,China,13,11,0,24
6168,2018,Zimbabwe,China,5,104,0,109
6169,2018,Afghanistan,Chile,13,13,0,26
6170,2018,Angola,Chile,0,8,0,8
6171,2018,Bangladesh,Chile,0,8,0,8
6172,2018,Bolivia (Plurinational State of),Chile,0,22,0,22
6173,2018,Brazil,Chile,0,5,0,5
6174,2018,Congo,Chile,8,5,0,13
6175,2018,Dem. Rep. of the Congo,Chile,5,0,0,5
6176,2018,Colombia,Chile,1218,5069,0,6287
6177,2018,Costa Rica,Chile,5,0,0,5
6178,2018,Cuba,Chile,18,3289,0,3307
6179,2018,Dominican Rep.,Chile,0,172,0,172
6180,2018,Ecuador,Chile,23,27,0,50
6181,2018,Palestinian,Chile,15,14,0,29
6182,2018,Ghana,Chile,0,10,0,10
6183,2018,Guatemala,Chile,0,5,0,5
6184,2018,Haiti,Chile,0,33,0,33
6185,2018,Honduras,Chile,5,0,0,5
6186,2018,Iraq,Chile,0,14,0,14
6187,2018,Kenya,Chile,5,0,0,5
6188,2018,Rep. of Korea,Chile,0,5,0,5
6189,2018,Sri Lanka,Chile,5,0,0,5
6190,2018,Mexico,Chile,0,5,0,5
6191,2018,Pakistan,Chile,0,7,0,7
6192,2018,Peru,Chile,113,19,0,132
6193,2018,Russian Federation,Chile,5,9,0,14
6194,2018,El Salvador,Chile,9,27,0,36
6195,2018,Senegal,Chile,5,5,0,10
6196,2018,Sierra Leone,Chile,0,5,0,5
6197,2018,Syrian Arab Rep.,Chile,107,36,0,143
6198,2018,Türkiye,Chile,26,5,0,31
6199,2018,United States of America,Chile,0,5,0,5
6200,2018,Venezuela (Bolivarian Republic of),Chile,9,3102,0,3111
6201,2018,Yemen,Chile,0,5,0,5
6202,2018,Unknown ,Chile,432,64,0,496
6203,2018,Angola,Cameroon,5,0,0,5
6204,2018,Burundi,Cameroon,70,25,0,95
6205,2018,Burkina Faso,Cameroon,0,23,0,23
6206,2018,Cambodia,Cameroon,5,0,0,5
6207,2018,Central African Rep.,Cameroon,274688,6533,0,281221
6208,2018,Chad,Cameroon,1567,458,0,2025
6209,2018,Cameroon,Cameroon,0,0,668494,0
6210,2018,Congo,Cameroon,54,21,0,75
6211,2018,Dem. Rep. of the Congo,Cameroon,534,176,0,710
6212,2018,Gambia,Cameroon,0,5,0,5
6213,2018,Guinea-Bissau,Cameroon,0,13,0,13
6214,2018,Guinea,Cameroon,12,176,0,188
6215,2018,Cote d'Ivoire,Cameroon,70,86,0,156
6216,2018,Iran (Islamic Rep. of),Cameroon,5,0,0,5
6217,2018,Liberia,Cameroon,9,0,0,9
6218,2018,Mauritania,Cameroon,5,0,0,5
6219,2018,Mali,Cameroon,0,162,0,162
6220,2018,Morocco,Cameroon,7,0,0,7
6221,2018,Niger,Cameroon,0,19,0,19
6222,2018,Nigeria,Cameroon,102287,37,0,102324
6223,2018,Rwanda,Cameroon,863,195,0,1058
6224,2018,Senegal,Cameroon,0,19,0,19
6225,2018,Sierra Leone,Cameroon,0,8,0,8
6226,2018,Sudan,Cameroon,94,39,0,133
6227,2018,South Sudan,Cameroon,13,0,0,13
6228,2018,Syrian Arab Rep.,Cameroon,22,6,0,28
6229,2018,Togo,Cameroon,17,11,0,28
6230,2018,Türkiye,Cameroon,0,80,0,80
6231,2018,Algeria,Congo,0,5,0,5
6232,2018,Angola,Congo,317,78,0,395
6233,2018,Burundi,Congo,94,12,0,106
6234,2018,Central African Rep.,Congo,24696,5507,0,30203
6235,2018,Chad,Congo,36,33,0,69
6236,2018,Cameroon,Congo,5,20,0,25
6237,2018,Congo,Congo,0,0,138000,0
6238,2018,Dem. Rep. of the Congo,Congo,11285,2737,0,14022
6239,2018,Guinea,Congo,0,8,0,8
6240,2018,Cote d'Ivoire,Congo,5,32,0,37
6241,2018,Liberia,Congo,0,10,0,10
6242,2018,Mauritania,Congo,5,94,0,99
6243,2018,Mali,Congo,5,11,0,16
6244,2018,Niger,Congo,0,5,0,5
6245,2018,Nigeria,Congo,5,0,0,5
6246,2018,Rwanda,Congo,991,529,0,1520
6247,2018,Sierra Leone,Congo,5,0,0,5
6248,2018,Sudan,Congo,30,58,0,88
6249,2018,South Sudan,Congo,0,13,0,13
6250,2018,Syrian Arab Rep.,Congo,12,19,0,31
6251,2018,Türkiye,Congo,0,5,0,5
6252,2018,Angola,Dem. Rep. of the Congo,490,13,0,503
6253,2018,Burundi,Dem. Rep. of the Congo,43010,529,0,43539
6254,2018,Central African Rep.,Dem. Rep. of the Congo,172011,619,0,172630
6255,2018,Chad,Dem. Rep. of the Congo,5,16,0,21
6256,2018,Cameroon,Dem. Rep. of the Congo,0,26,0,26
6257,2018,Congo,Dem. Rep. of the Congo,657,29,0,686
6258,2018,Dem. Rep. of the Congo,Dem. Rep. of the Congo,0,0,4516866,0
6259,2018,Eritrea,Dem. Rep. of the Congo,5,0,0,5
6260,2018,Cote d'Ivoire,Dem. Rep. of the Congo,5,7,0,12
6261,2018,Kenya,Dem. Rep. of the Congo,0,5,0,5
6262,2018,Liberia,Dem. Rep. of the Congo,5,19,0,24
6263,2018,Mali,Dem. Rep. of the Congo,0,15,0,15
6264,2018,Nepal,Dem. Rep. of the Congo,0,5,0,5
6265,2018,Niger,Dem. Rep. of the Congo,0,5,0,5
6266,2018,Rwanda,Dem. Rep. of the Congo,216986,171,0,217157
6267,2018,Somalia,Dem. Rep. of the Congo,14,52,0,66
6268,2018,Sudan,Dem. Rep. of the Congo,152,5,0,157
6269,2018,South Sudan,Dem. Rep. of the Congo,95704,4229,0,99933
6270,2018,Syrian Arab Rep.,Dem. Rep. of the Congo,5,20,0,25
6271,2018,Uganda,Dem. Rep. of the Congo,16,5,0,21
6272,2018,Afghanistan,Colombia,9,0,0,9
6273,2018,Bolivia (Plurinational State of),Colombia,5,0,0,5
6274,2018,Cameroon,Colombia,0,5,0,5
6275,2018,Colombia,Colombia,0,0,7816473,0
6276,2018,Cuba,Colombia,73,61,0,134
6277,2018,Ecuador,Colombia,8,0,0,8
6278,2018,Eritrea,Colombia,5,0,0,5
6279,2018,Ethiopia,Colombia,17,0,0,17
6280,2018,Palestinian,Colombia,0,5,0,5
6281,2018,Honduras,Colombia,5,0,0,5
6282,2018,Hungary,Colombia,6,0,0,6
6283,2018,Iraq,Colombia,9,0,0,9
6284,2018,Nicaragua,Colombia,14,0,0,14
6285,2018,Romania,Colombia,7,0,0,7
6286,2018,El Salvador,Colombia,11,0,0,11
6287,2018,Serbia and Kosovo: S/RES/1244 (1999),Colombia,7,0,0,7
6288,2018,Sierra Leone,Colombia,5,0,0,5
6289,2018,Somalia,Colombia,11,0,0,11
6290,2018,Syrian Arab Rep.,Colombia,8,8,0,16
6291,2018,Türkiye,Colombia,0,36,0,36
6292,2018,Venezuela (Bolivarian Republic of),Colombia,94,2729,0,2823
6293,2018,Yemen,Colombia,0,7,0,7
6294,2018,Stateless,Colombia,0,0,0,0
6295,2018,Angola,Costa Rica,0,15,0,15
6296,2018,Argentina,Costa Rica,0,14,0,14
6297,2018,Bangladesh,Costa Rica,0,16,0,16
6298,2018,Burkina Faso,Costa Rica,0,5,0,5
6299,2018,Brazil,Costa Rica,0,5,0,5
6300,2018,China,Costa Rica,0,11,0,11
6301,2018,Cameroon,Costa Rica,0,19,0,19
6302,2018,Congo,Costa Rica,0,57,0,57
6303,2018,Dem. Rep. of the Congo,Costa Rica,5,16,0,21
6304,2018,Colombia,Costa Rica,2258,898,0,3156
6305,2018,Cuba,Costa Rica,378,200,0,578
6306,2018,Ecuador,Costa Rica,0,13,0,13
6307,2018,Eritrea,Costa Rica,0,5,0,5
6308,2018,Ethiopia,Costa Rica,5,0,0,5
6309,2018,Gambia,Costa Rica,0,5,0,5
6310,2018,Germany,Costa Rica,0,5,0,5
6311,2018,Ghana,Costa Rica,0,58,0,58
6312,2018,Guatemala,Costa Rica,25,14,0,39
6313,2018,Haiti,Costa Rica,12,44,0,56
6314,2018,Honduras,Costa Rica,159,388,0,547
6315,2018,Cote d'Ivoire,Costa Rica,0,5,0,5
6316,2018,India,Costa Rica,5,0,0,5
6317,2018,Iran (Islamic Rep. of),Costa Rica,5,0,0,5
6318,2018,Israel,Costa Rica,0,5,0,5
6319,2018,Italy,Costa Rica,0,5,0,5
6320,2018,Mexico,Costa Rica,6,15,0,21
6321,2018,Nepal,Costa Rica,0,105,0,105
6322,2018,Niger,Costa Rica,0,5,0,5
6323,2018,Nicaragua,Costa Rica,456,22706,0,23162
6324,2018,Nigeria,Costa Rica,19,0,0,19
6325,2018,Pakistan,Costa Rica,0,11,0,11
6326,2018,Panama,Costa Rica,5,5,0,10
6327,2018,Peru,Costa Rica,15,0,0,15
6328,2018,Russian Federation,Costa Rica,19,5,0,24
6329,2018,El Salvador,Costa Rica,782,2310,0,3092
6330,2018,Senegal,Costa Rica,0,6,0,6
6331,2018,Somalia,Costa Rica,7,7,0,14
6332,2018,Spain,Costa Rica,0,8,0,8
6333,2018,Syrian Arab Rep.,Costa Rica,9,12,0,21
6334,2018,Ukraine,Costa Rica,17,0,0,17
6335,2018,United States of America,Costa Rica,0,26,0,26
6336,2018,Venezuela (Bolivarian Republic of),Costa Rica,344,5365,0,5709
6337,2018,Zimbabwe,Costa Rica,0,5,0,5
6338,2018,Stateless,Costa Rica,0,0,0,0
6339,2018,Unknown ,Costa Rica,0,201,0,201
6340,2018,Afghanistan,Cuba,42,0,0,42
6341,2018,Eritrea,Cuba,17,0,0,17
6342,2018,Ethiopia,Cuba,5,0,0,5
6343,2018,Palestinian,Cuba,6,0,0,6
6344,2018,Iran (Islamic Rep. of),Cuba,17,12,0,29
6345,2018,Iraq,Cuba,5,0,0,5
6346,2018,Sudan,Cuba,0,7,0,7
6347,2018,Syrian Arab Rep.,Cuba,44,5,0,49
6348,2018,Western Sahara,Cuba,134,0,0,134
6349,2018,Yemen,Cuba,17,0,0,17
6350,2018,Stateless,Cabo Verde,0,0,0,0
6351,2018,Afghanistan,Cyprus,14,5,0,19
6352,2018,Albania,Cyprus,0,5,0,5
6353,2018,Algeria,Cyprus,8,7,0,15
6354,2018,Egypt,Cyprus,110,706,0,816
6355,2018,Armenia,Cyprus,26,21,0,47
6356,2018,Bangladesh,Cyprus,5,750,0,755
6357,2018,Burkina Faso,Cyprus,0,5,0,5
6358,2018,Belarus,Cyprus,0,5,0,5
6359,2018,Bosnia and Herzegovina,Cyprus,15,0,0,15
6360,2018,China,Cyprus,5,7,0,12
6361,2018,Cameroon,Cyprus,59,660,0,719
6362,2018,Congo,Cyprus,6,32,0,38
6363,2018,Dem. Rep. of the Congo,Cyprus,21,120,0,141
6364,2018,Cuba,Cyprus,0,5,0,5
6365,2018,Eritrea,Cyprus,53,0,0,53
6366,2018,Ethiopia,Cyprus,10,13,0,23
6367,2018,Gambia,Cyprus,5,58,0,63
6368,2018,Palestinian,Cyprus,1997,294,0,2291
6369,2018,Georgia,Cyprus,85,475,0,560
6370,2018,Ghana,Cyprus,0,13,0,13
6371,2018,Guinea,Cyprus,5,15,0,20
6372,2018,Cote d'Ivoire,Cyprus,5,22,0,27
6373,2018,India,Cyprus,7,982,0,989
6374,2018,Iran (Islamic Rep. of),Cyprus,550,266,0,816
6375,2018,Iraq,Cyprus,890,445,0,1335
6376,2018,Jordan,Cyprus,38,70,0,108
6377,2018,Kazakhstan,Cyprus,5,0,0,5
6378,2018,Kyrgyzstan,Cyprus,5,0,0,5
6379,2018,Libya,Cyprus,0,9,0,9
6380,2018,Lebanon,Cyprus,52,45,0,97
6381,2018,Sri Lanka,Cyprus,25,364,0,389
6382,2018,Rep. of Moldova,Cyprus,18,5,0,23
6383,2018,Mali,Cyprus,0,5,0,5
6384,2018,Morocco,Cyprus,0,5,0,5
6385,2018,Nepal,Cyprus,0,205,0,205
6386,2018,Nigeria,Cyprus,12,192,0,204
6387,2018,Pakistan,Cyprus,17,590,0,607
6388,2018,Philippines,Cyprus,12,185,0,197
6389,2018,Russian Federation,Cyprus,77,45,0,122
6390,2018,Rwanda,Cyprus,5,0,0,5
6391,2018,Serbia and Kosovo: S/RES/1244 (1999),Cyprus,59,5,0,64
6392,2018,Senegal,Cyprus,0,23,0,23
6393,2018,Sierra Leone,Cyprus,24,5,0,29
6394,2018,Somalia,Cyprus,184,256,0,440
6395,2018,Viet Nam,Cyprus,0,529,0,529
6396,2018,Sudan,Cyprus,13,0,0,13
6397,2018,Syrian Arab Rep.,Cyprus,6259,2553,0,8812
6398,2018,Türkiye,Cyprus,210,111,0,321
6399,2018,Ukraine,Cyprus,30,120,0,150
6400,2018,Uzbekistan,Cyprus,5,5,0,10
6401,2018,Yemen,Cyprus,20,9,0,29
6402,2018,Zimbabwe,Cyprus,0,12,0,12
6403,2018,Stateless,Cyprus,56,0,0,56
6404,2018,Unknown ,Cyprus,0,8,0,8
6405,2018,Afghanistan,Czechia,46,16,0,62
6406,2018,Algeria,Czechia,0,8,0,8
6407,2018,Egypt,Czechia,5,7,0,12
6408,2018,Armenia,Czechia,29,74,0,103
6409,2018,Azerbaijan,Czechia,18,32,0,50
6410,2018,Belarus,Czechia,232,16,0,248
6411,2018,Bosnia and Herzegovina,Czechia,5,0,0,5
6412,2018,China,Czechia,20,0,0,20
6413,2018,Cameroon,Czechia,5,5,0,10
6414,2018,Dem. Rep. of the Congo,Czechia,8,0,0,8
6415,2018,Cuba,Czechia,61,25,0,86
6416,2018,Eritrea,Czechia,13,0,0,13
6417,2018,Ethiopia,Czechia,5,0,0,5
6418,2018,Georgia,Czechia,16,45,0,61
6419,2018,Guinea,Czechia,5,0,0,5
6420,2018,India,Czechia,0,5,0,5
6421,2018,Iran (Islamic Rep. of),Czechia,8,8,0,16
6422,2018,Iraq,Czechia,172,21,0,193
6423,2018,Jordan,Czechia,0,5,0,5
6424,2018,Kazakhstan,Czechia,120,24,0,144
6425,2018,Kyrgyzstan,Czechia,14,18,0,32
6426,2018,Libya,Czechia,14,14,0,28
6427,2018,Lebanon,Czechia,5,0,0,5
6428,2018,Sri Lanka,Czechia,7,0,0,7
6429,2018,Rep. of Moldova,Czechia,19,7,0,26
6430,2018,Mongolia,Czechia,6,6,0,12
6431,2018,Morocco,Czechia,5,0,0,5
6432,2018,Myanmar,Czechia,145,0,0,145
6433,2018,Nigeria,Czechia,8,17,0,25
6434,2018,Pakistan,Czechia,13,23,0,36
6435,2018,Russian Federation,Czechia,148,53,0,201
6436,2018,Saudi Arabia,Czechia,5,0,0,5
6437,2018,Serbia and Kosovo: S/RES/1244 (1999),Czechia,9,0,0,9
6438,2018,Sierra Leone,Czechia,5,0,0,5
6439,2018,Somalia,Czechia,10,5,0,15
6440,2018,Viet Nam,Czechia,16,45,0,61
6441,2018,Sudan,Czechia,11,0,0,11
6442,2018,Syrian Arab Rep.,Czechia,448,8,0,456
6443,2018,Turkmenistan,Czechia,7,0,0,7
6444,2018,Togo,Czechia,5,0,0,5
6445,2018,Tunisia,Czechia,0,8,0,8
6446,2018,Türkiye,Czechia,5,20,0,25
6447,2018,Uganda,Czechia,5,0,0,5
6448,2018,Ukraine,Czechia,318,241,0,559
6449,2018,Uzbekistan,Czechia,72,52,0,124
6450,2018,Venezuela (Bolivarian Republic of),Czechia,5,5,0,10
6451,2018,Yemen,Czechia,15,5,0,20
6452,2018,Stateless,Czechia,98,15,0,113
6453,2018,Unknown ,Czechia,0,1077,0,1077
6454,2018,Afghanistan,Denmark,2750,284,0,3034
6455,2018,Albania,Denmark,5,15,0,20
6456,2018,Algeria,Denmark,5,16,0,21
6457,2018,Egypt,Denmark,16,10,0,26
6458,2018,Armenia,Denmark,71,36,0,107
6459,2018,Azerbaijan,Denmark,41,16,0,57
6460,2018,Burundi,Denmark,5,5,0,10
6461,2018,Bangladesh,Denmark,20,6,0,26
6462,2018,Belarus,Denmark,5,18,0,23
6463,2018,Bosnia and Herzegovina,Denmark,5,0,0,5
6464,2018,China,Denmark,16,0,0,16
6465,2018,Cameroon,Denmark,6,17,0,23
6466,2018,Congo,Denmark,5,0,0,5
6467,2018,Dem. Rep. of the Congo,Denmark,84,15,0,99
6468,2018,Colombia,Denmark,5,35,0,40
6469,2018,Eritrea,Denmark,4610,322,0,4932
6470,2018,Ethiopia,Denmark,93,22,0,115
6471,2018,Gambia,Denmark,5,11,0,16
6472,2018,Palestinian,Denmark,20,0,0,20
6473,2018,Georgia,Denmark,5,145,0,150
6474,2018,Ghana,Denmark,5,10,0,15
6475,2018,Guinea-Bissau,Denmark,5,0,0,5
6476,2018,Guinea,Denmark,0,11,0,11
6477,2018,Cote d'Ivoire,Denmark,14,0,0,14
6478,2018,India,Denmark,5,9,0,14
6479,2018,Indonesia,Denmark,0,10,0,10
6480,2018,Iran (Islamic Rep. of),Denmark,3253,295,0,3548
6481,2018,Iraq,Denmark,446,172,0,618
6482,2018,Jordan,Denmark,5,13,0,18
6483,2018,Kenya,Denmark,6,9,0,15
6484,2018,Kyrgyzstan,Denmark,5,0,0,5
6485,2018,Dem. People's Rep. of Korea,Denmark,9,0,0,9
6486,2018,Libya,Denmark,11,13,0,24
6487,2018,Lebanon,Denmark,25,10,0,35
6488,2018,Sri Lanka,Denmark,61,28,0,89
6489,2018,North Macedonia,Denmark,0,9,0,9
6490,2018,Morocco,Denmark,8,51,0,59
6491,2018,Myanmar,Denmark,30,12,0,42
6492,2018,Nepal,Denmark,5,0,0,5
6493,2018,Nicaragua,Denmark,0,8,0,8
6494,2018,Nigeria,Denmark,12,40,0,52
6495,2018,Pakistan,Denmark,64,14,0,78
6496,2018,South Africa,Denmark,0,5,0,5
6497,2018,Russian Federation,Denmark,923,64,0,987
6498,2018,Rwanda,Denmark,17,0,0,17
6499,2018,El Salvador,Denmark,5,8,0,13
6500,2018,Serbia and Kosovo: S/RES/1244 (1999),Denmark,0,7,0,7
6501,2018,Senegal,Denmark,0,5,0,5
6502,2018,Sierra Leone,Denmark,0,5,0,5
6503,2018,Somalia,Denmark,1303,149,0,1452
6504,2018,Viet Nam,Denmark,0,14,0,14
6505,2018,Sudan,Denmark,71,6,0,77
6506,2018,Syrian Arab Rep.,Denmark,19698,292,0,19990
6507,2018,Thailand,Denmark,5,0,0,5
6508,2018,Tajikistan,Denmark,5,0,0,5
6509,2018,Tunisia,Denmark,0,9,0,9
6510,2018,Türkiye,Denmark,5,27,0,32
6511,2018,Uganda,Denmark,74,23,0,97
6512,2018,Ukraine,Denmark,27,46,0,73
6513,2018,Uzbekistan,Denmark,10,0,0,10
6514,2018,Venezuela (Bolivarian Republic of),Denmark,0,22,0,22
6515,2018,Yemen,Denmark,5,5,0,10
6516,2018,Zimbabwe,Denmark,10,0,0,10
6517,2018,Stateless,Denmark,2696,293,0,2989
6518,2018,Unknown ,Denmark,28,8,0,36
6519,2018,Eritrea,Djibouti,382,478,0,860
6520,2018,Ethiopia,Djibouti,510,9902,0,10412
6521,2018,Iraq,Djibouti,14,5,0,19
6522,2018,Kenya,Djibouti,11,0,0,11
6523,2018,Mali,Djibouti,0,5,0,5
6524,2018,Philippines,Djibouti,5,0,0,5
6525,2018,Somalia,Djibouti,12660,84,0,12744
6526,2018,Sudan,Djibouti,7,0,0,7
6527,2018,South Sudan,Djibouti,0,5,0,5
6528,2018,Syrian Arab Rep.,Djibouti,10,0,0,10
6529,2018,Yemen,Djibouti,4694,0,0,4694
6530,2018,Afghanistan,Dominican Rep.,0,5,0,5
6531,2018,Colombia,Dominican Rep.,0,6,0,6
6532,2018,Cuba,Dominican Rep.,0,18,0,18
6533,2018,Haiti,Dominican Rep.,164,221,0,385
6534,2018,Honduras,Dominican Rep.,0,5,0,5
6535,2018,Venezuela (Bolivarian Republic of),Dominican Rep.,0,72,0,72
6536,2018,Afghanistan,Ecuador,141,9,0,150
6537,2018,Albania,Ecuador,6,0,0,6
6538,2018,Angola,Ecuador,5,39,0,44
6539,2018,Egypt,Ecuador,0,10,0,10
6540,2018,Bangladesh,Ecuador,5,11,0,16
6541,2018,Brazil,Ecuador,5,8,0,13
6542,2018,Canada,Ecuador,0,5,0,5
6543,2018,China,Ecuador,12,0,0,12
6544,2018,Chile,Ecuador,5,8,0,13
6545,2018,Cameroon,Ecuador,6,17,0,23
6546,2018,Congo,Ecuador,5,0,0,5
6547,2018,Dem. Rep. of the Congo,Ecuador,0,35,0,35
6548,2018,Colombia,Ecuador,50532,10029,0,60561
6549,2018,Cuba,Ecuador,212,80,0,292
6550,2018,Dominican Rep.,Ecuador,5,10,0,15
6551,2018,Eritrea,Ecuador,11,0,0,11
6552,2018,Ethiopia,Ecuador,5,0,0,5
6553,2018,Gambia,Ecuador,0,5,0,5
6554,2018,Palestinian,Ecuador,7,5,0,12
6555,2018,Ghana,Ecuador,5,5,0,10
6556,2018,Guinea,Ecuador,9,0,0,9
6557,2018,Haiti,Ecuador,21,10,0,31
6558,2018,Honduras,Ecuador,0,5,0,5
6559,2018,Cote d'Ivoire,Ecuador,0,5,0,5
6560,2018,India,Ecuador,0,10,0,10
6561,2018,Iran (Islamic Rep. of),Ecuador,41,37,0,78
6562,2018,Iraq,Ecuador,61,7,0,68
6563,2018,Liberia,Ecuador,5,5,0,10
6564,2018,Libya,Ecuador,5,5,0,10
6565,2018,Lebanon,Ecuador,5,5,0,10
6566,2018,Sri Lanka,Ecuador,18,6,0,24
6567,2018,North Macedonia,Ecuador,14,0,0,14
6568,2018,Mexico,Ecuador,0,5,0,5
6569,2018,Mali,Ecuador,5,0,0,5
6570,2018,Morocco,Ecuador,5,0,0,5
6571,2018,Nepal,Ecuador,5,0,0,5
6572,2018,Nicaragua,Ecuador,0,11,0,11
6573,2018,Nigeria,Ecuador,26,19,0,45
6574,2018,Pakistan,Ecuador,28,8,0,36
6575,2018,Peru,Ecuador,82,91,0,173
6576,2018,Philippines,Ecuador,0,6,0,6
6577,2018,Russian Federation,Ecuador,31,5,0,36
6578,2018,El Salvador,Ecuador,15,18,0,33
6579,2018,Saudi Arabia,Ecuador,5,8,0,13
6580,2018,Somalia,Ecuador,8,0,0,8
6581,2018,Spain,Ecuador,5,0,0,5
6582,2018,Viet Nam,Ecuador,5,0,0,5
6583,2018,Sudan,Ecuador,5,5,0,10
6584,2018,Syrian Arab Rep.,Ecuador,102,90,0,192
6585,2018,Turkmenistan,Ecuador,0,8,0,8
6586,2018,Türkiye,Ecuador,0,6,0,6
6587,2018,Ukraine,Ecuador,14,0,0,14
6588,2018,United States of America,Ecuador,7,0,0,7
6589,2018,Uzbekistan,Ecuador,5,0,0,5
6590,2018,Venezuela (Bolivarian Republic of),Ecuador,15,6292,0,6307
6591,2018,Western Sahara,Ecuador,5,0,0,5
6592,2018,Yemen,Ecuador,50,101,0,151
6593,2018,Zimbabwe,Ecuador,5,0,0,5
6594,2018,Unknown ,Ecuador,49976,0,0,49976
6595,2018,Eritrea,Eritrea,0,0,0,0
6596,2018,Ethiopia,Eritrea,26,0,0,26
6597,2018,Somalia,Eritrea,2148,0,0,2148
6598,2018,Sudan,Eritrea,70,0,0,70
6599,2018,South Sudan,Eritrea,8,0,0,8
6600,2018,Afghanistan,Estonia,8,0,0,8
6601,2018,Egypt,Estonia,0,5,0,5
6602,2018,Azerbaijan,Estonia,5,0,0,5
6603,2018,Eritrea,Estonia,5,0,0,5
6604,2018,Georgia,Estonia,5,0,0,5
6605,2018,Iran (Islamic Rep. of),Estonia,0,5,0,5
6606,2018,Iraq,Estonia,25,0,0,25
6607,2018,Sri Lanka,Estonia,6,0,0,6
6608,2018,Pakistan,Estonia,5,5,0,10
6609,2018,Russian Federation,Estonia,22,6,0,28
6610,2018,Serbia and Kosovo: S/RES/1244 (1999),Estonia,5,0,0,5
6611,2018,Sudan,Estonia,18,0,0,18
6612,2018,Syrian Arab Rep.,Estonia,146,0,0,146
6613,2018,Ukraine,Estonia,64,9,0,73
6614,2018,Yemen,Estonia,5,0,0,5
6615,2018,Stateless,Estonia,0,0,0,0
6616,2018,Egypt,Ethiopia,5,0,0,5
6617,2018,Burundi,Ethiopia,62,68,0,130
6618,2018,Dem. Rep. of the Congo,Ethiopia,552,297,0,849
6619,2018,Cuba,Ethiopia,5,0,0,5
6620,2018,Djibouti,Ethiopia,79,8,0,87
6621,2018,Eritrea,Ethiopia,173965,139,0,174104
6622,2018,Ethiopia,Ethiopia,0,0,2615800,0
6623,2018,Cote d'Ivoire,Ethiopia,5,0,0,5
6624,2018,Iraq,Ethiopia,10,0,0,10
6625,2018,Kenya,Ethiopia,3471,429,0,3900
6626,2018,Rwanda,Ethiopia,11,6,0,17
6627,2018,Somalia,Ethiopia,257199,84,0,257283
6628,2018,Sudan,Ethiopia,44003,437,0,44440
6629,2018,South Sudan,Ethiopia,422135,400,0,422535
6630,2018,Syrian Arab Rep.,Ethiopia,9,70,0,79
6631,2018,Uganda,Ethiopia,17,5,0,22
6632,2018,Yemen,Ethiopia,1698,193,0,1891
6633,2018,Afghanistan,Fiji,0,7,0,7
6634,2018,Bangladesh,Fiji,0,5,0,5
6635,2018,Pakistan,Fiji,0,5,0,5
6636,2018,Afghanistan,Finland,2944,187,0,3131
6637,2018,Albania,Finland,5,7,0,12
6638,2018,Algeria,Finland,15,10,0,25
6639,2018,Angola,Finland,111,16,0,127
6640,2018,Egypt,Finland,14,15,0,29
6641,2018,Armenia,Finland,0,5,0,5
6642,2018,Azerbaijan,Finland,43,12,0,55
6643,2018,Burundi,Finland,5,5,0,10
6644,2018,Bangladesh,Finland,22,16,0,38
6645,2018,Burkina Faso,Finland,5,0,0,5
6646,2018,Belarus,Finland,13,15,0,28
6647,2018,Brazil,Finland,5,5,0,10
6648,2018,Bulgaria,Finland,0,5,0,5
6649,2018,Cambodia,Finland,5,0,0,5
6650,2018,Central African Rep.,Finland,5,0,0,5
6651,2018,China,Finland,125,11,0,136
6652,2018,Cameroon,Finland,91,56,0,147
6653,2018,Congo,Finland,10,0,0,10
6654,2018,Dem. Rep. of the Congo,Finland,135,19,0,154
6655,2018,Cuba,Finland,5,8,0,13
6656,2018,Dominican Rep.,Finland,5,0,0,5
6657,2018,Ecuador,Finland,5,0,0,5
6658,2018,Eritrea,Finland,840,12,0,852
6659,2018,Ethiopia,Finland,149,25,0,174
6660,2018,Gambia,Finland,30,12,0,42
6661,2018,Georgia,Finland,5,19,0,24
6662,2018,Ghana,Finland,53,7,0,60
6663,2018,Guatemala,Finland,5,0,0,5
6664,2018,Guinea,Finland,20,5,0,25
6665,2018,Honduras,Finland,13,0,0,13
6666,2018,Cote d'Ivoire,Finland,11,0,0,11
6667,2018,India,Finland,5,5,0,10
6668,2018,Iran (Islamic Rep. of),Finland,871,228,0,1099
6669,2018,Iraq,Finland,8523,1044,0,9567
6670,2018,Jordan,Finland,0,10,0,10
6671,2018,Kazakhstan,Finland,13,5,0,18
6672,2018,Kenya,Finland,13,5,0,18
6673,2018,Kyrgyzstan,Finland,19,0,0,19
6674,2018,Liberia,Finland,5,0,0,5
6675,2018,Libya,Finland,26,5,0,31
6676,2018,Lebanon,Finland,12,5,0,17
6677,2018,Sri Lanka,Finland,67,12,0,79
6678,2018,Mauritania,Finland,5,0,0,5
6679,2018,Rep. of Moldova,Finland,6,0,0,6
6680,2018,Mexico,Finland,0,5,0,5
6681,2018,Mali,Finland,6,0,0,6
6682,2018,Morocco,Finland,37,12,0,49
6683,2018,Myanmar,Finland,30,5,0,35
6684,2018,Nicaragua,Finland,0,26,0,26
6685,2018,Nigeria,Finland,160,78,0,238
6686,2018,Pakistan,Finland,70,21,0,91
6687,2018,Russian Federation,Finland,730,597,0,1327
6688,2018,Rwanda,Finland,26,11,0,37
6689,2018,El Salvador,Finland,10,0,0,10
6690,2018,Serbia and Kosovo: S/RES/1244 (1999),Finland,72,8,0,80
6691,2018,Senegal,Finland,5,5,0,10
6692,2018,Sierra Leone,Finland,6,5,0,11
6693,2018,Somalia,Finland,3319,172,0,3491
6694,2018,Viet Nam,Finland,5,0,0,5
6695,2018,Sudan,Finland,39,0,0,39
6696,2018,South Sudan,Finland,8,0,0,8
6697,2018,Syrian Arab Rep.,Finland,2497,73,0,2570
6698,2018,United Rep. of Tanzania,Finland,5,8,0,13
6699,2018,Tajikistan,Finland,0,5,0,5
6700,2018,Togo,Finland,5,0,0,5
6701,2018,Tunisia,Finland,5,0,0,5
6702,2018,Türkiye,Finland,183,268,0,451
6703,2018,Uganda,Finland,31,8,0,39
6704,2018,Ukraine,Finland,8,38,0,46
6705,2018,Uzbekistan,Finland,6,0,0,6
6706,2018,Venezuela (Bolivarian Republic of),Finland,5,8,0,13
6707,2018,Yemen,Finland,182,46,0,228
6708,2018,Zimbabwe,Finland,5,0,0,5
6709,2018,Stateless,Finland,414,16,0,430
6710,2018,Unknown ,Finland,159,58,0,217
6711,2018,Afghanistan,France,18534,8085,0,26619
6712,2018,Albania,France,5119,5019,0,10138
6713,2018,Algeria,France,1790,1395,0,3185
6714,2018,Angola,France,3541,942,0,4483
6715,2018,Egypt,France,980,413,0,1393
6716,2018,Argentina,France,5,5,0,10
6717,2018,Armenia,France,4197,1778,0,5975
6718,2018,Azerbaijan,France,2886,384,0,3270
6719,2018,Bahrain,France,10,0,0,10
6720,2018,Burundi,France,834,211,0,1045
6721,2018,Benin,France,49,46,0,95
6722,2018,Bangladesh,France,5631,3958,0,9589
6723,2018,Bhutan,France,123,5,0,128
6724,2018,Burkina Faso,France,236,231,0,467
6725,2018,Belarus,France,509,33,0,542
6726,2018,Bolivia (Plurinational State of),France,38,0,0,38
6727,2018,Brazil,France,15,0,0,15
6728,2018,Bosnia and Herzegovina,France,4099,448,0,4547
6729,2018,Bulgaria,France,70,0,0,70
6730,2018,Cambodia,France,11193,32,0,11225
6731,2018,Central African Rep.,France,2962,831,0,3793
6732,2018,Chad,France,1604,816,0,2420
6733,2018,China,France,5810,964,0,6774
6734,2018,Chile,France,69,0,0,69
6735,2018,Cameroon,France,1246,928,0,2174
6736,2018,Congo,France,3519,1058,0,4577
6737,2018,Dem. Rep. of the Congo,France,16484,3267,0,19751
6738,2018,Comoros,France,583,401,0,984
6739,2018,Colombia,France,527,211,0,738
6740,2018,Costa Rica,France,5,0,0,5
6741,2018,Cuba,France,179,28,0,207
6742,2018,Czechia,France,27,0,0,27
6743,2018,Djibouti,France,308,56,0,364
6744,2018,Dominican Rep.,France,56,0,0,56
6745,2018,Ecuador,France,25,0,0,25
6746,2018,Equatorial Guinea,France,32,17,0,49
6747,2018,Eritrea,France,5040,1092,0,6132
6748,2018,Estonia,France,7,0,0,7
6749,2018,Ethiopia,France,1423,774,0,2197
6750,2018,Gabon,France,179,365,0,544
6751,2018,Gambia,France,286,106,0,392
6752,2018,Palestinian,France,940,271,0,1211
6753,2018,Georgia,France,3233,4342,0,7575
6754,2018,Germany,France,5,0,0,5
6755,2018,Ghana,France,513,0,0,513
6756,2018,Guinea-Bissau,France,900,87,0,987
6757,2018,Guatemala,France,14,0,0,14
6758,2018,Guinea,France,9264,6076,0,15340
6759,2018,Guyana,France,17,0,0,17
6760,2018,Haiti,France,3567,1256,0,4823
6761,2018,Honduras,France,10,0,0,10
6762,2018,Croatia,France,59,0,0,59
6763,2018,Hungary,France,56,0,0,56
6764,2018,Cote d'Ivoire,France,4199,4794,0,8993
6765,2018,India,France,223,202,0,425
6766,2018,Indonesia,France,7,0,0,7
6767,2018,Iran (Islamic Rep. of),France,2757,647,0,3404
6768,2018,Iraq,France,8131,1521,0,9652
6769,2018,Israel,France,7,0,0,7
6770,2018,Jamaica,France,16,0,0,16
6771,2018,Jordan,France,31,5,0,36
6772,2018,Kazakhstan,France,584,181,0,765
6773,2018,Kenya,France,123,24,0,147
6774,2018,Kyrgyzstan,France,309,12,0,321
6775,2018,Rep. of Korea,France,0,7,0,7
6776,2018,Dem. People's Rep. of Korea,France,0,6,0,6
6777,2018,Kuwait,France,121,173,0,294
6778,2018,Lao People's Dem. Rep.,France,6617,5,0,6622
6779,2018,Liberia,France,239,35,0,274
6780,2018,Libya,France,721,792,0,1513
6781,2018,Lebanon,France,140,124,0,264
6782,2018,Sri Lanka,France,23918,1837,0,25755
6783,2018,Lithuania,France,9,0,0,9
6784,2018,Latvia,France,33,0,0,33
6785,2018,Madagascar,France,218,51,0,269
6786,2018,Mauritania,France,5419,959,0,6378
6787,2018,North Macedonia,France,351,666,0,1017
6788,2018,Rep. of Moldova,France,319,187,0,506
6789,2018,Maldives,France,5,0,0,5
6790,2018,Mexico,France,24,0,0,24
6791,2018,Mali,France,4773,2162,0,6935
6792,2018,Malaysia,France,11,0,0,11
6793,2018,Mongolia,France,445,193,0,638
6794,2018,Morocco,France,632,449,0,1081
6795,2018,Mozambique,France,11,5,0,16
6796,2018,Montenegro,France,89,32,0,121
6797,2018,Mauritius,France,26,5,0,31
6798,2018,Myanmar,France,321,28,0,349
6799,2018,Nepal,France,141,70,0,211
6800,2018,Niger,France,89,45,0,134
6801,2018,Nicaragua,France,8,5,0,13
6802,2018,Nigeria,France,2525,2880,0,5405
6803,2018,Pakistan,France,1639,1891,0,3530
6804,2018,Paraguay,France,6,0,0,6
6805,2018,Peru,France,315,33,0,348
6806,2018,Philippines,France,5,0,0,5
6807,2018,Poland,France,139,0,0,139
6808,2018,Romania,France,146,0,0,146
6809,2018,South Africa,France,42,0,0,42
6810,2018,Russian Federation,France,15898,2492,0,18390
6811,2018,Rwanda,France,2890,368,0,3258
6812,2018,El Salvador,France,55,14,0,69
6813,2018,Saudi Arabia,France,12,0,0,12
6814,2018,Serbia and Kosovo: S/RES/1244 (1999),France,13778,2454,0,16232
6815,2018,Senegal,France,1351,1196,0,2547
6816,2018,Sierra Leone,France,580,271,0,851
6817,2018,Somalia,France,3640,2483,0,6123
6818,2018,Viet Nam,France,7821,26,0,7847
6819,2018,Sao Tome and Principe,France,5,0,0,5
6820,2018,Sudan,France,14700,3949,0,18649
6821,2018,Suriname,France,5,0,0,5
6822,2018,South Sudan,France,40,0,0,40
6823,2018,Slovakia,France,113,0,0,113
6824,2018,Syrian Arab Rep.,France,15822,3352,0,19174
6825,2018,United Rep. of Tanzania,France,9,5,0,14
6826,2018,Thailand,France,6,0,0,6
6827,2018,Tajikistan,France,48,0,0,48
6828,2018,Turkmenistan,France,23,0,0,23
6829,2018,Togo,France,743,248,0,991
6830,2018,Tunisia,France,326,225,0,551
6831,2018,Türkiye,France,11196,1628,0,12824
6832,2018,Uganda,France,133,16,0,149
6833,2018,Ukraine,France,1715,703,0,2418
6834,2018,Uzbekistan,France,212,9,0,221
6835,2018,Venezuela (Bolivarian Republic of),France,304,403,0,707
6836,2018,Western Sahara,France,573,1097,0,1670
6837,2018,Yemen,France,338,196,0,534
6838,2018,Zambia,France,5,0,0,5
6839,2018,Zimbabwe,France,46,6,0,52
6840,2018,Stateless,France,0,515,0,515
6841,2018,Unknown ,France,91266,1442,0,92708
6842,2018,Burundi,Gabon,5,0,0,5
6843,2018,Central African Rep.,Gabon,38,9,0,47
6844,2018,Chad,Gabon,421,12,0,433
6845,2018,Cameroon,Gabon,5,0,0,5
6846,2018,Congo,Gabon,85,0,0,85
6847,2018,Dem. Rep. of the Congo,Gabon,74,56,0,130
6848,2018,Equatorial Guinea,Gabon,5,5,0,10
6849,2018,Mauritania,Gabon,7,0,0,7
6850,2018,Sao Tome and Principe,Gabon,26,0,0,26
6851,2018,Sudan,Gabon,5,0,0,5
6852,2018,Togo,Gabon,15,0,0,15
6853,2018,Central African Rep.,Gambia,0,15,0,15
6854,2018,Congo,Gambia,0,5,0,5
6855,2018,Dem. Rep. of the Congo,Gambia,48,6,0,54
6856,2018,Guinea-Bissau,Gambia,0,6,0,6
6857,2018,Guinea,Gambia,5,5,0,10
6858,2018,Cote d'Ivoire,Gambia,138,5,0,143
6859,2018,Liberia,Gambia,14,0,0,14
6860,2018,Senegal,Gambia,3709,296,0,4005
6861,2018,Sierra Leone,Gambia,106,11,0,117
6862,2018,Togo,Gambia,7,0,0,7
6863,2018,Afghanistan,United Kingdom of Great Britain and Northern Ireland,9839,2438,0,12277
6864,2018,Albania,United Kingdom of Great Britain and Northern Ireland,2617,4150,0,6767
6865,2018,Algeria,United Kingdom of Great Britain and Northern Ireland,337,257,0,594
6866,2018,Angola,United Kingdom of Great Britain and Northern Ireland,178,66,0,244
6867,2018,Antigua and Barbuda,United Kingdom of Great Britain and Northern Ireland,5,0,0,5
6868,2018,Egypt,United Kingdom of Great Britain and Northern Ireland,758,327,0,1085
6869,2018,Armenia,United Kingdom of Great Britain and Northern Ireland,59,10,0,69
6870,2018,Australia,United Kingdom of Great Britain and Northern Ireland,5,7,0,12
6871,2018,Azerbaijan,United Kingdom of Great Britain and Northern Ireland,134,56,0,190
6872,2018,Bahrain,United Kingdom of Great Britain and Northern Ireland,168,11,0,179
6873,2018,Barbados,United Kingdom of Great Britain and Northern Ireland,11,0,0,11
6874,2018,Burundi,United Kingdom of Great Britain and Northern Ireland,50,11,0,61
6875,2018,Benin,United Kingdom of Great Britain and Northern Ireland,7,15,0,22
6876,2018,Bangladesh,United Kingdom of Great Britain and Northern Ireland,1363,1483,0,2846
6877,2018,Bahamas,United Kingdom of Great Britain and Northern Ireland,5,5,0,10
6878,2018,Bhutan,United Kingdom of Great Britain and Northern Ireland,71,0,0,71
6879,2018,Burkina Faso,United Kingdom of Great Britain and Northern Ireland,7,5,0,12
6880,2018,Belarus,United Kingdom of Great Britain and Northern Ireland,131,17,0,148
6881,2018,Bolivia (Plurinational State of),United Kingdom of Great Britain and Northern Ireland,14,20,0,34
6882,2018,Botswana,United Kingdom of Great Britain and Northern Ireland,22,38,0,60
6883,2018,Brazil,United Kingdom of Great Britain and Northern Ireland,16,62,0,78
6884,2018,Bosnia and Herzegovina,United Kingdom of Great Britain and Northern Ireland,21,5,0,26
6885,2018,Belize,United Kingdom of Great Britain and Northern Ireland,5,0,0,5
6886,2018,Canada,United Kingdom of Great Britain and Northern Ireland,10,0,0,10
6887,2018,Central African Rep.,United Kingdom of Great Britain and Northern Ireland,10,0,0,10
6888,2018,Chad,United Kingdom of Great Britain and Northern Ireland,41,23,0,64
6889,2018,China,United Kingdom of Great Britain and Northern Ireland,1465,952,0,2417
6890,2018,Chile,United Kingdom of Great Britain and Northern Ireland,0,6,0,6
6891,2018,Cameroon,United Kingdom of Great Britain and Northern Ireland,633,189,0,822
6892,2018,Congo,United Kingdom of Great Britain and Northern Ireland,122,23,0,145
6893,2018,Dem. Rep. of the Congo,United Kingdom of Great Britain and Northern Ireland,1091,198,0,1289
6894,2018,Comoros,United Kingdom of Great Britain and Northern Ireland,5,5,0,10
6895,2018,Colombia,United Kingdom of Great Britain and Northern Ireland,31,21,0,52
6896,2018,Costa Rica,United Kingdom of Great Britain and Northern Ireland,0,5,0,5
6897,2018,Cuba,United Kingdom of Great Britain and Northern Ireland,12,0,0,12
6898,2018,Cabo Verde,United Kingdom of Great Britain and Northern Ireland,5,0,0,5
6899,2018,Cyprus,United Kingdom of Great Britain and Northern Ireland,0,5,0,5
6900,2018,Djibouti,United Kingdom of Great Britain and Northern Ireland,5,5,0,10
6901,2018,Dominica,United Kingdom of Great Britain and Northern Ireland,17,7,0,24
6902,2018,Ecuador,United Kingdom of Great Britain and Northern Ireland,9,9,0,18
6903,2018,Eritrea,United Kingdom of Great Britain and Northern Ireland,13041,1833,0,14874
6904,2018,Ethiopia,United Kingdom of Great Britain and Northern Ireland,1601,500,0,2101
6905,2018,Fiji,United Kingdom of Great Britain and Northern Ireland,8,0,0,8
6906,2018,Gabon,United Kingdom of Great Britain and Northern Ireland,5,0,0,5
6907,2018,Gambia,United Kingdom of Great Britain and Northern Ireland,1308,113,0,1421
6908,2018,Palestinian,United Kingdom of Great Britain and Northern Ireland,536,259,0,795
6909,2018,Georgia,United Kingdom of Great Britain and Northern Ireland,68,80,0,148
6910,2018,Germany,United Kingdom of Great Britain and Northern Ireland,0,5,0,5
6911,2018,Ghana,United Kingdom of Great Britain and Northern Ireland,315,260,0,575
6912,2018,Guinea-Bissau,United Kingdom of Great Britain and Northern Ireland,7,5,0,12
6913,2018,Greece,United Kingdom of Great Britain and Northern Ireland,5,0,0,5
6914,2018,Grenada,United Kingdom of Great Britain and Northern Ireland,20,16,0,36
6915,2018,Guatemala,United Kingdom of Great Britain and Northern Ireland,7,5,0,12
6916,2018,Guinea,United Kingdom of Great Britain and Northern Ireland,258,49,0,307
6917,2018,Guyana,United Kingdom of Great Britain and Northern Ireland,20,0,0,20
6918,2018,Haiti,United Kingdom of Great Britain and Northern Ireland,0,9,0,9
6919,2018,"China, Hong Kong SAR",United Kingdom of Great Britain and Northern Ireland,0,11,0,11
6920,2018,Honduras,United Kingdom of Great Britain and Northern Ireland,38,60,0,98
6921,2018,Cote d'Ivoire,United Kingdom of Great Britain and Northern Ireland,223,73,0,296
6922,2018,India,United Kingdom of Great Britain and Northern Ireland,396,1667,0,2063
6923,2018,Indonesia,United Kingdom of Great Britain and Northern Ireland,23,27,0,50
6924,2018,Iran (Islamic Rep. of),United Kingdom of Great Britain and Northern Ireland,17231,3276,0,20507
6925,2018,Iraq,United Kingdom of Great Britain and Northern Ireland,4708,3420,0,8128
6926,2018,Israel,United Kingdom of Great Britain and Northern Ireland,6,5,0,11
6927,2018,Jamaica,United Kingdom of Great Britain and Northern Ireland,376,138,0,514
6928,2018,Jordan,United Kingdom of Great Britain and Northern Ireland,70,56,0,126
6929,2018,Japan,United Kingdom of Great Britain and Northern Ireland,0,5,0,5
6930,2018,Kazakhstan,United Kingdom of Great Britain and Northern Ireland,19,35,0,54
6931,2018,Kenya,United Kingdom of Great Britain and Northern Ireland,289,195,0,484
6932,2018,Kyrgyzstan,United Kingdom of Great Britain and Northern Ireland,34,15,0,49
6933,2018,Rep. of Korea,United Kingdom of Great Britain and Northern Ireland,6,0,0,6
6934,2018,Dem. People's Rep. of Korea,United Kingdom of Great Britain and Northern Ireland,81,29,0,110
6935,2018,Kuwait,United Kingdom of Great Britain and Northern Ireland,583,424,0,1007
6936,2018,Lao People's Dem. Rep.,United Kingdom of Great Britain and Northern Ireland,5,0,0,5
6937,2018,Liberia,United Kingdom of Great Britain and Northern Ireland,31,11,0,42
6938,2018,Libya,United Kingdom of Great Britain and Northern Ireland,3003,815,0,3818
6939,2018,Saint Lucia,United Kingdom of Great Britain and Northern Ireland,22,19,0,41
6940,2018,Lebanon,United Kingdom of Great Britain and Northern Ireland,171,50,0,221
6941,2018,Lesotho,United Kingdom of Great Britain and Northern Ireland,0,5,0,5
6942,2018,Sri Lanka,United Kingdom of Great Britain and Northern Ireland,5711,1019,0,6730
6943,2018,Lithuania,United Kingdom of Great Britain and Northern Ireland,0,5,0,5
6944,2018,Mauritania,United Kingdom of Great Britain and Northern Ireland,6,5,0,11
6945,2018,North Macedonia,United Kingdom of Great Britain and Northern Ireland,20,0,0,20
6946,2018,Rep. of Moldova,United Kingdom of Great Britain and Northern Ireland,16,5,0,21
6947,2018,Maldives,United Kingdom of Great Britain and Northern Ireland,37,10,0,47
6948,2018,Mexico,United Kingdom of Great Britain and Northern Ireland,12,17,0,29
6949,2018,Mali,United Kingdom of Great Britain and Northern Ireland,19,11,0,30
6950,2018,Malaysia,United Kingdom of Great Britain and Northern Ireland,210,190,0,400
6951,2018,Malawi,United Kingdom of Great Britain and Northern Ireland,329,90,0,419
6952,2018,Mongolia,United Kingdom of Great Britain and Northern Ireland,76,37,0,113
6953,2018,Morocco,United Kingdom of Great Britain and Northern Ireland,198,114,0,312
6954,2018,Mozambique,United Kingdom of Great Britain and Northern Ireland,5,5,0,10
6955,2018,Mauritius,United Kingdom of Great Britain and Northern Ireland,48,81,0,129
6956,2018,Myanmar,United Kingdom of Great Britain and Northern Ireland,721,61,0,782
6957,2018,Namibia,United Kingdom of Great Britain and Northern Ireland,55,248,0,303
6958,2018,Nepal,United Kingdom of Great Britain and Northern Ireland,38,172,0,210
6959,2018,Niger,United Kingdom of Great Britain and Northern Ireland,6,5,0,11
6960,2018,Nicaragua,United Kingdom of Great Britain and Northern Ireland,0,35,0,35
6961,2018,Nigeria,United Kingdom of Great Britain and Northern Ireland,2535,1755,0,4290
6962,2018,Norway,United Kingdom of Great Britain and Northern Ireland,5,0,0,5
6963,2018,Oman,United Kingdom of Great Britain and Northern Ireland,16,11,0,27
6964,2018,Pakistan,United Kingdom of Great Britain and Northern Ireland,7742,2618,0,10360
6965,2018,Philippines,United Kingdom of Great Britain and Northern Ireland,30,105,0,135
6966,2018,Qatar,United Kingdom of Great Britain and Northern Ireland,5,0,0,5
6967,2018,Romania,United Kingdom of Great Britain and Northern Ireland,5,5,0,10
6968,2018,South Africa,United Kingdom of Great Britain and Northern Ireland,167,118,0,285
6969,2018,Russian Federation,United Kingdom of Great Britain and Northern Ireland,571,219,0,790
6970,2018,Rwanda,United Kingdom of Great Britain and Northern Ireland,116,26,0,142
6971,2018,El Salvador,United Kingdom of Great Britain and Northern Ireland,102,161,0,263
6972,2018,Saudi Arabia,United Kingdom of Great Britain and Northern Ireland,165,74,0,239
6973,2018,Serbia and Kosovo: S/RES/1244 (1999),United Kingdom of Great Britain and Northern Ireland,90,46,0,136
6974,2018,Senegal,United Kingdom of Great Britain and Northern Ireland,105,21,0,126
6975,2018,Seychelles,United Kingdom of Great Britain and Northern Ireland,5,0,0,5
6976,2018,Singapore,United Kingdom of Great Britain and Northern Ireland,5,5,0,10
6977,2018,Sierra Leone,United Kingdom of Great Britain and Northern Ireland,310,98,0,408
6978,2018,Somalia,United Kingdom of Great Britain and Northern Ireland,3920,396,0,4316
6979,2018,Viet Nam,United Kingdom of Great Britain and Northern Ireland,1416,1597,0,3013
6980,2018,Saint Kitts and Nevis,United Kingdom of Great Britain and Northern Ireland,8,11,0,19
6981,2018,Sudan,United Kingdom of Great Britain and Northern Ireland,8959,1705,0,10664
6982,2018,South Sudan,United Kingdom of Great Britain and Northern Ireland,44,22,0,66
6983,2018,Eswatini,United Kingdom of Great Britain and Northern Ireland,57,0,0,57
6984,2018,Syrian Arab Rep.,United Kingdom of Great Britain and Northern Ireland,9720,685,0,10405
6985,2018,United Rep. of Tanzania,United Kingdom of Great Britain and Northern Ireland,92,58,0,150
6986,2018,Thailand,United Kingdom of Great Britain and Northern Ireland,38,43,0,81
6987,2018,Tajikistan,United Kingdom of Great Britain and Northern Ireland,10,7,0,17
6988,2018,Turkmenistan,United Kingdom of Great Britain and Northern Ireland,15,17,0,32
6989,2018,Timor-Leste,United Kingdom of Great Britain and Northern Ireland,0,5,0,5
6990,2018,Togo,United Kingdom of Great Britain and Northern Ireland,18,9,0,27
6991,2018,Trinidad and Tobago,United Kingdom of Great Britain and Northern Ireland,81,33,0,114
6992,2018,Tunisia,United Kingdom of Great Britain and Northern Ireland,53,43,0,96
6993,2018,Türkiye,United Kingdom of Great Britain and Northern Ireland,1267,742,0,2009
6994,2018,United Arab Emirates,United Kingdom of Great Britain and Northern Ireland,20,8,0,28
6995,2018,Uganda,United Kingdom of Great Britain and Northern Ireland,1216,183,0,1399
6996,2018,Ukraine,United Kingdom of Great Britain and Northern Ireland,144,178,0,322
6997,2018,United States of America,United Kingdom of Great Britain and Northern Ireland,52,52,0,104
6998,2018,Uzbekistan,United Kingdom of Great Britain and Northern Ireland,71,22,0,93
6999,2018,Saint Vincent and the Grenadines,United Kingdom of Great Britain and Northern Ireland,26,10,0,36
7000,2018,Venezuela (Bolivarian Republic of),United Kingdom of Great Britain and Northern Ireland,41,21,0,62
7001,2018,Western Sahara,United Kingdom of Great Britain and Northern Ireland,11,5,0,16
7002,2018,Yemen,United Kingdom of Great Britain and Northern Ireland,624,168,0,792
7003,2018,Zambia,United Kingdom of Great Britain and Northern Ireland,82,28,0,110
7004,2018,Zimbabwe,United Kingdom of Great Britain and Northern Ireland,6772,273,0,7045
7005,2018,Stateless,United Kingdom of Great Britain and Northern Ireland,2502,484,0,2986
7006,2018,Unknown ,United Kingdom of Great Britain and Northern Ireland,6175,7156,0,13331
7007,2018,Afghanistan,Georgia,5,37,0,42
7008,2018,Egypt,Georgia,43,49,0,92
7009,2018,Armenia,Georgia,0,5,0,5
7010,2018,Azerbaijan,Georgia,6,14,0,20
7011,2018,Bangladesh,Georgia,0,19,0,19
7012,2018,Cameroon,Georgia,0,5,0,5
7013,2018,Congo,Georgia,0,8,0,8
7014,2018,Ethiopia,Georgia,0,5,0,5
7015,2018,Georgia,Georgia,0,0,282382,0
7016,2018,Ghana,Georgia,0,5,0,5
7017,2018,India,Georgia,0,23,0,23
7018,2018,Iran (Islamic Rep. of),Georgia,34,183,0,217
7019,2018,Iraq,Georgia,560,46,0,606
7020,2018,Lebanon,Georgia,6,5,0,11
7021,2018,Nigeria,Georgia,0,18,0,18
7022,2018,Pakistan,Georgia,11,14,0,25
7023,2018,South Africa,Georgia,0,6,0,6
7024,2018,Russian Federation,Georgia,235,21,0,256
7025,2018,Sierra Leone,Georgia,0,5,0,5
7026,2018,Somalia,Georgia,0,27,0,27
7027,2018,Sudan,Georgia,6,6,0,12
7028,2018,Syrian Arab Rep.,Georgia,428,24,0,452
7029,2018,Tajikistan,Georgia,5,0,0,5
7030,2018,Türkiye,Georgia,5,85,0,90
7031,2018,Ukraine,Georgia,617,10,0,627
7032,2018,Yemen,Georgia,20,35,0,55
7033,2018,Stateless,Georgia,0,5,0,5
7034,2018,Unknown ,Georgia,6,17,0,23
7035,2018,Afghanistan,Germany,126018,65838,0,191856
7036,2018,Albania,Germany,1170,3146,0,4316
7037,2018,Algeria,Germany,589,1295,0,1884
7038,2018,Angola,Germany,846,370,0,1216
7039,2018,Egypt,Germany,2122,2589,0,4711
7040,2018,Argentina,Germany,14,11,0,25
7041,2018,Armenia,Germany,2474,7262,0,9736
7042,2018,Australia,Germany,5,0,0,5
7043,2018,Austria,Germany,5,0,0,5
7044,2018,Azerbaijan,Germany,3643,6195,0,9838
7045,2018,Bahrain,Germany,79,14,0,93
7046,2018,Burundi,Germany,106,55,0,161
7047,2018,Belgium,Germany,5,0,0,5
7048,2018,Benin,Germany,82,238,0,320
7049,2018,Bangladesh,Germany,706,1341,0,2047
7050,2018,Bhutan,Germany,22,5,0,27
7051,2018,Burkina Faso,Germany,82,192,0,274
7052,2018,Belarus,Germany,186,283,0,469
7053,2018,Bolivia (Plurinational State of),Germany,6,0,0,6
7054,2018,Botswana,Germany,5,5,0,10
7055,2018,Brazil,Germany,32,29,0,61
7056,2018,Bosnia and Herzegovina,Germany,1473,665,0,2138
7057,2018,Bulgaria,Germany,78,15,0,93
7058,2018,Cambodia,Germany,30,47,0,77
7059,2018,Canada,Germany,24,5,0,29
7060,2018,Central African Rep.,Germany,37,54,0,91
7061,2018,Chad,Germany,91,292,0,383
7062,2018,China,Germany,1620,972,0,2592
7063,2018,Chile,Germany,170,0,0,170
7064,2018,Cameroon,Germany,698,2990,0,3688
7065,2018,Congo,Germany,276,104,0,380
7066,2018,Dem. Rep. of the Congo,Germany,1650,655,0,2305
7067,2018,Comoros,Germany,0,16,0,16
7068,2018,Colombia,Germany,66,196,0,262
7069,2018,Cuba,Germany,93,68,0,161
7070,2018,Czechia,Germany,752,0,0,752
7071,2018,Djibouti,Germany,33,20,0,53
7072,2018,Dominican Rep.,Germany,8,6,0,14
7073,2018,Ecuador,Germany,13,5,0,18
7074,2018,Equatorial Guinea,Germany,23,8,0,31
7075,2018,Eritrea,Germany,55334,5914,0,61248
7076,2018,Estonia,Germany,5,0,0,5
7077,2018,Ethiopia,Germany,4780,6730,0,11510
7078,2018,France,Germany,15,0,0,15
7079,2018,Gabon,Germany,10,38,0,48
7080,2018,Gambia,Germany,899,7391,0,8290
7081,2018,United Kingdom of Great Britain and Northern Ireland,Germany,15,0,0,15
7082,2018,Georgia,Germany,633,4717,0,5350
7083,2018,Ghana,Germany,549,1742,0,2291
7084,2018,Guinea-Bissau,Germany,92,293,0,385
7085,2018,Greece,Germany,49,0,0,49
7086,2018,Guatemala,Germany,5,10,0,15
7087,2018,Guinea,Germany,2393,6167,0,8560
7088,2018,Haiti,Germany,17,9,0,26
7089,2018,Honduras,Germany,64,16,0,80
7090,2018,Croatia,Germany,299,5,0,304
7091,2018,Hungary,Germany,250,0,0,250
7092,2018,Iceland,Germany,5,0,0,5
7093,2018,Cote d'Ivoire,Germany,520,2046,0,2566
7094,2018,India,Germany,370,1313,0,1683
7095,2018,Indonesia,Germany,13,18,0,31
7096,2018,Iran (Islamic Rep. of),Germany,41150,21407,0,62557
7097,2018,Iraq,Germany,136463,41954,0,178417
7098,2018,Israel,Germany,41,36,0,77
7099,2018,Italy,Germany,27,25,0,52
7100,2018,Jamaica,Germany,55,38,0,93
7101,2018,Jordan,Germany,382,387,0,769
7102,2018,Japan,Germany,24,0,0,24
7103,2018,Kazakhstan,Germany,99,191,0,290
7104,2018,Kenya,Germany,183,645,0,828
7105,2018,Kyrgyzstan,Germany,167,310,0,477
7106,2018,Rep. of Korea,Germany,86,9,0,95
7107,2018,Dem. People's Rep. of Korea,Germany,34,57,0,91
7108,2018,Kuwait,Germany,27,51,0,78
7109,2018,Lao People's Dem. Rep.,Germany,41,0,0,41
7110,2018,Liberia,Germany,100,363,0,463
7111,2018,Libya,Germany,1732,1345,0,3077
7112,2018,Lebanon,Germany,1557,2820,0,4377
7113,2018,Sri Lanka,Germany,3820,1494,0,5314
7114,2018,Lithuania,Germany,5,0,0,5
7115,2018,Latvia,Germany,8,5,0,13
7116,2018,Madagascar,Germany,5,18,0,23
7117,2018,Mauritania,Germany,34,87,0,121
7118,2018,North Macedonia,Germany,669,1982,0,2651
7119,2018,Rep. of Moldova,Germany,106,979,0,1085
7120,2018,Mexico,Germany,22,154,0,176
7121,2018,Mali,Germany,272,933,0,1205
7122,2018,Malaysia,Germany,14,17,0,31
7123,2018,Malawi,Germany,5,13,0,18
7124,2018,Mongolia,Germany,130,717,0,847
7125,2018,Morocco,Germany,712,1310,0,2022
7126,2018,Mozambique,Germany,14,23,0,37
7127,2018,Montenegro,Germany,288,272,0,560
7128,2018,Mauritius,Germany,5,5,0,10
7129,2018,Myanmar,Germany,854,150,0,1004
7130,2018,Namibia,Germany,0,16,0,16
7131,2018,Nepal,Germany,56,129,0,185
7132,2018,Netherlands,Germany,25,0,0,25
7133,2018,Niger,Germany,55,169,0,224
7134,2018,Nicaragua,Germany,5,27,0,32
7135,2018,Nigeria,Germany,6435,21477,0,27912
7136,2018,New Zealand,Germany,8,0,0,8
7137,2018,Oman,Germany,9,6,0,15
7138,2018,Pakistan,Germany,7454,13645,0,21099
7139,2018,Peru,Germany,39,0,0,39
7140,2018,Philippines,Germany,33,37,0,70
7141,2018,Poland,Germany,636,5,0,641
7142,2018,Portugal,Germany,5,0,0,5
7143,2018,Romania,Germany,155,11,0,166
7144,2018,South Africa,Germany,17,50,0,67
7145,2018,Russian Federation,Germany,8119,18059,0,26178
7146,2018,Rwanda,Germany,239,159,0,398
7147,2018,El Salvador,Germany,42,5,0,47
7148,2018,Saudi Arabia,Germany,130,36,0,166
7149,2018,Serbia and Kosovo: S/RES/1244 (1999),Germany,9155,4404,0,13559
7150,2018,Senegal,Germany,157,575,0,732
7151,2018,Singapore,Germany,8,0,0,8
7152,2018,Sierra Leone,Germany,730,1582,0,2312
7153,2018,Solomon Islands,Germany,6,0,0,6
7154,2018,Somalia,Germany,23581,9853,0,33434
7155,2018,Spain,Germany,17,25,0,42
7156,2018,Viet Nam,Germany,1236,246,0,1482
7157,2018,Sudan,Germany,2436,1843,0,4279
7158,2018,South Sudan,Germany,76,79,0,155
7159,2018,Slovakia,Germany,87,0,0,87
7160,2018,Slovenia,Germany,6,0,0,6
7161,2018,Eswatini,Germany,5,0,0,5
7162,2018,Sweden,Germany,8,0,0,8
7163,2018,Syrian Arab Rep.,Germany,532065,52396,0,584461
7164,2018,United Rep. of Tanzania,Germany,60,210,0,270
7165,2018,Thailand,Germany,25,5,0,30
7166,2018,Tajikistan,Germany,666,1901,0,2567
7167,2018,Turkmenistan,Germany,84,199,0,283
7168,2018,Togo,Germany,1074,1086,0,2160
7169,2018,Trinidad and Tobago,Germany,5,0,0,5
7170,2018,Tunisia,Germany,197,599,0,796
7171,2018,Türkiye,Germany,24036,14704,0,38740
7172,2018,United Arab Emirates,Germany,33,5,0,38
7173,2018,Uganda,Germany,197,333,0,530
7174,2018,Ukraine,Germany,741,3149,0,3890
7175,2018,United States of America,Germany,133,26,0,159
7176,2018,Uzbekistan,Germany,107,124,0,231
7177,2018,Saint Vincent and the Grenadines,Germany,5,0,0,5
7178,2018,Venezuela (Bolivarian Republic of),Germany,183,468,0,651
7179,2018,Yemen,Germany,1809,873,0,2682
7180,2018,Zambia,Germany,8,12,0,20
7181,2018,Zimbabwe,Germany,204,288,0,492
7182,2018,Stateless,Germany,9250,1967,0,11217
7183,2018,Unknown ,Germany,31203,9264,0,40467
7184,2018,Egypt,Ghana,0,16,0,16
7185,2018,Burundi,Ghana,12,13,0,25
7186,2018,Benin,Ghana,5,0,0,5
7187,2018,Central African Rep.,Ghana,117,90,0,207
7188,2018,Chad,Ghana,31,11,0,42
7189,2018,Cameroon,Ghana,6,127,0,133
7190,2018,Congo,Ghana,7,17,0,24
7191,2018,Dem. Rep. of the Congo,Ghana,46,36,0,82
7192,2018,Eritrea,Ghana,69,98,0,167
7193,2018,Ethiopia,Ghana,7,7,0,14
7194,2018,Palestinian,Ghana,14,6,0,20
7195,2018,Cote d'Ivoire,Ghana,6585,345,0,6930
7196,2018,Iraq,Ghana,11,0,0,11
7197,2018,Liberia,Ghana,735,0,0,735
7198,2018,Libya,Ghana,0,8,0,8
7199,2018,Lebanon,Ghana,8,0,0,8
7200,2018,Mali,Ghana,0,5,0,5
7201,2018,Nigeria,Ghana,9,19,0,28
7202,2018,Pakistan,Ghana,26,31,0,57
7203,2018,Rwanda,Ghana,36,0,0,36
7204,2018,Sierra Leone,Ghana,88,5,0,93
7205,2018,Somalia,Ghana,63,18,0,81
7206,2018,Sudan,Ghana,413,229,0,642
7207,2018,South Sudan,Ghana,6,5,0,11
7208,2018,Syrian Arab Rep.,Ghana,157,85,0,242
7209,2018,Togo,Ghana,3431,83,0,3514
7210,2018,Türkiye,Ghana,0,47,0,47
7211,2018,Uganda,Ghana,5,6,0,11
7212,2018,Uzbekistan,Ghana,9,0,0,9
7213,2018,Yemen,Ghana,0,5,0,5
7214,2018,Burundi,Guinea-Bissau,11,0,0,11
7215,2018,Congo,Guinea-Bissau,5,0,0,5
7216,2018,Dem. Rep. of the Congo,Guinea-Bissau,5,0,0,5
7217,2018,Comoros,Guinea-Bissau,15,6,0,21
7218,2018,Gambia,Guinea-Bissau,6,0,0,6
7219,2018,Guinea,Guinea-Bissau,10,0,0,10
7220,2018,Liberia,Guinea-Bissau,5,0,0,5
7221,2018,Nigeria,Guinea-Bissau,5,0,0,5
7222,2018,Senegal,Guinea-Bissau,3707,5,0,3712
7223,2018,Sierra Leone,Guinea-Bissau,12,5,0,17
7224,2018,Türkiye,Guinea-Bissau,0,5,0,5
7225,2018,Unknown ,Guinea-Bissau,1072,0,0,1072
7226,2018,Afghanistan,Greece,9291,13533,0,22824
7227,2018,Albania,Greece,156,3593,0,3749
7228,2018,Algeria,Greece,86,677,0,763
7229,2018,Angola,Greece,5,10,0,15
7230,2018,Egypt,Greece,264,1284,0,1548
7231,2018,Armenia,Greece,11,103,0,114
7232,2018,Azerbaijan,Greece,5,0,0,5
7233,2018,Burundi,Greece,30,24,0,54
7234,2018,Bangladesh,Greece,273,2311,0,2584
7235,2018,Burkina Faso,Greece,15,53,0,68
7236,2018,Belarus,Greece,5,13,0,18
7237,2018,Brazil,Greece,0,9,0,9
7238,2018,Bosnia and Herzegovina,Greece,0,5,0,5
7239,2018,Central African Rep.,Greece,12,5,0,17
7240,2018,Chad,Greece,5,8,0,13
7241,2018,China,Greece,71,590,0,661
7242,2018,Cameroon,Greece,278,970,0,1248
7243,2018,Congo,Greece,96,97,0,193
7244,2018,Dem. Rep. of the Congo,Greece,549,1699,0,2248
7245,2018,Comoros,Greece,6,7,0,13
7246,2018,Colombia,Greece,0,5,0,5
7247,2018,Cuba,Greece,0,8,0,8
7248,2018,Djibouti,Greece,0,5,0,5
7249,2018,Dominican Rep.,Greece,8,23,0,31
7250,2018,Equatorial Guinea,Greece,5,0,0,5
7251,2018,Eritrea,Greece,935,302,0,1237
7252,2018,Ethiopia,Greece,363,225,0,588
7253,2018,Gabon,Greece,0,10,0,10
7254,2018,Gambia,Greece,28,58,0,86
7255,2018,Palestinian,Greece,1290,1242,0,2532
7256,2018,Georgia,Greece,267,1700,0,1967
7257,2018,Ghana,Greece,52,200,0,252
7258,2018,Guinea,Greece,87,216,0,303
7259,2018,Haiti,Greece,8,16,0,24
7260,2018,Cote d'Ivoire,Greece,77,57,0,134
7261,2018,India,Greece,29,296,0,325
7262,2018,Indonesia,Greece,15,32,0,47
7263,2018,Iran (Islamic Rep. of),Greece,1532,1935,0,3467
7264,2018,Iraq,Greece,8828,9066,0,17894
7265,2018,Jordan,Greece,19,37,0,56
7266,2018,Kazakhstan,Greece,5,5,0,10
7267,2018,Kenya,Greece,28,10,0,38
7268,2018,Kuwait,Greece,85,60,0,145
7269,2018,Liberia,Greece,0,5,0,5
7270,2018,Libya,Greece,39,48,0,87
7271,2018,Lebanon,Greece,41,99,0,140
7272,2018,Sri Lanka,Greece,44,75,0,119
7273,2018,Mauritania,Greece,53,21,0,74
7274,2018,North Macedonia,Greece,0,5,0,5
7275,2018,Rep. of Moldova,Greece,13,41,0,54
7276,2018,Mali,Greece,47,84,0,131
7277,2018,Morocco,Greece,150,345,0,495
7278,2018,Myanmar,Greece,50,65,0,115
7279,2018,Nepal,Greece,10,138,0,148
7280,2018,Niger,Greece,5,5,0,10
7281,2018,Nigeria,Greece,285,274,0,559
7282,2018,Pakistan,Greece,902,9868,0,10770
7283,2018,Philippines,Greece,7,7,0,14
7284,2018,Russian Federation,Greece,12,67,0,79
7285,2018,Rwanda,Greece,10,10,0,20
7286,2018,El Salvador,Greece,10,5,0,15
7287,2018,Saudi Arabia,Greece,7,0,0,7
7288,2018,Serbia and Kosovo: S/RES/1244 (1999),Greece,22,7,0,29
7289,2018,Senegal,Greece,52,50,0,102
7290,2018,Sierra Leone,Greece,40,108,0,148
7291,2018,Somalia,Greece,664,668,0,1332
7292,2018,Viet Nam,Greece,5,22,0,27
7293,2018,Sudan,Greece,443,87,0,530
7294,2018,South Sudan,Greece,13,13,0,26
7295,2018,Syrian Arab Rep.,Greece,23931,14104,0,38035
7296,2018,United Rep. of Tanzania,Greece,13,11,0,24
7297,2018,Tajikistan,Greece,5,5,0,10
7298,2018,Turkmenistan,Greece,0,11,0,11
7299,2018,Togo,Greece,14,98,0,112
7300,2018,Tunisia,Greece,19,53,0,72
7301,2018,Türkiye,Greece,472,4913,0,5385
7302,2018,Uganda,Greece,24,53,0,77
7303,2018,Ukraine,Greece,145,117,0,262
7304,2018,United States of America,Greece,0,5,0,5
7305,2018,Uzbekistan,Greece,16,5,0,21
7306,2018,Venezuela (Bolivarian Republic of),Greece,6,34,0,40
7307,2018,Western Sahara,Greece,7,5,0,12
7308,2018,Yemen,Greece,369,178,0,547
7309,2018,Zimbabwe,Greece,6,15,0,21
7310,2018,Stateless,Greece,471,269,0,740
7311,2018,Unknown ,Greece,8205,3565,0,11770
7312,2018,Cameroon,Guatemala,0,5,0,5
7313,2018,Colombia,Guatemala,8,8,0,16
7314,2018,Honduras,Guatemala,39,33,0,72
7315,2018,Nicaragua,Guatemala,100,97,0,197
7316,2018,El Salvador,Guatemala,216,91,0,307
7317,2018,Venezuela (Bolivarian Republic of),Guatemala,17,17,0,34
7318,2018,Unknown ,Guatemala,0,0,0,0
7319,2018,Burundi,Guinea,5,0,0,5
7320,2018,Central African Rep.,Guinea,37,0,0,37
7321,2018,Congo,Guinea,12,0,0,12
7322,2018,Dem. Rep. of the Congo,Guinea,38,12,0,50
7323,2018,Gambia,Guinea,7,0,0,7
7324,2018,Cote d'Ivoire,Guinea,3597,10,0,3607
7325,2018,Liberia,Guinea,302,49,0,351
7326,2018,Sri Lanka,Guinea,8,0,0,8
7327,2018,Mali,Guinea,7,0,0,7
7328,2018,Nigeria,Guinea,7,0,0,7
7329,2018,Rwanda,Guinea,10,0,0,10
7330,2018,Sierra Leone,Guinea,245,1502,0,1747
7331,2018,Somalia,Guinea,6,0,0,6
7332,2018,Syrian Arab Rep.,Guinea,5,5,0,10
7333,2018,Togo,Guinea,8,0,0,8
7334,2018,Dem. Rep. of the Congo,Guyana,7,0,0,7
7335,2018,Cuba,Guyana,8,12,0,20
7336,2018,Pakistan,Guyana,5,0,0,5
7337,2018,Rwanda,Guyana,5,0,0,5
7338,2018,Venezuela (Bolivarian Republic of),Guyana,0,0,0,0
7339,2018,Yemen,Haiti,5,0,0,5
7340,2018,Stateless,Haiti,0,0,0,0
7341,2018,Egypt,"China, Hong Kong SAR",5,0,0,5
7342,2018,Burundi,"China, Hong Kong SAR",11,0,0,11
7343,2018,Bangladesh,"China, Hong Kong SAR",5,0,0,5
7344,2018,Central African Rep.,"China, Hong Kong SAR",5,0,0,5
7345,2018,Dem. Rep. of the Congo,"China, Hong Kong SAR",5,0,0,5
7346,2018,Indonesia,"China, Hong Kong SAR",6,0,0,6
7347,2018,Sri Lanka,"China, Hong Kong SAR",21,0,0,21
7348,2018,Pakistan,"China, Hong Kong SAR",8,0,0,8
7349,2018,Rwanda,"China, Hong Kong SAR",28,0,0,28
7350,2018,Somalia,"China, Hong Kong SAR",22,0,0,22
7351,2018,Yemen,"China, Hong Kong SAR",12,0,0,12
7352,2018,Honduras,Honduras,0,0,174001,0
7353,2018,Iran (Islamic Rep. of),Honduras,5,0,0,5
7354,2018,Nicaragua,Honduras,6,55,0,61
7355,2018,El Salvador,Honduras,11,0,0,11
7356,2018,Venezuela (Bolivarian Republic of),Honduras,6,0,0,6
7357,2018,Afghanistan,Croatia,53,21,0,74
7358,2018,Algeria,Croatia,0,19,0,19
7359,2018,Egypt,Croatia,7,0,0,7
7360,2018,Azerbaijan,Croatia,5,0,0,5
7361,2018,Bangladesh,Croatia,5,0,0,5
7362,2018,Belarus,Croatia,5,0,0,5
7363,2018,Bosnia and Herzegovina,Croatia,37,0,0,37
7364,2018,Congo,Croatia,5,0,0,5
7365,2018,Eritrea,Croatia,21,0,0,21
7366,2018,Palestinian,Croatia,5,5,0,10
7367,2018,Georgia,Croatia,5,0,0,5
7368,2018,Croatia,Croatia,0,0,0,0
7369,2018,Iran (Islamic Rep. of),Croatia,22,48,0,70
7370,2018,Iraq,Croatia,97,35,0,132
7371,2018,Kazakhstan,Croatia,5,0,0,5
7372,2018,Libya,Croatia,5,0,0,5
7373,2018,Mauritania,Croatia,5,0,0,5
7374,2018,Morocco,Croatia,0,5,0,5
7375,2018,Nigeria,Croatia,12,0,0,12
7376,2018,Pakistan,Croatia,7,5,0,12
7377,2018,Russian Federation,Croatia,15,5,0,20
7378,2018,Serbia and Kosovo: S/RES/1244 (1999),Croatia,0,5,0,5
7379,2018,Somalia,Croatia,26,0,0,26
7380,2018,Sudan,Croatia,5,0,0,5
7381,2018,Syrian Arab Rep.,Croatia,398,29,0,427
7382,2018,Türkiye,Croatia,17,11,0,28
7383,2018,Ukraine,Croatia,8,5,0,13
7384,2018,Uzbekistan,Croatia,5,0,0,5
7385,2018,Yemen,Croatia,7,0,0,7
7386,2018,Stateless,Croatia,5,5,0,10
7387,2018,Afghanistan,Hungary,1552,68,0,1620
7388,2018,Algeria,Hungary,15,0,0,15
7389,2018,Angola,Hungary,5,0,0,5
7390,2018,Egypt,Hungary,13,0,0,13
7391,2018,Armenia,Hungary,48,0,0,48
7392,2018,Azerbaijan,Hungary,16,0,0,16
7393,2018,Bangladesh,Hungary,9,0,0,9
7394,2018,China,Hungary,5,0,0,5
7395,2018,Cameroon,Hungary,42,0,0,42
7396,2018,Congo,Hungary,14,0,0,14
7397,2018,Dem. Rep. of the Congo,Hungary,22,0,0,22
7398,2018,Cuba,Hungary,82,0,0,82
7399,2018,Eritrea,Hungary,48,0,0,48
7400,2018,Ethiopia,Hungary,37,5,0,42
7401,2018,Palestinian,Hungary,93,0,0,93
7402,2018,Georgia,Hungary,62,0,0,62
7403,2018,Ghana,Hungary,7,0,0,7
7404,2018,Guinea,Hungary,5,0,0,5
7405,2018,Cote d'Ivoire,Hungary,15,0,0,15
7406,2018,India,Hungary,5,0,0,5
7407,2018,Iran (Islamic Rep. of),Hungary,176,8,0,184
7408,2018,Iraq,Hungary,672,22,0,694
7409,2018,Libya,Hungary,7,0,0,7
7410,2018,Lebanon,Hungary,7,0,0,7
7411,2018,Sri Lanka,Hungary,12,0,0,12
7412,2018,Rep. of Moldova,Hungary,5,0,0,5
7413,2018,Mali,Hungary,5,0,0,5
7414,2018,Myanmar,Hungary,5,0,0,5
7415,2018,Nepal,Hungary,11,0,0,11
7416,2018,Nigeria,Hungary,57,0,0,57
7417,2018,Pakistan,Hungary,60,7,0,67
7418,2018,Russian Federation,Hungary,36,0,0,36
7419,2018,Serbia and Kosovo: S/RES/1244 (1999),Hungary,56,0,0,56
7420,2018,Sierra Leone,Hungary,5,0,0,5
7421,2018,Somalia,Hungary,655,0,0,655
7422,2018,Sudan,Hungary,68,0,0,68
7423,2018,Syrian Arab Rep.,Hungary,971,5,0,976
7424,2018,Tunisia,Hungary,8,0,0,8
7425,2018,Türkiye,Hungary,34,5,0,39
7426,2018,Uganda,Hungary,7,0,0,7
7427,2018,Ukraine,Hungary,19,0,0,19
7428,2018,Uzbekistan,Hungary,7,0,0,7
7429,2018,Yemen,Hungary,18,0,0,18
7430,2018,Zimbabwe,Hungary,5,0,0,5
7431,2018,Stateless,Hungary,76,0,0,76
7432,2018,Unknown ,Hungary,942,0,0,942
7433,2018,Afghanistan,Iceland,58,29,0,87
7434,2018,Albania,Iceland,6,0,0,6
7435,2018,Algeria,Iceland,0,5,0,5
7436,2018,Egypt,Iceland,0,9,0,9
7437,2018,China,Iceland,5,0,0,5
7438,2018,Colombia,Iceland,0,7,0,7
7439,2018,Eritrea,Iceland,10,0,0,10
7440,2018,Palestinian,Iceland,18,12,0,30
7441,2018,Georgia,Iceland,5,5,0,10
7442,2018,Ghana,Iceland,0,5,0,5
7443,2018,Iran (Islamic Rep. of),Iceland,46,33,0,79
7444,2018,Iraq,Iceland,146,96,0,242
7445,2018,Kazakhstan,Iceland,5,0,0,5
7446,2018,Kenya,Iceland,5,0,0,5
7447,2018,Libya,Iceland,5,5,0,10
7448,2018,North Macedonia,Iceland,5,0,0,5
7449,2018,Rep. of Moldova,Iceland,0,26,0,26
7450,2018,Morocco,Iceland,5,8,0,13
7451,2018,Mozambique,Iceland,0,5,0,5
7452,2018,Nigeria,Iceland,6,29,0,35
7453,2018,Pakistan,Iceland,18,26,0,44
7454,2018,Russian Federation,Iceland,10,10,0,20
7455,2018,El Salvador,Iceland,12,0,0,12
7456,2018,Serbia and Kosovo: S/RES/1244 (1999),Iceland,5,5,0,10
7457,2018,Somalia,Iceland,25,44,0,69
7458,2018,Sudan,Iceland,5,5,0,10
7459,2018,South Sudan,Iceland,5,0,0,5
7460,2018,Syrian Arab Rep.,Iceland,87,30,0,117
7461,2018,Tunisia,Iceland,0,7,0,7
7462,2018,Türkiye,Iceland,0,5,0,5
7463,2018,Uganda,Iceland,11,0,0,11
7464,2018,Ukraine,Iceland,17,24,0,41
7465,2018,Venezuela (Bolivarian Republic of),Iceland,7,7,0,14
7466,2018,Stateless,Iceland,10,0,0,10
7467,2018,Unknown ,Iceland,12,0,0,12
7468,2018,Burundi,Cote d'Ivoire,34,0,0,34
7469,2018,Benin,Cote d'Ivoire,0,5,0,5
7470,2018,Burkina Faso,Cote d'Ivoire,0,5,0,5
7471,2018,Cambodia,Cote d'Ivoire,5,0,0,5
7472,2018,Central African Rep.,Cote d'Ivoire,462,34,0,496
7473,2018,Cameroon,Cote d'Ivoire,0,9,0,9
7474,2018,Congo,Cote d'Ivoire,53,13,0,66
7475,2018,Dem. Rep. of the Congo,Cote d'Ivoire,120,29,0,149
7476,2018,Eritrea,Cote d'Ivoire,5,0,0,5
7477,2018,Ethiopia,Cote d'Ivoire,5,5,0,10
7478,2018,Cote d'Ivoire,Cote d'Ivoire,0,0,0,0
7479,2018,Iran (Islamic Rep. of),Cote d'Ivoire,5,0,0,5
7480,2018,Iraq,Cote d'Ivoire,5,0,0,5
7481,2018,Liberia,Cote d'Ivoire,906,54,0,960
7482,2018,Sri Lanka,Cote d'Ivoire,5,0,0,5
7483,2018,Mauritania,Cote d'Ivoire,0,9,0,9
7484,2018,Mali,Cote d'Ivoire,6,5,0,11
7485,2018,Nigeria,Cote d'Ivoire,5,0,0,5
7486,2018,Rwanda,Cote d'Ivoire,46,0,0,46
7487,2018,Somalia,Cote d'Ivoire,5,0,0,5
7488,2018,Viet Nam,Cote d'Ivoire,5,0,0,5
7489,2018,Sudan,Cote d'Ivoire,9,0,0,9
7490,2018,Syrian Arab Rep.,Cote d'Ivoire,92,8,0,100
7491,2018,Togo,Cote d'Ivoire,15,14,0,29
7492,2018,Türkiye,Cote d'Ivoire,20,8,0,28
7493,2018,Stateless,Cote d'Ivoire,0,0,0,0
7494,2018,Afghanistan,India,6984,7864,0,14848
7495,2018,Egypt,India,0,5,0,5
7496,2018,Burundi,India,0,5,0,5
7497,2018,China,India,108008,0,0,108008
7498,2018,Cameroon,India,0,89,0,89
7499,2018,Congo,India,5,14,0,19
7500,2018,Dem. Rep. of the Congo,India,43,41,0,84
7501,2018,Eritrea,India,15,11,0,26
7502,2018,Ethiopia,India,20,22,0,42
7503,2018,Palestinian,India,73,5,0,78
7504,2018,Cote d'Ivoire,India,5,5,0,10
7505,2018,Iran (Islamic Rep. of),India,53,32,0,85
7506,2018,Iraq,India,277,99,0,376
7507,2018,Libya,India,0,7,0,7
7508,2018,Sri Lanka,India,60802,0,0,60802
7509,2018,Maldives,India,5,0,0,5
7510,2018,Myanmar,India,18813,2064,0,20877
7511,2018,Russian Federation,India,0,7,0,7
7512,2018,Rwanda,India,5,5,0,10
7513,2018,Saudi Arabia,India,5,0,0,5
7514,2018,Somalia,India,608,330,0,938
7515,2018,Sudan,India,78,66,0,144
7516,2018,South Sudan,India,5,85,0,90
7517,2018,Syrian Arab Rep.,India,83,17,0,100
7518,2018,United Rep. of Tanzania,India,0,5,0,5
7519,2018,Thailand,India,0,5,0,5
7520,2018,Tajikistan,India,0,8,0,8
7521,2018,Ukraine,India,0,7,0,7
7522,2018,Uzbekistan,India,0,6,0,6
7523,2018,Yemen,India,0,1134,0,1134
7524,2018,Afghanistan,Indonesia,6098,1635,0,7733
7525,2018,Algeria,Indonesia,0,5,0,5
7526,2018,Angola,Indonesia,0,7,0,7
7527,2018,Egypt,Indonesia,16,13,0,29
7528,2018,Bangladesh,Indonesia,0,10,0,10
7529,2018,China,Indonesia,12,5,0,17
7530,2018,Cameroon,Indonesia,0,9,0,9
7531,2018,Dem. Rep. of the Congo,Indonesia,5,11,0,16
7532,2018,Eritrea,Indonesia,39,186,0,225
7533,2018,Ethiopia,Indonesia,160,50,0,210
7534,2018,Palestinian,Indonesia,367,68,0,435
7535,2018,Cote d'Ivoire,Indonesia,0,5,0,5
7536,2018,Iran (Islamic Rep. of),Indonesia,308,41,0,349
7537,2018,Iraq,Indonesia,587,249,0,836
7538,2018,Jordan,Indonesia,5,0,0,5
7539,2018,Kuwait,Indonesia,10,0,0,10
7540,2018,Libya,Indonesia,14,5,0,19
7541,2018,Sri Lanka,Indonesia,409,35,0,444
7542,2018,Myanmar,Indonesia,713,113,0,826
7543,2018,Pakistan,Indonesia,340,27,0,367
7544,2018,Russian Federation,Indonesia,5,0,0,5
7545,2018,Somalia,Indonesia,1139,336,0,1475
7546,2018,Viet Nam,Indonesia,20,0,0,20
7547,2018,Sudan,Indonesia,400,78,0,478
7548,2018,Syrian Arab Rep.,Indonesia,29,18,0,47
7549,2018,Türkiye,Indonesia,0,41,0,41
7550,2018,Uganda,Indonesia,5,0,0,5
7551,2018,Yemen,Indonesia,105,249,0,354
7552,2018,Afghanistan,Ireland,289,148,0,437
7553,2018,Albania,Ireland,91,886,0,977
7554,2018,Algeria,Ireland,43,220,0,263
7555,2018,Angola,Ireland,50,25,0,75
7556,2018,Egypt,Ireland,19,68,0,87
7557,2018,Armenia,Ireland,9,6,0,15
7558,2018,Azerbaijan,Ireland,6,0,0,6
7559,2018,Burundi,Ireland,16,6,0,22
7560,2018,Benin,Ireland,5,0,0,5
7561,2018,Bangladesh,Ireland,34,298,0,332
7562,2018,Bhutan,Ireland,10,0,0,10
7563,2018,Belarus,Ireland,22,5,0,27
7564,2018,Bolivia (Plurinational State of),Ireland,7,34,0,41
7565,2018,Botswana,Ireland,0,26,0,26
7566,2018,Brazil,Ireland,0,146,0,146
7567,2018,Chad,Ireland,5,0,0,5
7568,2018,China,Ireland,54,86,0,140
7569,2018,Chile,Ireland,0,5,0,5
7570,2018,Cameroon,Ireland,73,53,0,126
7571,2018,Congo,Ireland,16,10,0,26
7572,2018,Dem. Rep. of the Congo,Ireland,302,278,0,580
7573,2018,Cuba,Ireland,5,0,0,5
7574,2018,Eritrea,Ireland,47,32,0,79
7575,2018,Ethiopia,Ireland,32,18,0,50
7576,2018,Gambia,Ireland,0,10,0,10
7577,2018,Palestinian,Ireland,78,46,0,124
7578,2018,Georgia,Ireland,66,648,0,714
7579,2018,Ghana,Ireland,22,64,0,86
7580,2018,Guatemala,Ireland,0,5,0,5
7581,2018,Guinea,Ireland,14,0,0,14
7582,2018,Guyana,Ireland,0,6,0,6
7583,2018,Honduras,Ireland,5,0,0,5
7584,2018,Cote d'Ivoire,Ireland,14,11,0,25
7585,2018,India,Ireland,0,116,0,116
7586,2018,Iran (Islamic Rep. of),Ireland,126,39,0,165
7587,2018,Iraq,Ireland,342,103,0,445
7588,2018,Israel,Ireland,5,5,0,10
7589,2018,Kazakhstan,Ireland,19,0,0,19
7590,2018,Kenya,Ireland,44,14,0,58
7591,2018,Kyrgyzstan,Ireland,5,7,0,12
7592,2018,Dem. People's Rep. of Korea,Ireland,7,0,0,7
7593,2018,Kuwait,Ireland,47,19,0,66
7594,2018,Liberia,Ireland,13,0,0,13
7595,2018,Libya,Ireland,150,67,0,217
7596,2018,Lebanon,Ireland,5,8,0,13
7597,2018,Lesotho,Ireland,0,5,0,5
7598,2018,Sri Lanka,Ireland,21,17,0,38
7599,2018,Rep. of Moldova,Ireland,55,7,0,62
7600,2018,Mexico,Ireland,0,12,0,12
7601,2018,Mali,Ireland,8,0,0,8
7602,2018,Malaysia,Ireland,0,25,0,25
7603,2018,Malawi,Ireland,75,176,0,251
7604,2018,Mongolia,Ireland,5,16,0,21
7605,2018,Morocco,Ireland,6,35,0,41
7606,2018,Mozambique,Ireland,5,5,0,10
7607,2018,Montenegro,Ireland,5,0,0,5
7608,2018,Mauritius,Ireland,8,50,0,58
7609,2018,Myanmar,Ireland,8,8,0,16
7610,2018,Nepal,Ireland,5,21,0,26
7611,2018,Niger,Ireland,5,0,0,5
7612,2018,Nicaragua,Ireland,0,8,0,8
7613,2018,Nigeria,Ireland,255,556,0,811
7614,2018,Pakistan,Ireland,185,1000,0,1185
7615,2018,Philippines,Ireland,0,5,0,5
7616,2018,South Africa,Ireland,55,347,0,402
7617,2018,Russian Federation,Ireland,70,35,0,105
7618,2018,Rwanda,Ireland,37,5,0,42
7619,2018,El Salvador,Ireland,0,5,0,5
7620,2018,Saudi Arabia,Ireland,9,7,0,16
7621,2018,Serbia and Kosovo: S/RES/1244 (1999),Ireland,58,27,0,85
7622,2018,Sierra Leone,Ireland,22,41,0,63
7623,2018,Somalia,Ireland,205,68,0,273
7624,2018,Viet Nam,Ireland,0,21,0,21
7625,2018,Sudan,Ireland,159,62,0,221
7626,2018,Eswatini,Ireland,13,17,0,30
7627,2018,Syrian Arab Rep.,Ireland,2126,66,0,2192
7628,2018,United Rep. of Tanzania,Ireland,0,7,0,7
7629,2018,Togo,Ireland,17,6,0,23
7630,2018,Tunisia,Ireland,0,14,0,14
7631,2018,Türkiye,Ireland,6,12,0,18
7632,2018,Uganda,Ireland,34,23,0,57
7633,2018,Ukraine,Ireland,78,53,0,131
7634,2018,United States of America,Ireland,0,9,0,9
7635,2018,Uzbekistan,Ireland,17,0,0,17
7636,2018,Venezuela (Bolivarian Republic of),Ireland,29,59,0,88
7637,2018,Yemen,Ireland,8,6,0,14
7638,2018,Zambia,Ireland,0,7,0,7
7639,2018,Zimbabwe,Ireland,319,652,0,971
7640,2018,Stateless,Ireland,7,0,0,7
7641,2018,Unknown ,Ireland,0,146,0,146
7642,2018,Afghanistan,Iran (Islamic Rep. of),951142,0,0,951142
7643,2018,Iraq,Iran (Islamic Rep. of),28268,0,0,28268
7644,2018,Kuwait,Iran (Islamic Rep. of),8,0,0,8
7645,2018,Myanmar,Iran (Islamic Rep. of),0,33,0,33
7646,2018,Pakistan,Iran (Islamic Rep. of),10,0,0,10
7647,2018,Uzbekistan,Iran (Islamic Rep. of),7,0,0,7
7648,2018,Afghanistan,Iraq,12,66,0,78
7649,2018,Egypt,Iraq,0,24,0,24
7650,2018,Bahrain,Iraq,0,20,0,20
7651,2018,Eritrea,Iraq,5,24,0,29
7652,2018,Ethiopia,Iraq,0,5,0,5
7653,2018,Palestinian,Iraq,7944,140,0,8084
7654,2018,Indonesia,Iraq,0,5,0,5
7655,2018,Iran (Islamic Rep. of),Iraq,7026,6602,0,13628
7656,2018,Iraq,Iraq,0,0,1802832,0
7657,2018,Jordan,Iraq,9,5,0,14
7658,2018,Kyrgyzstan,Iraq,0,10,0,10
7659,2018,Kuwait,Iraq,0,174,0,174
7660,2018,Lebanon,Iraq,0,5,0,5
7661,2018,Pakistan,Iraq,0,26,0,26
7662,2018,Saudi Arabia,Iraq,0,5,0,5
7663,2018,Somalia,Iraq,6,5,0,11
7664,2018,Sudan,Iraq,85,822,0,907
7665,2018,South Sudan,Iraq,0,14,0,14
7666,2018,Syrian Arab Rep.,Iraq,252526,0,0,252526
7667,2018,Tunisia,Iraq,0,6,0,6
7668,2018,Türkiye,Iraq,15405,5936,0,21341
7669,2018,Uzbekistan,Iraq,0,5,0,5
7670,2018,Yemen,Iraq,0,114,0,114
7671,2018,Stateless,Iraq,0,0,0,0
7672,2018,Egypt,Israel,0,12,0,12
7673,2018,Armenia,Israel,0,51,0,51
7674,2018,Azerbaijan,Israel,0,46,0,46
7675,2018,Benin,Israel,0,5,0,5
7676,2018,Burkina Faso,Israel,0,5,0,5
7677,2018,Belarus,Israel,0,400,0,400
7678,2018,Botswana,Israel,0,5,0,5
7679,2018,Brazil,Israel,0,6,0,6
7680,2018,Bulgaria,Israel,0,5,0,5
7681,2018,Central African Rep.,Israel,0,18,0,18
7682,2018,Chad,Israel,5,6,0,11
7683,2018,China,Israel,0,55,0,55
7684,2018,Cameroon,Israel,0,43,0,43
7685,2018,Congo,Israel,0,29,0,29
7686,2018,Dem. Rep. of the Congo,Israel,209,216,0,425
7687,2018,Colombia,Israel,0,108,0,108
7688,2018,Ecuador,Israel,0,14,0,14
7689,2018,Eritrea,Israel,14516,9779,0,24295
7690,2018,Ethiopia,Israel,95,838,0,933
7691,2018,Georgia,Israel,5,2488,0,2493
7692,2018,Ghana,Israel,0,450,0,450
7693,2018,Greece,Israel,0,5,0,5
7694,2018,Guinea,Israel,0,28,0,28
7695,2018,Cote d'Ivoire,Israel,5,16,0,21
7696,2018,India,Israel,0,973,0,973
7697,2018,Iran (Islamic Rep. of),Israel,6,5,0,11
7698,2018,Iraq,Israel,10,0,0,10
7699,2018,Kazakhstan,Israel,0,186,0,186
7700,2018,Kenya,Israel,0,84,0,84
7701,2018,Kyrgyzstan,Israel,0,64,0,64
7702,2018,Dem. People's Rep. of Korea,Israel,5,0,0,5
7703,2018,Lesotho,Israel,0,6,0,6
7704,2018,Sri Lanka,Israel,0,1004,0,1004
7705,2018,Latvia,Israel,0,5,0,5
7706,2018,Rep. of Moldova,Israel,0,651,0,651
7707,2018,Mali,Israel,0,5,0,5
7708,2018,Malawi,Israel,0,38,0,38
7709,2018,Myanmar,Israel,0,23,0,23
7710,2018,Nepal,Israel,0,42,0,42
7711,2018,Nigeria,Israel,5,984,0,989
7712,2018,Philippines,Israel,0,9,0,9
7713,2018,Romania,Israel,0,45,0,45
7714,2018,South Africa,Israel,0,367,0,367
7715,2018,Russian Federation,Israel,0,2971,0,2971
7716,2018,Rwanda,Israel,0,5,0,5
7717,2018,Sierra Leone,Israel,5,14,0,19
7718,2018,Somalia,Israel,0,12,0,12
7719,2018,Sudan,Israel,3351,4631,0,7982
7720,2018,South Sudan,Israel,127,102,0,229
7721,2018,Thailand,Israel,0,5,0,5
7722,2018,Tajikistan,Israel,0,7,0,7
7723,2018,Turkmenistan,Israel,0,5,0,5
7724,2018,Togo,Israel,0,5,0,5
7725,2018,Türkiye,Israel,5,190,0,195
7726,2018,Uganda,Israel,0,97,0,97
7727,2018,Ukraine,Israel,0,7857,0,7857
7728,2018,Uzbekistan,Israel,0,455,0,455
7729,2018,Venezuela (Bolivarian Republic of),Israel,0,5,0,5
7730,2018,Zimbabwe,Israel,0,16,0,16
7731,2018,Stateless,Israel,0,0,0,0
7732,2018,Unknown ,Israel,205,73,0,278
7733,2018,Afghanistan,Italy,16941,825,0,17766
7734,2018,Albania,Italy,684,1097,0,1781
7735,2018,Algeria,Italy,199,165,0,364
7736,2018,Angola,Italy,31,16,0,47
7737,2018,Egypt,Italy,2289,796,0,3085
7738,2018,Argentina,Italy,7,11,0,18
7739,2018,Armenia,Italy,319,222,0,541
7740,2018,Azerbaijan,Italy,74,37,0,111
7741,2018,Bahrain,Italy,5,0,0,5
7742,2018,Burundi,Italy,24,5,0,29
7743,2018,Benin,Italy,269,113,0,382
7744,2018,Bangladesh,Italy,8438,6116,0,14554
7745,2018,Bahamas,Italy,5,0,0,5
7746,2018,Burkina Faso,Italy,1121,495,0,1616
7747,2018,Belarus,Italy,38,39,0,77
7748,2018,Bolivia (Plurinational State of),Italy,13,8,0,21
7749,2018,Brazil,Italy,149,203,0,352
7750,2018,Bosnia and Herzegovina,Italy,657,133,0,790
7751,2018,Cambodia,Italy,5,0,0,5
7752,2018,Central African Rep.,Italy,103,43,0,146
7753,2018,Chad,Italy,456,97,0,553
7754,2018,China,Italy,184,844,0,1028
7755,2018,Chile,Italy,8,6,0,14
7756,2018,Cameroon,Italy,1802,1571,0,3373
7757,2018,Congo,Italy,421,93,0,514
7758,2018,Dem. Rep. of the Congo,Italy,589,130,0,719
7759,2018,Comoros,Italy,0,34,0,34
7760,2018,Colombia,Italy,450,523,0,973
7761,2018,Costa Rica,Italy,6,0,0,6
7762,2018,Cuba,Italy,207,166,0,373
7763,2018,Cabo Verde,Italy,5,5,0,10
7764,2018,Dominican Rep.,Italy,20,35,0,55
7765,2018,Ecuador,Italy,33,21,0,54
7766,2018,Equatorial Guinea,Italy,14,7,0,21
7767,2018,Eritrea,Italy,6975,13426,0,20401
7768,2018,Ethiopia,Italy,1271,225,0,1496
7769,2018,Gabon,Italy,37,17,0,54
7770,2018,Gambia,Italy,12549,3600,0,16149
7771,2018,Palestinian,Italy,1049,205,0,1254
7772,2018,Georgia,Italy,510,1235,0,1745
7773,2018,Ghana,Italy,5723,2894,0,8617
7774,2018,Guinea-Bissau,Italy,870,415,0,1285
7775,2018,Guatemala,Italy,5,15,0,20
7776,2018,Guinea,Italy,4571,4831,0,9402
7777,2018,Haiti,Italy,9,0,0,9
7778,2018,Honduras,Italy,116,249,0,365
7779,2018,Croatia,Italy,18,0,0,18
7780,2018,Cote d'Ivoire,Italy,7174,5436,0,12610
7781,2018,India,Italy,322,1039,0,1361
7782,2018,Indonesia,Italy,0,6,0,6
7783,2018,Iran (Islamic Rep. of),Italy,1907,274,0,2181
7784,2018,Iraq,Italy,6174,1011,0,7185
7785,2018,Israel,Italy,7,5,0,12
7786,2018,Jamaica,Italy,5,0,0,5
7787,2018,Jordan,Italy,35,15,0,50
7788,2018,Kazakhstan,Italy,21,8,0,29
7789,2018,Kenya,Italy,118,36,0,154
7790,2018,Kyrgyzstan,Italy,86,104,0,190
7791,2018,Rep. of Korea,Italy,5,0,0,5
7792,2018,Kuwait,Italy,8,0,0,8
7793,2018,Liberia,Italy,358,225,0,583
7794,2018,Libya,Italy,1142,367,0,1509
7795,2018,Lebanon,Italy,328,44,0,372
7796,2018,Lesotho,Italy,0,17,0,17
7797,2018,Sri Lanka,Italy,530,640,0,1170
7798,2018,Madagascar,Italy,22,7,0,29
7799,2018,Mauritania,Italy,347,37,0,384
7800,2018,North Macedonia,Italy,67,61,0,128
7801,2018,Rep. of Moldova,Italy,100,72,0,172
7802,2018,Mexico,Italy,5,16,0,21
7803,2018,Mali,Italy,15003,4806,0,19809
7804,2018,Malaysia,Italy,0,7,0,7
7805,2018,Malawi,Italy,5,0,0,5
7806,2018,Mongolia,Italy,0,5,0,5
7807,2018,Morocco,Italy,1076,2275,0,3351
7808,2018,Mozambique,Italy,5,0,0,5
7809,2018,Montenegro,Italy,84,12,0,96
7810,2018,Mauritius,Italy,18,9,0,27
7811,2018,Myanmar,Italy,43,14,0,57
7812,2018,Namibia,Italy,5,0,0,5
7813,2018,Nepal,Italy,114,127,0,241
7814,2018,Niger,Italy,573,332,0,905
7815,2018,Nicaragua,Italy,18,45,0,63
7816,2018,Nigeria,Italy,22319,17349,0,39668
7817,2018,Pakistan,Italy,18249,10501,0,28750
7818,2018,Paraguay,Italy,6,21,0,27
7819,2018,Peru,Italy,98,640,0,738
7820,2018,Philippines,Italy,67,166,0,233
7821,2018,South Africa,Italy,8,6,0,14
7822,2018,Russian Federation,Italy,269,232,0,501
7823,2018,Rwanda,Italy,12,6,0,18
7824,2018,El Salvador,Italy,1631,2576,0,4207
7825,2018,Saudi Arabia,Italy,11,11,0,22
7826,2018,Serbia and Kosovo: S/RES/1244 (1999),Italy,1181,804,0,1985
7827,2018,Senegal,Italy,7644,4984,0,12628
7828,2018,Sierra Leone,Italy,717,651,0,1368
7829,2018,Somalia,Italy,13373,830,0,14203
7830,2018,Viet Nam,Italy,8,5,0,13
7831,2018,Sudan,Italy,1579,492,0,2071
7832,2018,South Sudan,Italy,127,27,0,154
7833,2018,Eswatini,Italy,9,0,0,9
7834,2018,Syrian Arab Rep.,Italy,4652,1197,0,5849
7835,2018,United Rep. of Tanzania,Italy,29,10,0,39
7836,2018,Thailand,Italy,0,5,0,5
7837,2018,Tajikistan,Italy,11,6,0,17
7838,2018,Turkmenistan,Italy,5,5,0,10
7839,2018,Timor-Leste,Italy,5,0,0,5
7840,2018,Togo,Italy,932,405,0,1337
7841,2018,Tunisia,Italy,672,705,0,1377
7842,2018,Türkiye,Italy,2497,592,0,3089
7843,2018,Uganda,Italy,70,17,0,87
7844,2018,Ukraine,Italy,5861,4164,0,10025
7845,2018,Uruguay,Italy,0,5,0,5
7846,2018,United States of America,Italy,5,5,0,10
7847,2018,Uzbekistan,Italy,18,5,0,23
7848,2018,Venezuela (Bolivarian Republic of),Italy,563,1104,0,1667
7849,2018,Western Sahara,Italy,5,0,0,5
7850,2018,Yemen,Italy,141,54,0,195
7851,2018,Zimbabwe,Italy,25,6,0,31
7852,2018,Stateless,Italy,17,0,0,17
7853,2018,Unknown ,Italy,1437,0,0,1437
7854,2018,Cuba,Jamaica,0,8,0,8
7855,2018,Haiti,Jamaica,8,0,0,8
7856,2018,South Africa,Jamaica,0,13,0,13
7857,2018,Syrian Arab Rep.,Jamaica,5,0,0,5
7858,2018,Afghanistan,Jordan,8,10,0,18
7859,2018,Algeria,Jordan,5,8,0,13
7860,2018,Egypt,Jordan,105,676,0,781
7861,2018,Bangladesh,Jordan,0,13,0,13
7862,2018,Burkina Faso,Jordan,0,5,0,5
7863,2018,Bosnia and Herzegovina,Jordan,9,0,0,9
7864,2018,Chad,Jordan,0,26,0,26
7865,2018,Comoros,Jordan,0,5,0,5
7866,2018,Eritrea,Jordan,29,24,0,53
7867,2018,Ethiopia,Jordan,10,56,0,66
7868,2018,Palestinian,Jordan,0,0,0,0
7869,2018,Ghana,Jordan,0,10,0,10
7870,2018,India,Jordan,0,7,0,7
7871,2018,Indonesia,Jordan,0,5,0,5
7872,2018,Iran (Islamic Rep. of),Jordan,7,5,0,12
7873,2018,Iraq,Jordan,34626,33384,0,68010
7874,2018,Jordan,Jordan,0,0,0,0
7875,2018,Kenya,Jordan,0,28,0,28
7876,2018,Kuwait,Jordan,10,0,0,10
7877,2018,Libya,Jordan,30,218,0,248
7878,2018,Lebanon,Jordan,9,109,0,118
7879,2018,Sri Lanka,Jordan,7,14,0,21
7880,2018,Rep. of Moldova,Jordan,0,5,0,5
7881,2018,Morocco,Jordan,0,17,0,17
7882,2018,Niger,Jordan,0,10,0,10
7883,2018,Nigeria,Jordan,0,95,0,95
7884,2018,Pakistan,Jordan,5,22,0,27
7885,2018,Philippines,Jordan,0,12,0,12
7886,2018,South Africa,Jordan,0,5,0,5
7887,2018,Russian Federation,Jordan,25,22,0,47
7888,2018,Saudi Arabia,Jordan,0,21,0,21
7889,2018,Serbia and Kosovo: S/RES/1244 (1999),Jordan,0,5,0,5
7890,2018,Senegal,Jordan,0,5,0,5
7891,2018,Somalia,Jordan,680,147,0,827
7892,2018,Sudan,Jordan,2788,3482,0,6270
7893,2018,Suriname,Jordan,0,7,0,7
7894,2018,South Sudan,Jordan,11,10,0,21
7895,2018,Syrian Arab Rep.,Jordan,676283,0,0,676283
7896,2018,Tajikistan,Jordan,0,10,0,10
7897,2018,Tunisia,Jordan,9,21,0,30
7898,2018,Türkiye,Jordan,0,8,0,8
7899,2018,Ukraine,Jordan,0,18,0,18
7900,2018,Yemen,Jordan,642,13835,0,14477
7901,2018,Stateless,Jordan,0,176,0,176
7902,2018,Afghanistan,Japan,55,0,0,55
7903,2018,Burundi,Japan,9,0,0,9
7904,2018,Bangladesh,Japan,27,0,0,27
7905,2018,China,Japan,73,0,0,73
7906,2018,Cameroon,Japan,17,0,0,17
7907,2018,Dem. Rep. of the Congo,Japan,20,0,0,20
7908,2018,Ethiopia,Japan,28,0,0,28
7909,2018,Iran (Islamic Rep. of),Japan,17,0,0,17
7910,2018,Iraq,Japan,13,0,0,13
7911,2018,Sri Lanka,Japan,53,0,0,53
7912,2018,Myanmar,Japan,1125,0,0,1125
7913,2018,Pakistan,Japan,34,0,0,34
7914,2018,Somalia,Japan,5,0,0,5
7915,2018,Sudan,Japan,15,0,0,15
7916,2018,Syrian Arab Rep.,Japan,69,0,0,69
7917,2018,Türkiye,Japan,39,0,0,39
7918,2018,Stateless,Japan,10,0,0,10
7919,2018,Unknown ,Japan,284,29040,0,29324
7920,2018,Afghanistan,Kazakhstan,538,164,0,702
7921,2018,China,Kazakhstan,0,12,0,12
7922,2018,Syrian Arab Rep.,Kazakhstan,15,14,0,29
7923,2018,Uzbekistan,Kazakhstan,15,0,0,15
7924,2018,Stateless,Kazakhstan,0,0,0,0
7925,2018,Afghanistan,Kenya,8,10,0,18
7926,2018,Angola,Kenya,0,5,0,5
7927,2018,Egypt,Kenya,0,9,0,9
7928,2018,Burundi,Kenya,4872,8448,0,13320
7929,2018,Central African Rep.,Kenya,0,5,0,5
7930,2018,Cameroon,Kenya,0,46,0,46
7931,2018,Congo,Kenya,59,94,0,153
7932,2018,Dem. Rep. of the Congo,Kenya,24586,16719,0,41305
7933,2018,Eritrea,Kenya,707,1099,0,1806
7934,2018,Ethiopia,Kenya,18115,9584,0,27699
7935,2018,Cote d'Ivoire,Kenya,0,6,0,6
7936,2018,India,Kenya,0,5,0,5
7937,2018,Iraq,Kenya,5,0,0,5
7938,2018,Sri Lanka,Kenya,9,0,0,9
7939,2018,Mozambique,Kenya,7,0,0,7
7940,2018,Nigeria,Kenya,6,15,0,21
7941,2018,Pakistan,Kenya,9,5,0,14
7942,2018,Rwanda,Kenya,648,1092,0,1740
7943,2018,Sierra Leone,Kenya,5,0,0,5
7944,2018,Somalia,Kenya,252498,4822,0,257320
7945,2018,Sudan,Kenya,3582,6524,0,10106
7946,2018,South Sudan,Kenya,115202,83,0,115285
7947,2018,Syrian Arab Rep.,Kenya,0,11,0,11
7948,2018,United Rep. of Tanzania,Kenya,11,28,0,39
7949,2018,Türkiye,Kenya,0,59,0,59
7950,2018,Uganda,Kenya,843,1569,0,2412
7951,2018,Yemen,Kenya,66,213,0,279
7952,2018,Zimbabwe,Kenya,5,7,0,12
7953,2018,Stateless,Kenya,0,0,0,0
7954,2018,Afghanistan,Kyrgyzstan,223,34,0,257
7955,2018,China,Kyrgyzstan,0,5,0,5
7956,2018,Iraq,Kyrgyzstan,5,5,0,10
7957,2018,Syrian Arab Rep.,Kyrgyzstan,77,14,0,91
7958,2018,Tajikistan,Kyrgyzstan,5,0,0,5
7959,2018,Türkiye,Kyrgyzstan,0,31,0,31
7960,2018,Ukraine,Kyrgyzstan,19,6,0,25
7961,2018,Uzbekistan,Kyrgyzstan,0,10,0,10
7962,2018,Stateless,Kyrgyzstan,0,0,0,0
7963,2018,Afghanistan,Rep. of Korea,38,31,0,69
7964,2018,Algeria,Rep. of Korea,6,129,0,135
7965,2018,Angola,Rep. of Korea,5,59,0,64
7966,2018,Egypt,Rep. of Korea,26,1115,0,1141
7967,2018,Argentina,Rep. of Korea,0,5,0,5
7968,2018,Azerbaijan,Rep. of Korea,0,5,0,5
7969,2018,Burundi,Rep. of Korea,37,9,0,46
7970,2018,Benin,Rep. of Korea,0,5,0,5
7971,2018,Bangladesh,Rep. of Korea,108,845,0,953
7972,2018,Burkina Faso,Rep. of Korea,0,18,0,18
7973,2018,Bolivia (Plurinational State of),Rep. of Korea,0,5,0,5
7974,2018,Brazil,Rep. of Korea,0,5,0,5
7975,2018,Cambodia,Rep. of Korea,0,53,0,53
7976,2018,China,Rep. of Korea,43,1620,0,1663
7977,2018,Cameroon,Rep. of Korea,20,238,0,258
7978,2018,Congo,Rep. of Korea,0,7,0,7
7979,2018,Dem. Rep. of the Congo,Rep. of Korea,57,31,0,88
7980,2018,Colombia,Rep. of Korea,0,5,0,5
7981,2018,Ecuador,Rep. of Korea,0,5,0,5
7982,2018,Eritrea,Rep. of Korea,9,0,0,9
7983,2018,Ethiopia,Rep. of Korea,147,102,0,249
7984,2018,Gabon,Rep. of Korea,0,5,0,5
7985,2018,Gambia,Rep. of Korea,0,102,0,102
7986,2018,Palestinian,Rep. of Korea,5,5,0,10
7987,2018,Ghana,Rep. of Korea,7,294,0,301
7988,2018,Guinea-Bissau,Rep. of Korea,0,15,0,15
7989,2018,Guinea,Rep. of Korea,0,152,0,152
7990,2018,Haiti,Rep. of Korea,0,7,0,7
7991,2018,Cote d'Ivoire,Rep. of Korea,33,32,0,65
7992,2018,India,Rep. of Korea,0,1657,0,1657
7993,2018,Indonesia,Rep. of Korea,0,22,0,22
7994,2018,Iran (Islamic Rep. of),Rep. of Korea,55,90,0,145
7995,2018,Iraq,Rep. of Korea,27,18,0,45
7996,2018,Jordan,Rep. of Korea,7,8,0,15
7997,2018,Kazakhstan,Rep. of Korea,5,2942,0,2947
7998,2018,Kenya,Rep. of Korea,5,28,0,33
7999,2018,Kyrgyzstan,Rep. of Korea,0,151,0,151
8000,2018,Lao People's Dem. Rep.,Rep. of Korea,0,6,0,6
8001,2018,Liberia,Rep. of Korea,11,328,0,339
8002,2018,Libya,Rep. of Korea,6,7,0,13
8003,2018,Sri Lanka,Rep. of Korea,8,215,0,223
8004,2018,Mali,Rep. of Korea,7,102,0,109
8005,2018,Malaysia,Rep. of Korea,0,1452,0,1452
8006,2018,Mongolia,Rep. of Korea,0,523,0,523
8007,2018,Morocco,Rep. of Korea,5,362,0,367
8008,2018,Mozambique,Rep. of Korea,0,11,0,11
8009,2018,Myanmar,Rep. of Korea,328,27,0,355
8010,2018,Nepal,Rep. of Korea,5,226,0,231
8011,2018,Nicaragua,Rep. of Korea,0,5,0,5
8012,2018,Nigeria,Rep. of Korea,10,637,0,647
8013,2018,Pakistan,Rep. of Korea,102,1507,0,1609
8014,2018,Peru,Rep. of Korea,0,5,0,5
8015,2018,Philippines,Rep. of Korea,0,592,0,592
8016,2018,South Africa,Rep. of Korea,0,159,0,159
8017,2018,Russian Federation,Rep. of Korea,13,2010,0,2023
8018,2018,Rwanda,Rep. of Korea,0,20,0,20
8019,2018,Saudi Arabia,Rep. of Korea,0,6,0,6
8020,2018,Senegal,Rep. of Korea,0,164,0,164
8021,2018,Sierra Leone,Rep. of Korea,0,9,0,9
8022,2018,Somalia,Rep. of Korea,5,0,0,5
8023,2018,Viet Nam,Rep. of Korea,0,118,0,118
8024,2018,Sudan,Rep. of Korea,19,36,0,55
8025,2018,South Sudan,Rep. of Korea,0,6,0,6
8026,2018,Eswatini,Rep. of Korea,0,5,0,5
8027,2018,Syrian Arab Rep.,Rep. of Korea,1177,59,0,1236
8028,2018,United Rep. of Tanzania,Rep. of Korea,5,50,0,55
8029,2018,Thailand,Rep. of Korea,9,452,0,461
8030,2018,Tajikistan,Rep. of Korea,0,16,0,16
8031,2018,Togo,Rep. of Korea,0,13,0,13
8032,2018,Tunisia,Rep. of Korea,0,82,0,82
8033,2018,Türkiye,Rep. of Korea,0,178,0,178
8034,2018,Uganda,Rep. of Korea,34,78,0,112
8035,2018,Ukraine,Rep. of Korea,14,59,0,73
8036,2018,United States of America,Rep. of Korea,0,5,0,5
8037,2018,Uzbekistan,Rep. of Korea,9,150,0,159
8038,2018,Venezuela (Bolivarian Republic of),Rep. of Korea,0,8,0,8
8039,2018,Yemen,Rep. of Korea,483,308,0,791
8040,2018,Zimbabwe,Rep. of Korea,0,11,0,11
8041,2018,Stateless,Rep. of Korea,0,0,0,0
8042,2018,Egypt,Kuwait,0,18,0,18
8043,2018,Djibouti,Kuwait,0,5,0,5
8044,2018,Eritrea,Kuwait,0,29,0,29
8045,2018,Ethiopia,Kuwait,0,11,0,11
8046,2018,Palestinian,Kuwait,5,5,0,10
8047,2018,Iran (Islamic Rep. of),Kuwait,9,83,0,92
8048,2018,Iraq,Kuwait,351,283,0,634
8049,2018,Jordan,Kuwait,0,6,0,6
8050,2018,Lebanon,Kuwait,0,5,0,5
8051,2018,Sri Lanka,Kuwait,0,6,0,6
8052,2018,Pakistan,Kuwait,0,12,0,12
8053,2018,Philippines,Kuwait,0,5,0,5
8054,2018,Somalia,Kuwait,228,434,0,662
8055,2018,Sudan,Kuwait,0,17,0,17
8056,2018,Syrian Arab Rep.,Kuwait,73,50,0,123
8057,2018,Ukraine,Kuwait,0,5,0,5
8058,2018,Yemen,Kuwait,5,9,0,14
8059,2018,Stateless,Kuwait,0,0,0,0
8060,2018,Dem. Rep. of the Congo,Liberia,10,13,0,23
8061,2018,Cote d'Ivoire,Liberia,9051,0,0,9051
8062,2018,Iraq,Liberia,0,5,0,5
8063,2018,Mali,Liberia,19,0,0,19
8064,2018,Nigeria,Liberia,0,7,0,7
8065,2018,Rwanda,Liberia,0,5,0,5
8066,2018,Sudan,Liberia,8,0,0,8
8067,2018,Syrian Arab Rep.,Liberia,10,5,0,15
8068,2018,Togo,Liberia,5,0,0,5
8069,2018,Türkiye,Liberia,0,5,0,5
8070,2018,Afghanistan,Libya,0,11,0,11
8071,2018,Algeria,Libya,5,0,0,5
8072,2018,Chad,Libya,15,47,0,62
8073,2018,Congo,Libya,0,5,0,5
8074,2018,Dem. Rep. of the Congo,Libya,10,8,0,18
8075,2018,Eritrea,Libya,509,7261,0,7770
8076,2018,Ethiopia,Libya,19,1157,0,1176
8077,2018,Palestinian,Libya,4555,1984,0,6539
8078,2018,Cote d'Ivoire,Libya,0,5,0,5
8079,2018,Iraq,Libya,1994,648,0,2642
8080,2018,Liberia,Libya,16,0,0,16
8081,2018,Libya,Libya,0,0,170491,0
8082,2018,Morocco,Libya,0,5,0,5
8083,2018,Somalia,Libya,161,3106,0,3267
8084,2018,Sudan,Libya,956,9834,0,10790
8085,2018,South Sudan,Libya,0,116,0,116
8086,2018,Syrian Arab Rep.,Libya,552,23173,0,23725
8087,2018,Yemen,Libya,0,43,0,43
8088,2018,Afghanistan,Lebanon,17,6,0,23
8089,2018,Algeria,Lebanon,0,0,0,0
8090,2018,Egypt,Lebanon,70,246,0,316
8091,2018,Armenia,Lebanon,0,0,0,0
8092,2018,Bahrain,Lebanon,25,12,0,37
8093,2018,Benin,Lebanon,0,5,0,5
8094,2018,Bangladesh,Lebanon,0,50,0,50
8095,2018,Cameroon,Lebanon,0,33,0,33
8096,2018,Congo,Lebanon,0,11,0,11
8097,2018,Dem. Rep. of the Congo,Lebanon,0,5,0,5
8098,2018,Eritrea,Lebanon,17,32,0,49
8099,2018,Ethiopia,Lebanon,39,486,0,525
8100,2018,Gambia,Lebanon,0,12,0,12
8101,2018,Palestinian,Lebanon,0,5,0,5
8102,2018,Cote d'Ivoire,Lebanon,0,13,0,13
8103,2018,India,Lebanon,0,8,0,8
8104,2018,Iran (Islamic Rep. of),Lebanon,25,30,0,55
8105,2018,Iraq,Lebanon,4458,13976,0,18434
8106,2018,Jordan,Lebanon,29,66,0,95
8107,2018,Kenya,Lebanon,0,20,0,20
8108,2018,Kuwait,Lebanon,0,9,0,9
8109,2018,Libya,Lebanon,9,13,0,22
8110,2018,Sri Lanka,Lebanon,0,7,0,7
8111,2018,Mali,Lebanon,0,5,0,5
8112,2018,Morocco,Lebanon,0,0,0,0
8113,2018,Nigeria,Lebanon,0,92,0,92
8114,2018,Pakistan,Lebanon,5,5,0,10
8115,2018,Philippines,Lebanon,0,28,0,28
8116,2018,Saudi Arabia,Lebanon,13,5,0,18
8117,2018,Somalia,Lebanon,18,9,0,27
8118,2018,Sudan,Lebanon,668,1060,0,1728
8119,2018,South Sudan,Lebanon,42,0,0,42
8120,2018,Syrian Arab Rep.,Lebanon,944181,5,0,944186
8121,2018,Tunisia,Lebanon,11,0,0,11
8122,2018,Türkiye,Lebanon,8,9,0,17
8123,2018,Ukraine,Lebanon,0,5,0,5
8124,2018,Yemen,Lebanon,18,136,0,154
8125,2018,Dem. Rep. of the Congo,Lesotho,41,36,0,77
8126,2018,Eritrea,Lesotho,5,0,0,5
8127,2018,Ethiopia,Lesotho,10,0,0,10
8128,2018,Afghanistan,Liechtenstein,5,0,0,5
8129,2018,Armenia,Liechtenstein,8,0,0,8
8130,2018,Belarus,Liechtenstein,0,5,0,5
8131,2018,China,Liechtenstein,28,6,0,34
8132,2018,Eritrea,Liechtenstein,12,5,0,17
8133,2018,Georgia,Liechtenstein,0,9,0,9
8134,2018,Iran (Islamic Rep. of),Liechtenstein,5,6,0,11
8135,2018,Iraq,Liechtenstein,7,0,0,7
8136,2018,North Macedonia,Liechtenstein,0,10,0,10
8137,2018,Nigeria,Liechtenstein,0,5,0,5
8138,2018,Serbia and Kosovo: S/RES/1244 (1999),Liechtenstein,36,10,0,46
8139,2018,Somalia,Liechtenstein,28,5,0,33
8140,2018,Syrian Arab Rep.,Liechtenstein,32,0,0,32
8141,2018,Ukraine,Liechtenstein,5,9,0,14
8142,2018,Afghanistan,Sri Lanka,146,34,0,180
8143,2018,Palestinian,Sri Lanka,9,0,0,9
8144,2018,Iran (Islamic Rep. of),Sri Lanka,18,12,0,30
8145,2018,Sri Lanka,Sri Lanka,0,0,35473,0
8146,2018,Maldives,Sri Lanka,6,5,0,11
8147,2018,Myanmar,Sri Lanka,33,0,0,33
8148,2018,Nigeria,Sri Lanka,0,7,0,7
8149,2018,Pakistan,Sri Lanka,558,676,0,1234
8150,2018,Sudan,Sri Lanka,0,5,0,5
8151,2018,Syrian Arab Rep.,Sri Lanka,14,0,0,14
8152,2018,Yemen,Sri Lanka,12,5,0,17
8153,2018,Afghanistan,Lithuania,222,20,0,242
8154,2018,Armenia,Lithuania,5,6,0,11
8155,2018,Azerbaijan,Lithuania,13,18,0,31
8156,2018,Belarus,Lithuania,35,5,0,40
8157,2018,Cameroon,Lithuania,5,0,0,5
8158,2018,Cuba,Lithuania,5,0,0,5
8159,2018,Eritrea,Lithuania,40,0,0,40
8160,2018,Ethiopia,Lithuania,5,0,0,5
8161,2018,Georgia,Lithuania,5,0,0,5
8162,2018,Iran (Islamic Rep. of),Lithuania,6,13,0,19
8163,2018,Iraq,Lithuania,59,23,0,82
8164,2018,Kyrgyzstan,Lithuania,0,12,0,12
8165,2018,Sri Lanka,Lithuania,10,14,0,24
8166,2018,Rep. of Moldova,Lithuania,0,5,0,5
8167,2018,Nigeria,Lithuania,5,7,0,12
8168,2018,Pakistan,Lithuania,5,0,0,5
8169,2018,Russian Federation,Lithuania,659,46,0,705
8170,2018,Somalia,Lithuania,22,0,0,22
8171,2018,Syrian Arab Rep.,Lithuania,435,10,0,445
8172,2018,Tajikistan,Lithuania,53,70,0,123
8173,2018,Türkiye,Lithuania,27,12,0,39
8174,2018,Ukraine,Lithuania,64,7,0,71
8175,2018,Uzbekistan,Lithuania,16,0,0,16
8176,2018,Stateless,Lithuania,35,5,0,40
8177,2018,Afghanistan,Luxembourg,43,115,0,158
8178,2018,Albania,Luxembourg,82,25,0,107
8179,2018,Algeria,Luxembourg,0,40,0,40
8180,2018,Angola,Luxembourg,15,0,0,15
8181,2018,Egypt,Luxembourg,5,10,0,15
8182,2018,Armenia,Luxembourg,6,0,0,6
8183,2018,Azerbaijan,Luxembourg,15,0,0,15
8184,2018,Benin,Luxembourg,0,10,0,10
8185,2018,Bhutan,Luxembourg,5,0,0,5
8186,2018,Burkina Faso,Luxembourg,0,5,0,5
8187,2018,Belarus,Luxembourg,7,10,0,17
8188,2018,Bosnia and Herzegovina,Luxembourg,7,5,0,12
8189,2018,China,Luxembourg,5,0,0,5
8190,2018,Cameroon,Luxembourg,12,20,0,32
8191,2018,Congo,Luxembourg,5,0,0,5
8192,2018,Dem. Rep. of the Congo,Luxembourg,38,20,0,58
8193,2018,Eritrea,Luxembourg,79,300,0,379
8194,2018,Ethiopia,Luxembourg,43,25,0,68
8195,2018,Gabon,Luxembourg,5,0,0,5
8196,2018,Gambia,Luxembourg,6,5,0,11
8197,2018,Georgia,Luxembourg,0,40,0,40
8198,2018,Guinea,Luxembourg,10,40,0,50
8199,2018,Cote d'Ivoire,Luxembourg,6,20,0,26
8200,2018,Iran (Islamic Rep. of),Luxembourg,148,40,0,188
8201,2018,Iraq,Luxembourg,280,115,0,395
8202,2018,Jordan,Luxembourg,0,5,0,5
8203,2018,Dem. People's Rep. of Korea,Luxembourg,12,0,0,12
8204,2018,Kuwait,Luxembourg,0,5,0,5
8205,2018,Libya,Luxembourg,5,10,0,15
8206,2018,Lebanon,Luxembourg,0,5,0,5
8207,2018,Sri Lanka,Luxembourg,5,0,0,5
8208,2018,Mauritania,Luxembourg,0,5,0,5
8209,2018,North Macedonia,Luxembourg,0,10,0,10
8210,2018,Rep. of Moldova,Luxembourg,0,5,0,5
8211,2018,Mexico,Luxembourg,5,0,0,5
8212,2018,Mali,Luxembourg,0,10,0,10
8213,2018,Morocco,Luxembourg,0,50,0,50
8214,2018,Montenegro,Luxembourg,18,15,0,33
8215,2018,Niger,Luxembourg,0,5,0,5
8216,2018,Nigeria,Luxembourg,10,20,0,30
8217,2018,Pakistan,Luxembourg,0,5,0,5
8218,2018,Peru,Luxembourg,5,0,0,5
8219,2018,Russian Federation,Luxembourg,33,15,0,48
8220,2018,Rwanda,Luxembourg,19,0,0,19
8221,2018,Serbia and Kosovo: S/RES/1244 (1999),Luxembourg,265,55,0,320
8222,2018,Senegal,Luxembourg,0,10,0,10
8223,2018,Somalia,Luxembourg,44,20,0,64
8224,2018,Sudan,Luxembourg,0,60,0,60
8225,2018,Syrian Arab Rep.,Luxembourg,686,160,0,846
8226,2018,Turkmenistan,Luxembourg,5,0,0,5
8227,2018,Togo,Luxembourg,5,10,0,15
8228,2018,Tunisia,Luxembourg,5,60,0,65
8229,2018,Türkiye,Luxembourg,24,40,0,64
8230,2018,Ukraine,Luxembourg,6,20,0,26
8231,2018,Venezuela (Bolivarian Republic of),Luxembourg,0,10,0,10
8232,2018,Yemen,Luxembourg,0,10,0,10
8233,2018,Stateless,Luxembourg,46,0,0,46
8234,2018,Unknown ,Luxembourg,0,20,0,20
8235,2018,Afghanistan,Latvia,67,0,0,67
8236,2018,Egypt,Latvia,5,7,0,12
8237,2018,Azerbaijan,Latvia,6,5,0,11
8238,2018,Cuba,Latvia,0,5,0,5
8239,2018,Eritrea,Latvia,37,0,0,37
8240,2018,Palestinian,Latvia,5,0,0,5
8241,2018,Iran (Islamic Rep. of),Latvia,23,0,0,23
8242,2018,Iraq,Latvia,38,5,0,43
8243,2018,Kazakhstan,Latvia,5,0,0,5
8244,2018,Kyrgyzstan,Latvia,8,0,0,8
8245,2018,Lebanon,Latvia,5,0,0,5
8246,2018,Sri Lanka,Latvia,5,0,0,5
8247,2018,Nigeria,Latvia,5,0,0,5
8248,2018,Russian Federation,Latvia,33,23,0,56
8249,2018,Somalia,Latvia,5,0,0,5
8250,2018,Syrian Arab Rep.,Latvia,384,0,0,384
8251,2018,Tajikistan,Latvia,5,0,0,5
8252,2018,Türkiye,Latvia,19,0,0,19
8253,2018,Uzbekistan,Latvia,9,0,0,9
8254,2018,Stateless,Latvia,0,0,0,0
8255,2018,Afghanistan,Madagascar,5,0,0,5
8256,2018,Dem. Rep. of the Congo,Madagascar,0,9,0,9
8257,2018,Pakistan,Madagascar,12,35,0,47
8258,2018,Somalia,Madagascar,0,5,0,5
8259,2018,Türkiye,Madagascar,0,20,0,20
8260,2018,Yemen,Madagascar,22,21,0,43
8261,2018,Afghanistan,Mauritania,0,8,0,8
8262,2018,Algeria,Mauritania,0,5,0,5
8263,2018,Benin,Mauritania,0,5,0,5
8264,2018,Burkina Faso,Mauritania,0,5,0,5
8265,2018,Central African Rep.,Mauritania,558,92,0,650
8266,2018,Chad,Mauritania,5,0,0,5
8267,2018,China,Mauritania,0,6,0,6
8268,2018,Cameroon,Mauritania,0,44,0,44
8269,2018,Congo,Mauritania,8,13,0,21
8270,2018,Dem. Rep. of the Congo,Mauritania,43,10,0,53
8271,2018,Ethiopia,Mauritania,6,0,0,6
8272,2018,Gabon,Mauritania,0,5,0,5
8273,2018,Gambia,Mauritania,0,10,0,10
8274,2018,Palestinian,Mauritania,29,34,0,63
8275,2018,Ghana,Mauritania,0,10,0,10
8276,2018,Guinea-Bissau,Mauritania,0,35,0,35
8277,2018,Guinea,Mauritania,9,98,0,107
8278,2018,Cote d'Ivoire,Mauritania,259,83,0,342
8279,2018,Iraq,Mauritania,24,0,0,24
8280,2018,Liberia,Mauritania,7,23,0,30
8281,2018,Lebanon,Mauritania,5,0,0,5
8282,2018,Mali,Mauritania,55785,28,0,55813
8283,2018,Morocco,Mauritania,0,6,0,6
8284,2018,Niger,Mauritania,0,7,0,7
8285,2018,Nigeria,Mauritania,11,75,0,86
8286,2018,Senegal,Mauritania,57,58,0,115
8287,2018,Sierra Leone,Mauritania,0,326,0,326
8288,2018,Sudan,Mauritania,11,17,0,28
8289,2018,South Sudan,Mauritania,5,0,0,5
8290,2018,Syrian Arab Rep.,Mauritania,332,47,0,379
8291,2018,Togo,Mauritania,24,40,0,64
8292,2018,Türkiye,Mauritania,0,24,0,24
8293,2018,Ukraine,Mauritania,5,0,0,5
8294,2018,Western Sahara,Mauritania,26000,0,0,26000
8295,2018,Yemen,Mauritania,0,12,0,12
8296,2018,Afghanistan,North Macedonia,5,0,0,5
8297,2018,Congo,North Macedonia,5,0,0,5
8298,2018,Iraq,North Macedonia,0,5,0,5
8299,2018,Pakistan,North Macedonia,5,0,0,5
8300,2018,Serbia and Kosovo: S/RES/1244 (1999),North Macedonia,381,0,0,381
8301,2018,Syrian Arab Rep.,North Macedonia,17,0,0,17
8302,2018,Stateless,North Macedonia,0,0,0,0
8303,2018,Unknown ,Monaco,25,0,0,25
8304,2018,Afghanistan,Rep. of Moldova,18,6,0,24
8305,2018,Egypt,Rep. of Moldova,5,0,0,5
8306,2018,Armenia,Rep. of Moldova,19,5,0,24
8307,2018,Azerbaijan,Rep. of Moldova,5,0,0,5
8308,2018,Bangladesh,Rep. of Moldova,0,13,0,13
8309,2018,Palestinian,Rep. of Moldova,5,0,0,5
8310,2018,Iran (Islamic Rep. of),Rep. of Moldova,5,0,0,5
8311,2018,Iraq,Rep. of Moldova,22,0,0,22
8312,2018,Kyrgyzstan,Rep. of Moldova,11,0,0,11
8313,2018,Russian Federation,Rep. of Moldova,5,12,0,17
8314,2018,Sudan,Rep. of Moldova,9,0,0,9
8315,2018,Syrian Arab Rep.,Rep. of Moldova,213,5,0,218
8316,2018,Tajikistan,Rep. of Moldova,7,0,0,7
8317,2018,Türkiye,Rep. of Moldova,12,32,0,44
8318,2018,Ukraine,Rep. of Moldova,58,10,0,68
8319,2018,Uzbekistan,Rep. of Moldova,10,10,0,20
8320,2018,Yemen,Rep. of Moldova,5,0,0,5
8321,2018,Stateless,Rep. of Moldova,0,0,0,0
8322,2018,Albania,Mexico,8,0,0,8
8323,2018,Angola,Mexico,5,0,0,5
8324,2018,Egypt,Mexico,5,0,0,5
8325,2018,Argentina,Mexico,5,5,0,10
8326,2018,Bangladesh,Mexico,5,0,0,5
8327,2018,Burkina Faso,Mexico,0,6,0,6
8328,2018,Belize,Mexico,0,5,0,5
8329,2018,Cambodia,Mexico,24,44,0,68
8330,2018,China,Mexico,5,5,0,10
8331,2018,Chile,Mexico,0,5,0,5
8332,2018,Congo,Mexico,20,7,0,27
8333,2018,Dem. Rep. of the Congo,Mexico,63,5,0,68
8334,2018,Colombia,Mexico,311,186,0,497
8335,2018,Costa Rica,Mexico,0,5,0,5
8336,2018,Cuba,Mexico,79,215,0,294
8337,2018,Dominican Rep.,Mexico,12,8,0,20
8338,2018,Ecuador,Mexico,0,14,0,14
8339,2018,Eritrea,Mexico,7,0,0,7
8340,2018,Ethiopia,Mexico,5,0,0,5
8341,2018,Palestinian,Mexico,5,0,0,5
8342,2018,Ghana,Mexico,7,28,0,35
8343,2018,Guatemala,Mexico,847,1039,0,1886
8344,2018,Guinea,Mexico,5,9,0,14
8345,2018,Haiti,Mexico,187,388,0,575
8346,2018,Honduras,Mexico,4656,10569,0,15225
8347,2018,Cote d'Ivoire,Mexico,5,0,0,5
8348,2018,India,Mexico,12,5,0,17
8349,2018,Iran (Islamic Rep. of),Mexico,38,0,0,38
8350,2018,Iraq,Mexico,43,5,0,48
8351,2018,Jamaica,Mexico,5,5,0,10
8352,2018,Sri Lanka,Mexico,20,15,0,35
8353,2018,Nicaragua,Mexico,100,1074,0,1174
8354,2018,Nigeria,Mexico,30,16,0,46
8355,2018,Pakistan,Mexico,9,5,0,14
8356,2018,Panama,Mexico,5,0,0,5
8357,2018,Peru,Mexico,12,7,0,19
8358,2018,Portugal,Mexico,5,0,0,5
8359,2018,Romania,Mexico,7,0,0,7
8360,2018,South Africa,Mexico,0,5,0,5
8361,2018,Russian Federation,Mexico,30,9,0,39
8362,2018,El Salvador,Mexico,5155,4527,0,9682
8363,2018,Somalia,Mexico,0,5,0,5
8364,2018,Spain,Mexico,0,5,0,5
8365,2018,Syrian Arab Rep.,Mexico,28,5,0,33
8366,2018,Türkiye,Mexico,7,0,0,7
8367,2018,Uganda,Mexico,0,15,0,15
8368,2018,Ukraine,Mexico,18,5,0,23
8369,2018,Uruguay,Mexico,0,5,0,5
8370,2018,United States of America,Mexico,7,33,0,40
8371,2018,Venezuela (Bolivarian Republic of),Mexico,4721,5523,0,10244
8372,2018,Yemen,Mexico,12,21,0,33
8373,2018,Stateless,Mexico,0,0,0,0
8374,2018,Unknown ,Mexico,0,0,0,0
8375,2018,Burundi,Mali,7,7,0,14
8376,2018,Bangladesh,Mali,0,22,0,22
8377,2018,Burkina Faso,Mali,8457,0,0,8457
8378,2018,Central African Rep.,Mali,854,406,0,1260
8379,2018,Cameroon,Mali,0,5,0,5
8380,2018,Congo,Mali,24,5,0,29
8381,2018,Dem. Rep. of the Congo,Mali,234,69,0,303
8382,2018,Eritrea,Mali,5,0,0,5
8383,2018,Cote d'Ivoire,Mali,583,46,0,629
8384,2018,Mauritania,Mali,15319,0,0,15319
8385,2018,Mali,Mali,0,0,120298,0
8386,2018,Niger,Mali,1024,0,0,1024
8387,2018,Nigeria,Mali,0,5,0,5
8388,2018,Pakistan,Mali,0,9,0,9
8389,2018,Rwanda,Mali,8,0,0,8
8390,2018,Syrian Arab Rep.,Mali,9,330,0,339
8391,2018,Togo,Mali,14,8,0,22
8392,2018,Türkiye,Mali,0,5,0,5
8393,2018,Afghanistan,Malaysia,647,1070,0,1717
8394,2018,Egypt,Malaysia,8,23,0,31
8395,2018,Austria,Malaysia,5,0,0,5
8396,2018,Bangladesh,Malaysia,31,10,0,41
8397,2018,Cambodia,Malaysia,72,0,0,72
8398,2018,Central African Rep.,Malaysia,0,10,0,10
8399,2018,China,Malaysia,27,14,0,41
8400,2018,Cameroon,Malaysia,0,6,0,6
8401,2018,Congo,Malaysia,0,5,0,5
8402,2018,Dem. Rep. of the Congo,Malaysia,0,7,0,7
8403,2018,Eritrea,Malaysia,5,10,0,15
8404,2018,Ethiopia,Malaysia,10,5,0,15
8405,2018,Palestinian,Malaysia,226,531,0,757
8406,2018,United Kingdom of Great Britain and Northern Ireland,Malaysia,5,0,0,5
8407,2018,Guinea,Malaysia,0,11,0,11
8408,2018,Cote d'Ivoire,Malaysia,5,0,0,5
8409,2018,India,Malaysia,0,5,0,5
8410,2018,Indonesia,Malaysia,926,17,0,943
8411,2018,Iran (Islamic Rep. of),Malaysia,210,170,0,380
8412,2018,Iraq,Malaysia,458,966,0,1424
8413,2018,Jordan,Malaysia,10,5,0,15
8414,2018,Lao People's Dem. Rep.,Malaysia,0,5,0,5
8415,2018,Liberia,Malaysia,10,13,0,23
8416,2018,Libya,Malaysia,5,25,0,30
8417,2018,Lebanon,Malaysia,5,0,0,5
8418,2018,Sri Lanka,Malaysia,942,797,0,1739
8419,2018,Mali,Malaysia,5,0,0,5
8420,2018,Myanmar,Malaysia,114227,26448,0,140675
8421,2018,Nepal,Malaysia,10,0,0,10
8422,2018,Nigeria,Malaysia,5,10,0,15
8423,2018,Pakistan,Malaysia,1638,4310,0,5948
8424,2018,Philippines,Malaysia,20,0,0,20
8425,2018,Russian Federation,Malaysia,5,0,0,5
8426,2018,Sierra Leone,Malaysia,5,42,0,47
8427,2018,Somalia,Malaysia,1045,1872,0,2917
8428,2018,Sudan,Malaysia,102,171,0,273
8429,2018,South Sudan,Malaysia,11,27,0,38
8430,2018,Syrian Arab Rep.,Malaysia,421,2406,0,2827
8431,2018,Thailand,Malaysia,28,5,0,33
8432,2018,Togo,Malaysia,0,5,0,5
8433,2018,Türkiye,Malaysia,0,6,0,6
8434,2018,United Arab Emirates,Malaysia,0,5,0,5
8435,2018,Uganda,Malaysia,0,6,0,6
8436,2018,United States of America,Malaysia,8,0,0,8
8437,2018,Uzbekistan,Malaysia,0,9,0,9
8438,2018,Yemen,Malaysia,163,2769,0,2932
8439,2018,Zimbabwe,Malaysia,5,5,0,10
8440,2018,Stateless,Malaysia,0,0,0,0
8441,2018,Burundi,Malawi,2514,5589,0,8103
8442,2018,Dem. Rep. of the Congo,Malawi,9187,13780,0,22967
8443,2018,Ethiopia,Malawi,5,42,0,47
8444,2018,Cote d'Ivoire,Malawi,5,0,0,5
8445,2018,Mozambique,Malawi,0,5,0,5
8446,2018,Rwanda,Malawi,2017,3597,0,5614
8447,2018,Somalia,Malawi,50,48,0,98
8448,2018,South Sudan,Malawi,5,0,0,5
8449,2018,United Rep. of Tanzania,Malawi,0,6,0,6
8450,2018,Türkiye,Malawi,0,48,0,48
8451,2018,Uganda,Malawi,0,13,0,13
8452,2018,Zimbabwe,Malawi,0,7,0,7
8453,2018,Afghanistan,Mongolia,5,0,0,5
8454,2018,Mongolia,Mongolia,0,0,0,0
8455,2018,Stateless,Mongolia,0,0,0,0
8456,2018,Afghanistan,Morocco,5,5,0,10
8457,2018,Algeria,Morocco,6,10,0,16
8458,2018,Egypt,Morocco,0,5,0,5
8459,2018,Benin,Morocco,0,5,0,5
8460,2018,Burkina Faso,Morocco,0,6,0,6
8461,2018,Central African Rep.,Morocco,408,32,0,440
8462,2018,Chad,Morocco,5,5,0,10
8463,2018,Cameroon,Morocco,100,447,0,547
8464,2018,Congo,Morocco,20,45,0,65
8465,2018,Dem. Rep. of the Congo,Morocco,183,105,0,288
8466,2018,Eritrea,Morocco,9,5,0,14
8467,2018,Gabon,Morocco,0,5,0,5
8468,2018,Gambia,Morocco,5,5,0,10
8469,2018,Palestinian,Morocco,84,97,0,181
8470,2018,Ghana,Morocco,0,5,0,5
8471,2018,Guinea-Bissau,Morocco,0,5,0,5
8472,2018,Guinea,Morocco,35,393,0,428
8473,2018,Cote d'Ivoire,Morocco,320,203,0,523
8474,2018,Iraq,Morocco,153,5,0,158
8475,2018,Liberia,Morocco,5,25,0,30
8476,2018,Libya,Morocco,35,5,0,40
8477,2018,Lebanon,Morocco,0,10,0,10
8478,2018,Mauritania,Morocco,5,5,0,10
8479,2018,Mali,Morocco,19,69,0,88
8480,2018,Nigeria,Morocco,12,193,0,205
8481,2018,Pakistan,Morocco,9,5,0,14
8482,2018,Senegal,Morocco,79,75,0,154
8483,2018,Sierra Leone,Morocco,0,21,0,21
8484,2018,Somalia,Morocco,8,0,0,8
8485,2018,Sudan,Morocco,10,7,0,17
8486,2018,South Sudan,Morocco,159,0,0,159
8487,2018,Syrian Arab Rep.,Morocco,3506,0,0,3506
8488,2018,Togo,Morocco,0,11,0,11
8489,2018,Türkiye,Morocco,0,15,0,15
8490,2018,Yemen,Morocco,752,0,0,752
8491,2018,Angola,Mozambique,5,0,0,5
8492,2018,Burundi,Mozambique,1032,7176,0,8208
8493,2018,Central African Rep.,Mozambique,0,5,0,5
8494,2018,Congo,Mozambique,15,16,0,31
8495,2018,Dem. Rep. of the Congo,Mozambique,2907,6688,0,9595
8496,2018,Comoros,Mozambique,0,16,0,16
8497,2018,Eritrea,Mozambique,0,5,0,5
8498,2018,Ethiopia,Mozambique,7,11,0,18
8499,2018,Guinea,Mozambique,0,5,0,5
8500,2018,Mauritania,Mozambique,0,5,0,5
8501,2018,Rwanda,Mozambique,773,3162,0,3935
8502,2018,Somalia,Mozambique,161,3997,0,4158
8503,2018,Sudan,Mozambique,5,16,0,21
8504,2018,Uganda,Mozambique,5,31,0,36
8505,2018,Afghanistan,Malta,0,5,0,5
8506,2018,Algeria,Malta,0,7,0,7
8507,2018,Egypt,Malta,74,30,0,104
8508,2018,Armenia,Malta,0,5,0,5
8509,2018,Bangladesh,Malta,9,108,0,117
8510,2018,Burkina Faso,Malta,5,5,0,10
8511,2018,Belarus,Malta,9,0,0,9
8512,2018,Chad,Malta,8,10,0,18
8513,2018,China,Malta,17,0,0,17
8514,2018,Cameroon,Malta,10,6,0,16
8515,2018,Dem. Rep. of the Congo,Malta,5,0,0,5
8516,2018,Colombia,Malta,0,6,0,6
8517,2018,Eritrea,Malta,784,47,0,831
8518,2018,Ethiopia,Malta,174,32,0,206
8519,2018,Gambia,Malta,27,62,0,89
8520,2018,Palestinian,Malta,70,46,0,116
8521,2018,Georgia,Malta,5,10,0,15
8522,2018,Ghana,Malta,8,8,0,16
8523,2018,Guinea-Bissau,Malta,0,5,0,5
8524,2018,Guinea,Malta,0,23,0,23
8525,2018,Cote d'Ivoire,Malta,11,55,0,66
8526,2018,Iran (Islamic Rep. of),Malta,29,5,0,34
8527,2018,Iraq,Malta,78,6,0,84
8528,2018,Jordan,Malta,5,0,0,5
8529,2018,Liberia,Malta,6,5,0,11
8530,2018,Libya,Malta,2688,297,0,2985
8531,2018,Sri Lanka,Malta,7,10,0,17
8532,2018,North Macedonia,Malta,5,10,0,15
8533,2018,Mali,Malta,18,28,0,46
8534,2018,Morocco,Malta,29,17,0,46
8535,2018,Niger,Malta,0,21,0,21
8536,2018,Nigeria,Malta,124,30,0,154
8537,2018,Pakistan,Malta,57,46,0,103
8538,2018,Russian Federation,Malta,18,0,0,18
8539,2018,El Salvador,Malta,0,5,0,5
8540,2018,Saudi Arabia,Malta,5,0,0,5
8541,2018,Serbia and Kosovo: S/RES/1244 (1999),Malta,7,0,0,7
8542,2018,Senegal,Malta,5,24,0,29
8543,2018,Sierra Leone,Malta,5,10,0,15
8544,2018,Somalia,Malta,1770,168,0,1938
8545,2018,Sudan,Malta,194,186,0,380
8546,2018,South Sudan,Malta,22,0,0,22
8547,2018,Syrian Arab Rep.,Malta,1497,370,0,1867
8548,2018,Togo,Malta,5,8,0,13
8549,2018,Tunisia,Malta,12,7,0,19
8550,2018,Türkiye,Malta,5,13,0,18
8551,2018,Uganda,Malta,0,5,0,5
8552,2018,Ukraine,Malta,136,43,0,179
8553,2018,Uzbekistan,Malta,0,5,0,5
8554,2018,Venezuela (Bolivarian Republic of),Malta,5,61,0,66
8555,2018,Yemen,Malta,0,5,0,5
8556,2018,Zimbabwe,Malta,5,5,0,10
8557,2018,Stateless,Malta,11,0,0,11
8558,2018,Unknown ,Malta,615,0,0,615
8559,2018,Algeria,Montenegro,0,19,0,19
8560,2018,Belarus,Montenegro,5,0,0,5
8561,2018,Bosnia and Herzegovina,Montenegro,20,0,0,20
8562,2018,Cuba,Montenegro,8,0,0,8
8563,2018,Palestinian,Montenegro,0,6,0,6
8564,2018,Ghana,Montenegro,5,0,0,5
8565,2018,Croatia,Montenegro,10,0,0,10
8566,2018,Iran (Islamic Rep. of),Montenegro,5,12,0,17
8567,2018,Iraq,Montenegro,0,7,0,7
8568,2018,Libya,Montenegro,0,24,0,24
8569,2018,Morocco,Montenegro,0,20,0,20
8570,2018,Nepal,Montenegro,0,5,0,5
8571,2018,Pakistan,Montenegro,0,22,0,22
8572,2018,Serbia and Kosovo: S/RES/1244 (1999),Montenegro,658,0,0,658
8573,2018,Syrian Arab Rep.,Montenegro,5,47,0,52
8574,2018,Yemen,Montenegro,11,0,0,11
8575,2018,Stateless,Montenegro,0,0,0,0
8576,2018,Unknown ,Montenegro,0,0,0,0
8577,2018,Dem. Rep. of the Congo,Mauritius,11,0,0,11
8578,2018,Syrian Arab Rep.,Mauritius,5,0,0,5
8579,2018,Myanmar,Myanmar,0,0,370306,0
8580,2018,Stateless,Myanmar,0,0,0,0
8581,2018,Burundi,Namibia,246,87,0,333
8582,2018,Central African Rep.,Namibia,0,18,0,18
8583,2018,Cameroon,Namibia,5,12,0,17
8584,2018,Congo,Namibia,5,0,0,5
8585,2018,Dem. Rep. of the Congo,Namibia,1942,1320,0,3262
8586,2018,Nigeria,Namibia,0,5,0,5
8587,2018,Rwanda,Namibia,127,21,0,148
8588,2018,Somalia,Namibia,5,0,0,5
8589,2018,Sudan,Namibia,5,0,0,5
8590,2018,Uganda,Namibia,5,5,0,10
8591,2018,Zimbabwe,Namibia,54,48,0,102
8592,2018,Afghanistan,Nepal,55,0,0,55
8593,2018,Bangladesh,Nepal,10,0,0,10
8594,2018,Bhutan,Nepal,6626,0,0,6626
8595,2018,India,Nepal,0,0,0,0
8596,2018,Iran (Islamic Rep. of),Nepal,5,0,0,5
8597,2018,Sri Lanka,Nepal,20,0,0,20
8598,2018,Myanmar,Nepal,332,34,0,366
8599,2018,Nepal,Nepal,0,0,0,0
8600,2018,Pakistan,Nepal,218,17,0,235
8601,2018,Somalia,Nepal,29,0,0,29
8602,2018,Tibetan,Nepal,13509,0,0,13509
8603,2018,Afghanistan,Netherlands,6267,538,0,6805
8604,2018,Albania,Netherlands,6,24,0,30
8605,2018,Algeria,Netherlands,16,325,0,341
8606,2018,Angola,Netherlands,51,5,0,56
8607,2018,Egypt,Netherlands,242,109,0,351
8608,2018,Argentina,Netherlands,5,0,0,5
8609,2018,Armenia,Netherlands,399,37,0,436
8610,2018,Azerbaijan,Netherlands,235,113,0,348
8611,2018,Bahrain,Netherlands,8,0,0,8
8612,2018,Burundi,Netherlands,141,5,0,146
8613,2018,Benin,Netherlands,5,5,0,10
8614,2018,Bangladesh,Netherlands,40,20,0,60
8615,2018,Bhutan,Netherlands,152,0,0,152
8616,2018,Burkina Faso,Netherlands,14,0,0,14
8617,2018,Belarus,Netherlands,51,111,0,162
8618,2018,Bosnia and Herzegovina,Netherlands,5,0,0,5
8619,2018,Cambodia,Netherlands,17,0,0,17
8620,2018,Central African Rep.,Netherlands,7,0,0,7
8621,2018,Chad,Netherlands,5,19,0,24
8622,2018,China,Netherlands,1106,122,0,1228
8623,2018,Cameroon,Netherlands,71,14,0,85
8624,2018,Congo,Netherlands,428,21,0,449
8625,2018,Dem. Rep. of the Congo,Netherlands,183,0,0,183
8626,2018,Colombia,Netherlands,29,36,0,65
8627,2018,Cuba,Netherlands,19,16,0,35
8628,2018,Ecuador,Netherlands,8,0,0,8
8629,2018,Eritrea,Netherlands,14931,765,0,15696
8630,2018,Ethiopia,Netherlands,524,45,0,569
8631,2018,Gambia,Netherlands,34,156,0,190
8632,2018,Palestinian,Netherlands,162,39,0,201
8633,2018,Georgia,Netherlands,43,46,0,89
8634,2018,Ghana,Netherlands,6,23,0,29
8635,2018,Guinea-Bissau,Netherlands,0,5,0,5
8636,2018,Guinea,Netherlands,627,179,0,806
8637,2018,Honduras,Netherlands,7,0,0,7
8638,2018,Cote d'Ivoire,Netherlands,258,25,0,283
8639,2018,India,Netherlands,6,6,0,12
8640,2018,Indonesia,Netherlands,0,5,0,5
8641,2018,Iran (Islamic Rep. of),Netherlands,4918,1921,0,6839
8642,2018,Iraq,Netherlands,9259,819,0,10078
8643,2018,Jamaica,Netherlands,189,0,0,189
8644,2018,Jordan,Netherlands,16,49,0,65
8645,2018,Kazakhstan,Netherlands,40,11,0,51
8646,2018,Kenya,Netherlands,38,7,0,45
8647,2018,Kyrgyzstan,Netherlands,19,0,0,19
8648,2018,Dem. People's Rep. of Korea,Netherlands,46,0,0,46
8649,2018,Kuwait,Netherlands,5,0,0,5
8650,2018,Lao People's Dem. Rep.,Netherlands,33,0,0,33
8651,2018,Liberia,Netherlands,64,5,0,69
8652,2018,Libya,Netherlands,280,202,0,482
8653,2018,Lebanon,Netherlands,36,43,0,79
8654,2018,Sri Lanka,Netherlands,635,54,0,689
8655,2018,Mauritania,Netherlands,7,0,0,7
8656,2018,Rep. of Moldova,Netherlands,0,229,0,229
8657,2018,Mali,Netherlands,16,12,0,28
8658,2018,Malaysia,Netherlands,7,0,0,7
8659,2018,Malawi,Netherlands,5,0,0,5
8660,2018,Mongolia,Netherlands,38,0,0,38
8661,2018,Morocco,Netherlands,44,327,0,371
8662,2018,Myanmar,Netherlands,567,22,0,589
8663,2018,Namibia,Netherlands,5,0,0,5
8664,2018,Nepal,Netherlands,239,0,0,239
8665,2018,Niger,Netherlands,6,9,0,15
8666,2018,Nicaragua,Netherlands,0,20,0,20
8667,2018,Nigeria,Netherlands,303,377,0,680
8668,2018,Pakistan,Netherlands,479,250,0,729
8669,2018,Peru,Netherlands,9,0,0,9
8670,2018,Russian Federation,Netherlands,284,132,0,416
8671,2018,Rwanda,Netherlands,54,7,0,61
8672,2018,El Salvador,Netherlands,0,8,0,8
8673,2018,Saudi Arabia,Netherlands,13,0,0,13
8674,2018,Serbia and Kosovo: S/RES/1244 (1999),Netherlands,25,0,0,25
8675,2018,Senegal,Netherlands,30,19,0,49
8676,2018,Sierra Leone,Netherlands,437,65,0,502
8677,2018,Somalia,Netherlands,14011,133,0,14144
8678,2018,Viet Nam,Netherlands,5,5,0,10
8679,2018,Sudan,Netherlands,819,145,0,964
8680,2018,Syrian Arab Rep.,Netherlands,32092,1687,0,33779
8681,2018,United Rep. of Tanzania,Netherlands,6,0,0,6
8682,2018,Tajikistan,Netherlands,34,32,0,66
8683,2018,Turkmenistan,Netherlands,5,0,0,5
8684,2018,Togo,Netherlands,29,0,0,29
8685,2018,Trinidad and Tobago,Netherlands,75,7,0,82
8686,2018,Tunisia,Netherlands,16,64,0,80
8687,2018,Türkiye,Netherlands,844,1090,0,1934
8688,2018,Uganda,Netherlands,531,129,0,660
8689,2018,Ukraine,Netherlands,23,31,0,54
8690,2018,United States of America,Netherlands,6,14,0,20
8691,2018,Uzbekistan,Netherlands,42,0,0,42
8692,2018,Venezuela (Bolivarian Republic of),Netherlands,0,128,0,128
8693,2018,Yemen,Netherlands,376,399,0,775
8694,2018,Zambia,Netherlands,8,0,0,8
8695,2018,Zimbabwe,Netherlands,30,0,0,30
8696,2018,Stateless,Netherlands,5406,61,0,5467
8697,2018,Unknown ,Netherlands,3212,976,0,4188
8698,2018,Central African Rep.,Niger,59,91,0,150
8699,2018,Chad,Niger,165,858,0,1023
8700,2018,Cameroon,Niger,7,83,0,90
8701,2018,Congo,Niger,5,0,0,5
8702,2018,Dem. Rep. of the Congo,Niger,74,14,0,88
8703,2018,Eritrea,Niger,493,297,0,790
8704,2018,Ethiopia,Niger,48,80,0,128
8705,2018,Ghana,Niger,0,5,0,5
8706,2018,Guinea,Niger,0,15,0,15
8707,2018,Cote d'Ivoire,Niger,36,10,0,46
8708,2018,Iraq,Niger,6,0,0,6
8709,2018,Libya,Niger,7,6,0,13
8710,2018,Mali,Niger,55540,37,0,55577
8711,2018,Niger,Niger,0,0,156137,0
8712,2018,Nigeria,Niger,118868,135,0,119003
8713,2018,Pakistan,Niger,0,9,0,9
8714,2018,Rwanda,Niger,18,0,0,18
8715,2018,Somalia,Niger,52,200,0,252
8716,2018,Sudan,Niger,19,1687,0,1706
8717,2018,South Sudan,Niger,5,8,0,13
8718,2018,Syrian Arab Rep.,Niger,11,5,0,16
8719,2018,Togo,Niger,0,7,0,7
8720,2018,Colombia,Nicaragua,6,0,0,6
8721,2018,Cuba,Nicaragua,15,0,0,15
8722,2018,Guatemala,Nicaragua,9,0,0,9
8723,2018,Honduras,Nicaragua,74,26,0,100
8724,2018,El Salvador,Nicaragua,217,100,0,317
8725,2018,Afghanistan,Nigeria,5,0,0,5
8726,2018,Benin,Nigeria,0,5,0,5
8727,2018,Central African Rep.,Nigeria,432,190,0,622
8728,2018,Chad,Nigeria,87,35,0,122
8729,2018,Cameroon,Nigeria,32751,271,0,33022
8730,2018,Congo,Nigeria,5,5,0,10
8731,2018,Dem. Rep. of the Congo,Nigeria,624,212,0,836
8732,2018,Eritrea,Nigeria,29,5,0,34
8733,2018,Ethiopia,Nigeria,6,0,0,6
8734,2018,Palestinian,Nigeria,10,0,0,10
8735,2018,Ghana,Nigeria,5,7,0,12
8736,2018,Guinea-Bissau,Nigeria,5,0,0,5
8737,2018,Guinea,Nigeria,17,5,0,22
8738,2018,Cote d'Ivoire,Nigeria,123,19,0,142
8739,2018,Liberia,Nigeria,9,5,0,14
8740,2018,Lebanon,Nigeria,0,9,0,9
8741,2018,Mali,Nigeria,137,33,0,170
8742,2018,Niger,Nigeria,6,0,0,6
8743,2018,Nigeria,Nigeria,0,0,2167925,0
8744,2018,Sierra Leone,Nigeria,21,5,0,26
8745,2018,Sudan,Nigeria,49,5,0,54
8746,2018,Syrian Arab Rep.,Nigeria,224,75,0,299
8747,2018,Togo,Nigeria,20,22,0,42
8748,2018,Türkiye,Nigeria,162,32,0,194
8749,2018,Afghanistan,Norway,6065,193,0,6258
8750,2018,Albania,Norway,19,37,0,56
8751,2018,Algeria,Norway,8,0,0,8
8752,2018,Angola,Norway,14,5,0,19
8753,2018,Egypt,Norway,59,5,0,64
8754,2018,Armenia,Norway,0,5,0,5
8755,2018,Azerbaijan,Norway,27,0,0,27
8756,2018,Burundi,Norway,63,0,0,63
8757,2018,Bangladesh,Norway,8,15,0,23
8758,2018,Bulgaria,Norway,8,0,0,8
8759,2018,Central African Rep.,Norway,6,0,0,6
8760,2018,Chad,Norway,5,0,0,5
8761,2018,China,Norway,594,10,0,604
8762,2018,Cameroon,Norway,25,5,0,30
8763,2018,Congo,Norway,6,0,0,6
8764,2018,Dem. Rep. of the Congo,Norway,181,12,0,193
8765,2018,Colombia,Norway,10,6,0,16
8766,2018,Cuba,Norway,7,0,0,7
8767,2018,Eritrea,Norway,15246,124,0,15370
8768,2018,Ethiopia,Norway,1951,67,0,2018
8769,2018,Gambia,Norway,17,0,0,17
8770,2018,Georgia,Norway,5,0,0,5
8771,2018,Ghana,Norway,8,0,0,8
8772,2018,Guinea-Bissau,Norway,5,0,0,5
8773,2018,Guatemala,Norway,7,0,0,7
8774,2018,Guinea,Norway,51,0,0,51
8775,2018,Honduras,Norway,5,0,0,5
8776,2018,Cote d'Ivoire,Norway,15,0,0,15
8777,2018,Iran (Islamic Rep. of),Norway,1966,180,0,2146
8778,2018,Iraq,Norway,1989,138,0,2127
8779,2018,Israel,Norway,11,0,0,11
8780,2018,Jordan,Norway,7,0,0,7
8781,2018,Kazakhstan,Norway,11,5,0,16
8782,2018,Kenya,Norway,6,5,0,11
8783,2018,Kyrgyzstan,Norway,17,0,0,17
8784,2018,Liberia,Norway,14,5,0,19
8785,2018,Libya,Norway,58,5,0,63
8786,2018,Lebanon,Norway,26,5,0,31
8787,2018,Sri Lanka,Norway,171,10,0,181
8788,2018,Rep. of Moldova,Norway,5,0,0,5
8789,2018,Mali,Norway,8,0,0,8
8790,2018,Malaysia,Norway,0,5,0,5
8791,2018,Mongolia,Norway,5,6,0,11
8792,2018,Morocco,Norway,27,10,0,37
8793,2018,Montenegro,Norway,5,0,0,5
8794,2018,Myanmar,Norway,128,10,0,138
8795,2018,Nepal,Norway,7,0,0,7
8796,2018,Nicaragua,Norway,0,13,0,13
8797,2018,Nigeria,Norway,166,16,0,182
8798,2018,Pakistan,Norway,96,11,0,107
8799,2018,Peru,Norway,0,5,0,5
8800,2018,Philippines,Norway,6,5,0,11
8801,2018,Russian Federation,Norway,766,55,0,821
8802,2018,Rwanda,Norway,36,0,0,36
8803,2018,El Salvador,Norway,0,10,0,10
8804,2018,Saudi Arabia,Norway,6,0,0,6
8805,2018,Serbia and Kosovo: S/RES/1244 (1999),Norway,85,0,0,85
8806,2018,Sierra Leone,Norway,12,0,0,12
8807,2018,Somalia,Norway,7183,69,0,7252
8808,2018,Viet Nam,Norway,42,0,0,42
8809,2018,Sudan,Norway,1938,32,0,1970
8810,2018,South Sudan,Norway,14,5,0,19
8811,2018,Syrian Arab Rep.,Norway,13914,235,0,14149
8812,2018,United Rep. of Tanzania,Norway,5,0,0,5
8813,2018,Tajikistan,Norway,6,0,0,6
8814,2018,Turkmenistan,Norway,8,5,0,13
8815,2018,Tunisia,Norway,5,5,0,10
8816,2018,Türkiye,Norway,249,744,0,993
8817,2018,United Arab Emirates,Norway,0,5,0,5
8818,2018,Uganda,Norway,116,10,0,126
8819,2018,Ukraine,Norway,10,14,0,24
8820,2018,Uzbekistan,Norway,208,11,0,219
8821,2018,Venezuela (Bolivarian Republic of),Norway,7,24,0,31
8822,2018,Yemen,Norway,235,7,0,242
8823,2018,Zimbabwe,Norway,14,0,0,14
8824,2018,Stateless,Norway,3001,97,0,3098
8825,2018,Afghanistan,Nauru,81,5,0,86
8826,2018,Bangladesh,Nauru,9,33,0,42
8827,2018,India,Nauru,11,11,0,22
8828,2018,Indonesia,Nauru,5,5,0,10
8829,2018,Iran (Islamic Rep. of),Nauru,316,203,0,519
8830,2018,Iraq,Nauru,43,13,0,56
8831,2018,Kuwait,Nauru,5,0,0,5
8832,2018,Lebanon,Nauru,14,0,0,14
8833,2018,Sri Lanka,Nauru,101,55,0,156
8834,2018,Malaysia,Nauru,5,5,0,10
8835,2018,Myanmar,Nauru,115,13,0,128
8836,2018,Nepal,Nauru,5,14,0,19
8837,2018,Pakistan,Nauru,120,26,0,146
8838,2018,Somalia,Nauru,56,9,0,65
8839,2018,Sudan,Nauru,13,0,0,13
8840,2018,Syrian Arab Rep.,Nauru,0,5,0,5
8841,2018,Stateless,Nauru,65,19,0,84
8842,2018,Afghanistan,New Zealand,47,5,0,52
8843,2018,Algeria,New Zealand,5,0,0,5
8844,2018,Egypt,New Zealand,28,0,0,28
8845,2018,Bahrain,New Zealand,24,0,0,24
8846,2018,Bangladesh,New Zealand,7,10,0,17
8847,2018,China,New Zealand,192,77,0,269
8848,2018,Chile,New Zealand,5,0,0,5
8849,2018,Cameroon,New Zealand,5,0,0,5
8850,2018,Congo,New Zealand,5,0,0,5
8851,2018,Dem. Rep. of the Congo,New Zealand,5,0,0,5
8852,2018,Colombia,New Zealand,26,7,0,33
8853,2018,Czechia,New Zealand,17,8,0,25
8854,2018,Eritrea,New Zealand,7,0,0,7
8855,2018,Ethiopia,New Zealand,10,5,0,15
8856,2018,Fiji,New Zealand,28,0,0,28
8857,2018,Palestinian,New Zealand,16,0,0,16
8858,2018,Hungary,New Zealand,8,0,0,8
8859,2018,India,New Zealand,8,34,0,42
8860,2018,Indonesia,New Zealand,5,0,0,5
8861,2018,Iran (Islamic Rep. of),New Zealand,144,15,0,159
8862,2018,Iraq,New Zealand,94,0,0,94
8863,2018,Jordan,New Zealand,8,0,0,8
8864,2018,Kuwait,New Zealand,7,0,0,7
8865,2018,Libya,New Zealand,22,0,0,22
8866,2018,Sri Lanka,New Zealand,62,31,0,93
8867,2018,Madagascar,New Zealand,5,0,0,5
8868,2018,Maldives,New Zealand,5,0,0,5
8869,2018,Mexico,New Zealand,5,0,0,5
8870,2018,Malaysia,New Zealand,5,9,0,14
8871,2018,Myanmar,New Zealand,7,5,0,12
8872,2018,Nepal,New Zealand,5,0,0,5
8873,2018,Pakistan,New Zealand,61,16,0,77
8874,2018,Philippines,New Zealand,0,5,0,5
8875,2018,South Africa,New Zealand,10,5,0,15
8876,2018,Russian Federation,New Zealand,19,7,0,26
8877,2018,El Salvador,New Zealand,5,0,0,5
8878,2018,Saudi Arabia,New Zealand,60,20,0,80
8879,2018,Somalia,New Zealand,16,0,0,16
8880,2018,Viet Nam,New Zealand,9,0,0,9
8881,2018,Sudan,New Zealand,5,5,0,10
8882,2018,Syrian Arab Rep.,New Zealand,68,0,0,68
8883,2018,Türkiye,New Zealand,53,7,0,60
8884,2018,Uganda,New Zealand,5,0,0,5
8885,2018,Uruguay,New Zealand,0,5,0,5
8886,2018,Yemen,New Zealand,8,0,0,8
8887,2018,Zimbabwe,New Zealand,23,6,0,29
8888,2018,Unknown ,New Zealand,386,164,0,550
8889,2018,Iraq,Oman,298,254,0,552
8890,2018,Pakistan,Oman,5,0,0,5
8891,2018,Syrian Arab Rep.,Oman,7,0,0,7
8892,2018,Afghanistan,Pakistan,1403521,5012,0,1408533
8893,2018,Algeria,Pakistan,22,0,0,22
8894,2018,Palestinian,Pakistan,21,0,0,21
8895,2018,Iran (Islamic Rep. of),Pakistan,38,19,0,57
8896,2018,Iraq,Pakistan,22,7,0,29
8897,2018,Myanmar,Pakistan,22,31,0,53
8898,2018,Pakistan,Pakistan,0,0,96384,0
8899,2018,Russian Federation,Pakistan,7,0,0,7
8900,2018,Somalia,Pakistan,181,13,0,194
8901,2018,Syrian Arab Rep.,Pakistan,29,6,0,35
8902,2018,Tajikistan,Pakistan,6,0,0,6
8903,2018,Türkiye,Pakistan,11,51,0,62
8904,2018,Yemen,Pakistan,128,31,0,159
8905,2018,Afghanistan,Panama,5,6,0,11
8906,2018,Armenia,Panama,0,6,0,6
8907,2018,Bangladesh,Panama,0,18,0,18
8908,2018,Belarus,Panama,7,5,0,12
8909,2018,Brazil,Panama,0,6,0,6
8910,2018,Bosnia and Herzegovina,Panama,5,0,0,5
8911,2018,Cameroon,Panama,8,5,0,13
8912,2018,Dem. Rep. of the Congo,Panama,5,0,0,5
8913,2018,Colombia,Panama,1691,1796,0,3487
8914,2018,Costa Rica,Panama,0,5,0,5
8915,2018,Cuba,Panama,120,1740,0,1860
8916,2018,Dominican Rep.,Panama,5,28,0,33
8917,2018,Ecuador,Panama,0,19,0,19
8918,2018,Eritrea,Panama,0,39,0,39
8919,2018,Guatemala,Panama,12,14,0,26
8920,2018,Haiti,Panama,19,0,0,19
8921,2018,Honduras,Panama,0,46,0,46
8922,2018,Croatia,Panama,5,0,0,5
8923,2018,Cote d'Ivoire,Panama,0,5,0,5
8924,2018,India,Panama,0,5,0,5
8925,2018,Iran (Islamic Rep. of),Panama,5,0,0,5
8926,2018,Italy,Panama,0,5,0,5
8927,2018,Kenya,Panama,0,7,0,7
8928,2018,Liberia,Panama,5,0,0,5
8929,2018,Sri Lanka,Panama,0,8,0,8
8930,2018,Mexico,Panama,5,0,0,5
8931,2018,Nepal,Panama,0,14,0,14
8932,2018,Nicaragua,Panama,173,3291,0,3464
8933,2018,Nigeria,Panama,10,35,0,45
8934,2018,Peru,Panama,23,5,0,28
8935,2018,El Salvador,Panama,342,1306,0,1648
8936,2018,Sierra Leone,Panama,5,0,0,5
8937,2018,Somalia,Panama,0,103,0,103
8938,2018,Sudan,Panama,5,0,0,5
8939,2018,Syrian Arab Rep.,Panama,0,12,0,12
8940,2018,Ukraine,Panama,0,5,0,5
8941,2018,Venezuela (Bolivarian Republic of),Panama,46,5068,0,5114
8942,2018,Bolivia (Plurinational State of),Paraguay,17,0,0,17
8943,2018,Colombia,Paraguay,35,5,0,40
8944,2018,Cuba,Paraguay,81,229,0,310
8945,2018,Iraq,Paraguay,6,0,0,6
8946,2018,Lebanon,Paraguay,0,5,0,5
8947,2018,Nigeria,Paraguay,0,5,0,5
8948,2018,Russian Federation,Paraguay,8,0,0,8
8949,2018,El Salvador,Paraguay,5,5,0,10
8950,2018,Viet Nam,Paraguay,6,0,0,6
8951,2018,Syrian Arab Rep.,Paraguay,63,22,0,85
8952,2018,Türkiye,Paraguay,5,0,0,5
8953,2018,Venezuela (Bolivarian Republic of),Paraguay,34,79,0,113
8954,2018,Angola,Peru,0,5,0,5
8955,2018,Argentina,Peru,0,11,0,11
8956,2018,Bangladesh,Peru,20,0,0,20
8957,2018,Bolivia (Plurinational State of),Peru,12,12,0,24
8958,2018,Brazil,Peru,5,5,0,10
8959,2018,Bosnia and Herzegovina,Peru,5,0,0,5
8960,2018,China,Peru,0,8,0,8
8961,2018,Chile,Peru,0,6,0,6
8962,2018,Cameroon,Peru,13,0,0,13
8963,2018,Congo,Peru,0,9,0,9
8964,2018,Dem. Rep. of the Congo,Peru,5,0,0,5
8965,2018,Colombia,Peru,623,780,0,1403
8966,2018,Costa Rica,Peru,0,5,0,5
8967,2018,Cuba,Peru,676,2254,0,2930
8968,2018,Dominican Rep.,Peru,16,35,0,51
8969,2018,Ecuador,Peru,5,69,0,74
8970,2018,Ethiopia,Peru,5,0,0,5
8971,2018,Gambia,Peru,5,0,0,5
8972,2018,Palestinian,Peru,37,8,0,45
8973,2018,Ghana,Peru,5,0,0,5
8974,2018,Haiti,Peru,69,73,0,142
8975,2018,Honduras,Peru,0,5,0,5
8976,2018,Hungary,Peru,6,0,0,6
8977,2018,India,Peru,6,0,0,6
8978,2018,Iran (Islamic Rep. of),Peru,10,5,0,15
8979,2018,Iraq,Peru,17,0,0,17
8980,2018,Italy,Peru,0,5,0,5
8981,2018,Sri Lanka,Peru,0,6,0,6
8982,2018,Mexico,Peru,0,5,0,5
8983,2018,Nepal,Peru,0,5,0,5
8984,2018,Nicaragua,Peru,0,12,0,12
8985,2018,Nigeria,Peru,16,9,0,25
8986,2018,Pakistan,Peru,0,11,0,11
8987,2018,Panama,Peru,0,8,0,8
8988,2018,Paraguay,Peru,0,5,0,5
8989,2018,Philippines,Peru,0,27,0,27
8990,2018,Poland,Peru,5,5,0,10
8991,2018,Portugal,Peru,0,11,0,11
8992,2018,Russian Federation,Peru,16,5,0,21
8993,2018,El Salvador,Peru,5,5,0,10
8994,2018,Serbia and Kosovo: S/RES/1244 (1999),Peru,64,0,0,64
8995,2018,Spain,Peru,0,12,0,12
8996,2018,Syrian Arab Rep.,Peru,44,7,0,51
8997,2018,Türkiye,Peru,55,44,0,99
8998,2018,Ukraine,Peru,16,0,0,16
8999,2018,Uruguay,Peru,0,5,0,5
9000,2018,United States of America,Peru,0,5,0,5
9001,2018,Uzbekistan,Peru,5,0,0,5
9002,2018,Venezuela (Bolivarian Republic of),Peru,735,227325,0,228060
9003,2018,Yemen,Peru,0,38,0,38
9004,2018,Unknown ,Peru,5,0,0,5
9005,2018,Afghanistan,Philippines,14,6,0,20
9006,2018,Burundi,Philippines,13,0,0,13
9007,2018,Bangladesh,Philippines,0,5,0,5
9008,2018,Cambodia,Philippines,6,10,0,16
9009,2018,China,Philippines,5,5,0,10
9010,2018,Cameroon,Philippines,12,12,0,24
9011,2018,Congo,Philippines,0,5,0,5
9012,2018,Dem. Rep. of the Congo,Philippines,6,0,0,6
9013,2018,Eritrea,Philippines,17,5,0,22
9014,2018,Ethiopia,Philippines,5,0,0,5
9015,2018,Palestinian,Philippines,55,6,0,61
9016,2018,Ghana,Philippines,5,0,0,5
9017,2018,Guinea,Philippines,0,5,0,5
9018,2018,Cote d'Ivoire,Philippines,24,22,0,46
9019,2018,Iran (Islamic Rep. of),Philippines,69,10,0,79
9020,2018,Iraq,Philippines,52,9,0,61
9021,2018,Liberia,Philippines,5,0,0,5
9022,2018,Lebanon,Philippines,5,0,0,5
9023,2018,Sri Lanka,Philippines,20,0,0,20
9024,2018,Myanmar,Philippines,10,0,0,10
9025,2018,Nigeria,Philippines,5,10,0,15
9026,2018,Pakistan,Philippines,91,12,0,103
9027,2018,Philippines,Philippines,0,0,77651,0
9028,2018,Rwanda,Philippines,19,0,0,19
9029,2018,Saudi Arabia,Philippines,7,5,0,12
9030,2018,Somalia,Philippines,29,11,0,40
9031,2018,Viet Nam,Philippines,8,0,0,8
9032,2018,Sudan,Philippines,6,10,0,16
9033,2018,Syrian Arab Rep.,Philippines,105,33,0,138
9034,2018,Türkiye,Philippines,23,37,0,60
9035,2018,Yemen,Philippines,10,12,0,22
9036,2018,Stateless,Philippines,5,0,0,5
9037,2018,Unknown ,Philippines,0,8,0,8
9038,2018,Afghanistan,Papua New Guinea,118,7,0,125
9039,2018,Bangladesh,Papua New Guinea,20,5,0,25
9040,2018,India,Papua New Guinea,0,5,0,5
9041,2018,Indonesia,Papua New Guinea,9368,0,0,9368
9042,2018,Iran (Islamic Rep. of),Papua New Guinea,159,124,0,283
9043,2018,Iraq,Papua New Guinea,47,5,0,52
9044,2018,Sri Lanka,Papua New Guinea,21,0,0,21
9045,2018,Myanmar,Papua New Guinea,0,5,0,5
9046,2018,Pakistan,Papua New Guinea,96,0,0,96
9047,2018,Somalia,Papua New Guinea,39,0,0,39
9048,2018,Sudan,Papua New Guinea,75,0,0,75
9049,2018,Stateless,Papua New Guinea,79,0,0,79
9050,2018,Afghanistan,Poland,110,15,0,125
9051,2018,Algeria,Poland,5,6,0,11
9052,2018,Egypt,Poland,65,15,0,80
9053,2018,Armenia,Poland,78,36,0,114
9054,2018,Azerbaijan,Poland,5,5,0,10
9055,2018,Bangladesh,Poland,8,8,0,16
9056,2018,Belarus,Poland,199,25,0,224
9057,2018,Central African Rep.,Poland,5,0,0,5
9058,2018,China,Poland,18,0,0,18
9059,2018,Cameroon,Poland,11,0,0,11
9060,2018,Congo,Poland,7,0,0,7
9061,2018,Dem. Rep. of the Congo,Poland,6,0,0,6
9062,2018,Cuba,Poland,17,0,0,17
9063,2018,Eritrea,Poland,31,0,0,31
9064,2018,Ethiopia,Poland,5,0,0,5
9065,2018,Palestinian,Poland,17,5,0,22
9066,2018,Georgia,Poland,71,62,0,133
9067,2018,India,Poland,5,5,0,10
9068,2018,Iran (Islamic Rep. of),Poland,35,17,0,52
9069,2018,Iraq,Poland,255,27,0,282
9070,2018,Jordan,Poland,0,5,0,5
9071,2018,Kazakhstan,Poland,64,26,0,90
9072,2018,Kenya,Poland,5,0,0,5
9073,2018,Kyrgyzstan,Poland,57,30,0,87
9074,2018,Libya,Poland,31,5,0,36
9075,2018,Sri Lanka,Poland,49,0,0,49
9076,2018,Rep. of Moldova,Poland,5,5,0,10
9077,2018,Mongolia,Poland,19,0,0,19
9078,2018,Nepal,Poland,8,0,0,8
9079,2018,Nigeria,Poland,10,5,0,15
9080,2018,Pakistan,Poland,32,20,0,52
9081,2018,Russian Federation,Poland,9893,2246,0,12139
9082,2018,Rwanda,Poland,5,0,0,5
9083,2018,Serbia and Kosovo: S/RES/1244 (1999),Poland,5,0,0,5
9084,2018,Senegal,Poland,5,0,0,5
9085,2018,Somalia,Poland,47,0,0,47
9086,2018,Viet Nam,Poland,16,9,0,25
9087,2018,Sudan,Poland,5,0,0,5
9088,2018,Syrian Arab Rep.,Poland,531,20,0,551
9089,2018,Tajikistan,Poland,73,95,0,168
9090,2018,Turkmenistan,Poland,42,0,0,42
9091,2018,Türkiye,Poland,43,37,0,80
9092,2018,Uganda,Poland,6,0,0,6
9093,2018,Ukraine,Poland,464,309,0,773
9094,2018,Uzbekistan,Poland,20,5,0,25
9095,2018,Yemen,Poland,9,8,0,17
9096,2018,Stateless,Poland,98,8,0,106
9097,2018,Afghanistan,Portugal,16,5,0,21
9098,2018,Angola,Portugal,0,25,0,25
9099,2018,Armenia,Portugal,5,0,0,5
9100,2018,Bangladesh,Portugal,5,0,0,5
9101,2018,Belarus,Portugal,16,0,0,16
9102,2018,Brazil,Portugal,0,5,0,5
9103,2018,Bosnia and Herzegovina,Portugal,11,0,0,11
9104,2018,Central African Rep.,Portugal,8,0,0,8
9105,2018,Cameroon,Portugal,13,0,0,13
9106,2018,Congo,Portugal,7,0,0,7
9107,2018,Dem. Rep. of the Congo,Portugal,60,5,0,65
9108,2018,Colombia,Portugal,58,0,0,58
9109,2018,Cuba,Portugal,5,0,0,5
9110,2018,Eritrea,Portugal,188,0,0,188
9111,2018,Ethiopia,Portugal,6,0,0,6
9112,2018,Gambia,Portugal,5,5,0,10
9113,2018,Palestinian,Portugal,5,5,0,10
9114,2018,Georgia,Portugal,5,0,0,5
9115,2018,Guinea-Bissau,Portugal,9,5,0,14
9116,2018,Guinea,Portugal,98,5,0,103
9117,2018,Cote d'Ivoire,Portugal,32,0,0,32
9118,2018,Iran (Islamic Rep. of),Portugal,37,0,0,37
9119,2018,Iraq,Portugal,162,0,0,162
9120,2018,Kenya,Portugal,6,0,0,6
9121,2018,Libya,Portugal,14,0,0,14
9122,2018,Sri Lanka,Portugal,41,0,0,41
9123,2018,Mauritania,Portugal,5,0,0,5
9124,2018,Mali,Portugal,13,0,0,13
9125,2018,Morocco,Portugal,9,0,0,9
9126,2018,Nigeria,Portugal,24,0,0,24
9127,2018,Pakistan,Portugal,65,5,0,70
9128,2018,Russian Federation,Portugal,16,0,0,16
9129,2018,Rwanda,Portugal,5,0,0,5
9130,2018,Senegal,Portugal,7,0,0,7
9131,2018,Sierra Leone,Portugal,26,0,0,26
9132,2018,Somalia,Portugal,37,5,0,42
9133,2018,Sudan,Portugal,23,0,0,23
9134,2018,South Sudan,Portugal,15,0,0,15
9135,2018,Syrian Arab Rep.,Portugal,602,0,0,602
9136,2018,Togo,Portugal,6,0,0,6
9137,2018,Türkiye,Portugal,5,0,0,5
9138,2018,Uganda,Portugal,5,0,0,5
9139,2018,Ukraine,Portugal,423,15,0,438
9140,2018,Yemen,Portugal,7,0,0,7
9141,2018,Stateless,Portugal,25,0,0,25
9142,2018,Egypt,Qatar,9,0,0,9
9143,2018,Eritrea,Qatar,0,5,0,5
9144,2018,Iraq,Qatar,138,73,0,211
9145,2018,Somalia,Qatar,8,0,0,8
9146,2018,Sudan,Qatar,0,13,0,13
9147,2018,Syrian Arab Rep.,Qatar,34,0,0,34
9148,2018,Stateless,Qatar,0,0,0,0
9149,2018,Afghanistan,Romania,155,74,0,229
9150,2018,Algeria,Romania,5,0,0,5
9151,2018,Angola,Romania,5,0,0,5
9152,2018,Egypt,Romania,21,0,0,21
9153,2018,Burundi,Romania,7,0,0,7
9154,2018,Bangladesh,Romania,5,19,0,24
9155,2018,Central African Rep.,Romania,8,0,0,8
9156,2018,Cameroon,Romania,24,8,0,32
9157,2018,Congo,Romania,8,5,0,13
9158,2018,Dem. Rep. of the Congo,Romania,15,5,0,20
9159,2018,Eritrea,Romania,59,5,0,64
9160,2018,Ethiopia,Romania,7,0,0,7
9161,2018,Palestinian,Romania,53,5,0,58
9162,2018,Guinea,Romania,6,5,0,11
9163,2018,India,Romania,0,15,0,15
9164,2018,Iran (Islamic Rep. of),Romania,93,88,0,181
9165,2018,Iraq,Romania,968,969,0,1937
9166,2018,Jordan,Romania,8,0,0,8
9167,2018,Liberia,Romania,5,0,0,5
9168,2018,Libya,Romania,5,0,0,5
9169,2018,Lebanon,Romania,5,0,0,5
9170,2018,Morocco,Romania,0,5,0,5
9171,2018,Myanmar,Romania,29,5,0,34
9172,2018,Nigeria,Romania,5,6,0,11
9173,2018,Pakistan,Romania,42,47,0,89
9174,2018,Rwanda,Romania,7,0,0,7
9175,2018,Sierra Leone,Romania,5,0,0,5
9176,2018,Somalia,Romania,60,5,0,65
9177,2018,Sudan,Romania,16,0,0,16
9178,2018,Syrian Arab Rep.,Romania,2292,150,0,2442
9179,2018,Türkiye,Romania,25,39,0,64
9180,2018,Ukraine,Romania,28,7,0,35
9181,2018,Yemen,Romania,33,9,0,42
9182,2018,Zimbabwe,Romania,8,0,0,8
9183,2018,Stateless,Romania,122,5,0,127
9184,2018,Algeria,South Africa,0,9,0,9
9185,2018,Angola,South Africa,25,0,0,25
9186,2018,Egypt,South Africa,0,9,0,9
9187,2018,Burundi,South Africa,3033,6171,0,9204
9188,2018,Bangladesh,South Africa,319,26431,0,26750
9189,2018,China,South Africa,0,134,0,134
9190,2018,Cameroon,South Africa,392,1592,0,1984
9191,2018,Congo,South Africa,5273,8694,0,13967
9192,2018,Dem. Rep. of the Congo,South Africa,26263,33217,0,59480
9193,2018,Eritrea,South Africa,1943,817,0,2760
9194,2018,Ethiopia,South Africa,17726,49347,0,67073
9195,2018,Palestinian,South Africa,38,0,0,38
9196,2018,Ghana,South Africa,0,2131,0,2131
9197,2018,Cote d'Ivoire,South Africa,41,0,0,41
9198,2018,India,South Africa,0,4329,0,4329
9199,2018,Kenya,South Africa,157,1072,0,1229
9200,2018,Liberia,South Africa,60,0,0,60
9201,2018,Sri Lanka,South Africa,0,7,0,7
9202,2018,Malawi,South Africa,0,2344,0,2344
9203,2018,Mozambique,South Africa,0,785,0,785
9204,2018,Niger,South Africa,0,861,0,861
9205,2018,Nigeria,South Africa,0,7763,0,7763
9206,2018,Pakistan,South Africa,0,9834,0,9834
9207,2018,Rwanda,South Africa,1297,927,0,2224
9208,2018,Senegal,South Africa,0,846,0,846
9209,2018,Somalia,South Africa,27113,3969,0,31082
9210,2018,Sudan,South Africa,112,0,0,112
9211,2018,Syrian Arab Rep.,South Africa,45,7,0,52
9212,2018,United Rep. of Tanzania,South Africa,37,614,0,651
9213,2018,Türkiye,South Africa,0,5,0,5
9214,2018,Uganda,South Africa,549,4549,0,5098
9215,2018,Yemen,South Africa,0,6,0,6
9216,2018,Zambia,South Africa,64,0,0,64
9217,2018,Zimbabwe,South Africa,4561,14261,0,18822
9218,2018,Unknown ,South Africa,237,3462,0,3699
9219,2018,Afghanistan,Russian Federation,789,226,0,1015
9220,2018,Argentina,Russian Federation,5,0,0,5
9221,2018,Armenia,Russian Federation,0,5,0,5
9222,2018,Azerbaijan,Russian Federation,12,6,0,18
9223,2018,Belgium,Russian Federation,0,15,0,15
9224,2018,Bangladesh,Russian Federation,5,5,0,10
9225,2018,Bosnia and Herzegovina,Russian Federation,5,0,0,5
9226,2018,China,Russian Federation,5,0,0,5
9227,2018,Dem. Rep. of the Congo,Russian Federation,12,5,0,17
9228,2018,Eritrea,Russian Federation,0,5,0,5
9229,2018,Palestinian,Russian Federation,12,5,0,17
9230,2018,Georgia,Russian Federation,155,7,0,162
9231,2018,Germany,Russian Federation,9,0,0,9
9232,2018,Cote d'Ivoire,Russian Federation,5,0,0,5
9233,2018,Iran (Islamic Rep. of),Russian Federation,5,0,0,5
9234,2018,Iraq,Russian Federation,17,5,0,22
9235,2018,Kazakhstan,Russian Federation,10,7,0,17
9236,2018,Kyrgyzstan,Russian Federation,20,7,0,27
9237,2018,Dem. People's Rep. of Korea,Russian Federation,57,14,0,71
9238,2018,Lebanon,Russian Federation,6,0,0,6
9239,2018,Lithuania,Russian Federation,5,0,0,5
9240,2018,Latvia,Russian Federation,5,0,0,5
9241,2018,Rep. of Moldova,Russian Federation,30,9,0,39
9242,2018,Nigeria,Russian Federation,0,5,0,5
9243,2018,Pakistan,Russian Federation,5,0,0,5
9244,2018,Somalia,Russian Federation,0,5,0,5
9245,2018,Sudan,Russian Federation,7,5,0,12
9246,2018,Syrian Arab Rep.,Russian Federation,828,174,0,1002
9247,2018,Tajikistan,Russian Federation,25,13,0,38
9248,2018,Turkmenistan,Russian Federation,7,0,0,7
9249,2018,Türkiye,Russian Federation,6,0,0,6
9250,2018,Ukraine,Russian Federation,75146,795,0,75941
9251,2018,United States of America,Russian Federation,5,0,0,5
9252,2018,Uzbekistan,Russian Federation,70,19,0,89
9253,2018,Venezuela (Bolivarian Republic of),Russian Federation,0,5,0,5
9254,2018,Yemen,Russian Federation,92,9,0,101
9255,2018,Stateless,Russian Federation,22,5,0,27
9256,2018,Unknown ,Russian Federation,0,5,0,5
9257,2018,Angola,Rwanda,8,0,0,8
9258,2018,Burundi,Rwanda,68280,95,0,68375
9259,2018,Chad,Rwanda,5,0,0,5
9260,2018,Dem. Rep. of the Congo,Rwanda,77044,318,0,77362
9261,2018,Eritrea,Rwanda,5,5,0,10
9262,2018,Ethiopia,Rwanda,5,0,0,5
9263,2018,Rwanda,Rwanda,0,0,0,0
9264,2018,Somalia,Rwanda,5,0,0,5
9265,2018,South Sudan,Rwanda,7,5,0,12
9266,2018,Colombia,El Salvador,5,5,0,10
9267,2018,Honduras,El Salvador,17,0,0,17
9268,2018,Iraq,El Salvador,5,0,0,5
9269,2018,Mexico,El Salvador,5,0,0,5
9270,2018,Nicaragua,El Salvador,7,11,0,18
9271,2018,El Salvador,El Salvador,0,0,71501,0
9272,2018,Syrian Arab Rep.,El Salvador,5,0,0,5
9273,2018,Chad,Saudi Arabia,9,0,0,9
9274,2018,China,Saudi Arabia,14,14,0,28
9275,2018,Eritrea,Saudi Arabia,31,6,0,37
9276,2018,Palestinian,Saudi Arabia,9,13,0,22
9277,2018,Iraq,Saudi Arabia,36,24,0,60
9278,2018,Liberia,Saudi Arabia,7,0,0,7
9279,2018,Somalia,Saudi Arabia,16,0,0,16
9280,2018,Sudan,Saudi Arabia,0,5,0,5
9281,2018,South Sudan,Saudi Arabia,5,0,0,5
9282,2018,Syrian Arab Rep.,Saudi Arabia,103,2063,0,2166
9283,2018,Tunisia,Saudi Arabia,6,0,0,6
9284,2018,Yemen,Saudi Arabia,27,42,0,69
9285,2018,Stateless,Saudi Arabia,0,0,0,0
9286,2018,Afghanistan,Serbia and Kosovo: S/RES/1244 (1999),1726,18,0,1744
9287,2018,Bangladesh,Serbia and Kosovo: S/RES/1244 (1999),133,0,0,133
9288,2018,Bosnia and Herzegovina,Serbia and Kosovo: S/RES/1244 (1999),8271,0,0,8271
9289,2018,Bulgaria,Serbia and Kosovo: S/RES/1244 (1999),0,5,0,5
9290,2018,Congo,Serbia and Kosovo: S/RES/1244 (1999),0,7,0,7
9291,2018,Cuba,Serbia and Kosovo: S/RES/1244 (1999),5,0,0,5
9292,2018,Ethiopia,Serbia and Kosovo: S/RES/1244 (1999),5,0,0,5
9293,2018,Croatia,Serbia and Kosovo: S/RES/1244 (1999),18237,0,0,18237
9294,2018,India,Serbia and Kosovo: S/RES/1244 (1999),0,5,0,5
9295,2018,Iran (Islamic Rep. of),Serbia and Kosovo: S/RES/1244 (1999),1231,136,0,1367
9296,2018,Iraq,Serbia and Kosovo: S/RES/1244 (1999),288,0,0,288
9297,2018,Libya,Serbia and Kosovo: S/RES/1244 (1999),42,0,0,42
9298,2018,Nigeria,Serbia and Kosovo: S/RES/1244 (1999),0,9,0,9
9299,2018,Pakistan,Serbia and Kosovo: S/RES/1244 (1999),596,0,0,596
9300,2018,Russian Federation,Serbia and Kosovo: S/RES/1244 (1999),0,6,0,6
9301,2018,Serbia and Kosovo: S/RES/1244 (1999),Serbia and Kosovo: S/RES/1244 (1999),0,0,215794,0
9302,2018,Somalia,Serbia and Kosovo: S/RES/1244 (1999),5,16,0,21
9303,2018,Sudan,Serbia and Kosovo: S/RES/1244 (1999),5,0,0,5
9304,2018,Syrian Arab Rep.,Serbia and Kosovo: S/RES/1244 (1999),74,7,0,81
9305,2018,Türkiye,Serbia and Kosovo: S/RES/1244 (1999),63,10,0,73
9306,2018,Ukraine,Serbia and Kosovo: S/RES/1244 (1999),15,0,0,15
9307,2018,Stateless,Serbia and Kosovo: S/RES/1244 (1999),0,0,0,0
9308,2018,Unknown ,Serbia and Kosovo: S/RES/1244 (1999),248,0,0,248
9309,2018,Afghanistan,Senegal,0,9,0,9
9310,2018,Burundi,Senegal,5,7,0,12
9311,2018,Benin,Senegal,0,5,0,5
9312,2018,Burkina Faso,Senegal,0,5,0,5
9313,2018,Central African Rep.,Senegal,173,388,0,561
9314,2018,Chad,Senegal,6,25,0,31
9315,2018,Cameroon,Senegal,0,23,0,23
9316,2018,Congo,Senegal,0,73,0,73
9317,2018,Dem. Rep. of the Congo,Senegal,10,162,0,172
9318,2018,Eritrea,Senegal,0,13,0,13
9319,2018,Gambia,Senegal,10,327,0,337
9320,2018,Guinea-Bissau,Senegal,0,5,0,5
9321,2018,Guinea,Senegal,0,100,0,100
9322,2018,Haiti,Senegal,0,5,0,5
9323,2018,Cote d'Ivoire,Senegal,17,163,0,180
9324,2018,Liberia,Senegal,5,63,0,68
9325,2018,Sri Lanka,Senegal,0,6,0,6
9326,2018,Mauritania,Senegal,14120,61,0,14181
9327,2018,Mali,Senegal,0,60,0,60
9328,2018,Nigeria,Senegal,0,44,0,44
9329,2018,Rwanda,Senegal,13,7,0,20
9330,2018,Sierra Leone,Senegal,0,34,0,34
9331,2018,Sudan,Senegal,0,7,0,7
9332,2018,Syrian Arab Rep.,Senegal,0,14,0,14
9333,2018,Togo,Senegal,0,29,0,29
9334,2018,Türkiye,Senegal,0,64,0,64
9335,2018,Stateless,Singapore,0,0,0,0
9336,2018,Cote d'Ivoire,Sierra Leone,17,0,0,17
9337,2018,Liberia,Sierra Leone,565,0,0,565
9338,2018,Sudan,Sierra Leone,9,0,0,9
9339,2018,Indonesia,Solomon Islands,0,5,0,5
9340,2018,Egypt,Somalia,0,24,0,24
9341,2018,Bangladesh,Somalia,6,0,0,6
9342,2018,Cameroon,Somalia,0,5,0,5
9343,2018,Djibouti,Somalia,0,12,0,12
9344,2018,Eritrea,Somalia,50,40,0,90
9345,2018,Ethiopia,Somalia,3981,16067,0,20048
9346,2018,Palestinian,Somalia,19,0,0,19
9347,2018,Iraq,Somalia,21,0,0,21
9348,2018,Mozambique,Somalia,0,5,0,5
9349,2018,Nigeria,Somalia,0,5,0,5
9350,2018,Pakistan,Somalia,0,5,0,5
9351,2018,Somalia,Somalia,0,0,2648001,0
9352,2018,Sudan,Somalia,5,12,0,17
9353,2018,Syrian Arab Rep.,Somalia,206,14,0,220
9354,2018,United Rep. of Tanzania,Somalia,0,118,0,118
9355,2018,Yemen,Somalia,12450,54,0,12504
9356,2018,Afghanistan,Spain,338,195,0,533
9357,2018,Albania,Spain,0,95,0,95
9358,2018,Algeria,Spain,48,1215,0,1263
9359,2018,Angola,Spain,6,45,0,51
9360,2018,Egypt,Spain,15,65,0,80
9361,2018,Argentina,Spain,0,50,0,50
9362,2018,Armenia,Spain,29,325,0,354
9363,2018,Azerbaijan,Spain,46,45,0,91
9364,2018,Burundi,Spain,0,10,0,10
9365,2018,Benin,Spain,5,10,0,15
9366,2018,Bangladesh,Spain,20,265,0,285
9367,2018,Burkina Faso,Spain,0,95,0,95
9368,2018,Belarus,Spain,13,55,0,68
9369,2018,Bolivia (Plurinational State of),Spain,9,40,0,49
9370,2018,Brazil,Spain,0,185,0,185
9371,2018,Central African Rep.,Spain,72,110,0,182
9372,2018,Chad,Spain,0,15,0,15
9373,2018,China,Spain,20,600,0,620
9374,2018,Chile,Spain,0,45,0,45
9375,2018,Cameroon,Spain,63,1065,0,1128
9376,2018,Congo,Spain,10,265,0,275
9377,2018,Dem. Rep. of the Congo,Spain,62,380,0,442
9378,2018,Comoros,Spain,0,5,0,5
9379,2018,Colombia,Spain,208,10385,0,10593
9380,2018,Costa Rica,Spain,0,15,0,15
9381,2018,Cuba,Spain,885,615,0,1500
9382,2018,Dominican Rep.,Spain,0,240,0,240
9383,2018,Ecuador,Spain,0,70,0,70
9384,2018,Equatorial Guinea,Spain,22,75,0,97
9385,2018,Eritrea,Spain,264,55,0,319
9386,2018,Ethiopia,Spain,53,20,0,73
9387,2018,Gabon,Spain,0,10,0,10
9388,2018,Gambia,Spain,17,225,0,242
9389,2018,Palestinian,Spain,1051,2510,0,3561
9390,2018,Georgia,Spain,8,1245,0,1253
9391,2018,Ghana,Spain,0,200,0,200
9392,2018,Guinea-Bissau,Spain,0,45,0,45
9393,2018,Guatemala,Spain,14,215,0,229
9394,2018,Guinea,Spain,12,1080,0,1092
9395,2018,Haiti,Spain,17,15,0,32
9396,2018,Honduras,Spain,42,3690,0,3732
9397,2018,Cote d'Ivoire,Spain,193,820,0,1013
9398,2018,India,Spain,6,65,0,71
9399,2018,Iran (Islamic Rep. of),Spain,85,165,0,250
9400,2018,Iraq,Spain,324,150,0,474
9401,2018,Jamaica,Spain,0,40,0,40
9402,2018,Jordan,Spain,28,20,0,48
9403,2018,Kazakhstan,Spain,10,20,0,30
9404,2018,Kenya,Spain,0,15,0,15
9405,2018,Kyrgyzstan,Spain,6,10,0,16
9406,2018,Liberia,Spain,6,40,0,46
9407,2018,Libya,Spain,24,145,0,169
9408,2018,Lebanon,Spain,24,130,0,154
9409,2018,Sri Lanka,Spain,108,45,0,153
9410,2018,Mauritania,Spain,0,95,0,95
9411,2018,North Macedonia,Spain,0,20,0,20
9412,2018,Rep. of Moldova,Spain,0,20,0,20
9413,2018,Mexico,Spain,21,75,0,96
9414,2018,Mali,Spain,39,780,0,819
9415,2018,Mongolia,Spain,5,20,0,25
9416,2018,Morocco,Spain,173,1060,0,1233
9417,2018,Myanmar,Spain,5,5,0,10
9418,2018,Nepal,Spain,0,5,0,5
9419,2018,Niger,Spain,0,20,0,20
9420,2018,Nicaragua,Spain,15,1380,0,1395
9421,2018,Nigeria,Spain,52,1250,0,1302
9422,2018,Pakistan,Spain,392,690,0,1082
9423,2018,Panama,Spain,0,15,0,15
9424,2018,Paraguay,Spain,0,65,0,65
9425,2018,Peru,Spain,0,630,0,630
9426,2018,Philippines,Spain,0,5,0,5
9427,2018,South Africa,Spain,0,10,0,10
9428,2018,Russian Federation,Spain,154,1035,0,1189
9429,2018,Rwanda,Spain,0,5,0,5
9430,2018,El Salvador,Spain,7,3685,0,3692
9431,2018,Saudi Arabia,Spain,0,5,0,5
9432,2018,Serbia and Kosovo: S/RES/1244 (1999),Spain,5,30,0,35
9433,2018,Senegal,Spain,7,385,0,392
9434,2018,Sierra Leone,Spain,9,80,0,89
9435,2018,Somalia,Spain,682,75,0,757
9436,2018,Viet Nam,Spain,0,85,0,85
9437,2018,Sudan,Spain,52,130,0,182
9438,2018,South Sudan,Spain,0,10,0,10
9439,2018,Syrian Arab Rep.,Spain,13765,2320,0,16085
9440,2018,Tajikistan,Spain,5,5,0,10
9441,2018,Turkmenistan,Spain,0,5,0,5
9442,2018,Togo,Spain,14,30,0,44
9443,2018,Trinidad and Tobago,Spain,0,5,0,5
9444,2018,Tunisia,Spain,0,100,0,100
9445,2018,Türkiye,Spain,25,350,0,375
9446,2018,Uganda,Spain,5,10,0,15
9447,2018,Ukraine,Spain,562,4300,0,4862
9448,2018,Uruguay,Spain,0,35,0,35
9449,2018,United States of America,Spain,0,35,0,35
9450,2018,Uzbekistan,Spain,14,5,0,19
9451,2018,Venezuela (Bolivarian Republic of),Spain,72,31620,0,31692
9452,2018,Western Sahara,Spain,19,95,0,114
9453,2018,Yemen,Spain,103,500,0,603
9454,2018,Zimbabwe,Spain,0,5,0,5
9455,2018,Stateless,Spain,0,5,0,5
9456,2018,Tibetan,Spain,5,0,0,5
9457,2018,Unknown ,Spain,67,35,0,102
9458,2018,Stateless,Viet Nam,0,0,0,0
9459,2018,Cuba,Saint Kitts and Nevis,5,0,0,5
9460,2018,Afghanistan,Sudan,6,0,0,6
9461,2018,Egypt,Sudan,17,25,0,42
9462,2018,Burundi,Sudan,16,10,0,26
9463,2018,Central African Rep.,Sudan,6995,5,0,7000
9464,2018,Chad,Sudan,3373,10,0,3383
9465,2018,Cameroon,Sudan,7,0,0,7
9466,2018,Congo,Sudan,0,6,0,6
9467,2018,Dem. Rep. of the Congo,Sudan,154,683,0,837
9468,2018,Eritrea,Sudan,114545,6428,0,120973
9469,2018,Ethiopia,Sudan,6045,7517,0,13562
9470,2018,Palestinian,Sudan,54,74,0,128
9471,2018,Iraq,Sudan,16,23,0,39
9472,2018,Jordan,Sudan,0,0,0,0
9473,2018,Nigeria,Sudan,0,10,0,10
9474,2018,Somalia,Sudan,432,196,0,628
9475,2018,Sudan,Sudan,0,0,1864195,0
9476,2018,South Sudan,Sudan,852080,0,0,852080
9477,2018,Syrian Arab Rep.,Sudan,93502,0,0,93502
9478,2018,Uganda,Sudan,5,0,0,5
9479,2018,Yemen,Sudan,1013,2619,0,3632
9480,2018,Unknown ,Sudan,20,13,0,33
9481,2018,Cuba,Suriname,30,158,0,188
9482,2018,Dominican Rep.,Suriname,0,14,0,14
9483,2018,Jamaica,Suriname,5,0,0,5
9484,2018,Venezuela (Bolivarian Republic of),Suriname,6,34,0,40
9485,2018,Burundi,South Sudan,5,281,0,286
9486,2018,Central African Rep.,South Sudan,2006,0,0,2006
9487,2018,Dem. Rep. of the Congo,South Sudan,15617,6,0,15623
9488,2018,Eritrea,South Sudan,83,1899,0,1982
9489,2018,Ethiopia,South Sudan,4203,310,0,4513
9490,2018,Somalia,South Sudan,0,30,0,30
9491,2018,Sudan,South Sudan,269924,9,0,269933
9492,2018,South Sudan,South Sudan,0,0,1878154,0
9493,2018,Afghanistan,Slovakia,260,0,0,260
9494,2018,Angola,Slovakia,24,0,0,24
9495,2018,Egypt,Slovakia,5,0,0,5
9496,2018,Armenia,Slovakia,34,0,0,34
9497,2018,Burundi,Slovakia,5,0,0,5
9498,2018,Bosnia and Herzegovina,Slovakia,36,0,0,36
9499,2018,Bulgaria,Slovakia,8,0,0,8
9500,2018,Cambodia,Slovakia,5,0,0,5
9501,2018,China,Slovakia,5,0,0,5
9502,2018,Cameroon,Slovakia,7,0,0,7
9503,2018,Dem. Rep. of the Congo,Slovakia,16,0,0,16
9504,2018,Cuba,Slovakia,32,0,0,32
9505,2018,Palestinian,Slovakia,7,0,0,7
9506,2018,Iran (Islamic Rep. of),Slovakia,28,0,0,28
9507,2018,Iraq,Slovakia,213,0,0,213
9508,2018,Liberia,Slovakia,5,0,0,5
9509,2018,Pakistan,Slovakia,6,0,0,6
9510,2018,Romania,Slovakia,37,0,0,37
9511,2018,Russian Federation,Slovakia,37,0,0,37
9512,2018,Serbia and Kosovo: S/RES/1244 (1999),Slovakia,46,0,0,46
9513,2018,Somalia,Slovakia,31,0,0,31
9514,2018,Viet Nam,Slovakia,16,0,0,16
9515,2018,Syrian Arab Rep.,Slovakia,14,0,0,14
9516,2018,Uganda,Slovakia,5,0,0,5
9517,2018,Ukraine,Slovakia,23,0,0,23
9518,2018,Uzbekistan,Slovakia,5,0,0,5
9519,2018,Yemen,Slovakia,19,0,0,19
9520,2018,Stateless,Slovakia,9,0,0,9
9521,2018,Unknown ,Slovakia,0,17,0,17
9522,2018,Afghanistan,Slovenia,48,29,0,77
9523,2018,Algeria,Slovenia,0,24,0,24
9524,2018,Azerbaijan,Slovenia,0,5,0,5
9525,2018,Bosnia and Herzegovina,Slovenia,8,5,0,13
9526,2018,Cameroon,Slovenia,5,0,0,5
9527,2018,Dem. Rep. of the Congo,Slovenia,8,5,0,13
9528,2018,Eritrea,Slovenia,82,23,0,105
9529,2018,Palestinian,Slovenia,12,5,0,17
9530,2018,Iran (Islamic Rep. of),Slovenia,66,35,0,101
9531,2018,Iraq,Slovenia,42,15,0,57
9532,2018,Kazakhstan,Slovenia,19,0,0,19
9533,2018,Morocco,Slovenia,0,11,0,11
9534,2018,Nigeria,Slovenia,0,5,0,5
9535,2018,Pakistan,Slovenia,0,14,0,14
9536,2018,Russian Federation,Slovenia,17,8,0,25
9537,2018,Serbia and Kosovo: S/RES/1244 (1999),Slovenia,65,11,0,76
9538,2018,Sierra Leone,Slovenia,5,0,0,5
9539,2018,Somalia,Slovenia,50,0,0,50
9540,2018,Sudan,Slovenia,6,0,0,6
9541,2018,Syrian Arab Rep.,Slovenia,290,23,0,313
9542,2018,Türkiye,Slovenia,13,21,0,34
9543,2018,Ukraine,Slovenia,5,0,0,5
9544,2018,Yemen,Slovenia,5,0,0,5
9545,2018,Stateless,Slovenia,0,0,0,0
9546,2018,Unknown ,Slovenia,0,6,0,6
9547,2018,Angola,Eswatini,11,0,0,11
9548,2018,Burundi,Eswatini,181,103,0,284
9549,2018,Congo,Eswatini,14,80,0,94
9550,2018,Dem. Rep. of the Congo,Eswatini,372,213,0,585
9551,2018,Eritrea,Eswatini,0,5,0,5
9552,2018,Ethiopia,Eswatini,9,50,0,59
9553,2018,Guinea,Eswatini,5,0,0,5
9554,2018,Kenya,Eswatini,5,0,0,5
9555,2018,Sri Lanka,Eswatini,5,0,0,5
9556,2018,Rwanda,Eswatini,168,96,0,264
9557,2018,Somalia,Eswatini,91,192,0,283
9558,2018,Uganda,Eswatini,6,0,0,6
9559,2018,Zimbabwe,Eswatini,7,0,0,7
9560,2018,Afghanistan,Sweden,28204,8614,0,36818
9561,2018,Albania,Sweden,331,415,0,746
9562,2018,Algeria,Sweden,60,87,0,147
9563,2018,Angola,Sweden,29,26,0,55
9564,2018,Egypt,Sweden,362,572,0,934
9565,2018,Argentina,Sweden,0,5,0,5
9566,2018,Armenia,Sweden,413,271,0,684
9567,2018,Azerbaijan,Sweden,648,510,0,1158
9568,2018,Bahrain,Sweden,15,5,0,20
9569,2018,Burundi,Sweden,211,143,0,354
9570,2018,Benin,Sweden,7,5,0,12
9571,2018,Bangladesh,Sweden,230,345,0,575
9572,2018,Bhutan,Sweden,5,0,0,5
9573,2018,Burkina Faso,Sweden,0,5,0,5
9574,2018,Belarus,Sweden,123,124,0,247
9575,2018,Bolivia (Plurinational State of),Sweden,59,37,0,96
9576,2018,Brazil,Sweden,8,20,0,28
9577,2018,Bosnia and Herzegovina,Sweden,119,92,0,211
9578,2018,Bulgaria,Sweden,16,0,0,16
9579,2018,Canada,Sweden,0,5,0,5
9580,2018,Central African Rep.,Sweden,70,0,0,70
9581,2018,Chad,Sweden,22,0,0,22
9582,2018,China,Sweden,282,69,0,351
9583,2018,Chile,Sweden,13,31,0,44
9584,2018,Cameroon,Sweden,165,175,0,340
9585,2018,Congo,Sweden,46,27,0,73
9586,2018,Dem. Rep. of the Congo,Sweden,917,122,0,1039
9587,2018,Comoros,Sweden,5,0,0,5
9588,2018,Colombia,Sweden,32,294,0,326
9589,2018,Cuba,Sweden,49,42,0,91
9590,2018,Djibouti,Sweden,22,28,0,50
9591,2018,Ecuador,Sweden,6,17,0,23
9592,2018,Equatorial Guinea,Sweden,5,10,0,15
9593,2018,Eritrea,Sweden,27653,768,0,28421
9594,2018,Ethiopia,Sweden,2360,870,0,3230
9595,2018,France,Sweden,5,0,0,5
9596,2018,Gambia,Sweden,158,156,0,314
9597,2018,Palestinian,Sweden,1060,574,0,1634
9598,2018,United Kingdom of Great Britain and Northern Ireland,Sweden,7,0,0,7
9599,2018,Georgia,Sweden,123,604,0,727
9600,2018,Ghana,Sweden,59,79,0,138
9601,2018,Guinea-Bissau,Sweden,9,5,0,14
9602,2018,Greece,Sweden,18,0,0,18
9603,2018,Guatemala,Sweden,10,5,0,15
9604,2018,Guinea,Sweden,76,62,0,138
9605,2018,Honduras,Sweden,13,31,0,44
9606,2018,Croatia,Sweden,0,5,0,5
9607,2018,Hungary,Sweden,5,0,0,5
9608,2018,Cote d'Ivoire,Sweden,54,15,0,69
9609,2018,India,Sweden,24,91,0,115
9610,2018,Indonesia,Sweden,16,0,0,16
9611,2018,Iran (Islamic Rep. of),Sweden,6485,2954,0,9439
9612,2018,Iraq,Sweden,12693,5060,0,17753
9613,2018,Israel,Sweden,29,27,0,56
9614,2018,Italy,Sweden,5,0,0,5
9615,2018,Jamaica,Sweden,0,5,0,5
9616,2018,Jordan,Sweden,294,271,0,565
9617,2018,Kazakhstan,Sweden,256,179,0,435
9618,2018,Kenya,Sweden,96,66,0,162
9619,2018,Kyrgyzstan,Sweden,179,190,0,369
9620,2018,Rep. of Korea,Sweden,6,5,0,11
9621,2018,Dem. People's Rep. of Korea,Sweden,5,5,0,10
9622,2018,Kuwait,Sweden,25,55,0,80
9623,2018,Liberia,Sweden,12,21,0,33
9624,2018,Libya,Sweden,397,115,0,512
9625,2018,Lebanon,Sweden,528,478,0,1006
9626,2018,Sri Lanka,Sweden,35,52,0,87
9627,2018,Lithuania,Sweden,0,7,0,7
9628,2018,Mauritania,Sweden,14,0,0,14
9629,2018,North Macedonia,Sweden,51,49,0,100
9630,2018,Rep. of Moldova,Sweden,8,5,0,13
9631,2018,Mexico,Sweden,0,5,0,5
9632,2018,Mali,Sweden,45,5,0,50
9633,2018,Malaysia,Sweden,10,0,0,10
9634,2018,Mongolia,Sweden,300,339,0,639
9635,2018,Morocco,Sweden,240,318,0,558
9636,2018,Mozambique,Sweden,0,8,0,8
9637,2018,Montenegro,Sweden,30,33,0,63
9638,2018,Myanmar,Sweden,15,11,0,26
9639,2018,Nepal,Sweden,16,20,0,36
9640,2018,Niger,Sweden,5,0,0,5
9641,2018,Nicaragua,Sweden,9,243,0,252
9642,2018,Nigeria,Sweden,539,571,0,1110
9643,2018,Pakistan,Sweden,503,535,0,1038
9644,2018,Peru,Sweden,10,105,0,115
9645,2018,Philippines,Sweden,7,24,0,31
9646,2018,Poland,Sweden,5,0,0,5
9647,2018,Romania,Sweden,59,0,0,59
9648,2018,South Africa,Sweden,0,10,0,10
9649,2018,Russian Federation,Sweden,1554,692,0,2246
9650,2018,Rwanda,Sweden,37,47,0,84
9651,2018,El Salvador,Sweden,94,224,0,318
9652,2018,Saudi Arabia,Sweden,50,15,0,65
9653,2018,Serbia and Kosovo: S/RES/1244 (1999),Sweden,1105,373,0,1478
9654,2018,Senegal,Sweden,55,25,0,80
9655,2018,Sierra Leone,Sweden,68,29,0,97
9656,2018,Somalia,Sweden,21032,1611,0,22643
9657,2018,Spain,Sweden,0,5,0,5
9658,2018,Viet Nam,Sweden,55,52,0,107
9659,2018,Sudan,Sweden,1075,205,0,1280
9660,2018,South Sudan,Sweden,61,0,0,61
9661,2018,Slovakia,Sweden,6,5,0,11
9662,2018,Syrian Arab Rep.,Sweden,109343,2353,0,111696
9663,2018,United Rep. of Tanzania,Sweden,46,68,0,114
9664,2018,Thailand,Sweden,6,18,0,24
9665,2018,Tajikistan,Sweden,58,106,0,164
9666,2018,Turkmenistan,Sweden,8,10,0,18
9667,2018,Togo,Sweden,5,0,0,5
9668,2018,Tunisia,Sweden,53,104,0,157
9669,2018,Türkiye,Sweden,846,920,0,1766
9670,2018,United Arab Emirates,Sweden,5,0,0,5
9671,2018,Uganda,Sweden,696,123,0,819
9672,2018,Ukraine,Sweden,215,445,0,660
9673,2018,United States of America,Sweden,20,15,0,35
9674,2018,Uzbekistan,Sweden,586,823,0,1409
9675,2018,Venezuela (Bolivarian Republic of),Sweden,8,146,0,154
9676,2018,Yemen,Sweden,1343,228,0,1571
9677,2018,Zambia,Sweden,11,10,0,21
9678,2018,Zimbabwe,Sweden,21,7,0,28
9679,2018,Stateless,Sweden,22109,1340,0,23449
9680,2018,Unknown ,Sweden,604,761,0,1365
9681,2018,Afghanistan,Switzerland,12282,1793,0,14075
9682,2018,Albania,Switzerland,92,66,0,158
9683,2018,Algeria,Switzerland,162,194,0,356
9684,2018,Angola,Switzerland,750,72,0,822
9685,2018,Egypt,Switzerland,110,19,0,129
9686,2018,Armenia,Switzerland,152,76,0,228
9687,2018,Azerbaijan,Switzerland,96,145,0,241
9688,2018,Bahrain,Switzerland,5,0,0,5
9689,2018,Burundi,Switzerland,103,35,0,138
9690,2018,Benin,Switzerland,25,6,0,31
9691,2018,Bangladesh,Switzerland,60,13,0,73
9692,2018,Burkina Faso,Switzerland,20,10,0,30
9693,2018,Belarus,Switzerland,46,21,0,67
9694,2018,Brazil,Switzerland,14,5,0,19
9695,2018,Bosnia and Herzegovina,Switzerland,1854,12,0,1866
9696,2018,Bulgaria,Switzerland,8,0,0,8
9697,2018,Cambodia,Switzerland,307,0,0,307
9698,2018,Central African Rep.,Switzerland,15,7,0,22
9699,2018,Chad,Switzerland,46,11,0,57
9700,2018,China,Switzerland,2957,274,0,3231
9701,2018,Chile,Switzerland,12,0,0,12
9702,2018,Cameroon,Switzerland,177,59,0,236
9703,2018,Congo,Switzerland,58,5,0,63
9704,2018,Dem. Rep. of the Congo,Switzerland,1250,142,0,1392
9705,2018,Colombia,Switzerland,228,59,0,287
9706,2018,Cuba,Switzerland,35,5,0,40
9707,2018,Czechia,Switzerland,5,0,0,5
9708,2018,Djibouti,Switzerland,15,0,0,15
9709,2018,Dominican Rep.,Switzerland,0,6,0,6
9710,2018,Ecuador,Switzerland,6,0,0,6
9711,2018,Equatorial Guinea,Switzerland,5,0,0,5
9712,2018,Eritrea,Switzerland,34072,2259,0,36331
9713,2018,Ethiopia,Switzerland,1563,449,0,2012
9714,2018,France,Switzerland,5,0,0,5
9715,2018,Gambia,Switzerland,52,27,0,79
9716,2018,United Kingdom of Great Britain and Northern Ireland,Switzerland,5,0,0,5
9717,2018,Georgia,Switzerland,164,262,0,426
9718,2018,Ghana,Switzerland,19,8,0,27
9719,2018,Guinea-Bissau,Switzerland,57,10,0,67
9720,2018,Guatemala,Switzerland,7,0,0,7
9721,2018,Guinea,Switzerland,173,89,0,262
9722,2018,Croatia,Switzerland,28,0,0,28
9723,2018,Hungary,Switzerland,5,0,0,5
9724,2018,Cote d'Ivoire,Switzerland,167,57,0,224
9725,2018,India,Switzerland,33,9,0,42
9726,2018,Indonesia,Switzerland,0,5,0,5
9727,2018,Iran (Islamic Rep. of),Switzerland,1687,1001,0,2688
9728,2018,Iraq,Switzerland,4476,854,0,5330
9729,2018,Israel,Switzerland,5,5,0,10
9730,2018,Italy,Switzerland,5,0,0,5
9731,2018,Jordan,Switzerland,66,5,0,71
9732,2018,Kazakhstan,Switzerland,12,10,0,22
9733,2018,Kenya,Switzerland,42,5,0,47
9734,2018,Kyrgyzstan,Switzerland,19,6,0,25
9735,2018,Kuwait,Switzerland,0,5,0,5
9736,2018,Lao People's Dem. Rep.,Switzerland,122,0,0,122
9737,2018,Liberia,Switzerland,41,5,0,46
9738,2018,Libya,Switzerland,303,66,0,369
9739,2018,Lebanon,Switzerland,36,23,0,59
9740,2018,Sri Lanka,Switzerland,5744,1579,0,7323
9741,2018,Madagascar,Switzerland,5,0,0,5
9742,2018,Mauritania,Switzerland,9,0,0,9
9743,2018,North Macedonia,Switzerland,175,25,0,200
9744,2018,Rep. of Moldova,Switzerland,8,0,0,8
9745,2018,Mali,Switzerland,37,9,0,46
9746,2018,Malaysia,Switzerland,0,5,0,5
9747,2018,Mongolia,Switzerland,137,19,0,156
9748,2018,Morocco,Switzerland,67,96,0,163
9749,2018,Montenegro,Switzerland,50,0,0,50
9750,2018,Myanmar,Switzerland,36,0,0,36
9751,2018,Nepal,Switzerland,19,8,0,27
9752,2018,Niger,Switzerland,12,0,0,12
9753,2018,Nicaragua,Switzerland,0,8,0,8
9754,2018,Nigeria,Switzerland,208,113,0,321
9755,2018,Pakistan,Switzerland,206,206,0,412
9756,2018,Paraguay,Switzerland,5,0,0,5
9757,2018,Peru,Switzerland,8,5,0,13
9758,2018,Philippines,Switzerland,7,6,0,13
9759,2018,Portugal,Switzerland,5,0,0,5
9760,2018,Romania,Switzerland,19,0,0,19
9761,2018,South Africa,Switzerland,14,0,0,14
9762,2018,Russian Federation,Switzerland,749,119,0,868
9763,2018,Rwanda,Switzerland,138,6,0,144
9764,2018,El Salvador,Switzerland,5,9,0,14
9765,2018,Saudi Arabia,Switzerland,7,11,0,18
9766,2018,Serbia and Kosovo: S/RES/1244 (1999),Switzerland,2595,114,0,2709
9767,2018,Senegal,Switzerland,53,12,0,65
9768,2018,Sierra Leone,Switzerland,32,9,0,41
9769,2018,Somalia,Switzerland,4595,517,0,5112
9770,2018,Spain,Switzerland,5,0,0,5
9771,2018,Viet Nam,Switzerland,930,0,0,930
9772,2018,Sudan,Switzerland,297,63,0,360
9773,2018,South Sudan,Switzerland,10,6,0,16
9774,2018,Syrian Arab Rep.,Switzerland,16565,1789,0,18354
9775,2018,United Rep. of Tanzania,Switzerland,19,0,0,19
9776,2018,Tajikistan,Switzerland,18,7,0,25
9777,2018,Turkmenistan,Switzerland,5,0,0,5
9778,2018,Togo,Switzerland,638,30,0,668
9779,2018,Tunisia,Switzerland,246,34,0,280
9780,2018,Türkiye,Switzerland,3539,1360,0,4899
9781,2018,United Arab Emirates,Switzerland,0,68,0,68
9782,2018,Uganda,Switzerland,36,22,0,58
9783,2018,Ukraine,Switzerland,56,0,0,56
9784,2018,United States of America,Switzerland,0,5,0,5
9785,2018,Uzbekistan,Switzerland,55,6,0,61
9786,2018,Venezuela (Bolivarian Republic of),Switzerland,6,39,0,45
9787,2018,Western Sahara,Switzerland,9,0,0,9
9788,2018,Yemen,Switzerland,336,20,0,356
9789,2018,Zimbabwe,Switzerland,15,0,0,15
9790,2018,Stateless,Switzerland,553,10,0,563
9791,2018,Unknown ,Switzerland,1669,246,0,1915
9792,2018,Afghanistan,Syrian Arab Rep.,1229,10,0,1239
9793,2018,Algeria,Syrian Arab Rep.,5,0,0,5
9794,2018,Egypt,Syrian Arab Rep.,35,5,0,40
9795,2018,Bahrain,Syrian Arab Rep.,0,5,0,5
9796,2018,Chad,Syrian Arab Rep.,8,5,0,13
9797,2018,Eritrea,Syrian Arab Rep.,23,0,0,23
9798,2018,Ethiopia,Syrian Arab Rep.,17,0,0,17
9799,2018,Guinea,Syrian Arab Rep.,52,0,0,52
9800,2018,Cote d'Ivoire,Syrian Arab Rep.,5,0,0,5
9801,2018,Iran (Islamic Rep. of),Syrian Arab Rep.,46,0,0,46
9802,2018,Iraq,Syrian Arab Rep.,15699,18339,0,34038
9803,2018,Jordan,Syrian Arab Rep.,19,0,0,19
9804,2018,Kuwait,Syrian Arab Rep.,5,0,0,5
9805,2018,Libya,Syrian Arab Rep.,12,0,0,12
9806,2018,Lebanon,Syrian Arab Rep.,24,6,0,30
9807,2018,Sri Lanka,Syrian Arab Rep.,0,5,0,5
9808,2018,Morocco,Syrian Arab Rep.,5,0,0,5
9809,2018,Pakistan,Syrian Arab Rep.,186,20,0,206
9810,2018,Saudi Arabia,Syrian Arab Rep.,11,0,0,11
9811,2018,Sierra Leone,Syrian Arab Rep.,19,0,0,19
9812,2018,Somalia,Syrian Arab Rep.,371,22,0,393
9813,2018,Sudan,Syrian Arab Rep.,769,61,0,830
9814,2018,South Sudan,Syrian Arab Rep.,106,0,0,106
9815,2018,Syrian Arab Rep.,Syrian Arab Rep.,0,0,6183920,0
9816,2018,United Rep. of Tanzania,Syrian Arab Rep.,0,5,0,5
9817,2018,Tunisia,Syrian Arab Rep.,5,0,0,5
9818,2018,Türkiye,Syrian Arab Rep.,7,13,0,20
9819,2018,Yemen,Syrian Arab Rep.,159,135,0,294
9820,2018,Stateless,Syrian Arab Rep.,0,0,0,0
9821,2018,Burundi,United Rep. of Tanzania,221354,18382,0,239736
9822,2018,Dem. Rep. of the Congo,United Rep. of Tanzania,56561,21122,0,77683
9823,2018,Somalia,United Rep. of Tanzania,150,0,0,150
9824,2018,Unknown ,United Rep. of Tanzania,257,155,0,412
9825,2018,Cuba,Turks and Caicos Islands,5,0,0,5
9826,2018,Afghanistan,Thailand,136,11,0,147
9827,2018,Egypt,Thailand,15,6,0,21
9828,2018,Cambodia,Thailand,203,135,0,338
9829,2018,China,Thailand,186,14,0,200
9830,2018,Cameroon,Thailand,0,10,0,10
9831,2018,Dem. Rep. of the Congo,Thailand,21,5,0,26
9832,2018,Eritrea,Thailand,7,0,0,7
9833,2018,Ethiopia,Thailand,13,13,0,26
9834,2018,Palestinian,Thailand,377,6,0,383
9835,2018,Guinea,Thailand,0,5,0,5
9836,2018,Cote d'Ivoire,Thailand,15,0,0,15
9837,2018,Iran (Islamic Rep. of),Thailand,63,43,0,106
9838,2018,Iraq,Thailand,248,26,0,274
9839,2018,Jordan,Thailand,5,0,0,5
9840,2018,Lao People's Dem. Rep.,Thailand,5,0,0,5
9841,2018,Sri Lanka,Thailand,137,31,0,168
9842,2018,Myanmar,Thailand,97603,0,0,97603
9843,2018,Nepal,Thailand,10,0,0,10
9844,2018,Pakistan,Thailand,1942,114,0,2056
9845,2018,Russian Federation,Thailand,5,6,0,11
9846,2018,Somalia,Thailand,230,39,0,269
9847,2018,Viet Nam,Thailand,682,448,0,1130
9848,2018,Sudan,Thailand,12,5,0,17
9849,2018,Syrian Arab Rep.,Thailand,276,7,0,283
9850,2018,United Rep. of Tanzania,Thailand,5,0,0,5
9851,2018,Togo,Thailand,6,0,0,6
9852,2018,Türkiye,Thailand,0,5,0,5
9853,2018,Uzbekistan,Thailand,0,5,0,5
9854,2018,Yemen,Thailand,32,0,0,32
9855,2018,Stateless,Thailand,0,0,0,0
9856,2018,Afghanistan,Tajikistan,2649,315,0,2964
9857,2018,Iran (Islamic Rep. of),Tajikistan,5,0,0,5
9858,2018,Stateless,Tajikistan,0,0,0,0
9859,2018,Afghanistan,Turkmenistan,14,0,0,14
9860,2018,Azerbaijan,Turkmenistan,7,0,0,7
9861,2018,Stateless,Turkmenistan,0,0,0,0
9862,2018,Burundi,Togo,5,0,0,5
9863,2018,Burkina Faso,Togo,0,5,0,5
9864,2018,Central African Rep.,Togo,361,140,0,501
9865,2018,Chad,Togo,17,12,0,29
9866,2018,Cameroon,Togo,6,10,0,16
9867,2018,Congo,Togo,29,12,0,41
9868,2018,Dem. Rep. of the Congo,Togo,107,81,0,188
9869,2018,Ghana,Togo,9747,5,0,9752
9870,2018,Cote d'Ivoire,Togo,1793,330,0,2123
9871,2018,Iraq,Togo,5,0,0,5
9872,2018,Lebanon,Togo,0,13,0,13
9873,2018,Sri Lanka,Togo,0,5,0,5
9874,2018,Mali,Togo,91,35,0,126
9875,2018,Nigeria,Togo,8,13,0,21
9876,2018,Rwanda,Togo,139,0,0,139
9877,2018,Sudan,Togo,0,5,0,5
9878,2018,Syrian Arab Rep.,Togo,0,9,0,9
9879,2018,Türkiye,Togo,27,19,0,46
9880,2018,Egypt,Trinidad and Tobago,0,5,0,5
9881,2018,Bangladesh,Trinidad and Tobago,10,78,0,88
9882,2018,Cameroon,Trinidad and Tobago,0,6,0,6
9883,2018,Colombia,Trinidad and Tobago,15,29,0,44
9884,2018,Cuba,Trinidad and Tobago,154,1852,0,2006
9885,2018,Dominican Rep.,Trinidad and Tobago,0,75,0,75
9886,2018,Ghana,Trinidad and Tobago,0,21,0,21
9887,2018,Guyana,Trinidad and Tobago,5,16,0,21
9888,2018,Haiti,Trinidad and Tobago,0,9,0,9
9889,2018,Jamaica,Trinidad and Tobago,16,25,0,41
9890,2018,Sri Lanka,Trinidad and Tobago,5,0,0,5
9891,2018,Mexico,Trinidad and Tobago,6,0,0,6
9892,2018,Nicaragua,Trinidad and Tobago,0,5,0,5
9893,2018,Nigeria,Trinidad and Tobago,5,100,0,105
9894,2018,Pakistan,Trinidad and Tobago,9,15,0,24
9895,2018,Syrian Arab Rep.,Trinidad and Tobago,57,37,0,94
9896,2018,Tajikistan,Trinidad and Tobago,0,5,0,5
9897,2018,Trinidad and Tobago,Trinidad and Tobago,0,0,0,0
9898,2018,Saint Vincent and the Grenadines,Trinidad and Tobago,5,0,0,5
9899,2018,Venezuela (Bolivarian Republic of),Trinidad and Tobago,497,7659,0,8156
9900,2018,Algeria,Tunisia,8,5,0,13
9901,2018,Central African Rep.,Tunisia,7,6,0,13
9902,2018,Cameroon,Tunisia,5,16,0,21
9903,2018,Dem. Rep. of the Congo,Tunisia,0,11,0,11
9904,2018,Eritrea,Tunisia,5,44,0,49
9905,2018,Palestinian,Tunisia,37,5,0,42
9906,2018,Ghana,Tunisia,0,5,0,5
9907,2018,Guinea,Tunisia,0,13,0,13
9908,2018,Cote d'Ivoire,Tunisia,5,64,0,69
9909,2018,Iran (Islamic Rep. of),Tunisia,5,0,0,5
9910,2018,Iraq,Tunisia,19,5,0,24
9911,2018,Libya,Tunisia,0,5,0,5
9912,2018,Lebanon,Tunisia,6,0,0,6
9913,2018,Nigeria,Tunisia,0,13,0,13
9914,2018,Rwanda,Tunisia,6,0,0,6
9915,2018,Sierra Leone,Tunisia,0,5,0,5
9916,2018,Somalia,Tunisia,5,0,0,5
9917,2018,Sudan,Tunisia,26,6,0,32
9918,2018,Syrian Arab Rep.,Tunisia,927,0,0,927
9919,2018,Türkiye,Tunisia,0,15,0,15
9920,2018,Yemen,Tunisia,0,32,0,32
9921,2018,Afghanistan,Türkiye,6606,164913,0,171519
9922,2018,Algeria,Türkiye,5,24,0,29
9923,2018,Angola,Türkiye,5,15,0,20
9924,2018,Egypt,Türkiye,59,317,0,376
9925,2018,Azerbaijan,Türkiye,5,0,0,5
9926,2018,Burundi,Türkiye,5,33,0,38
9927,2018,Bangladesh,Türkiye,0,171,0,171
9928,2018,Central African Rep.,Türkiye,0,19,0,19
9929,2018,China,Türkiye,13,417,0,430
9930,2018,Cameroon,Türkiye,6,61,0,67
9931,2018,Congo,Türkiye,6,92,0,98
9932,2018,Dem. Rep. of the Congo,Türkiye,45,614,0,659
9933,2018,Djibouti,Türkiye,0,39,0,39
9934,2018,Eritrea,Türkiye,64,183,0,247
9935,2018,Ethiopia,Türkiye,73,266,0,339
9936,2018,Gabon,Türkiye,0,8,0,8
9937,2018,Gambia,Türkiye,0,11,0,11
9938,2018,Palestinian,Türkiye,1226,570,0,1796
9939,2018,Ghana,Türkiye,0,11,0,11
9940,2018,Guinea,Türkiye,10,17,0,27
9941,2018,Cote d'Ivoire,Türkiye,10,14,0,24
9942,2018,India,Türkiye,0,5,0,5
9943,2018,Iran (Islamic Rep. of),Türkiye,8731,30489,0,39220
9944,2018,Iraq,Türkiye,39088,103640,0,142728
9945,2018,Jordan,Türkiye,36,97,0,133
9946,2018,Kazakhstan,Türkiye,0,21,0,21
9947,2018,Kenya,Türkiye,0,5,0,5
9948,2018,Kyrgyzstan,Türkiye,175,93,0,268
9949,2018,Kuwait,Türkiye,0,5,0,5
9950,2018,Liberia,Türkiye,5,5,0,10
9951,2018,Libya,Türkiye,27,87,0,114
9952,2018,Lebanon,Türkiye,13,29,0,42
9953,2018,Sri Lanka,Türkiye,15,9,0,24
9954,2018,Mauritania,Türkiye,8,0,0,8
9955,2018,Mali,Türkiye,0,21,0,21
9956,2018,Malaysia,Türkiye,0,5,0,5
9957,2018,Mongolia,Türkiye,0,110,0,110
9958,2018,Morocco,Türkiye,33,75,0,108
9959,2018,Myanmar,Türkiye,0,26,0,26
9960,2018,Nepal,Türkiye,0,5,0,5
9961,2018,Niger,Türkiye,0,5,0,5
9962,2018,Nigeria,Türkiye,10,85,0,95
9963,2018,Pakistan,Türkiye,51,2303,0,2354
9964,2018,Philippines,Türkiye,5,7,0,12
9965,2018,Russian Federation,Türkiye,5,0,0,5
9966,2018,Rwanda,Türkiye,0,5,0,5
9967,2018,Saudi Arabia,Türkiye,5,11,0,16
9968,2018,Senegal,Türkiye,5,13,0,18
9969,2018,Sierra Leone,Türkiye,5,7,0,12
9970,2018,Somalia,Türkiye,2220,3536,0,5756
9971,2018,Sudan,Türkiye,266,148,0,414
9972,2018,South Sudan,Türkiye,5,5,0,10
9973,2018,Syrian Arab Rep.,Türkiye,3622366,111,0,3622477
9974,2018,United Rep. of Tanzania,Türkiye,0,5,0,5
9975,2018,Tajikistan,Türkiye,8,283,0,291
9976,2018,Turkmenistan,Türkiye,6,721,0,727
9977,2018,Togo,Türkiye,0,6,0,6
9978,2018,Tunisia,Türkiye,13,38,0,51
9979,2018,United Arab Emirates,Türkiye,6,21,0,27
9980,2018,Uganda,Türkiye,15,470,0,485
9981,2018,Uzbekistan,Türkiye,45,664,0,709
9982,2018,Yemen,Türkiye,169,608,0,777
9983,2018,Zimbabwe,Türkiye,6,59,0,65
9984,2018,Stateless,Türkiye,208,66,0,274
9985,2018,Afghanistan,United Arab Emirates,5,20,0,25
9986,2018,Egypt,United Arab Emirates,0,0,0,0
9987,2018,Eritrea,United Arab Emirates,5,6,0,11
9988,2018,Ethiopia,United Arab Emirates,10,0,0,10
9989,2018,Palestinian,United Arab Emirates,5,40,0,45
9990,2018,Iran (Islamic Rep. of),United Arab Emirates,8,8,0,16
9991,2018,Iraq,United Arab Emirates,778,556,0,1334
9992,2018,Jordan,United Arab Emirates,0,0,0,0
9993,2018,Kuwait,United Arab Emirates,5,0,0,5
9994,2018,Libya,United Arab Emirates,0,5,0,5
9995,2018,Lebanon,United Arab Emirates,15,0,0,15
9996,2018,Morocco,United Arab Emirates,0,0,0,0
9997,2018,Pakistan,United Arab Emirates,5,0,0,5
9998,2018,Philippines,United Arab Emirates,0,0,0,0
9999,2018,Saudi Arabia,United Arab Emirates,5,0,0,5
10000,2018,Somalia,United Arab Emirates,21,0,0,21
10001,2018,Sudan,United Arab Emirates,8,12,0,20
10002,2018,Syrian Arab Rep.,United Arab Emirates,287,5820,0,6107
10003,2018,Uganda,United Arab Emirates,5,0,0,5
10004,2018,Yemen,United Arab Emirates,5,33,0,38
10005,2018,Egypt,Uganda,0,5,0,5
10006,2018,Burundi,Uganda,32518,2463,0,34981
10007,2018,Central African Rep.,Uganda,23,5,0,28
10008,2018,Chad,Uganda,7,0,0,7
10009,2018,Congo,Uganda,6,0,0,6
10010,2018,Dem. Rep. of the Congo,Uganda,303092,9607,0,312699
10011,2018,Eritrea,Uganda,3373,6149,0,9522
10012,2018,Ethiopia,Uganda,1708,675,0,2383
10013,2018,Kenya,Uganda,194,20,0,214
10014,2018,Liberia,Uganda,5,0,0,5
10015,2018,Mali,Uganda,0,5,0,5
10016,2018,Nigeria,Uganda,10,0,0,10
10017,2018,Pakistan,Uganda,220,91,0,311
10018,2018,Rwanda,Uganda,14024,589,0,14613
10019,2018,Senegal,Uganda,11,0,0,11
10020,2018,Somalia,Uganda,18764,4869,0,23633
10021,2018,Sudan,Uganda,2802,347,0,3149
10022,2018,South Sudan,Uganda,788848,439,0,789287
10023,2018,Syrian Arab Rep.,Uganda,5,5,0,10
10024,2018,United Rep. of Tanzania,Uganda,8,0,0,8
10025,2018,Türkiye,Uganda,8,0,0,8
10026,2018,Uganda,Uganda,0,0,0,0
10027,2018,Yemen,Uganda,20,0,0,20
10028,2018,Afghanistan,Ukraine,1013,2905,0,3918
10029,2018,Algeria,Ukraine,0,13,0,13
10030,2018,Angola,Ukraine,24,10,0,34
10031,2018,Egypt,Ukraine,5,22,0,27
10032,2018,Armenia,Ukraine,189,28,0,217
10033,2018,Azerbaijan,Ukraine,116,42,0,158
10034,2018,Burundi,Ukraine,0,7,0,7
10035,2018,Bangladesh,Ukraine,0,158,0,158
10036,2018,Bahamas,Ukraine,0,5,0,5
10037,2018,Belarus,Ukraine,23,39,0,62
10038,2018,Cambodia,Ukraine,0,5,0,5
10039,2018,Chad,Ukraine,7,5,0,12
10040,2018,China,Ukraine,0,12,0,12
10041,2018,Cameroon,Ukraine,0,98,0,98
10042,2018,Congo,Ukraine,18,39,0,57
10043,2018,Dem. Rep. of the Congo,Ukraine,53,125,0,178
10044,2018,Cuba,Ukraine,0,11,0,11
10045,2018,Eritrea,Ukraine,12,22,0,34
10046,2018,Ethiopia,Ukraine,28,30,0,58
10047,2018,Gambia,Ukraine,0,5,0,5
10048,2018,Palestinian,Ukraine,18,168,0,186
10049,2018,Georgia,Ukraine,48,98,0,146
10050,2018,Ghana,Ukraine,0,5,0,5
10051,2018,Guinea,Ukraine,5,123,0,128
10052,2018,Cote d'Ivoire,Ukraine,0,27,0,27
10053,2018,India,Ukraine,8,32,0,40
10054,2018,Iran (Islamic Rep. of),Ukraine,55,115,0,170
10055,2018,Iraq,Ukraine,79,268,0,347
10056,2018,Jordan,Ukraine,5,25,0,30
10057,2018,Kazakhstan,Ukraine,7,11,0,18
10058,2018,Kenya,Ukraine,0,6,0,6
10059,2018,Kyrgyzstan,Ukraine,6,148,0,154
10060,2018,Liberia,Ukraine,0,16,0,16
10061,2018,Libya,Ukraine,0,24,0,24
10062,2018,Lebanon,Ukraine,9,22,0,31
10063,2018,Sri Lanka,Ukraine,7,66,0,73
10064,2018,Rep. of Moldova,Ukraine,0,5,0,5
10065,2018,Mali,Ukraine,0,5,0,5
10066,2018,Morocco,Ukraine,0,5,0,5
10067,2018,Myanmar,Ukraine,0,13,0,13
10068,2018,Nepal,Ukraine,0,19,0,19
10069,2018,Nigeria,Ukraine,5,65,0,70
10070,2018,Pakistan,Ukraine,9,195,0,204
10071,2018,Russian Federation,Ukraine,137,200,0,337
10072,2018,Rwanda,Ukraine,5,0,0,5
10073,2018,Serbia and Kosovo: S/RES/1244 (1999),Ukraine,5,0,0,5
10074,2018,Sierra Leone,Ukraine,5,10,0,15
10075,2018,Somalia,Ukraine,98,300,0,398
10076,2018,Viet Nam,Ukraine,0,34,0,34
10077,2018,Sudan,Ukraine,29,115,0,144
10078,2018,Syrian Arab Rep.,Ukraine,457,489,0,946
10079,2018,Tajikistan,Ukraine,20,45,0,65
10080,2018,Turkmenistan,Ukraine,7,5,0,12
10081,2018,Togo,Ukraine,0,5,0,5
10082,2018,Tunisia,Ukraine,0,10,0,10
10083,2018,Türkiye,Ukraine,12,37,0,49
10084,2018,Uganda,Ukraine,0,5,0,5
10085,2018,Ukraine,Ukraine,0,0,1500002,0
10086,2018,Uzbekistan,Ukraine,30,73,0,103
10087,2018,Western Sahara,Ukraine,0,5,0,5
10088,2018,Yemen,Ukraine,5,6,0,11
10089,2018,Stateless,Ukraine,47,8,0,55
10090,2018,Angola,Uruguay,9,6,0,15
10091,2018,Egypt,Uruguay,0,5,0,5
10092,2018,Argentina,Uruguay,0,6,0,6
10093,2018,Bolivia (Plurinational State of),Uruguay,5,0,0,5
10094,2018,Brazil,Uruguay,0,8,0,8
10095,2018,Cameroon,Uruguay,9,0,0,9
10096,2018,Congo,Uruguay,5,0,0,5
10097,2018,Colombia,Uruguay,149,19,0,168
10098,2018,Cuba,Uruguay,15,6183,0,6198
10099,2018,Dominican Rep.,Uruguay,0,14,0,14
10100,2018,Ecuador,Uruguay,7,0,0,7
10101,2018,Haiti,Uruguay,0,5,0,5
10102,2018,Libya,Uruguay,5,0,0,5
10103,2018,Latvia,Uruguay,5,0,0,5
10104,2018,Mexico,Uruguay,5,0,0,5
10105,2018,Morocco,Uruguay,0,10,0,10
10106,2018,Nicaragua,Uruguay,0,12,0,12
10107,2018,Nigeria,Uruguay,17,17,0,34
10108,2018,Paraguay,Uruguay,5,0,0,5
10109,2018,Peru,Uruguay,6,0,0,6
10110,2018,Russian Federation,Uruguay,12,6,0,18
10111,2018,El Salvador,Uruguay,26,22,0,48
10112,2018,Senegal,Uruguay,0,27,0,27
10113,2018,Somalia,Uruguay,5,0,0,5
10114,2018,Spain,Uruguay,0,5,0,5
10115,2018,Syrian Arab Rep.,Uruguay,61,0,0,61
10116,2018,Türkiye,Uruguay,5,8,0,13
10117,2018,Ukraine,Uruguay,11,0,0,11
10118,2018,Venezuela (Bolivarian Republic of),Uruguay,17,51,0,68
10119,2018,Afghanistan,United States of America,1599,765,0,2364
10120,2018,Albania,United States of America,1516,1717,0,3233
10121,2018,Algeria,United States of America,147,333,0,480
10122,2018,Angola,United States of America,207,1416,0,1623
10123,2018,Antigua and Barbuda,United States of America,5,5,0,10
10124,2018,Egypt,United States of America,13163,4677,0,17840
10125,2018,Argentina,United States of America,45,231,0,276
10126,2018,Armenia,United States of America,1639,2456,0,4095
10127,2018,Australia,United States of America,0,10,0,10
10128,2018,Austria,United States of America,14,0,0,14
10129,2018,Azerbaijan,United States of America,386,1003,0,1389
10130,2018,Bahrain,United States of America,47,28,0,75
10131,2018,Barbados,United States of America,0,10,0,10
10132,2018,Burundi,United States of America,789,655,0,1444
10133,2018,Belgium,United States of America,29,34,0,63
10134,2018,Benin,United States of America,95,202,0,297
10135,2018,Bangladesh,United States of America,1628,6444,0,8072
10136,2018,Bahamas,United States of America,180,86,0,266
10137,2018,Bhutan,United States of America,41,330,0,371
10138,2018,Burkina Faso,United States of America,1300,3303,0,4603
10139,2018,Belarus,United States of America,1634,1970,0,3604
10140,2018,Bolivia (Plurinational State of),United States of America,105,405,0,510
10141,2018,Botswana,United States of America,0,7,0,7
10142,2018,Brazil,United States of America,709,7378,0,8087
10143,2018,Bosnia and Herzegovina,United States of America,100,192,0,292
10144,2018,Bulgaria,United States of America,277,254,0,531
10145,2018,Belize,United States of America,44,204,0,248
10146,2018,Cambodia,United States of America,148,64,0,212
10147,2018,Canada,United States of America,42,54,0,96
10148,2018,Central African Rep.,United States of America,215,106,0,321
10149,2018,Cayman Islands,United States of America,6,0,0,6
10150,2018,Chad,United States of America,309,212,0,521
10151,2018,China,United States of America,77710,66561,0,144271
10152,2018,Chile,United States of America,25,179,0,204
10153,2018,Cameroon,United States of America,4300,4414,0,8714
10154,2018,Congo,United States of America,1247,270,0,1517
10155,2018,Dem. Rep. of the Congo,United States of America,1232,2819,0,4051
10156,2018,Comoros,United States of America,5,0,0,5
10157,2018,Colombia,United States of America,3292,9398,0,12690
10158,2018,Costa Rica,United States of America,171,486,0,657
10159,2018,Cuba,United States of America,611,1398,0,2009
10160,2018,Cabo Verde,United States of America,0,23,0,23
10161,2018,Cyprus,United States of America,0,5,0,5
10162,2018,Czechia,United States of America,15,27,0,42
10163,2018,Denmark,United States of America,0,5,0,5
10164,2018,Djibouti,United States of America,302,525,0,827
10165,2018,Dominica,United States of America,11,25,0,36
10166,2018,Dominican Rep.,United States of America,208,1003,0,1211
10167,2018,Ecuador,United States of America,1144,17302,0,18446
10168,2018,Equatorial Guinea,United States of America,11,42,0,53
10169,2018,Eritrea,United States of America,5725,1372,0,7097
10170,2018,Estonia,United States of America,264,37,0,301
10171,2018,Ethiopia,United States of America,9635,5679,0,15314
10172,2018,French Guiana,United States of America,0,5,0,5
10173,2018,Fiji,United States of America,185,253,0,438
10174,2018,Finland,United States of America,5,0,0,5
10175,2018,France,United States of America,24,128,0,152
10176,2018,Gabon,United States of America,49,217,0,266
10177,2018,Gambia,United States of America,1521,836,0,2357
10178,2018,Palestinian,United States of America,5,77,0,82
10179,2018,United Kingdom of Great Britain and Northern Ireland,United States of America,36,114,0,150
10180,2018,Georgia,United States of America,411,1581,0,1992
10181,2018,Germany,United States of America,42,125,0,167
10182,2018,Ghana,United States of America,429,935,0,1364
10183,2018,Guinea-Bissau,United States of America,23,20,0,43
10184,2018,Greece,United States of America,15,68,0,83
10185,2018,Grenada,United States of America,22,38,0,60
10186,2018,Guatemala,United States of America,17610,84848,0,102458
10187,2018,Guinea,United States of America,2146,1126,0,3272
10188,2018,Guyana,United States of America,98,376,0,474
10189,2018,Haiti,United States of America,16192,17073,0,33265
10190,2018,"China, Hong Kong SAR",United States of America,0,6,0,6
10191,2018,Honduras,United States of America,12578,60417,0,72995
10192,2018,Croatia,United States of America,32,37,0,69
10193,2018,Hungary,United States of America,18,212,0,230
10194,2018,Cote d'Ivoire,United States of America,1233,1157,0,2390
10195,2018,India,United States of America,6110,28489,0,34599
10196,2018,Indonesia,United States of America,1379,2036,0,3415
10197,2018,Ireland,United States of America,0,26,0,26
10198,2018,Iran (Islamic Rep. of),United States of America,5648,3158,0,8806
10199,2018,Iraq,United States of America,5947,3626,0,9573
10200,2018,Israel,United States of America,138,477,0,615
10201,2018,Italy,United States of America,22,190,0,212
10202,2018,Jamaica,United States of America,832,958,0,1790
10203,2018,Jordan,United States of America,557,2045,0,2602
10204,2018,Japan,United States of America,8,82,0,90
10205,2018,Kazakhstan,United States of America,843,1809,0,2652
10206,2018,Kenya,United States of America,1987,3836,0,5823
10207,2018,Kyrgyzstan,United States of America,1412,1430,0,2842
10208,2018,Rep. of Korea,United States of America,33,207,0,240
10209,2018,Dem. People's Rep. of Korea,United States of America,8,35,0,43
10210,2018,Kuwait,United States of America,148,195,0,343
10211,2018,Lao People's Dem. Rep.,United States of America,97,162,0,259
10212,2018,Liberia,United States of America,1252,985,0,2237
10213,2018,Libya,United States of America,361,1034,0,1395
10214,2018,Saint Lucia,United States of America,9,21,0,30
10215,2018,Lebanon,United States of America,396,732,0,1128
10216,2018,Lesotho,United States of America,6,0,0,6
10217,2018,Sri Lanka,United States of America,1281,1624,0,2905
10218,2018,Lithuania,United States of America,19,62,0,81
10219,2018,Latvia,United States of America,24,82,0,106
10220,2018,Madagascar,United States of America,14,14,0,28
10221,2018,Mauritania,United States of America,983,810,0,1793
10222,2018,North Macedonia,United States of America,123,179,0,302
10223,2018,Monaco,United States of America,5,0,0,5
10224,2018,Rep. of Moldova,United States of America,1502,2214,0,3716
10225,2018,Maldives,United States of America,6,5,0,11
10226,2018,Mexico,United States of America,9271,85596,0,94867
10227,2018,Marshall Islands,United States of America,7,0,0,7
10228,2018,Mali,United States of America,1191,574,0,1765
10229,2018,Malaysia,United States of America,94,301,0,395
10230,2018,Malawi,United States of America,35,99,0,134
10231,2018,Mongolia,United States of America,758,1995,0,2753
10232,2018,Morocco,United States of America,111,215,0,326
10233,2018,Mozambique,United States of America,5,37,0,42
10234,2018,Malta,United States of America,0,5,0,5
10235,2018,Montenegro,United States of America,120,259,0,379
10236,2018,Mauritius,United States of America,36,42,0,78
10237,2018,Myanmar,United States of America,1553,956,0,2509
10238,2018,Namibia,United States of America,44,7,0,51
10239,2018,Nepal,United States of America,7053,6724,0,13777
10240,2018,Netherlands,United States of America,11,51,0,62
10241,2018,Niger,United States of America,137,290,0,427
10242,2018,Nicaragua,United States of America,672,2721,0,3393
10243,2018,Nigeria,United States of America,1703,8685,0,10388
10244,2018,Niue,United States of America,19,5,0,24
10245,2018,Oman,United States of America,5,11,0,16
10246,2018,Pakistan,United States of America,3722,5334,0,9056
10247,2018,Panama,United States of America,14,84,0,98
10248,2018,Paraguay,United States of America,21,82,0,103
10249,2018,Peru,United States of America,501,2942,0,3443
10250,2018,Philippines,United States of America,166,1457,0,1623
10251,2018,Poland,United States of America,17,765,0,782
10252,2018,Portugal,United States of America,5,129,0,134
10253,2018,Qatar,United States of America,13,33,0,46
10254,2018,Romania,United States of America,401,3116,0,3517
10255,2018,South Africa,United States of America,47,419,0,466
10256,2018,Russian Federation,United States of America,5813,8901,0,14714
10257,2018,Rwanda,United States of America,1152,788,0,1940
10258,2018,El Salvador,United States of America,22152,101000,0,123152
10259,2018,Saudi Arabia,United States of America,482,770,0,1252
10260,2018,Serbia and Kosovo: S/RES/1244 (1999),United States of America,918,664,0,1582
10261,2018,Senegal,United States of America,406,603,0,1009
10262,2018,Seychelles,United States of America,5,0,0,5
10263,2018,Singapore,United States of America,13,32,0,45
10264,2018,Sierra Leone,United States of America,492,308,0,800
10265,2018,Somalia,United States of America,2231,423,0,2654
10266,2018,Spain,United States of America,13,72,0,85
10267,2018,Viet Nam,United States of America,275,571,0,846
10268,2018,Saint Kitts and Nevis,United States of America,5,0,0,5
10269,2018,Sudan,United States of America,1411,883,0,2294
10270,2018,Suriname,United States of America,12,26,0,38
10271,2018,South Sudan,United States of America,24,34,0,58
10272,2018,Slovakia,United States of America,8,15,0,23
10273,2018,Slovenia,United States of America,6,5,0,11
10274,2018,Eswatini,United States of America,5,10,0,15
10275,2018,Sweden,United States of America,8,10,0,18
10276,2018,Switzerland,United States of America,5,13,0,18
10277,2018,Syrian Arab Rep.,United States of America,7998,3057,0,11055
10278,2018,United Rep. of Tanzania,United States of America,131,174,0,305
10279,2018,Turks and Caicos Islands,United States of America,14,0,0,14
10280,2018,Thailand,United States of America,36,475,0,511
10281,2018,Tajikistan,United States of America,316,415,0,731
10282,2018,Turkmenistan,United States of America,193,260,0,453
10283,2018,Togo,United States of America,588,530,0,1118
10284,2018,Tonga,United States of America,0,6,0,6
10285,2018,Trinidad and Tobago,United States of America,51,215,0,266
10286,2018,Tunisia,United States of America,82,228,0,310
10287,2018,Türkiye,United States of America,1127,3390,0,4517
10288,2018,United Arab Emirates,United States of America,59,150,0,209
10289,2018,Uganda,United States of America,1560,2403,0,3963
10290,2018,Ukraine,United States of America,2270,7661,0,9931
10291,2018,Uruguay,United States of America,0,116,0,116
10292,2018,Uzbekistan,United States of America,1246,1893,0,3139
10293,2018,Vanuatu,United States of America,0,12,0,12
10294,2018,Saint Vincent and the Grenadines,United States of America,31,25,0,56
10295,2018,Venezuela (Bolivarian Republic of),United States of America,11259,81800,0,93059
10296,2018,Yemen,United States of America,606,800,0,1406
10297,2018,Zambia,United States of America,46,142,0,188
10298,2018,Zimbabwe,United States of America,916,783,0,1699
10299,2018,Stateless,United States of America,332,0,0,332
10300,2018,Guadeloupe,United States of America,0,11,0,11
10301,2018,Curacao ,United States of America,35,0,0,35
10302,2018,Unknown ,United States of America,5027,4091,0,9118
10303,2018,Afghanistan,Uzbekistan,13,0,0,13
10304,2018,Stateless,Uzbekistan,0,0,0,0
10305,2018,Afghanistan,Venezuela (Bolivarian Republic of),10,0,0,10
10306,2018,Chile,Venezuela (Bolivarian Republic of),10,0,0,10
10307,2018,Congo,Venezuela (Bolivarian Republic of),5,0,0,5
10308,2018,Colombia,Venezuela (Bolivarian Republic of),67156,142,0,67298
10309,2018,Palestinian,Venezuela (Bolivarian Republic of),7,0,0,7
10310,2018,Haiti,Venezuela (Bolivarian Republic of),7,0,0,7
10311,2018,Iraq,Venezuela (Bolivarian Republic of),18,0,0,18
10312,2018,Liberia,Venezuela (Bolivarian Republic of),9,0,0,9
10313,2018,Libya,Venezuela (Bolivarian Republic of),5,0,0,5
10314,2018,Lebanon,Venezuela (Bolivarian Republic of),12,0,0,12
10315,2018,Nigeria,Venezuela (Bolivarian Republic of),7,0,0,7
10316,2018,Peru,Venezuela (Bolivarian Republic of),5,0,0,5
10317,2018,Rwanda,Venezuela (Bolivarian Republic of),5,0,0,5
10318,2018,Sierra Leone,Venezuela (Bolivarian Republic of),5,0,0,5
10319,2018,Syrian Arab Rep.,Venezuela (Bolivarian Republic of),5,0,0,5
10320,2018,Türkiye,Venezuela (Bolivarian Republic of),6,0,0,6
10321,2018,Western Sahara,Venezuela (Bolivarian Republic of),11,0,0,11
10322,2018,Sri Lanka,Samoa,5,0,0,5
10323,2018,Algeria,Yemen,0,5,0,5
10324,2018,Egypt,Yemen,16,5,0,21
10325,2018,Dem. Rep. of the Congo,Yemen,5,0,0,5
10326,2018,Djibouti,Yemen,0,5,0,5
10327,2018,Eritrea,Yemen,1389,381,0,1770
10328,2018,Ethiopia,Yemen,6448,7213,0,13661
10329,2018,Palestinian,Yemen,619,227,0,846
10330,2018,Iran (Islamic Rep. of),Yemen,5,0,0,5
10331,2018,Iraq,Yemen,3330,53,0,3383
10332,2018,Jordan,Yemen,12,0,0,12
10333,2018,Lebanon,Yemen,0,6,0,6
10334,2018,Pakistan,Yemen,0,9,0,9
10335,2018,Somalia,Yemen,248955,62,0,249017
10336,2018,Viet Nam,Yemen,15,0,0,15
10337,2018,Sudan,Yemen,119,433,0,552
10338,2018,Syrian Arab Rep.,Yemen,3446,406,0,3852
10339,2018,United Rep. of Tanzania,Yemen,0,0,0,0
10340,2018,Yemen,Yemen,0,0,2144719,0
10341,2018,Angola,Zambia,0,0,0,0
10342,2018,Burundi,Zambia,4483,1110,0,5593
10343,2018,Congo,Zambia,7,0,0,7
10344,2018,Dem. Rep. of the Congo,Zambia,41490,1790,0,43280
10345,2018,Eritrea,Zambia,22,21,0,43
10346,2018,Ethiopia,Zambia,27,16,0,43
10347,2018,Palestinian,Zambia,12,0,0,12
10348,2018,Liberia,Zambia,7,0,0,7
10349,2018,Nigeria,Zambia,0,5,0,5
10350,2018,South Africa,Zambia,6,0,0,6
10351,2018,Rwanda,Zambia,755,64,0,819
10352,2018,Sierra Leone,Zambia,5,5,0,10
10353,2018,Somalia,Zambia,2891,274,0,3165
10354,2018,Sudan,Zambia,26,0,0,26
10355,2018,Syrian Arab Rep.,Zambia,8,9,0,17
10356,2018,Türkiye,Zambia,39,0,0,39
10357,2018,Uganda,Zambia,28,6,0,34
10358,2018,Unknown ,Zambia,71,0,0,71
10359,2018,Burundi,Zimbabwe,608,115,0,723
10360,2018,Central African Rep.,Zimbabwe,0,5,0,5
10361,2018,Dem. Rep. of the Congo,Zimbabwe,6489,1963,0,8452
10362,2018,Eritrea,Zimbabwe,16,0,0,16
10363,2018,Ethiopia,Zimbabwe,67,9,0,76
10364,2018,Cote d'Ivoire,Zimbabwe,11,8,0,19
10365,2018,Kenya,Zimbabwe,0,8,0,8
10366,2018,Mali,Zimbabwe,5,17,0,22
10367,2018,Mozambique,Zimbabwe,0,7994,0,7994
10368,2018,South Africa,Zimbabwe,0,0,0,0
10369,2018,Rwanda,Zimbabwe,572,43,0,615
10370,2018,Somalia,Zimbabwe,12,12,0,24
10371,2018,Sudan,Zimbabwe,0,28,0,28
10372,2018,South Sudan,Zimbabwe,8,0,0,8
10373,2018,Uganda,Zimbabwe,7,5,0,12
10374,2018,Zimbabwe,Zimbabwe,0,0,0,0
10375,2018,Colombia,Aruba,0,9,0,9
10376,2018,Venezuela (Bolivarian Republic of),Aruba,0,398,0,398
10377,2018,Colombia,Curacao ,53,57,0,110
10378,2018,Cuba,Curacao ,6,6,0,12
10379,2018,Jamaica,Curacao ,5,0,0,5
10380,2018,Venezuela (Bolivarian Republic of),Curacao ,35,279,0,314
10381,2018,Iran (Islamic Rep. of),Sint Maarten (Dutch part),5,0,0,5
