,Year,Country of origin,Country of asylum,Refugees under UNHCR's mandate,Asylum-seekers,IDPs of concern to UNHCR,International total
26892,2022,Afghanistan,Afghanistan,0,0,3393176,0
26893,2022,Bangladesh,Afghanistan,0,5,0,5
26894,2022,Iran (Islamic Rep. of),Afghanistan,38,26,0,64
26895,2022,Pakistan,Afghanistan,59486,220,0,59706
26896,2022,Tajikistan,Afghanistan,0,6,0,6
26897,2022,Afghanistan,Albania,5,0,0,5
26898,2022,Bangladesh,Albania,0,0,0,0
26899,2022,China,Albania,14,0,0,14
26900,2022,Palestinian,Albania,8,0,0,8
26901,2022,Iraq,Albania,0,0,0,0
26902,2022,Serbia and Kosovo: S/RES/1244 (1999),Albania,57,0,0,57
26903,2022,Syrian Arab Rep.,Albania,20,6,0,26
26904,2022,Ukraine,Albania,2192,0,0,2192
26905,2022,Uzbekistan,Albania,5,0,0,5
26906,2022,Venezuela (Bolivarian Republic of),Albania,5,0,0,5
26907,2022,Yemen,Albania,0,0,0,0
26908,2022,Stateless,Albania,0,0,0,0
26909,2022,Benin,Algeria,0,151,0,151
26910,2022,Burkina Faso,Algeria,6,50,0,56
26911,2022,Central African Rep.,Algeria,105,65,0,170
26912,2022,Chad,Algeria,5,31,0,36
26913,2022,Cameroon,Algeria,152,527,0,679
26914,2022,Congo,Algeria,0,11,0,11
26915,2022,Dem. Rep. of the Congo,Algeria,80,116,0,196
26916,2022,Eritrea,Algeria,5,0,0,5
26917,2022,Gambia,Algeria,0,5,0,5
26918,2022,Palestinian,Algeria,225,0,0,225
26919,2022,Ghana,Algeria,0,10,0,10
26920,2022,Guinea-Bissau,Algeria,0,5,0,5
26921,2022,Guinea,Algeria,50,561,0,611
26922,2022,Cote d'Ivoire,Algeria,84,237,0,321
26923,2022,India,Algeria,0,5,0,5
26924,2022,Iraq,Algeria,16,0,0,16
26925,2022,Liberia,Algeria,0,84,0,84
26926,2022,Libya,Algeria,21,13,0,34
26927,2022,Lebanon,Algeria,0,9,0,9
26928,2022,Mali,Algeria,231,603,0,834
26929,2022,Niger,Algeria,9,169,0,178
26930,2022,Nigeria,Algeria,5,342,0,347
26931,2022,Senegal,Algeria,0,6,0,6
26932,2022,Sierra Leone,Algeria,0,41,0,41
26933,2022,Sudan,Algeria,31,69,0,100
26934,2022,Syrian Arab Rep.,Algeria,7345,0,0,7345
26935,2022,Togo,Algeria,0,20,0,20
26936,2022,Türkiye,Algeria,0,11,0,11
26937,2022,Western Sahara,Algeria,90000,0,0,90000
26938,2022,Yemen,Algeria,309,0,0,309
26939,2022,Angola,Angola,0,0,0,0
26940,2022,Burundi,Angola,17,99,0,116
26941,2022,Central African Rep.,Angola,7,77,0,84
26942,2022,Chad,Angola,189,779,0,968
26943,2022,Congo,Angola,65,58,0,123
26944,2022,Dem. Rep. of the Congo,Angola,23274,500,0,23774
26945,2022,Eritrea,Angola,83,1791,0,1874
26946,2022,Ethiopia,Angola,0,57,0,57
26947,2022,Guinea-Bissau,Angola,7,268,0,275
26948,2022,Guinea,Angola,126,9146,0,9272
26949,2022,Cote d'Ivoire,Angola,417,5940,0,6357
26950,2022,Liberia,Angola,164,478,0,642
26951,2022,Mauritania,Angola,323,5402,0,5725
26952,2022,Rwanda,Angola,495,141,0,636
26953,2022,Sierra Leone,Angola,413,1497,0,1910
26954,2022,Somalia,Angola,271,1731,0,2002
26955,2022,Sudan,Angola,279,1670,0,1949
26956,2022,Syrian Arab Rep.,Angola,0,5,0,5
26957,2022,United Rep. of Tanzania,Angola,5,0,0,5
26958,2022,Türkiye,Angola,0,34,0,34
26959,2022,Uganda,Angola,0,6,0,6
26960,2022,Western Sahara,Angola,16,596,0,612
26961,2022,Haiti,Antigua and Barbuda,0,0,0,0
26962,2022,Venezuela (Bolivarian Republic of),Antigua and Barbuda,0,0,0,0
26963,2022,Afghanistan,Egypt,43,161,0,204
26964,2022,Burundi,Egypt,56,62,0,118
26965,2022,Bangladesh,Egypt,0,10,0,10
26966,2022,Central African Rep.,Egypt,45,31,0,76
26967,2022,Chad,Egypt,63,59,0,122
26968,2022,China,Egypt,0,76,0,76
26969,2022,Cameroon,Egypt,18,46,0,64
26970,2022,Congo,Egypt,14,24,0,38
26971,2022,Dem. Rep. of the Congo,Egypt,49,23,0,72
26972,2022,Djibouti,Egypt,22,21,0,43
26973,2022,Eritrea,Egypt,15436,7158,0,22594
26974,2022,Ethiopia,Egypt,5674,10550,0,16224
26975,2022,Palestinian,Egypt,70021,0,0,70021
26976,2022,Ghana,Egypt,0,10,0,10
26977,2022,Guinea,Egypt,11,70,0,81
26978,2022,Cote d'Ivoire,Egypt,36,5,0,41
26979,2022,Iraq,Egypt,4545,2252,0,6797
26980,2022,Jordan,Egypt,9,8,0,17
26981,2022,Kenya,Egypt,9,9,0,18
26982,2022,Liberia,Egypt,0,5,0,5
26983,2022,Libya,Egypt,6,0,0,6
26984,2022,Lebanon,Egypt,0,6,0,6
26985,2022,Sri Lanka,Egypt,0,5,0,5
26986,2022,Mali,Egypt,0,9,0,9
26987,2022,Nigeria,Egypt,27,156,0,183
26988,2022,Russian Federation,Egypt,9,10,0,19
26989,2022,Rwanda,Egypt,5,0,0,5
26990,2022,Saudi Arabia,Egypt,16,5,0,21
26991,2022,Sierra Leone,Egypt,5,7,0,12
26992,2022,Somalia,Egypt,4713,2171,0,6884
26993,2022,Sudan,Egypt,25706,32742,0,58448
26994,2022,South Sudan,Egypt,19649,2642,0,22291
26995,2022,Syrian Arab Rep.,Egypt,143803,0,0,143803
26996,2022,United Rep. of Tanzania,Egypt,5,0,0,5
26997,2022,Tajikistan,Egypt,12,11,0,23
26998,2022,Turkmenistan,Egypt,5,0,0,5
26999,2022,Togo,Egypt,0,10,0,10
27000,2022,Tunisia,Egypt,5,0,0,5
27001,2022,Türkiye,Egypt,0,356,0,356
27002,2022,Uganda,Egypt,14,15,0,29
27003,2022,Uzbekistan,Egypt,0,12,0,12
27004,2022,Yemen,Egypt,163,10482,0,10645
27005,2022,Zimbabwe,Egypt,42,14,0,56
27006,2022,Stateless,Egypt,5,0,0,5
27007,2022,Unknown ,Egypt,0,5,0,5
27008,2022,Afghanistan,Argentina,12,0,0,12
27009,2022,Albania,Argentina,18,0,0,18
27010,2022,Algeria,Argentina,30,23,0,53
27011,2022,Angola,Argentina,14,15,0,29
27012,2022,Egypt,Argentina,5,22,0,27
27013,2022,Armenia,Argentina,77,187,0,264
27014,2022,Burundi,Argentina,5,0,0,5
27015,2022,Bangladesh,Argentina,5,92,0,97
27016,2022,Belarus,Argentina,0,6,0,6
27017,2022,Bolivia (Plurinational State of),Argentina,60,65,0,125
27018,2022,Brazil,Argentina,0,23,0,23
27019,2022,Bosnia and Herzegovina,Argentina,6,0,0,6
27020,2022,China,Argentina,0,121,0,121
27021,2022,Chile,Argentina,34,8,0,42
27022,2022,Cameroon,Argentina,11,39,0,50
27023,2022,Dem. Rep. of the Congo,Argentina,26,28,0,54
27024,2022,Colombia,Argentina,562,294,0,856
27025,2022,Costa Rica,Argentina,5,0,0,5
27026,2022,Cuba,Argentina,262,847,0,1109
27027,2022,Cabo Verde,Argentina,0,5,0,5
27028,2022,Czechia,Argentina,0,5,0,5
27029,2022,Dominican Rep.,Argentina,10,578,0,588
27030,2022,Ecuador,Argentina,16,31,0,47
27031,2022,Eritrea,Argentina,6,5,0,11
27032,2022,Ethiopia,Argentina,5,0,0,5
27033,2022,Gambia,Argentina,0,10,0,10
27034,2022,Palestinian,Argentina,25,9,0,34
27035,2022,Georgia,Argentina,5,0,0,5
27036,2022,Ghana,Argentina,37,152,0,189
27037,2022,Guinea-Bissau,Argentina,8,5,0,13
27038,2022,Guatemala,Argentina,8,0,0,8
27039,2022,Guinea,Argentina,10,9,0,19
27040,2022,Haiti,Argentina,79,766,0,845
27041,2022,Honduras,Argentina,6,10,0,16
27042,2022,Hungary,Argentina,0,5,0,5
27043,2022,Cote d'Ivoire,Argentina,20,5,0,25
27044,2022,India,Argentina,23,130,0,153
27045,2022,Iran (Islamic Rep. of),Argentina,30,6,0,36
27046,2022,Iraq,Argentina,22,0,0,22
27047,2022,Jamaica,Argentina,13,0,0,13
27048,2022,Jordan,Argentina,5,5,0,10
27049,2022,Kazakhstan,Argentina,18,16,0,34
27050,2022,Kyrgyzstan,Argentina,5,0,0,5
27051,2022,Liberia,Argentina,42,0,0,42
27052,2022,Libya,Argentina,5,5,0,10
27053,2022,Sri Lanka,Argentina,36,0,0,36
27054,2022,North Macedonia,Argentina,9,0,0,9
27055,2022,Mexico,Argentina,0,6,0,6
27056,2022,Mali,Argentina,9,0,0,9
27057,2022,Morocco,Argentina,0,14,0,14
27058,2022,Nepal,Argentina,0,5,0,5
27059,2022,Nicaragua,Argentina,16,15,0,31
27060,2022,Nigeria,Argentina,42,75,0,117
27061,2022,Pakistan,Argentina,39,22,0,61
27062,2022,Paraguay,Argentina,20,17,0,37
27063,2022,Peru,Argentina,548,92,0,640
27064,2022,Philippines,Argentina,0,5,0,5
27065,2022,Romania,Argentina,51,0,0,51
27066,2022,South Africa,Argentina,0,17,0,17
27067,2022,Russian Federation,Argentina,81,98,0,179
27068,2022,El Salvador,Argentina,47,40,0,87
27069,2022,Senegal,Argentina,43,1386,0,1429
27070,2022,Sierra Leone,Argentina,37,10,0,47
27071,2022,Somalia,Argentina,5,0,0,5
27072,2022,Spain,Argentina,0,5,0,5
27073,2022,Sudan,Argentina,5,0,0,5
27074,2022,Syrian Arab Rep.,Argentina,440,100,0,540
27075,2022,Tunisia,Argentina,0,5,0,5
27076,2022,Türkiye,Argentina,7,0,0,7
27077,2022,Ukraine,Argentina,121,84,0,205
27078,2022,United States of America,Argentina,5,12,0,17
27079,2022,Venezuela (Bolivarian Republic of),Argentina,316,5632,0,5948
27080,2022,Yemen,Argentina,21,7,0,28
27081,2022,Unknown ,Argentina,645,139,0,784
27082,2022,Afghanistan,Armenia,6,0,0,6
27083,2022,Egypt,Armenia,5,0,0,5
27084,2022,Azerbaijan,Armenia,27929,0,0,27929
27085,2022,Congo,Armenia,5,0,0,5
27086,2022,Cuba,Armenia,5,45,0,50
27087,2022,Palestinian,Armenia,7,0,0,7
27088,2022,Georgia,Armenia,8,5,0,13
27089,2022,Cote d'Ivoire,Armenia,6,0,0,6
27090,2022,Iran (Islamic Rep. of),Armenia,144,72,0,216
27091,2022,Iraq,Armenia,1103,26,0,1129
27092,2022,Lebanon,Armenia,26,5,0,31
27093,2022,Nigeria,Armenia,6,0,0,6
27094,2022,Russian Federation,Armenia,0,6,0,6
27095,2022,Syrian Arab Rep.,Armenia,4855,9,0,4864
27096,2022,Türkiye,Armenia,17,10,0,27
27097,2022,Ukraine,Armenia,131,217,0,348
27098,2022,Yemen,Armenia,21,0,0,21
27099,2022,Stateless,Armenia,0,0,0,0
27100,2022,Afghanistan,Australia,8741,3264,0,12005
27101,2022,Albania,Australia,37,97,0,134
27102,2022,Algeria,Australia,8,22,0,30
27103,2022,Egypt,Australia,1214,224,0,1438
27104,2022,Argentina,Australia,0,27,0,27
27105,2022,Azerbaijan,Australia,10,12,0,22
27106,2022,Bahrain,Australia,44,5,0,49
27107,2022,Burundi,Australia,53,27,0,80
27108,2022,Belgium,Australia,0,5,0,5
27109,2022,Bangladesh,Australia,393,1314,0,1707
27110,2022,Bhutan,Australia,5,17,0,22
27111,2022,Belarus,Australia,7,0,0,7
27112,2022,Brazil,Australia,9,183,0,192
27113,2022,Brunei Darussalam,Australia,0,6,0,6
27114,2022,Bosnia and Herzegovina,Australia,0,5,0,5
27115,2022,Cambodia,Australia,67,493,0,560
27116,2022,Canada,Australia,0,5,0,5
27117,2022,China,Australia,1576,15082,0,16658
27118,2022,Chile,Australia,6,61,0,67
27119,2022,Cameroon,Australia,29,62,0,91
27120,2022,Congo,Australia,36,20,0,56
27121,2022,Dem. Rep. of the Congo,Australia,61,45,0,106
27122,2022,Colombia,Australia,81,320,0,401
27123,2022,Eritrea,Australia,99,11,0,110
27124,2022,Ethiopia,Australia,409,179,0,588
27125,2022,Fiji,Australia,248,2662,0,2910
27126,2022,France,Australia,0,25,0,25
27127,2022,Gambia,Australia,10,6,0,16
27128,2022,Palestinian,Australia,457,204,0,661
27129,2022,United Kingdom of Great Britain and Northern Ireland,Australia,6,97,0,103
27130,2022,Georgia,Australia,12,27,0,39
27131,2022,Germany,Australia,9,10,0,19
27132,2022,Ghana,Australia,44,178,0,222
27133,2022,Greece,Australia,6,50,0,56
27134,2022,Guinea,Australia,8,5,0,13
27135,2022,"China, Hong Kong SAR",Australia,6,472,0,478
27136,2022,Honduras,Australia,5,5,0,10
27137,2022,India,Australia,469,7273,0,7742
27138,2022,Indonesia,Australia,241,2377,0,2618
27139,2022,Ireland,Australia,0,83,0,83
27140,2022,Iran (Islamic Rep. of),Australia,12180,3429,0,15609
27141,2022,Iraq,Australia,4286,1195,0,5481
27142,2022,Israel,Australia,6,17,0,23
27143,2022,Italy,Australia,5,58,0,63
27144,2022,Jamaica,Australia,5,0,0,5
27145,2022,Jordan,Australia,144,179,0,323
27146,2022,Japan,Australia,10,20,0,30
27147,2022,Kazakhstan,Australia,5,0,0,5
27148,2022,Kenya,Australia,105,338,0,443
27149,2022,Kyrgyzstan,Australia,11,0,0,11
27150,2022,Kiribati,Australia,0,5,0,5
27151,2022,Rep. of Korea,Australia,21,326,0,347
27152,2022,Dem. People's Rep. of Korea,Australia,0,9,0,9
27153,2022,Kuwait,Australia,23,0,0,23
27154,2022,Lao People's Dem. Rep.,Australia,5,304,0,309
27155,2022,Liberia,Australia,43,18,0,61
27156,2022,Libya,Australia,1212,37,0,1249
27157,2022,Lebanon,Australia,481,952,0,1433
27158,2022,Sri Lanka,Australia,3809,3136,0,6945
27159,2022,North Macedonia,Australia,5,78,0,83
27160,2022,Maldives,Australia,19,10,0,29
27161,2022,Mexico,Australia,19,26,0,45
27162,2022,Malaysia,Australia,734,18884,0,19618
27163,2022,Mongolia,Australia,13,391,0,404
27164,2022,Morocco,Australia,10,19,0,29
27165,2022,Mozambique,Australia,0,7,0,7
27166,2022,Mauritius,Australia,11,132,0,143
27167,2022,Myanmar,Australia,413,972,0,1385
27168,2022,Nepal,Australia,94,707,0,801
27169,2022,Nigeria,Australia,265,530,0,795
27170,2022,Nauru,Australia,5,16,0,21
27171,2022,New Zealand,Australia,34,26,0,60
27172,2022,Oman,Australia,5,0,0,5
27173,2022,Pakistan,Australia,5042,2578,0,7620
27174,2022,Peru,Australia,26,74,0,100
27175,2022,Philippines,Australia,41,1640,0,1681
27176,2022,Papua New Guinea,Australia,526,618,0,1144
27177,2022,Poland,Australia,0,19,0,19
27178,2022,Portugal,Australia,0,12,0,12
27179,2022,Romania,Australia,0,10,0,10
27180,2022,South Africa,Australia,26,468,0,494
27181,2022,Russian Federation,Australia,53,96,0,149
27182,2022,Rwanda,Australia,87,56,0,143
27183,2022,El Salvador,Australia,12,32,0,44
27184,2022,Saudi Arabia,Australia,209,66,0,275
27185,2022,Serbia and Kosovo: S/RES/1244 (1999),Australia,0,20,0,20
27186,2022,Singapore,Australia,6,44,0,50
27187,2022,Sierra Leone,Australia,33,122,0,155
27188,2022,Solomon Islands,Australia,30,447,0,477
27189,2022,Somalia,Australia,558,126,0,684
27190,2022,Viet Nam,Australia,327,3524,0,3851
27191,2022,Sudan,Australia,580,253,0,833
27192,2022,South Sudan,Australia,22,37,0,59
27193,2022,Eswatini,Australia,0,21,0,21
27194,2022,Syrian Arab Rep.,Australia,595,52,0,647
27195,2022,United Rep. of Tanzania,Australia,8,32,0,40
27196,2022,Thailand,Australia,21,1979,0,2000
27197,2022,Timor-Leste,Australia,6,363,0,369
27198,2022,Tonga,Australia,29,973,0,1002
27199,2022,Tunisia,Australia,0,10,0,10
27200,2022,Türkiye,Australia,817,471,0,1288
27201,2022,United Arab Emirates,Australia,5,0,0,5
27202,2022,Uganda,Australia,66,85,0,151
27203,2022,Ukraine,Australia,26,267,0,293
27204,2022,Uruguay,Australia,0,7,0,7
27205,2022,United States of America,Australia,17,58,0,75
27206,2022,Uzbekistan,Australia,21,51,0,72
27207,2022,Vanuatu,Australia,0,336,0,336
27208,2022,Venezuela (Bolivarian Republic of),Australia,191,297,0,488
27209,2022,Samoa,Australia,7,214,0,221
27210,2022,Yemen,Australia,241,44,0,285
27211,2022,Zambia,Australia,18,24,0,42
27212,2022,Zimbabwe,Australia,285,196,0,481
27213,2022,Stateless,Australia,3682,1382,0,5064
27214,2022,Tibetan,Australia,10,0,0,10
27215,2022,Unknown ,Australia,1516,1065,0,2581
27216,2022,Afghanistan,Austria,43725,5499,0,49224
27217,2022,Albania,Austria,49,19,0,68
27218,2022,Algeria,Austria,26,190,0,216
27219,2022,Angola,Austria,34,10,0,44
27220,2022,Egypt,Austria,212,340,0,552
27221,2022,Armenia,Austria,288,126,0,414
27222,2022,Azerbaijan,Austria,145,73,0,218
27223,2022,Burundi,Austria,15,29,0,44
27224,2022,Benin,Austria,5,8,0,13
27225,2022,Bangladesh,Austria,369,268,0,637
27226,2022,Burkina Faso,Austria,5,7,0,12
27227,2022,Belarus,Austria,30,22,0,52
27228,2022,Bosnia and Herzegovina,Austria,53,13,0,66
27229,2022,Chad,Austria,5,0,0,5
27230,2022,China,Austria,655,60,0,715
27231,2022,Cameroon,Austria,185,63,0,248
27232,2022,Congo,Austria,75,8,0,83
27233,2022,Dem. Rep. of the Congo,Austria,310,65,0,375
27234,2022,Colombia,Austria,5,20,0,25
27235,2022,Cuba,Austria,14,14,0,28
27236,2022,Eritrea,Austria,492,31,0,523
27237,2022,Ethiopia,Austria,247,50,0,297
27238,2022,Gabon,Austria,5,0,0,5
27239,2022,Gambia,Austria,110,51,0,161
27240,2022,United Kingdom of Great Britain and Northern Ireland,Austria,5,5,0,10
27241,2022,Georgia,Austria,310,232,0,542
27242,2022,Germany,Austria,0,5,0,5
27243,2022,Ghana,Austria,15,29,0,44
27244,2022,Guinea-Bissau,Austria,5,5,0,10
27245,2022,Guatemala,Austria,6,0,0,6
27246,2022,Guinea,Austria,123,31,0,154
27247,2022,Cote d'Ivoire,Austria,44,9,0,53
27248,2022,India,Austria,36,1530,0,1566
27249,2022,Iran (Islamic Rep. of),Austria,7294,905,0,8199
27250,2022,Iraq,Austria,10110,1100,0,11210
27251,2022,Israel,Austria,10,5,0,15
27252,2022,Jordan,Austria,81,53,0,134
27253,2022,Kazakhstan,Austria,108,20,0,128
27254,2022,Kenya,Austria,15,9,0,24
27255,2022,Kyrgyzstan,Austria,115,21,0,136
27256,2022,Kuwait,Austria,9,5,0,14
27257,2022,Liberia,Austria,10,0,0,10
27258,2022,Libya,Austria,146,66,0,212
27259,2022,Lebanon,Austria,120,95,0,215
27260,2022,Sri Lanka,Austria,72,24,0,96
27261,2022,Mauritania,Austria,5,0,0,5
27262,2022,North Macedonia,Austria,17,39,0,56
27263,2022,Rep. of Moldova,Austria,18,103,0,121
27264,2022,Mali,Austria,13,13,0,26
27265,2022,Mongolia,Austria,107,53,0,160
27266,2022,Morocco,Austria,46,1046,0,1092
27267,2022,Montenegro,Austria,5,0,0,5
27268,2022,Myanmar,Austria,32,10,0,42
27269,2022,Namibia,Austria,0,5,0,5
27270,2022,Nepal,Austria,17,47,0,64
27271,2022,Nicaragua,Austria,5,0,0,5
27272,2022,Nigeria,Austria,435,266,0,701
27273,2022,Pakistan,Austria,386,2599,0,2985
27274,2022,Philippines,Austria,19,10,0,29
27275,2022,South Africa,Austria,0,6,0,6
27276,2022,Russian Federation,Austria,6124,597,0,6721
27277,2022,Rwanda,Austria,13,5,0,18
27278,2022,Saudi Arabia,Austria,7,5,0,12
27279,2022,Serbia and Kosovo: S/RES/1244 (1999),Austria,406,93,0,499
27280,2022,Senegal,Austria,12,11,0,23
27281,2022,Sierra Leone,Austria,18,7,0,25
27282,2022,Somalia,Austria,8684,1817,0,10501
27283,2022,Viet Nam,Austria,0,8,0,8
27284,2022,Sudan,Austria,293,47,0,340
27285,2022,South Sudan,Austria,6,0,0,6
27286,2022,Syrian Arab Rep.,Austria,67588,11589,0,79177
27287,2022,United Rep. of Tanzania,Austria,5,5,0,10
27288,2022,Tajikistan,Austria,255,79,0,334
27289,2022,Turkmenistan,Austria,8,0,0,8
27290,2022,Togo,Austria,6,5,0,11
27291,2022,Tunisia,Austria,17,2389,0,2406
27292,2022,Türkiye,Austria,706,1327,0,2033
27293,2022,Uganda,Austria,34,9,0,43
27294,2022,Ukraine,Austria,74689,321,0,75010
27295,2022,United States of America,Austria,5,5,0,10
27296,2022,Uzbekistan,Austria,46,70,0,116
27297,2022,Venezuela (Bolivarian Republic of),Austria,95,51,0,146
27298,2022,Yemen,Austria,504,157,0,661
27299,2022,Zambia,Austria,5,0,0,5
27300,2022,Stateless,Austria,1972,0,0,1972
27301,2022,Unknown ,Austria,5228,548,0,5776
27302,2022,Afghanistan,Azerbaijan,1179,35,0,1214
27303,2022,Azerbaijan,Azerbaijan,0,0,654839,0
27304,2022,Palestinian,Azerbaijan,5,0,0,5
27305,2022,Iran (Islamic Rep. of),Azerbaijan,51,0,0,51
27306,2022,Iraq,Azerbaijan,10,0,0,10
27307,2022,Libya,Azerbaijan,5,0,0,5
27308,2022,Nigeria,Azerbaijan,0,6,0,6
27309,2022,Pakistan,Azerbaijan,53,34,0,87
27310,2022,Russian Federation,Azerbaijan,325,0,0,325
27311,2022,Syrian Arab Rep.,Azerbaijan,34,0,0,34
27312,2022,Turkmenistan,Azerbaijan,0,5,0,5
27313,2022,Ukraine,Azerbaijan,4788,41,0,4829
27314,2022,Uzbekistan,Azerbaijan,5,0,0,5
27315,2022,Yemen,Azerbaijan,11,0,0,11
27316,2022,Stateless,Azerbaijan,0,0,0,0
27317,2022,Egypt,Bahrain,0,5,0,5
27318,2022,Palestinian,Bahrain,0,15,0,15
27319,2022,Iraq,Bahrain,241,117,0,358
27320,2022,Jordan,Bahrain,0,6,0,6
27321,2022,Syrian Arab Rep.,Bahrain,5,40,0,45
27322,2022,Tunisia,Bahrain,0,6,0,6
27323,2022,Yemen,Bahrain,9,5,0,14
27324,2022,Burundi,Burundi,0,0,7631,0
27325,2022,Dem. Rep. of the Congo,Burundi,81501,3314,0,84815
27326,2022,Kenya,Burundi,0,0,0,0
27327,2022,Mali,Burundi,12,0,0,12
27328,2022,Oman,Burundi,0,0,0,0
27329,2022,Pakistan,Burundi,0,0,0,0
27330,2022,South Africa,Burundi,0,5,0,5
27331,2022,Rwanda,Burundi,667,338,0,1005
27332,2022,Somalia,Burundi,5,0,0,5
27333,2022,United Rep. of Tanzania,Burundi,0,0,0,0
27334,2022,Uganda,Burundi,11,5,0,16
27335,2022,Afghanistan,Belgium,7049,5302,0,12351
27336,2022,Albania,Belgium,693,154,0,847
27337,2022,Algeria,Belgium,98,172,0,270
27338,2022,Angola,Belgium,98,164,0,262
27339,2022,Egypt,Belgium,113,84,0,197
27340,2022,Armenia,Belgium,325,238,0,563
27341,2022,Azerbaijan,Belgium,131,61,0,192
27342,2022,Burundi,Belgium,2408,354,0,2762
27343,2022,Benin,Belgium,40,51,0,91
27344,2022,Bangladesh,Belgium,21,6,0,27
27345,2022,Burkina Faso,Belgium,120,72,0,192
27346,2022,Belarus,Belgium,77,67,0,144
27347,2022,Brazil,Belgium,18,28,0,46
27348,2022,Bosnia and Herzegovina,Belgium,44,5,0,49
27349,2022,Bulgaria,Belgium,17,0,0,17
27350,2022,Cambodia,Belgium,13,0,0,13
27351,2022,Central African Rep.,Belgium,74,23,0,97
27352,2022,Chad,Belgium,47,42,0,89
27353,2022,China,Belgium,1226,45,0,1271
27354,2022,Chile,Belgium,44,5,0,49
27355,2022,Cameroon,Belgium,690,650,0,1340
27356,2022,Congo,Belgium,25,36,0,61
27357,2022,Dem. Rep. of the Congo,Belgium,1632,634,0,2266
27358,2022,Colombia,Belgium,143,252,0,395
27359,2022,Cuba,Belgium,10,5,0,15
27360,2022,Czechia,Belgium,5,0,0,5
27361,2022,Djibouti,Belgium,385,58,0,443
27362,2022,Ecuador,Belgium,0,6,0,6
27363,2022,Equatorial Guinea,Belgium,0,5,0,5
27364,2022,Eritrea,Belgium,4540,661,0,5201
27365,2022,Ethiopia,Belgium,187,144,0,331
27366,2022,Gabon,Belgium,30,40,0,70
27367,2022,Gambia,Belgium,37,73,0,110
27368,2022,Palestinian,Belgium,3655,1313,0,4968
27369,2022,Georgia,Belgium,249,360,0,609
27370,2022,Ghana,Belgium,19,67,0,86
27371,2022,Guinea-Bissau,Belgium,7,5,0,12
27372,2022,Guatemala,Belgium,41,33,0,74
27373,2022,Guinea,Belgium,3764,915,0,4679
27374,2022,Guyana,Belgium,5,0,0,5
27375,2022,Haiti,Belgium,5,5,0,10
27376,2022,Honduras,Belgium,21,15,0,36
27377,2022,Croatia,Belgium,5,0,0,5
27378,2022,Hungary,Belgium,29,0,0,29
27379,2022,Cote d'Ivoire,Belgium,260,171,0,431
27380,2022,India,Belgium,14,7,0,21
27381,2022,Iran (Islamic Rep. of),Belgium,1902,256,0,2158
27382,2022,Iraq,Belgium,5769,699,0,6468
27383,2022,Israel,Belgium,0,5,0,5
27384,2022,Jamaica,Belgium,5,0,0,5
27385,2022,Jordan,Belgium,28,41,0,69
27386,2022,Kazakhstan,Belgium,67,18,0,85
27387,2022,Kenya,Belgium,15,7,0,22
27388,2022,Kyrgyzstan,Belgium,93,29,0,122
27389,2022,Dem. People's Rep. of Korea,Belgium,32,0,0,32
27390,2022,Kuwait,Belgium,8,5,0,13
27391,2022,Lao People's Dem. Rep.,Belgium,10,0,0,10
27392,2022,Liberia,Belgium,16,25,0,41
27393,2022,Libya,Belgium,156,116,0,272
27394,2022,Lebanon,Belgium,140,87,0,227
27395,2022,Sri Lanka,Belgium,311,33,0,344
27396,2022,Lithuania,Belgium,10,0,0,10
27397,2022,Madagascar,Belgium,0,5,0,5
27398,2022,Mauritania,Belgium,278,131,0,409
27399,2022,North Macedonia,Belgium,133,28,0,161
27400,2022,Rep. of Moldova,Belgium,98,0,0,98
27401,2022,Maldives,Belgium,0,89,0,89
27402,2022,Mali,Belgium,105,37,0,142
27403,2022,Mongolia,Belgium,0,7,0,7
27404,2022,Morocco,Belgium,205,328,0,533
27405,2022,Mozambique,Belgium,0,5,0,5
27406,2022,Montenegro,Belgium,13,0,0,13
27407,2022,Myanmar,Belgium,8,0,0,8
27408,2022,Nepal,Belgium,6,0,0,6
27409,2022,Niger,Belgium,139,97,0,236
27410,2022,Nicaragua,Belgium,26,11,0,37
27411,2022,Nigeria,Belgium,72,300,0,372
27412,2022,Pakistan,Belgium,359,71,0,430
27413,2022,Peru,Belgium,10,23,0,33
27414,2022,Philippines,Belgium,0,16,0,16
27415,2022,Poland,Belgium,98,0,0,98
27416,2022,Romania,Belgium,52,0,0,52
27417,2022,South Africa,Belgium,5,0,0,5
27418,2022,Russian Federation,Belgium,2848,405,0,3253
27419,2022,Rwanda,Belgium,846,224,0,1070
27420,2022,El Salvador,Belgium,591,304,0,895
27421,2022,Saudi Arabia,Belgium,8,5,0,13
27422,2022,Serbia and Kosovo: S/RES/1244 (1999),Belgium,914,62,0,976
27423,2022,Senegal,Belgium,421,231,0,652
27424,2022,Sierra Leone,Belgium,29,39,0,68
27425,2022,Somalia,Belgium,2746,1041,0,3787
27426,2022,Spain,Belgium,0,7,0,7
27427,2022,Viet Nam,Belgium,23,18,0,41
27428,2022,Sudan,Belgium,316,116,0,432
27429,2022,Suriname,Belgium,0,5,0,5
27430,2022,South Sudan,Belgium,12,25,0,37
27431,2022,Syrian Arab Rep.,Belgium,20086,1089,0,21175
27432,2022,United Rep. of Tanzania,Belgium,43,21,0,64
27433,2022,Tajikistan,Belgium,21,18,0,39
27434,2022,Turkmenistan,Belgium,7,0,0,7
27435,2022,Togo,Belgium,164,97,0,261
27436,2022,Trinidad and Tobago,Belgium,0,5,0,5
27437,2022,Tunisia,Belgium,83,78,0,161
27438,2022,Türkiye,Belgium,3362,815,0,4177
27439,2022,Uganda,Belgium,26,23,0,49
27440,2022,Ukraine,Belgium,48238,160,0,48398
27441,2022,United States of America,Belgium,0,8,0,8
27442,2022,Uzbekistan,Belgium,67,14,0,81
27443,2022,Venezuela (Bolivarian Republic of),Belgium,515,180,0,695
27444,2022,Yemen,Belgium,311,91,0,402
27445,2022,Zambia,Belgium,0,5,0,5
27446,2022,Stateless,Belgium,329,7,0,336
27447,2022,Tibetan,Belgium,6,0,0,6
27448,2022,Unknown ,Belgium,7236,478,0,7714
27449,2022,Burundi,Benin,5,0,0,5
27450,2022,Burkina Faso,Benin,194,5,0,199
27451,2022,Central African Rep.,Benin,1144,174,0,1318
27452,2022,Chad,Benin,20,49,0,69
27453,2022,Cameroon,Benin,94,85,0,179
27454,2022,Congo,Benin,0,14,0,14
27455,2022,Dem. Rep. of the Congo,Benin,28,60,0,88
27456,2022,Eritrea,Benin,5,0,0,5
27457,2022,Guinea,Benin,0,14,0,14
27458,2022,Cote d'Ivoire,Benin,117,29,0,146
27459,2022,Liberia,Benin,0,5,0,5
27460,2022,Sri Lanka,Benin,5,5,0,10
27461,2022,Mali,Benin,48,15,0,63
27462,2022,Niger,Benin,22,10,0,32
27463,2022,Nigeria,Benin,0,43,0,43
27464,2022,Pakistan,Benin,5,0,0,5
27465,2022,Rwanda,Benin,0,5,0,5
27466,2022,Sudan,Benin,21,14,0,35
27467,2022,Syrian Arab Rep.,Benin,36,16,0,52
27468,2022,Togo,Benin,0,28,0,28
27469,2022,Türkiye,Benin,10,0,0,10
27470,2022,Yemen,Benin,17,0,0,17
27471,2022,Afghanistan,Bangladesh,5,0,0,5
27472,2022,Myanmar,Bangladesh,929662,5,0,929667
27473,2022,Somalia,Bangladesh,14,22,0,36
27474,2022,Stateless,Bangladesh,0,0,0,0
27475,2022,Cameroon,Bahamas,5,0,0,5
27476,2022,Jamaica,Bahamas,5,0,0,5
27477,2022,Afghanistan,Burkina Faso,0,10,0,10
27478,2022,Burundi,Burkina Faso,26,5,0,31
27479,2022,Benin,Burkina Faso,7,0,0,7
27480,2022,Burkina Faso,Burkina Faso,0,0,1902150,0
27481,2022,Central African Rep.,Burkina Faso,180,122,0,302
27482,2022,Chad,Burkina Faso,71,0,0,71
27483,2022,Cameroon,Burkina Faso,8,0,0,8
27484,2022,Congo,Burkina Faso,26,0,0,26
27485,2022,Dem. Rep. of the Congo,Burkina Faso,30,0,0,30
27486,2022,Cote d'Ivoire,Burkina Faso,5,0,0,5
27487,2022,Mali,Burkina Faso,26603,6273,0,32876
27488,2022,Niger,Burkina Faso,0,1029,0,1029
27489,2022,Rwanda,Burkina Faso,15,0,0,15
27490,2022,South Sudan,Burkina Faso,5,0,0,5
27491,2022,Syrian Arab Rep.,Burkina Faso,5,5,0,10
27492,2022,Togo,Burkina Faso,15,0,0,15
27493,2022,Türkiye,Burkina Faso,48,81,0,129
27494,2022,Afghanistan,Belarus,96,5,0,101
27495,2022,Egypt,Belarus,0,5,0,5
27496,2022,Armenia,Belarus,5,0,0,5
27497,2022,Azerbaijan,Belarus,5,0,0,5
27498,2022,Cuba,Belarus,0,5,0,5
27499,2022,Ethiopia,Belarus,5,0,0,5
27500,2022,Palestinian,Belarus,7,0,0,7
27501,2022,Georgia,Belarus,48,0,0,48
27502,2022,Iran (Islamic Rep. of),Belarus,5,0,0,5
27503,2022,Iraq,Belarus,11,0,0,11
27504,2022,Libya,Belarus,7,0,0,7
27505,2022,Lebanon,Belarus,5,0,0,5
27506,2022,Russian Federation,Belarus,9,0,0,9
27507,2022,Slovakia,Belarus,0,5,0,5
27508,2022,Syrian Arab Rep.,Belarus,59,12,0,71
27509,2022,Tajikistan,Belarus,10,0,0,10
27510,2022,Türkiye,Belarus,21,0,0,21
27511,2022,Ukraine,Belarus,12231,743,0,12974
27512,2022,Yemen,Belarus,23,5,0,28
27513,2022,Stateless,Belarus,0,0,0,0
27514,2022,Argentina,Bolivia (Plurinational State of),13,0,0,13
27515,2022,Colombia,Bolivia (Plurinational State of),200,21,0,221
27516,2022,Cuba,Bolivia (Plurinational State of),48,0,0,48
27517,2022,Ecuador,Bolivia (Plurinational State of),5,6,0,11
27518,2022,Cote d'Ivoire,Bolivia (Plurinational State of),5,0,0,5
27519,2022,Iraq,Bolivia (Plurinational State of),16,0,0,16
27520,2022,Niger,Bolivia (Plurinational State of),5,0,0,5
27521,2022,Pakistan,Bolivia (Plurinational State of),5,0,0,5
27522,2022,Peru,Bolivia (Plurinational State of),525,0,0,525
27523,2022,Russian Federation,Bolivia (Plurinational State of),14,0,0,14
27524,2022,Syrian Arab Rep.,Bolivia (Plurinational State of),22,0,0,22
27525,2022,Ukraine,Bolivia (Plurinational State of),5,0,0,5
27526,2022,Uruguay,Bolivia (Plurinational State of),10,0,0,10
27527,2022,Venezuela (Bolivarian Republic of),Bolivia (Plurinational State of),243,0,0,243
27528,2022,Angola,Botswana,0,0,0,0
27529,2022,Burundi,Botswana,59,0,0,59
27530,2022,Botswana,Botswana,0,0,0,0
27531,2022,Dem. Rep. of the Congo,Botswana,261,89,0,350
27532,2022,Ethiopia,Botswana,5,0,0,5
27533,2022,Kenya,Botswana,5,0,0,5
27534,2022,Namibia,Botswana,6,0,0,6
27535,2022,Rwanda,Botswana,18,0,0,18
27536,2022,Somalia,Botswana,325,0,0,325
27537,2022,Sudan,Botswana,5,0,0,5
27538,2022,South Sudan,Botswana,5,0,0,5
27539,2022,Uganda,Botswana,19,0,0,19
27540,2022,Zimbabwe,Botswana,15,0,0,15
27541,2022,Afghanistan,Brazil,170,490,0,660
27542,2022,Albania,Brazil,0,7,0,7
27543,2022,Algeria,Brazil,8,34,0,42
27544,2022,Andorra,Brazil,0,6,0,6
27545,2022,Angola,Brazil,1173,6444,0,7617
27546,2022,Egypt,Brazil,70,453,0,523
27547,2022,Argentina,Brazil,6,153,0,159
27548,2022,Armenia,Brazil,5,10,0,15
27549,2022,Burundi,Brazil,48,21,0,69
27550,2022,Belgium,Brazil,0,6,0,6
27551,2022,Benin,Brazil,5,265,0,270
27552,2022,Bangladesh,Brazil,33,4918,0,4951
27553,2022,Bhutan,Brazil,31,35,0,66
27554,2022,Burkina Faso,Brazil,96,241,0,337
27555,2022,Belarus,Brazil,0,8,0,8
27556,2022,Bolivia (Plurinational State of),Brazil,154,461,0,615
27557,2022,Bosnia and Herzegovina,Brazil,5,0,0,5
27558,2022,Bulgaria,Brazil,0,5,0,5
27559,2022,Cambodia,Brazil,0,5,0,5
27560,2022,Canada,Brazil,0,6,0,6
27561,2022,Central African Rep.,Brazil,5,7,0,12
27562,2022,China,Brazil,24,4903,0,4927
27563,2022,Chile,Brazil,21,135,0,156
27564,2022,Cameroon,Brazil,102,566,0,668
27565,2022,Congo,Brazil,20,128,0,148
27566,2022,Dem. Rep. of the Congo,Brazil,1696,2506,0,4202
27567,2022,Colombia,Brazil,1312,2072,0,3384
27568,2022,Costa Rica,Brazil,5,15,0,20
27569,2022,Cuba,Brazil,930,14954,0,15884
27570,2022,Cabo Verde,Brazil,0,195,0,195
27571,2022,Cyprus,Brazil,0,5,0,5
27572,2022,Czechia,Brazil,0,5,0,5
27573,2022,Denmark,Brazil,0,12,0,12
27574,2022,Djibouti,Brazil,0,7,0,7
27575,2022,Dominica,Brazil,0,18,0,18
27576,2022,Dominican Rep.,Brazil,7,1240,0,1247
27577,2022,Ecuador,Brazil,59,114,0,173
27578,2022,Equatorial Guinea,Brazil,0,17,0,17
27579,2022,Eritrea,Brazil,25,75,0,100
27580,2022,Ethiopia,Brazil,29,72,0,101
27581,2022,French Guiana,Brazil,0,20,0,20
27582,2022,Fiji,Brazil,0,21,0,21
27583,2022,France,Brazil,0,40,0,40
27584,2022,Gambia,Brazil,9,313,0,322
27585,2022,Palestinian,Brazil,578,343,0,921
27586,2022,United Kingdom of Great Britain and Northern Ireland,Brazil,0,13,0,13
27587,2022,Georgia,Brazil,11,5,0,16
27588,2022,Germany,Brazil,5,18,0,23
27589,2022,Ghana,Brazil,48,2462,0,2510
27590,2022,Guinea-Bissau,Brazil,26,1556,0,1582
27591,2022,Greece,Brazil,0,5,0,5
27592,2022,Guatemala,Brazil,5,26,0,31
27593,2022,Guinea,Brazil,116,843,0,959
27594,2022,Guyana,Brazil,5,171,0,176
27595,2022,Haiti,Brazil,9,37226,0,37235
27596,2022,Honduras,Brazil,6,14,0,20
27597,2022,Croatia,Brazil,6,5,0,11
27598,2022,Hungary,Brazil,5,0,0,5
27599,2022,Cote d'Ivoire,Brazil,58,180,0,238
27600,2022,India,Brazil,16,892,0,908
27601,2022,Indonesia,Brazil,0,7,0,7
27602,2022,Iran (Islamic Rep. of),Brazil,68,198,0,266
27603,2022,Iraq,Brazil,362,359,0,721
27604,2022,Israel,Brazil,0,33,0,33
27605,2022,Italy,Brazil,0,36,0,36
27606,2022,Jamaica,Brazil,0,13,0,13
27607,2022,Jordan,Brazil,13,100,0,113
27608,2022,Japan,Brazil,0,5,0,5
27609,2022,Kazakhstan,Brazil,0,16,0,16
27610,2022,Kenya,Brazil,10,75,0,85
27611,2022,Rep. of Korea,Brazil,0,261,0,261
27612,2022,Kuwait,Brazil,0,7,0,7
27613,2022,Liberia,Brazil,259,31,0,290
27614,2022,Libya,Brazil,7,67,0,74
27615,2022,Lebanon,Brazil,413,1947,0,2360
27616,2022,Lesotho,Brazil,0,5,0,5
27617,2022,Sri Lanka,Brazil,19,121,0,140
27618,2022,Lithuania,Brazil,0,7,0,7
27619,2022,"China, Macao SAR",Brazil,0,28,0,28
27620,2022,Mauritania,Brazil,61,229,0,290
27621,2022,North Macedonia,Brazil,6,0,0,6
27622,2022,Mexico,Brazil,8,48,0,56
27623,2022,Mali,Brazil,147,394,0,541
27624,2022,Malaysia,Brazil,0,5,0,5
27625,2022,Mongolia,Brazil,0,7,0,7
27626,2022,Morocco,Brazil,38,796,0,834
27627,2022,Mozambique,Brazil,5,92,0,97
27628,2022,Malta,Brazil,0,5,0,5
27629,2022,Myanmar,Brazil,0,5,0,5
27630,2022,Namibia,Brazil,0,39,0,39
27631,2022,Nepal,Brazil,12,415,0,427
27632,2022,Netherlands,Brazil,0,8,0,8
27633,2022,Niger,Brazil,0,7,0,7
27634,2022,Nicaragua,Brazil,24,18,0,42
27635,2022,Nigeria,Brazil,164,3276,0,3440
27636,2022,Norway,Brazil,0,5,0,5
27637,2022,New Zealand,Brazil,0,5,0,5
27638,2022,Pakistan,Brazil,392,1518,0,1910
27639,2022,Panama,Brazil,0,9,0,9
27640,2022,Paraguay,Brazil,5,165,0,170
27641,2022,Peru,Brazil,53,312,0,365
27642,2022,Philippines,Brazil,12,525,0,537
27643,2022,Poland,Brazil,0,16,0,16
27644,2022,Portugal,Brazil,0,115,0,115
27645,2022,Romania,Brazil,0,17,0,17
27646,2022,South Africa,Brazil,6,426,0,432
27647,2022,Russian Federation,Brazil,23,103,0,126
27648,2022,Rwanda,Brazil,18,7,0,25
27649,2022,El Salvador,Brazil,59,9,0,68
27650,2022,Saudi Arabia,Brazil,0,22,0,22
27651,2022,Serbia and Kosovo: S/RES/1244 (1999),Brazil,92,9,0,101
27652,2022,Senegal,Brazil,15,6256,0,6271
27653,2022,Sierra Leone,Brazil,167,319,0,486
27654,2022,Somalia,Brazil,53,524,0,577
27655,2022,Spain,Brazil,0,57,0,57
27656,2022,Viet Nam,Brazil,5,5,0,10
27657,2022,Sao Tome and Principe,Brazil,0,19,0,19
27658,2022,Sudan,Brazil,83,129,0,212
27659,2022,Suriname,Brazil,0,21,0,21
27660,2022,Slovenia,Brazil,0,5,0,5
27661,2022,Sweden,Brazil,0,5,0,5
27662,2022,Switzerland,Brazil,0,5,0,5
27663,2022,Syrian Arab Rep.,Brazil,3971,3832,0,7803
27664,2022,United Rep. of Tanzania,Brazil,9,110,0,119
27665,2022,Thailand,Brazil,0,46,0,46
27666,2022,Togo,Brazil,68,572,0,640
27667,2022,Trinidad and Tobago,Brazil,0,8,0,8
27668,2022,Tunisia,Brazil,8,166,0,174
27669,2022,Türkiye,Brazil,14,274,0,288
27670,2022,Uganda,Brazil,8,33,0,41
27671,2022,Ukraine,Brazil,34,70,0,104
27672,2022,Uruguay,Brazil,0,29,0,29
27673,2022,United States of America,Brazil,0,59,0,59
27674,2022,Vanuatu,Brazil,0,71,0,71
27675,2022,Holy See,Brazil,0,13,0,13
27676,2022,Venezuela (Bolivarian Republic of),Brazil,49964,94524,0,144488
27677,2022,Yemen,Brazil,19,135,0,154
27678,2022,Zambia,Brazil,0,5,0,5
27679,2022,Zimbabwe,Brazil,5,12,0,17
27680,2022,Stateless,Brazil,0,0,0,0
27681,2022,Unknown ,Brazil,0,35,0,35
27682,2022,Stateless,Brunei Darussalam,0,0,0,0
27683,2022,Afghanistan,Bosnia and Herzegovina,5,5,0,10
27684,2022,Algeria,Bosnia and Herzegovina,0,0,0,0
27685,2022,Egypt,Bosnia and Herzegovina,0,0,0,0
27686,2022,Azerbaijan,Bosnia and Herzegovina,5,0,0,5
27687,2022,Burundi,Bosnia and Herzegovina,0,0,0,0
27688,2022,Bangladesh,Bosnia and Herzegovina,0,0,0,0
27689,2022,Bosnia and Herzegovina,Bosnia and Herzegovina,0,0,96305,0
27690,2022,Cameroon,Bosnia and Herzegovina,0,0,0,0
27691,2022,Congo,Bosnia and Herzegovina,0,0,0,0
27692,2022,Cuba,Bosnia and Herzegovina,0,19,0,19
27693,2022,Eritrea,Bosnia and Herzegovina,0,0,0,0
27694,2022,Gambia,Bosnia and Herzegovina,0,0,0,0
27695,2022,Palestinian,Bosnia and Herzegovina,0,0,0,0
27696,2022,Ghana,Bosnia and Herzegovina,0,0,0,0
27697,2022,Guinea,Bosnia and Herzegovina,0,0,0,0
27698,2022,Cote d'Ivoire,Bosnia and Herzegovina,0,0,0,0
27699,2022,India,Bosnia and Herzegovina,0,0,0,0
27700,2022,Iran (Islamic Rep. of),Bosnia and Herzegovina,5,14,0,19
27701,2022,Iraq,Bosnia and Herzegovina,0,0,0,0
27702,2022,Libya,Bosnia and Herzegovina,0,0,0,0
27703,2022,Mali,Bosnia and Herzegovina,0,0,0,0
27704,2022,Morocco,Bosnia and Herzegovina,0,5,0,5
27705,2022,Nepal,Bosnia and Herzegovina,0,0,0,0
27706,2022,Pakistan,Bosnia and Herzegovina,5,9,0,14
27707,2022,Russian Federation,Bosnia and Herzegovina,0,12,0,12
27708,2022,Serbia and Kosovo: S/RES/1244 (1999),Bosnia and Herzegovina,36,5,0,41
27709,2022,Senegal,Bosnia and Herzegovina,0,0,0,0
27710,2022,Somalia,Bosnia and Herzegovina,0,0,0,0
27711,2022,Syrian Arab Rep.,Bosnia and Herzegovina,25,5,0,30
27712,2022,Togo,Bosnia and Herzegovina,0,0,0,0
27713,2022,Türkiye,Bosnia and Herzegovina,34,35,0,69
27714,2022,Ukraine,Bosnia and Herzegovina,234,25,0,259
27715,2022,Stateless,Bosnia and Herzegovina,0,0,0,0
27716,2022,Unknown ,Bosnia and Herzegovina,0,0,0,0
27717,2022,Afghanistan,Bulgaria,313,6244,0,6557
27718,2022,Albania,Bulgaria,0,6,0,6
27719,2022,Algeria,Bulgaria,5,82,0,87
27720,2022,Egypt,Bulgaria,19,34,0,53
27721,2022,Armenia,Bulgaria,61,5,0,66
27722,2022,Azerbaijan,Bulgaria,11,0,0,11
27723,2022,Bangladesh,Bulgaria,8,16,0,24
27724,2022,Belarus,Bulgaria,28,0,0,28
27725,2022,Canada,Bulgaria,5,0,0,5
27726,2022,Congo,Bulgaria,9,0,0,9
27727,2022,Dem. Rep. of the Congo,Bulgaria,0,5,0,5
27728,2022,Dominican Rep.,Bulgaria,0,6,0,6
27729,2022,Eritrea,Bulgaria,13,7,0,20
27730,2022,Ethiopia,Bulgaria,10,0,0,10
27731,2022,United Kingdom of Great Britain and Northern Ireland,Bulgaria,5,0,0,5
27732,2022,Georgia,Bulgaria,27,5,0,32
27733,2022,Guinea,Bulgaria,5,0,0,5
27734,2022,Cote d'Ivoire,Bulgaria,5,5,0,10
27735,2022,India,Bulgaria,5,0,0,5
27736,2022,Iran (Islamic Rep. of),Bulgaria,80,52,0,132
27737,2022,Iraq,Bulgaria,1102,108,0,1210
27738,2022,Israel,Bulgaria,20,0,0,20
27739,2022,Jordan,Bulgaria,8,0,0,8
27740,2022,Kazakhstan,Bulgaria,6,0,0,6
27741,2022,Libya,Bulgaria,0,5,0,5
27742,2022,Lebanon,Bulgaria,22,5,0,27
27743,2022,Mauritania,Bulgaria,0,6,0,6
27744,2022,Rep. of Moldova,Bulgaria,45,0,0,45
27745,2022,Mali,Bulgaria,5,0,0,5
27746,2022,Morocco,Bulgaria,5,544,0,549
27747,2022,Nigeria,Bulgaria,0,5,0,5
27748,2022,Pakistan,Bulgaria,34,52,0,86
27749,2022,Russian Federation,Bulgaria,214,49,0,263
27750,2022,Senegal,Bulgaria,0,5,0,5
27751,2022,Somalia,Bulgaria,43,19,0,62
27752,2022,Sudan,Bulgaria,12,0,0,12
27753,2022,Syrian Arab Rep.,Bulgaria,22226,2451,0,24677
27754,2022,Turkmenistan,Bulgaria,34,0,0,34
27755,2022,Tunisia,Bulgaria,5,17,0,22
27756,2022,Türkiye,Bulgaria,12,26,0,38
27757,2022,Ukraine,Bulgaria,119450,325,0,119775
27758,2022,United States of America,Bulgaria,14,0,0,14
27759,2022,Uzbekistan,Bulgaria,5,0,0,5
27760,2022,Yemen,Bulgaria,29,5,0,34
27761,2022,Stateless,Bulgaria,1021,43,0,1064
27762,2022,Cuba,Belize,0,5,0,5
27763,2022,Guatemala,Belize,0,411,0,411
27764,2022,Honduras,Belize,14,441,0,455
27765,2022,Nicaragua,Belize,5,5,0,10
27766,2022,Peru,Belize,0,5,0,5
27767,2022,El Salvador,Belize,70,1204,0,1274
27768,2022,Unknown ,Belize,0,0,0,0
27769,2022,Myanmar,Cambodia,8,7,0,15
27770,2022,Pakistan,Cambodia,0,5,0,5
27771,2022,Viet Nam,Cambodia,16,0,0,16
27772,2022,Stateless,Cambodia,0,0,0,0
27773,2022,Afghanistan,Canada,735,550,0,1285
27774,2022,Albania,Canada,202,224,0,426
27775,2022,Algeria,Canada,664,572,0,1236
27776,2022,Angola,Canada,467,971,0,1438
27777,2022,Antigua and Barbuda,Canada,36,28,0,64
27778,2022,Egypt,Canada,816,425,0,1241
27779,2022,Argentina,Canada,15,64,0,79
27780,2022,Armenia,Canada,6,18,0,24
27781,2022,Australia,Canada,0,12,0,12
27782,2022,Azerbaijan,Canada,135,33,0,168
27783,2022,Bahrain,Canada,11,11,0,22
27784,2022,Barbados,Canada,177,148,0,325
27785,2022,Burundi,Canada,888,228,0,1116
27786,2022,Belgium,Canada,5,17,0,22
27787,2022,Benin,Canada,28,68,0,96
27788,2022,Bangladesh,Canada,951,1040,0,1991
27789,2022,Bahamas,Canada,445,608,0,1053
27790,2022,Bhutan,Canada,5,0,0,5
27791,2022,Burkina Faso,Canada,80,99,0,179
27792,2022,Belarus,Canada,20,13,0,33
27793,2022,Bolivia (Plurinational State of),Canada,28,25,0,53
27794,2022,Botswana,Canada,9,7,0,16
27795,2022,Brazil,Canada,140,609,0,749
27796,2022,Bosnia and Herzegovina,Canada,5,5,0,10
27797,2022,Bulgaria,Canada,75,22,0,97
27798,2022,Cambodia,Canada,27,0,0,27
27799,2022,Central African Rep.,Canada,32,21,0,53
27800,2022,Chad,Canada,448,223,0,671
27801,2022,China,Canada,1984,1722,0,3706
27802,2022,Chile,Canada,119,859,0,978
27803,2022,Cameroon,Canada,579,430,0,1009
27804,2022,Congo,Canada,133,171,0,304
27805,2022,Dem. Rep. of the Congo,Canada,1075,1683,0,2758
27806,2022,Comoros,Canada,5,0,0,5
27807,2022,Colombia,Canada,3375,4477,0,7852
27808,2022,Costa Rica,Canada,11,51,0,62
27809,2022,Cuba,Canada,239,320,0,559
27810,2022,Cabo Verde,Canada,0,5,0,5
27811,2022,Cyprus,Canada,0,6,0,6
27812,2022,Czechia,Canada,186,75,0,261
27813,2022,Denmark,Canada,0,5,0,5
27814,2022,Djibouti,Canada,195,52,0,247
27815,2022,Dominica,Canada,5,5,0,10
27816,2022,Dominican Rep.,Canada,99,172,0,271
27817,2022,Ecuador,Canada,58,122,0,180
27818,2022,Equatorial Guinea,Canada,5,0,0,5
27819,2022,Eritrea,Canada,473,297,0,770
27820,2022,Ethiopia,Canada,966,485,0,1451
27821,2022,Fiji,Canada,0,6,0,6
27822,2022,France,Canada,0,100,0,100
27823,2022,Gabon,Canada,26,37,0,63
27824,2022,Gambia,Canada,48,88,0,136
27825,2022,Palestinian,Canada,671,264,0,935
27826,2022,United Kingdom of Great Britain and Northern Ireland,Canada,5,47,0,52
27827,2022,Georgia,Canada,187,182,0,369
27828,2022,Germany,Canada,0,20,0,20
27829,2022,Ghana,Canada,190,347,0,537
27830,2022,Guinea-Bissau,Canada,0,5,0,5
27831,2022,Greece,Canada,5,22,0,27
27832,2022,Grenada,Canada,11,8,0,19
27833,2022,Guatemala,Canada,206,261,0,467
27834,2022,Guinea,Canada,252,284,0,536
27835,2022,Guyana,Canada,33,55,0,88
27836,2022,Haiti,Canada,2487,4648,0,7135
27837,2022,"China, Hong Kong SAR",Canada,63,22,0,85
27838,2022,Honduras,Canada,348,342,0,690
27839,2022,Croatia,Canada,42,5,0,47
27840,2022,Hungary,Canada,1585,319,0,1904
27841,2022,Iceland,Canada,0,9,0,9
27842,2022,Cote d'Ivoire,Canada,159,175,0,334
27843,2022,India,Canada,3138,8652,0,11790
27844,2022,Indonesia,Canada,35,50,0,85
27845,2022,Ireland,Canada,0,31,0,31
27846,2022,Iran (Islamic Rep. of),Canada,5254,2441,0,7695
27847,2022,Iraq,Canada,511,241,0,752
27848,2022,Israel,Canada,33,59,0,92
27849,2022,Italy,Canada,17,93,0,110
27850,2022,Jamaica,Canada,252,530,0,782
27851,2022,Jordan,Canada,534,544,0,1078
27852,2022,Japan,Canada,5,5,0,10
27853,2022,Kazakhstan,Canada,66,29,0,95
27854,2022,Kenya,Canada,459,298,0,757
27855,2022,Kyrgyzstan,Canada,12,5,0,17
27856,2022,Rep. of Korea,Canada,21,16,0,37
27857,2022,Dem. People's Rep. of Korea,Canada,33,10,0,43
27858,2022,Kuwait,Canada,40,19,0,59
27859,2022,Liberia,Canada,94,88,0,182
27860,2022,Libya,Canada,368,137,0,505
27861,2022,Saint Lucia,Canada,51,20,0,71
27862,2022,Lebanon,Canada,486,715,0,1201
27863,2022,Lesotho,Canada,0,5,0,5
27864,2022,Sri Lanka,Canada,1371,780,0,2151
27865,2022,Lithuania,Canada,0,7,0,7
27866,2022,Latvia,Canada,10,5,0,15
27867,2022,Madagascar,Canada,20,13,0,33
27868,2022,Mauritania,Canada,150,98,0,248
27869,2022,North Macedonia,Canada,9,5,0,14
27870,2022,Rep. of Moldova,Canada,7,6,0,13
27871,2022,Mexico,Canada,3065,8079,0,11144
27872,2022,Mali,Canada,100,129,0,229
27873,2022,Malaysia,Canada,15,23,0,38
27874,2022,Malawi,Canada,48,30,0,78
27875,2022,Mongolia,Canada,43,38,0,81
27876,2022,Morocco,Canada,82,179,0,261
27877,2022,Mozambique,Canada,7,0,0,7
27878,2022,Malta,Canada,0,5,0,5
27879,2022,Mauritius,Canada,5,22,0,27
27880,2022,Myanmar,Canada,22,36,0,58
27881,2022,Namibia,Canada,26,17,0,43
27882,2022,Nepal,Canada,237,102,0,339
27883,2022,Netherlands,Canada,0,17,0,17
27884,2022,Niger,Canada,23,50,0,73
27885,2022,Nicaragua,Canada,464,308,0,772
27886,2022,Nigeria,Canada,3857,3402,0,7259
27887,2022,Norway,Canada,0,6,0,6
27888,2022,Oman,Canada,0,5,0,5
27889,2022,Pakistan,Canada,2506,1798,0,4304
27890,2022,Panama,Canada,5,21,0,26
27891,2022,Paraguay,Canada,7,0,0,7
27892,2022,Peru,Canada,144,357,0,501
27893,2022,Philippines,Canada,58,199,0,257
27894,2022,Poland,Canada,121,84,0,205
27895,2022,Portugal,Canada,7,77,0,84
27896,2022,Qatar,Canada,0,10,0,10
27897,2022,Romania,Canada,489,441,0,930
27898,2022,South Africa,Canada,120,103,0,223
27899,2022,Russian Federation,Canada,166,138,0,304
27900,2022,Rwanda,Canada,668,458,0,1126
27901,2022,El Salvador,Canada,590,410,0,1000
27902,2022,Saudi Arabia,Canada,222,107,0,329
27903,2022,Serbia and Kosovo: S/RES/1244 (1999),Canada,38,45,0,83
27904,2022,Senegal,Canada,158,195,0,353
27905,2022,Singapore,Canada,0,8,0,8
27906,2022,Sierra Leone,Canada,33,74,0,107
27907,2022,Somalia,Canada,660,391,0,1051
27908,2022,Spain,Canada,5,28,0,33
27909,2022,Viet Nam,Canada,75,220,0,295
27910,2022,Saint Kitts and Nevis,Canada,9,5,0,14
27911,2022,Sudan,Canada,624,275,0,899
27912,2022,Suriname,Canada,5,5,0,10
27913,2022,South Sudan,Canada,14,19,0,33
27914,2022,Slovakia,Canada,374,130,0,504
27915,2022,Slovenia,Canada,0,5,0,5
27916,2022,Eswatini,Canada,11,0,0,11
27917,2022,Sweden,Canada,0,13,0,13
27918,2022,Syrian Arab Rep.,Canada,411,246,0,657
27919,2022,United Rep. of Tanzania,Canada,146,113,0,259
27920,2022,Thailand,Canada,9,11,0,20
27921,2022,Tajikistan,Canada,28,5,0,33
27922,2022,Turkmenistan,Canada,11,0,0,11
27923,2022,Togo,Canada,59,77,0,136
27924,2022,Trinidad and Tobago,Canada,42,45,0,87
27925,2022,Tunisia,Canada,80,153,0,233
27926,2022,Türkiye,Canada,1739,2671,0,4410
27927,2022,United Arab Emirates,Canada,21,31,0,52
27928,2022,Uganda,Canada,699,244,0,943
27929,2022,Ukraine,Canada,149,217,0,366
27930,2022,Uruguay,Canada,6,20,0,26
27931,2022,United States of America,Canada,176,961,0,1137
27932,2022,Uzbekistan,Canada,21,21,0,42
27933,2022,Saint Vincent and the Grenadines,Canada,51,38,0,89
27934,2022,Venezuela (Bolivarian Republic of),Canada,1458,808,0,2266
27935,2022,Yemen,Canada,357,236,0,593
27936,2022,Zambia,Canada,21,10,0,31
27937,2022,Zimbabwe,Canada,296,151,0,447
27938,2022,Stateless,Canada,457,76,0,533
27939,2022,Unknown ,Canada,5,6579,0,6584
27940,2022,Angola,Central African Rep.,12,0,0,12
27941,2022,Burundi,Central African Rep.,24,0,0,24
27942,2022,Central African Rep.,Central African Rep.,0,0,610265,0
27943,2022,Chad,Central African Rep.,1252,88,0,1340
27944,2022,Cameroon,Central African Rep.,44,29,0,73
27945,2022,Congo,Central African Rep.,15,9,0,24
27946,2022,Dem. Rep. of the Congo,Central African Rep.,6298,219,0,6517
27947,2022,Guinea,Central African Rep.,6,0,0,6
27948,2022,Cote d'Ivoire,Central African Rep.,7,0,0,7
27949,2022,Liberia,Central African Rep.,5,0,0,5
27950,2022,Rwanda,Central African Rep.,220,0,0,220
27951,2022,Sudan,Central African Rep.,447,22,0,469
27952,2022,South Sudan,Central African Rep.,2609,0,0,2609
27953,2022,Türkiye,Central African Rep.,8,0,0,8
27954,2022,Uganda,Central African Rep.,12,0,0,12
27955,2022,Cuba,Cayman Islands,59,166,0,225
27956,2022,Haiti,Cayman Islands,0,0,0,0
27957,2022,Venezuela (Bolivarian Republic of),Cayman Islands,0,0,0,0
27958,2022,Burundi,Chad,6,0,0,6
27959,2022,Central African Rep.,Chad,123359,2353,0,125712
27960,2022,Chad,Chad,0,0,381289,0
27961,2022,Cameroon,Chad,42518,21,0,42539
27962,2022,Congo,Chad,11,5,0,16
27963,2022,Dem. Rep. of the Congo,Chad,259,33,0,292
27964,2022,Eritrea,Chad,9,20,0,29
27965,2022,Ethiopia,Chad,20,17,0,37
27966,2022,Cote d'Ivoire,Chad,5,0,0,5
27967,2022,Iran (Islamic Rep. of),Chad,5,0,0,5
27968,2022,Libya,Chad,31,13,0,44
27969,2022,Mali,Chad,7,0,0,7
27970,2022,Niger,Chad,858,5,0,863
27971,2022,Nigeria,Chad,20021,340,0,20361
27972,2022,Rwanda,Chad,15,0,0,15
27973,2022,Senegal,Chad,5,0,0,5
27974,2022,Somalia,Chad,7,0,0,7
27975,2022,Sudan,Chad,393082,1927,0,395009
27976,2022,South Sudan,Chad,23,0,0,23
27977,2022,Syrian Arab Rep.,Chad,49,22,0,71
27978,2022,Yemen,Chad,5,10,0,15
27979,2022,Afghanistan,China,31,33,0,64
27980,2022,Central African Rep.,China,0,5,0,5
27981,2022,Cameroon,China,21,335,0,356
27982,2022,Congo,China,0,7,0,7
27983,2022,Dem. Rep. of the Congo,China,17,5,0,22
27984,2022,Eritrea,China,6,0,0,6
27985,2022,Ethiopia,China,0,8,0,8
27986,2022,Palestinian,China,11,5,0,16
27987,2022,Ghana,China,0,27,0,27
27988,2022,Guinea,China,0,5,0,5
27989,2022,Cote d'Ivoire,China,0,25,0,25
27990,2022,Iran (Islamic Rep. of),China,5,0,0,5
27991,2022,Iraq,China,14,0,0,14
27992,2022,Kenya,China,0,12,0,12
27993,2022,Liberia,China,0,7,0,7
27994,2022,Lesotho,China,0,5,0,5
27995,2022,Nigeria,China,0,71,0,71
27996,2022,Pakistan,China,33,5,0,38
27997,2022,Russian Federation,China,0,8,0,8
27998,2022,Rwanda,China,5,5,0,10
27999,2022,Somalia,China,104,0,0,104
28000,2022,Syrian Arab Rep.,China,39,6,0,45
28001,2022,Uganda,China,5,114,0,119
28002,2022,Uzbekistan,China,0,5,0,5
28003,2022,Yemen,China,31,13,0,44
28004,2022,Zambia,China,0,5,0,5
28005,2022,Zimbabwe,China,9,84,0,93
28006,2022,Afghanistan,Chile,19,136,0,155
28007,2022,Angola,Chile,0,5,0,5
28008,2022,Bangladesh,Chile,0,7,0,7
28009,2022,Bolivia (Plurinational State of),Chile,0,21,0,21
28010,2022,Congo,Chile,8,5,0,13
28011,2022,Dem. Rep. of the Congo,Chile,5,0,0,5
28012,2022,Colombia,Chile,1235,2413,0,3648
28013,2022,Costa Rica,Chile,5,0,0,5
28014,2022,Cuba,Chile,19,940,0,959
28015,2022,Dominican Rep.,Chile,0,95,0,95
28016,2022,Ecuador,Chile,23,29,0,52
28017,2022,Palestinian,Chile,15,6,0,21
28018,2022,Ghana,Chile,0,8,0,8
28019,2022,Guatemala,Chile,0,5,0,5
28020,2022,Haiti,Chile,0,185,0,185
28021,2022,Honduras,Chile,5,0,0,5
28022,2022,Iraq,Chile,0,14,0,14
28023,2022,Kenya,Chile,5,0,0,5
28024,2022,Rep. of Korea,Chile,0,5,0,5
28025,2022,Sri Lanka,Chile,5,0,0,5
28026,2022,Nicaragua,Chile,0,5,0,5
28027,2022,Pakistan,Chile,0,7,0,7
28028,2022,Peru,Chile,113,51,0,164
28029,2022,Russian Federation,Chile,5,34,0,39
28030,2022,El Salvador,Chile,9,27,0,36
28031,2022,Senegal,Chile,5,0,0,5
28032,2022,Sierra Leone,Chile,5,0,0,5
28033,2022,Syrian Arab Rep.,Chile,113,31,0,144
28034,2022,Türkiye,Chile,27,5,0,32
28035,2022,Ukraine,Chile,0,75,0,75
28036,2022,United States of America,Chile,0,5,0,5
28037,2022,Venezuela (Bolivarian Republic of),Chile,29,6526,0,6555
28038,2022,Unknown ,Chile,436,117,0,553
28039,2022,Angola,Cameroon,5,0,0,5
28040,2022,Burundi,Cameroon,50,20,0,70
28041,2022,Burkina Faso,Cameroon,0,24,0,24
28042,2022,Central African Rep.,Cameroon,338476,6041,0,344517
28043,2022,Chad,Cameroon,1467,494,0,1961
28044,2022,Cameroon,Cameroon,0,0,933138,0
28045,2022,Congo,Cameroon,40,13,0,53
28046,2022,Dem. Rep. of the Congo,Cameroon,455,155,0,610
28047,2022,Equatorial Guinea,Cameroon,0,5,0,5
28048,2022,Ethiopia,Cameroon,0,5,0,5
28049,2022,Gabon,Cameroon,0,5,0,5
28050,2022,Gambia,Cameroon,0,5,0,5
28051,2022,Guinea,Cameroon,7,207,0,214
28052,2022,Cote d'Ivoire,Cameroon,53,39,0,92
28053,2022,Iran (Islamic Rep. of),Cameroon,5,0,0,5
28054,2022,Iraq,Cameroon,0,6,0,6
28055,2022,Liberia,Cameroon,9,5,0,14
28056,2022,Mauritania,Cameroon,5,5,0,10
28057,2022,Mali,Cameroon,19,356,0,375
28058,2022,Morocco,Cameroon,7,0,0,7
28059,2022,Niger,Cameroon,0,921,0,921
28060,2022,Nigeria,Cameroon,134437,35,0,134472
28061,2022,Rwanda,Cameroon,260,156,0,416
28062,2022,Senegal,Cameroon,0,6,0,6
28063,2022,Sierra Leone,Cameroon,0,5,0,5
28064,2022,Sudan,Cameroon,64,36,0,100
28065,2022,South Sudan,Cameroon,5,8,0,13
28066,2022,Syrian Arab Rep.,Cameroon,5,10,0,15
28067,2022,Togo,Cameroon,18,15,0,33
28068,2022,Türkiye,Cameroon,0,5,0,5
28069,2022,Yemen,Cameroon,5,0,0,5
28070,2022,Angola,Congo,13,45,0,58
28071,2022,Egypt,Congo,0,0,0,0
28072,2022,Burundi,Congo,78,8,0,86
28073,2022,Central African Rep.,Congo,26173,3012,0,29185
28074,2022,Chad,Congo,27,27,0,54
28075,2022,Cameroon,Congo,5,27,0,32
28076,2022,Congo,Congo,0,0,134430,0
28077,2022,Dem. Rep. of the Congo,Congo,12125,10008,0,22133
28078,2022,Guinea,Congo,0,5,0,5
28079,2022,Cote d'Ivoire,Congo,5,5,0,10
28080,2022,Mauritania,Congo,5,45,0,50
28081,2022,Mali,Congo,5,0,0,5
28082,2022,Nigeria,Congo,5,0,0,5
28083,2022,Rwanda,Congo,2562,477,0,3039
28084,2022,Sudan,Congo,31,41,0,72
28085,2022,Syrian Arab Rep.,Congo,5,12,0,17
28086,2022,Angola,Dem. Rep. of the Congo,417,25,0,442
28087,2022,Burundi,Dem. Rep. of the Congo,41187,1434,0,42621
28088,2022,Central African Rep.,Dem. Rep. of the Congo,207054,64,0,207118
28089,2022,Chad,Dem. Rep. of the Congo,5,15,0,20
28090,2022,Cameroon,Dem. Rep. of the Congo,0,19,0,19
28091,2022,Congo,Dem. Rep. of the Congo,644,25,0,669
28092,2022,Dem. Rep. of the Congo,Dem. Rep. of the Congo,0,0,5338418,0
28093,2022,Eritrea,Dem. Rep. of the Congo,8,0,0,8
28094,2022,Ethiopia,Dem. Rep. of the Congo,0,5,0,5
28095,2022,Palestinian,Dem. Rep. of the Congo,0,6,0,6
28096,2022,Cote d'Ivoire,Dem. Rep. of the Congo,12,6,0,18
28097,2022,Liberia,Dem. Rep. of the Congo,5,10,0,15
28098,2022,Lebanon,Dem. Rep. of the Congo,0,5,0,5
28099,2022,Mali,Dem. Rep. of the Congo,0,11,0,11
28100,2022,Niger,Dem. Rep. of the Congo,0,5,0,5
28101,2022,Romania,Dem. Rep. of the Congo,0,5,0,5
28102,2022,Rwanda,Dem. Rep. of the Congo,210067,110,0,210177
28103,2022,Somalia,Dem. Rep. of the Congo,14,163,0,177
28104,2022,Sudan,Dem. Rep. of the Congo,47,7,0,54
28105,2022,South Sudan,Dem. Rep. of the Congo,56303,761,0,57064
28106,2022,Syrian Arab Rep.,Dem. Rep. of the Congo,12,14,0,26
28107,2022,Uganda,Dem. Rep. of the Congo,25,5,0,30
28108,2022,Zimbabwe,Dem. Rep. of the Congo,0,6,0,6
28109,2022,Dem. Rep. of the Congo,Comoros,19,0,0,19
28110,2022,Afghanistan,Colombia,9,5,0,14
28111,2022,Bolivia (Plurinational State of),Colombia,5,0,0,5
28112,2022,Colombia,Colombia,0,0,6746833,0
28113,2022,Cuba,Colombia,88,92,0,180
28114,2022,Ecuador,Colombia,5,11,0,16
28115,2022,Eritrea,Colombia,5,0,0,5
28116,2022,Ethiopia,Colombia,7,0,0,7
28117,2022,Ghana,Colombia,5,0,0,5
28118,2022,Haiti,Colombia,0,8,0,8
28119,2022,Honduras,Colombia,5,0,0,5
28120,2022,Hungary,Colombia,5,0,0,5
28121,2022,Iraq,Colombia,8,0,0,8
28122,2022,Liberia,Colombia,5,0,0,5
28123,2022,Nicaragua,Colombia,10,0,0,10
28124,2022,Russian Federation,Colombia,0,12,0,12
28125,2022,El Salvador,Colombia,7,5,0,12
28126,2022,Serbia and Kosovo: S/RES/1244 (1999),Colombia,5,0,0,5
28127,2022,Sierra Leone,Colombia,5,0,0,5
28128,2022,Somalia,Colombia,11,0,0,11
28129,2022,Syrian Arab Rep.,Colombia,11,7,0,18
28130,2022,Türkiye,Colombia,6,9,0,15
28131,2022,Ukraine,Colombia,0,10,0,10
28132,2022,Venezuela (Bolivarian Republic of),Colombia,1315,26755,0,28070
28133,2022,Yemen,Colombia,0,5,0,5
28134,2022,Stateless,Colombia,0,0,0,0
28135,2022,Unknown ,Colombia,5,0,0,5
28136,2022,Angola,Costa Rica,0,63,0,63
28137,2022,Argentina,Costa Rica,0,50,0,50
28138,2022,Australia,Costa Rica,0,5,0,5
28139,2022,Burundi,Costa Rica,9,0,0,9
28140,2022,Bangladesh,Costa Rica,0,16,0,16
28141,2022,Burkina Faso,Costa Rica,0,5,0,5
28142,2022,Belarus,Costa Rica,0,5,0,5
28143,2022,Bolivia (Plurinational State of),Costa Rica,0,18,0,18
28144,2022,Brazil,Costa Rica,0,163,0,163
28145,2022,Belize,Costa Rica,0,5,0,5
28146,2022,China,Costa Rica,0,340,0,340
28147,2022,Chile,Costa Rica,0,61,0,61
28148,2022,Cameroon,Costa Rica,0,22,0,22
28149,2022,Congo,Costa Rica,0,57,0,57
28150,2022,Dem. Rep. of the Congo,Costa Rica,12,66,0,78
28151,2022,Colombia,Costa Rica,2315,2125,0,4440
28152,2022,Cuba,Costa Rica,481,3209,0,3690
28153,2022,Czechia,Costa Rica,0,5,0,5
28154,2022,Dominican Rep.,Costa Rica,0,146,0,146
28155,2022,Ecuador,Costa Rica,0,78,0,78
28156,2022,Eritrea,Costa Rica,0,7,0,7
28157,2022,Ethiopia,Costa Rica,5,0,0,5
28158,2022,French Guiana,Costa Rica,0,5,0,5
28159,2022,Gambia,Costa Rica,0,5,0,5
28160,2022,Germany,Costa Rica,0,13,0,13
28161,2022,Ghana,Costa Rica,0,61,0,61
28162,2022,Greece,Costa Rica,0,5,0,5
28163,2022,Guatemala,Costa Rica,25,131,0,156
28164,2022,Guyana,Costa Rica,0,9,0,9
28165,2022,Haiti,Costa Rica,12,886,0,898
28166,2022,Honduras,Costa Rica,223,1091,0,1314
28167,2022,Cote d'Ivoire,Costa Rica,0,6,0,6
28168,2022,India,Costa Rica,0,5,0,5
28169,2022,Indonesia,Costa Rica,5,0,0,5
28170,2022,Iran (Islamic Rep. of),Costa Rica,5,0,0,5
28171,2022,Iraq,Costa Rica,5,0,0,5
28172,2022,Israel,Costa Rica,0,6,0,6
28173,2022,Italy,Costa Rica,0,13,0,13
28174,2022,Jamaica,Costa Rica,0,44,0,44
28175,2022,Lebanon,Costa Rica,0,5,0,5
28176,2022,Latvia,Costa Rica,0,5,0,5
28177,2022,Mexico,Costa Rica,13,75,0,88
28178,2022,Nepal,Costa Rica,0,102,0,102
28179,2022,Niger,Costa Rica,0,5,0,5
28180,2022,Nicaragua,Costa Rica,4571,187304,0,191875
28181,2022,Nigeria,Costa Rica,17,7,0,24
28182,2022,Pakistan,Costa Rica,5,11,0,16
28183,2022,Panama,Costa Rica,6,76,0,82
28184,2022,Paraguay,Costa Rica,0,5,0,5
28185,2022,Peru,Costa Rica,13,70,0,83
28186,2022,Poland,Costa Rica,0,5,0,5
28187,2022,Romania,Costa Rica,0,7,0,7
28188,2022,South Africa,Costa Rica,0,7,0,7
28189,2022,Russian Federation,Costa Rica,27,158,0,185
28190,2022,El Salvador,Costa Rica,1611,114,0,1725
28191,2022,Senegal,Costa Rica,0,5,0,5
28192,2022,Somalia,Costa Rica,7,7,0,14
28193,2022,Spain,Costa Rica,0,10,0,10
28194,2022,Viet Nam,Costa Rica,0,7,0,7
28195,2022,Suriname,Costa Rica,0,5,0,5
28196,2022,Syrian Arab Rep.,Costa Rica,5,29,0,34
28197,2022,Türkiye,Costa Rica,0,6,0,6
28198,2022,Ukraine,Costa Rica,13,21,0,34
28199,2022,Uruguay,Costa Rica,0,6,0,6
28200,2022,United States of America,Costa Rica,5,43,0,48
28201,2022,Venezuela (Bolivarian Republic of),Costa Rica,1797,7893,0,9690
28202,2022,Zimbabwe,Costa Rica,0,5,0,5
28203,2022,Stateless,Costa Rica,0,0,0,0
28204,2022,Unknown ,Costa Rica,0,11,0,11
28205,2022,Afghanistan,Cuba,14,0,0,14
28206,2022,Cuba,Cuba,0,0,0,0
28207,2022,Eritrea,Cuba,5,0,0,5
28208,2022,Ethiopia,Cuba,5,0,0,5
28209,2022,Haiti,Cuba,5,0,0,5
28210,2022,Iran (Islamic Rep. of),Cuba,7,5,0,12
28211,2022,Sudan,Cuba,11,0,0,11
28212,2022,Syrian Arab Rep.,Cuba,23,8,0,31
28213,2022,Yemen,Cuba,11,0,0,11
28214,2022,Stateless,Cabo Verde,0,0,0,0
28215,2022,Afghanistan,Cyprus,20,804,0,824
28216,2022,Albania,Cyprus,0,5,0,5
28217,2022,Algeria,Cyprus,8,5,0,13
28218,2022,Angola,Cyprus,0,26,0,26
28219,2022,Egypt,Cyprus,125,394,0,519
28220,2022,Armenia,Cyprus,26,17,0,43
28221,2022,Azerbaijan,Cyprus,0,6,0,6
28222,2022,Burundi,Cyprus,0,28,0,28
28223,2022,Bangladesh,Cyprus,11,1977,0,1988
28224,2022,Burkina Faso,Cyprus,0,10,0,10
28225,2022,Belarus,Cyprus,0,6,0,6
28226,2022,Bosnia and Herzegovina,Cyprus,15,0,0,15
28227,2022,Central African Rep.,Cyprus,0,5,0,5
28228,2022,China,Cyprus,5,12,0,17
28229,2022,Cameroon,Cyprus,160,3288,0,3448
28230,2022,Congo,Cyprus,11,184,0,195
28231,2022,Dem. Rep. of the Congo,Cyprus,45,4194,0,4239
28232,2022,Comoros,Cyprus,0,10,0,10
28233,2022,Colombia,Cyprus,0,5,0,5
28234,2022,Djibouti,Cyprus,0,10,0,10
28235,2022,Eritrea,Cyprus,54,5,0,59
28236,2022,Ethiopia,Cyprus,10,21,0,31
28237,2022,Gabon,Cyprus,0,5,0,5
28238,2022,Gambia,Cyprus,6,65,0,71
28239,2022,Palestinian,Cyprus,2218,130,0,2348
28240,2022,Georgia,Cyprus,85,506,0,591
28241,2022,Ghana,Cyprus,0,47,0,47
28242,2022,Guinea-Bissau,Cyprus,0,5,0,5
28243,2022,Guinea,Cyprus,8,524,0,532
28244,2022,Haiti,Cyprus,0,10,0,10
28245,2022,Cote d'Ivoire,Cyprus,5,104,0,109
28246,2022,India,Cyprus,10,1716,0,1726
28247,2022,Iran (Islamic Rep. of),Cyprus,645,595,0,1240
28248,2022,Iraq,Cyprus,1006,104,0,1110
28249,2022,Israel,Cyprus,0,7,0,7
28250,2022,Jordan,Cyprus,55,74,0,129
28251,2022,Kazakhstan,Cyprus,5,0,0,5
28252,2022,Kenya,Cyprus,0,6,0,6
28253,2022,Kyrgyzstan,Cyprus,5,0,0,5
28254,2022,Liberia,Cyprus,0,327,0,327
28255,2022,Libya,Cyprus,12,5,0,17
28256,2022,Lebanon,Cyprus,61,92,0,153
28257,2022,Sri Lanka,Cyprus,29,387,0,416
28258,2022,Rep. of Moldova,Cyprus,18,19,0,37
28259,2022,Mali,Cyprus,0,6,0,6
28260,2022,Mongolia,Cyprus,0,46,0,46
28261,2022,Morocco,Cyprus,0,7,0,7
28262,2022,Nepal,Cyprus,0,1005,0,1005
28263,2022,Niger,Cyprus,0,6,0,6
28264,2022,Nigeria,Cyprus,28,3815,0,3843
28265,2022,Pakistan,Cyprus,27,1939,0,1966
28266,2022,Philippines,Cyprus,12,188,0,200
28267,2022,South Africa,Cyprus,0,5,0,5
28268,2022,Russian Federation,Cyprus,78,115,0,193
28269,2022,Rwanda,Cyprus,5,16,0,21
28270,2022,Serbia and Kosovo: S/RES/1244 (1999),Cyprus,59,9,0,68
28271,2022,Senegal,Cyprus,0,44,0,44
28272,2022,Sierra Leone,Cyprus,28,734,0,762
28273,2022,Somalia,Cyprus,408,1369,0,1777
28274,2022,Viet Nam,Cyprus,5,317,0,322
28275,2022,Sudan,Cyprus,14,10,0,24
28276,2022,Syrian Arab Rep.,Cyprus,10869,7229,0,18098
28277,2022,Tajikistan,Cyprus,0,5,0,5
28278,2022,Turkmenistan,Cyprus,0,6,0,6
28279,2022,Togo,Cyprus,0,23,0,23
28280,2022,Türkiye,Cyprus,253,329,0,582
28281,2022,Uganda,Cyprus,0,5,0,5
28282,2022,Ukraine,Cyprus,13707,94,0,13801
28283,2022,Uzbekistan,Cyprus,5,6,0,11
28284,2022,Yemen,Cyprus,47,32,0,79
28285,2022,Zimbabwe,Cyprus,0,26,0,26
28286,2022,Stateless,Cyprus,74,0,0,74
28287,2022,Unknown ,Cyprus,0,265,0,265
28288,2022,Afghanistan,Czechia,173,18,0,191
28289,2022,Algeria,Czechia,0,6,0,6
28290,2022,Egypt,Czechia,8,8,0,16
28291,2022,Armenia,Czechia,19,6,0,25
28292,2022,Azerbaijan,Czechia,35,16,0,51
28293,2022,Burundi,Czechia,5,0,0,5
28294,2022,Belarus,Czechia,180,43,0,223
28295,2022,China,Czechia,65,5,0,70
28296,2022,Cameroon,Czechia,0,5,0,5
28297,2022,Dem. Rep. of the Congo,Czechia,7,0,0,7
28298,2022,Colombia,Czechia,0,5,0,5
28299,2022,Cuba,Czechia,41,0,0,41
28300,2022,Eritrea,Czechia,11,0,0,11
28301,2022,Ethiopia,Czechia,5,0,0,5
28302,2022,Georgia,Czechia,11,18,0,29
28303,2022,India,Czechia,0,13,0,13
28304,2022,Iran (Islamic Rep. of),Czechia,10,5,0,15
28305,2022,Iraq,Czechia,95,6,0,101
28306,2022,Kazakhstan,Czechia,110,17,0,127
28307,2022,Kyrgyzstan,Czechia,20,0,0,20
28308,2022,Libya,Czechia,21,6,0,27
28309,2022,Lebanon,Czechia,5,5,0,10
28310,2022,Sri Lanka,Czechia,7,0,0,7
28311,2022,Rep. of Moldova,Czechia,17,24,0,41
28312,2022,Mongolia,Czechia,9,10,0,19
28313,2022,Myanmar,Czechia,154,9,0,163
28314,2022,Nepal,Czechia,0,5,0,5
28315,2022,Nigeria,Czechia,7,22,0,29
28316,2022,Pakistan,Czechia,7,10,0,17
28317,2022,Russian Federation,Czechia,178,83,0,261
28318,2022,Saudi Arabia,Czechia,5,0,0,5
28319,2022,Serbia and Kosovo: S/RES/1244 (1999),Czechia,5,0,0,5
28320,2022,Sierra Leone,Czechia,5,0,0,5
28321,2022,Somalia,Czechia,26,0,0,26
28322,2022,Viet Nam,Czechia,15,28,0,43
28323,2022,Sudan,Czechia,9,0,0,9
28324,2022,Syrian Arab Rep.,Czechia,422,11,0,433
28325,2022,Tajikistan,Czechia,5,0,0,5
28326,2022,Turkmenistan,Czechia,7,0,0,7
28327,2022,Togo,Czechia,5,0,0,5
28328,2022,Tunisia,Czechia,0,5,0,5
28329,2022,Türkiye,Czechia,14,40,0,54
28330,2022,Uganda,Czechia,5,0,0,5
28331,2022,Ukraine,Czechia,386371,278,0,386649
28332,2022,Uzbekistan,Czechia,40,33,0,73
28333,2022,Venezuela (Bolivarian Republic of),Czechia,12,15,0,27
28334,2022,Yemen,Czechia,29,0,0,29
28335,2022,Stateless,Czechia,99,5,0,104
28336,2022,Unknown ,Czechia,0,154,0,154
28337,2022,Afghanistan,Denmark,1620,561,0,2181
28338,2022,Algeria,Denmark,0,5,0,5
28339,2022,Egypt,Denmark,18,13,0,31
28340,2022,Armenia,Denmark,71,25,0,96
28341,2022,Azerbaijan,Denmark,30,9,0,39
28342,2022,Bahrain,Denmark,5,0,0,5
28343,2022,Burundi,Denmark,5,0,0,5
28344,2022,Bangladesh,Denmark,18,7,0,25
28345,2022,Belarus,Denmark,5,44,0,49
28346,2022,Bosnia and Herzegovina,Denmark,5,0,0,5
28347,2022,China,Denmark,18,16,0,34
28348,2022,Cameroon,Denmark,9,5,0,14
28349,2022,Dem. Rep. of the Congo,Denmark,63,12,0,75
28350,2022,Colombia,Denmark,5,19,0,24
28351,2022,Eritrea,Denmark,5885,142,0,6027
28352,2022,Ethiopia,Denmark,92,15,0,107
28353,2022,Gambia,Denmark,5,5,0,10
28354,2022,Georgia,Denmark,0,24,0,24
28355,2022,Ghana,Denmark,5,6,0,11
28356,2022,Guinea-Bissau,Denmark,5,0,0,5
28357,2022,Cote d'Ivoire,Denmark,10,0,0,10
28358,2022,India,Denmark,0,13,0,13
28359,2022,Iran (Islamic Rep. of),Denmark,2618,97,0,2715
28360,2022,Iraq,Denmark,269,61,0,330
28361,2022,Jordan,Denmark,0,9,0,9
28362,2022,Kenya,Denmark,6,0,0,6
28363,2022,Kyrgyzstan,Denmark,0,5,0,5
28364,2022,Libya,Denmark,0,5,0,5
28365,2022,Lebanon,Denmark,29,8,0,37
28366,2022,Sri Lanka,Denmark,34,0,0,34
28367,2022,North Macedonia,Denmark,0,5,0,5
28368,2022,Mongolia,Denmark,0,5,0,5
28369,2022,Morocco,Denmark,7,28,0,35
28370,2022,Myanmar,Denmark,13,10,0,23
28371,2022,Nicaragua,Denmark,13,0,0,13
28372,2022,Nigeria,Denmark,10,29,0,39
28373,2022,Pakistan,Denmark,60,18,0,78
28374,2022,Russian Federation,Denmark,565,63,0,628
28375,2022,Rwanda,Denmark,11,0,0,11
28376,2022,El Salvador,Denmark,5,0,0,5
28377,2022,Serbia and Kosovo: S/RES/1244 (1999),Denmark,5,5,0,10
28378,2022,Somalia,Denmark,1226,23,0,1249
28379,2022,Viet Nam,Denmark,0,23,0,23
28380,2022,Sudan,Denmark,48,10,0,58
28381,2022,Syrian Arab Rep.,Denmark,19424,203,0,19627
28382,2022,Thailand,Denmark,5,5,0,10
28383,2022,Tajikistan,Denmark,5,0,0,5
28384,2022,Tunisia,Denmark,5,10,0,15
28385,2022,Türkiye,Denmark,27,36,0,63
28386,2022,Uganda,Denmark,72,5,0,77
28387,2022,Ukraine,Denmark,27954,1191,0,29145
28388,2022,United States of America,Denmark,0,5,0,5
28389,2022,Uzbekistan,Denmark,6,40,0,46
28390,2022,Venezuela (Bolivarian Republic of),Denmark,5,5,0,10
28391,2022,Yemen,Denmark,7,0,0,7
28392,2022,Zambia,Denmark,5,0,0,5
28393,2022,Zimbabwe,Denmark,7,5,0,12
28394,2022,Stateless,Denmark,2898,93,0,2991
28395,2022,Unknown ,Denmark,0,5,0,5
28396,2022,Dem. Rep. of the Congo,Djibouti,0,13,0,13
28397,2022,Eritrea,Djibouti,673,350,0,1023
28398,2022,Ethiopia,Djibouti,2961,10667,0,13628
28399,2022,Iraq,Djibouti,16,0,0,16
28400,2022,Mali,Djibouti,5,5,0,10
28401,2022,Somalia,Djibouti,14152,138,0,14290
28402,2022,Sudan,Djibouti,9,5,0,14
28403,2022,Syrian Arab Rep.,Djibouti,15,5,0,20
28404,2022,Yemen,Djibouti,6518,0,0,6518
28405,2022,Afghanistan,Dominican Rep.,0,8,0,8
28406,2022,Colombia,Dominican Rep.,0,7,0,7
28407,2022,Cuba,Dominican Rep.,0,79,0,79
28408,2022,Haiti,Dominican Rep.,185,586,0,771
28409,2022,Honduras,Dominican Rep.,0,5,0,5
28410,2022,Sri Lanka,Dominican Rep.,0,5,0,5
28411,2022,Nicaragua,Dominican Rep.,0,11,0,11
28412,2022,Syrian Arab Rep.,Dominican Rep.,5,0,0,5
28413,2022,Venezuela (Bolivarian Republic of),Dominican Rep.,0,297,0,297
28414,2022,Unknown ,Dominican Rep.,0,19,0,19
28415,2022,Afghanistan,Ecuador,151,0,0,151
28416,2022,Albania,Ecuador,6,0,0,6
28417,2022,Angola,Ecuador,5,0,0,5
28418,2022,Egypt,Ecuador,5,8,0,13
28419,2022,Bangladesh,Ecuador,5,5,0,10
28420,2022,Brazil,Ecuador,5,5,0,10
28421,2022,China,Ecuador,12,0,0,12
28422,2022,Chile,Ecuador,7,5,0,12
28423,2022,Cameroon,Ecuador,19,5,0,24
28424,2022,Congo,Ecuador,10,5,0,15
28425,2022,Dem. Rep. of the Congo,Ecuador,8,5,0,13
28426,2022,Colombia,Ecuador,56295,4566,0,60861
28427,2022,Cuba,Ecuador,226,168,0,394
28428,2022,Dominican Rep.,Ecuador,5,5,0,10
28429,2022,Eritrea,Ecuador,11,5,0,16
28430,2022,Ethiopia,Ecuador,5,0,0,5
28431,2022,Palestinian,Ecuador,10,7,0,17
28432,2022,Ghana,Ecuador,5,0,0,5
28433,2022,Guinea,Ecuador,9,0,0,9
28434,2022,Haiti,Ecuador,26,10,0,36
28435,2022,Honduras,Ecuador,0,5,0,5
28436,2022,Cote d'Ivoire,Ecuador,5,0,0,5
28437,2022,India,Ecuador,5,6,0,11
28438,2022,Iran (Islamic Rep. of),Ecuador,69,7,0,76
28439,2022,Iraq,Ecuador,61,0,0,61
28440,2022,Liberia,Ecuador,6,0,0,6
28441,2022,Lebanon,Ecuador,16,12,0,28
28442,2022,Sri Lanka,Ecuador,18,5,0,23
28443,2022,Mali,Ecuador,5,0,0,5
28444,2022,Morocco,Ecuador,5,0,0,5
28445,2022,Nepal,Ecuador,5,0,0,5
28446,2022,Nicaragua,Ecuador,5,0,0,5
28447,2022,Nigeria,Ecuador,41,12,0,53
28448,2022,Pakistan,Ecuador,30,0,0,30
28449,2022,Panama,Ecuador,5,0,0,5
28450,2022,Peru,Ecuador,82,90,0,172
28451,2022,South Africa,Ecuador,0,5,0,5
28452,2022,Russian Federation,Ecuador,41,5,0,46
28453,2022,El Salvador,Ecuador,33,7,0,40
28454,2022,Saudi Arabia,Ecuador,8,0,0,8
28455,2022,Somalia,Ecuador,8,0,0,8
28456,2022,Spain,Ecuador,5,0,0,5
28457,2022,Viet Nam,Ecuador,5,0,0,5
28458,2022,Sudan,Ecuador,5,0,0,5
28459,2022,Syrian Arab Rep.,Ecuador,162,5,0,167
28460,2022,Togo,Ecuador,0,5,0,5
28461,2022,Türkiye,Ecuador,5,0,0,5
28462,2022,Uganda,Ecuador,7,0,0,7
28463,2022,Ukraine,Ecuador,44,16,0,60
28464,2022,United States of America,Ecuador,8,0,0,8
28465,2022,Uzbekistan,Ecuador,5,0,0,5
28466,2022,Venezuela (Bolivarian Republic of),Ecuador,1174,6642,0,7816
28467,2022,Western Sahara,Ecuador,5,0,0,5
28468,2022,Yemen,Ecuador,115,12,0,127
28469,2022,Zimbabwe,Ecuador,6,7,0,13
28470,2022,Unknown ,Ecuador,29,0,0,29
28471,2022,Eritrea,Eritrea,0,0,0,0
28472,2022,Ethiopia,Eritrea,15,0,0,15
28473,2022,Sudan,Eritrea,99,0,0,99
28474,2022,South Sudan,Eritrea,7,0,0,7
28475,2022,Afghanistan,Estonia,22,5,0,27
28476,2022,Egypt,Estonia,5,0,0,5
28477,2022,Azerbaijan,Estonia,15,0,0,15
28478,2022,Belarus,Estonia,18,6,0,24
28479,2022,Eritrea,Estonia,10,0,0,10
28480,2022,Georgia,Estonia,9,5,0,14
28481,2022,Iran (Islamic Rep. of),Estonia,5,0,0,5
28482,2022,Iraq,Estonia,17,0,0,17
28483,2022,Kazakhstan,Estonia,5,0,0,5
28484,2022,Rep. of Moldova,Estonia,10,0,0,10
28485,2022,Nigeria,Estonia,7,5,0,12
28486,2022,Pakistan,Estonia,5,0,0,5
28487,2022,Russian Federation,Estonia,118,79,0,197
28488,2022,Serbia and Kosovo: S/RES/1244 (1999),Estonia,7,0,0,7
28489,2022,Sudan,Estonia,13,0,0,13
28490,2022,Syrian Arab Rep.,Estonia,94,0,0,94
28491,2022,Turkmenistan,Estonia,5,0,0,5
28492,2022,Türkiye,Estonia,29,0,0,29
28493,2022,Ukraine,Estonia,28181,69,0,28250
28494,2022,United States of America,Estonia,5,0,0,5
28495,2022,Uzbekistan,Estonia,5,5,0,10
28496,2022,Yemen,Estonia,5,0,0,5
28497,2022,Stateless,Estonia,10,0,0,10
28498,2022,Egypt,Ethiopia,5,0,0,5
28499,2022,Burundi,Ethiopia,63,68,0,131
28500,2022,Chad,Ethiopia,0,5,0,5
28501,2022,Dem. Rep. of the Congo,Ethiopia,786,262,0,1048
28502,2022,Cuba,Ethiopia,5,0,0,5
28503,2022,Djibouti,Ethiopia,53,5,0,58
28504,2022,Eritrea,Ethiopia,161203,255,0,161458
28505,2022,Ethiopia,Ethiopia,0,0,4500000,0
28506,2022,Palestinian,Ethiopia,0,13,0,13
28507,2022,Cote d'Ivoire,Ethiopia,5,0,0,5
28508,2022,Iraq,Ethiopia,10,0,0,10
28509,2022,Jordan,Ethiopia,0,19,0,19
28510,2022,Kenya,Ethiopia,4023,0,0,4023
28511,2022,Lebanon,Ethiopia,0,18,0,18
28512,2022,Mali,Ethiopia,0,5,0,5
28513,2022,Nigeria,Ethiopia,5,5,0,10
28514,2022,Rwanda,Ethiopia,11,7,0,18
28515,2022,Somalia,Ethiopia,249104,51,0,249155
28516,2022,Sudan,Ethiopia,46989,605,0,47594
28517,2022,South Sudan,Ethiopia,403115,204,0,403319
28518,2022,Syrian Arab Rep.,Ethiopia,55,613,0,668
28519,2022,Uganda,Ethiopia,11,5,0,16
28520,2022,Yemen,Ethiopia,2356,107,0,2463
28521,2022,Afghanistan,Fiji,7,0,0,7
28522,2022,Bangladesh,Fiji,5,0,0,5
28523,2022,Afghanistan,Finland,3755,565,0,4320
28524,2022,Albania,Finland,5,15,0,20
28525,2022,Algeria,Finland,6,11,0,17
28526,2022,Angola,Finland,52,11,0,63
28527,2022,Egypt,Finland,41,22,0,63
28528,2022,Armenia,Finland,0,5,0,5
28529,2022,Azerbaijan,Finland,71,0,0,71
28530,2022,Burundi,Finland,6,0,0,6
28531,2022,Bangladesh,Finland,23,16,0,39
28532,2022,Burkina Faso,Finland,5,0,0,5
28533,2022,Belarus,Finland,19,22,0,41
28534,2022,Brazil,Finland,0,6,0,6
28535,2022,Cambodia,Finland,5,5,0,10
28536,2022,Central African Rep.,Finland,6,0,0,6
28537,2022,China,Finland,184,12,0,196
28538,2022,Cameroon,Finland,134,61,0,195
28539,2022,Congo,Finland,6,0,0,6
28540,2022,Dem. Rep. of the Congo,Finland,92,28,0,120
28541,2022,Colombia,Finland,5,37,0,42
28542,2022,Cuba,Finland,5,34,0,39
28543,2022,Dominican Rep.,Finland,5,0,0,5
28544,2022,Eritrea,Finland,871,7,0,878
28545,2022,Ethiopia,Finland,151,43,0,194
28546,2022,Gambia,Finland,28,28,0,56
28547,2022,United Kingdom of Great Britain and Northern Ireland,Finland,0,6,0,6
28548,2022,Georgia,Finland,0,67,0,67
28549,2022,Ghana,Finland,33,23,0,56
28550,2022,Guatemala,Finland,5,0,0,5
28551,2022,Guinea,Finland,24,5,0,29
28552,2022,Honduras,Finland,32,24,0,56
28553,2022,Cote d'Ivoire,Finland,7,5,0,12
28554,2022,India,Finland,5,6,0,11
28555,2022,Indonesia,Finland,5,0,0,5
28556,2022,Iran (Islamic Rep. of),Finland,958,192,0,1150
28557,2022,Iraq,Finland,9175,1508,0,10683
28558,2022,Jordan,Finland,6,5,0,11
28559,2022,Kazakhstan,Finland,8,0,0,8
28560,2022,Kenya,Finland,19,10,0,29
28561,2022,Kyrgyzstan,Finland,18,0,0,18
28562,2022,Liberia,Finland,5,0,0,5
28563,2022,Libya,Finland,33,12,0,45
28564,2022,Lebanon,Finland,12,5,0,17
28565,2022,Sri Lanka,Finland,31,17,0,48
28566,2022,Rep. of Moldova,Finland,6,11,0,17
28567,2022,Mexico,Finland,0,5,0,5
28568,2022,Mali,Finland,8,0,0,8
28569,2022,Malaysia,Finland,5,0,0,5
28570,2022,Morocco,Finland,40,26,0,66
28571,2022,Myanmar,Finland,31,9,0,40
28572,2022,Nepal,Finland,0,5,0,5
28573,2022,Niger,Finland,0,5,0,5
28574,2022,Nicaragua,Finland,73,0,0,73
28575,2022,Nigeria,Finland,139,139,0,278
28576,2022,Pakistan,Finland,80,36,0,116
28577,2022,Peru,Finland,0,5,0,5
28578,2022,Russian Federation,Finland,832,613,0,1445
28579,2022,Rwanda,Finland,49,37,0,86
28580,2022,El Salvador,Finland,10,12,0,22
28581,2022,Serbia and Kosovo: S/RES/1244 (1999),Finland,36,7,0,43
28582,2022,Senegal,Finland,5,5,0,10
28583,2022,Sierra Leone,Finland,5,13,0,18
28584,2022,Somalia,Finland,2483,467,0,2950
28585,2022,Viet Nam,Finland,7,5,0,12
28586,2022,Sudan,Finland,55,10,0,65
28587,2022,South Sudan,Finland,8,0,0,8
28588,2022,Syrian Arab Rep.,Finland,2610,100,0,2710
28589,2022,United Rep. of Tanzania,Finland,7,0,0,7
28590,2022,Tajikistan,Finland,9,5,0,14
28591,2022,Togo,Finland,5,0,0,5
28592,2022,Tunisia,Finland,5,10,0,15
28593,2022,Türkiye,Finland,876,201,0,1077
28594,2022,Uganda,Finland,36,16,0,52
28595,2022,Ukraine,Finland,29172,715,0,29887
28596,2022,United States of America,Finland,0,7,0,7
28597,2022,Uzbekistan,Finland,10,9,0,19
28598,2022,Venezuela (Bolivarian Republic of),Finland,5,12,0,17
28599,2022,Yemen,Finland,315,24,0,339
28600,2022,Zimbabwe,Finland,6,0,0,6
28601,2022,Stateless,Finland,414,24,0,438
28602,2022,Unknown ,Finland,134,59,0,193
28603,2022,Afghanistan,France,55681,9066,0,64747
28604,2022,Albania,France,10236,2003,0,12239
28605,2022,Algeria,France,3278,407,0,3685
28606,2022,Angola,France,6808,484,0,7292
28607,2022,Egypt,France,1670,368,0,2038
28608,2022,Argentina,France,12,6,0,18
28609,2022,Armenia,France,6417,891,0,7308
28610,2022,Azerbaijan,France,4664,271,0,4935
28611,2022,Bahrain,France,21,0,0,21
28612,2022,Burundi,France,1953,331,0,2284
28613,2022,Benin,France,221,164,0,385
28614,2022,Bangladesh,France,8858,5013,0,13871
28615,2022,Bhutan,France,178,0,0,178
28616,2022,Burkina Faso,France,590,242,0,832
28617,2022,Belarus,France,844,52,0,896
28618,2022,Bolivia (Plurinational State of),France,65,5,0,70
28619,2022,Brazil,France,65,74,0,139
28620,2022,Bosnia and Herzegovina,France,6913,130,0,7043
28621,2022,Bulgaria,France,70,0,0,70
28622,2022,Cambodia,France,11012,12,0,11024
28623,2022,Canada,France,5,0,0,5
28624,2022,Central African Rep.,France,5318,126,0,5444
28625,2022,Chad,France,3237,1183,0,4420
28626,2022,China,France,10543,223,0,10766
28627,2022,Chile,France,153,13,0,166
28628,2022,Cameroon,France,2736,1054,0,3790
28629,2022,Congo,France,5744,726,0,6470
28630,2022,Dem. Rep. of the Congo,France,31935,2645,0,34580
28631,2022,Comoros,France,1721,806,0,2527
28632,2022,Colombia,France,1185,807,0,1992
28633,2022,Cuba,France,331,111,0,442
28634,2022,Cabo Verde,France,0,10,0,10
28635,2022,Djibouti,France,569,172,0,741
28636,2022,Dominica,France,5,0,0,5
28637,2022,Dominican Rep.,France,160,78,0,238
28638,2022,Ecuador,France,37,0,0,37
28639,2022,Equatorial Guinea,France,60,15,0,75
28640,2022,Eritrea,France,11489,482,0,11971
28641,2022,Estonia,France,5,0,0,5
28642,2022,Ethiopia,France,3208,376,0,3584
28643,2022,Gabon,France,520,194,0,714
28644,2022,Gambia,France,548,191,0,739
28645,2022,Palestinian,France,1981,51,0,2032
28646,2022,Georgia,France,5896,2615,0,8511
28647,2022,Ghana,France,600,58,0,658
28648,2022,Guinea-Bissau,France,1288,42,0,1330
28649,2022,Guatemala,France,21,9,0,30
28650,2022,Guinea,France,21225,2575,0,23800
28651,2022,Guyana,France,31,0,0,31
28652,2022,Haiti,France,6910,342,0,7252
28653,2022,Honduras,France,51,9,0,60
28654,2022,Croatia,France,63,0,0,63
28655,2022,Hungary,France,72,10,0,82
28656,2022,Cote d'Ivoire,France,12286,3014,0,15300
28657,2022,India,France,321,69,0,390
28658,2022,Indonesia,France,9,0,0,9
28659,2022,Iran (Islamic Rep. of),France,4070,294,0,4364
28660,2022,Iraq,France,13974,358,0,14332
28661,2022,Israel,France,9,0,0,9
28662,2022,Italy,France,0,5,0,5
28663,2022,Jamaica,France,38,9,0,47
28664,2022,Jordan,France,61,5,0,66
28665,2022,Kazakhstan,France,1052,43,0,1095
28666,2022,Kenya,France,199,10,0,209
28667,2022,Kyrgyzstan,France,530,32,0,562
28668,2022,Kuwait,France,511,30,0,541
28669,2022,Lao People's Dem. Rep.,France,6498,15,0,6513
28670,2022,Liberia,France,344,22,0,366
28671,2022,Libya,France,2343,156,0,2499
28672,2022,Saint Lucia,France,6,8,0,14
28673,2022,Lebanon,France,344,143,0,487
28674,2022,Sri Lanka,France,33834,896,0,34730
28675,2022,Lithuania,France,6,0,0,6
28676,2022,Latvia,France,38,0,0,38
28677,2022,Madagascar,France,429,437,0,866
28678,2022,Mauritania,France,8124,896,0,9020
28679,2022,North Macedonia,France,742,141,0,883
28680,2022,Rep. of Moldova,France,455,194,0,649
28681,2022,Maldives,France,6,0,0,6
28682,2022,Mexico,France,34,17,0,51
28683,2022,Mali,France,8101,1207,0,9308
28684,2022,Malaysia,France,28,0,0,28
28685,2022,Mongolia,France,835,43,0,878
28686,2022,Morocco,France,1328,201,0,1529
28687,2022,Mozambique,France,18,0,0,18
28688,2022,Montenegro,France,197,24,0,221
28689,2022,Mauritius,France,58,6,0,64
28690,2022,Myanmar,France,369,17,0,386
28691,2022,Nepal,France,220,41,0,261
28692,2022,Niger,France,214,56,0,270
28693,2022,Nicaragua,France,74,17,0,91
28694,2022,Nigeria,France,6111,2787,0,8898
28695,2022,Pakistan,France,2866,1208,0,4074
28696,2022,Paraguay,France,9,0,0,9
28697,2022,Peru,France,486,111,0,597
28698,2022,Philippines,France,7,0,0,7
28699,2022,Poland,France,134,0,0,134
28700,2022,Romania,France,170,0,0,170
28701,2022,South Africa,France,150,10,0,160
28702,2022,Russian Federation,France,33148,1168,0,34316
28703,2022,Rwanda,France,4480,369,0,4849
28704,2022,El Salvador,France,116,10,0,126
28705,2022,Saudi Arabia,France,42,0,0,42
28706,2022,Serbia and Kosovo: S/RES/1244 (1999),France,18008,596,0,18604
28707,2022,Senegal,France,2932,849,0,3781
28708,2022,Sierra Leone,France,1206,292,0,1498
28709,2022,Somalia,France,10210,2935,0,13145
28710,2022,Viet Nam,France,7991,15,0,8006
28711,2022,Sudan,France,24223,1104,0,25327
28712,2022,Suriname,France,11,21,0,32
28713,2022,South Sudan,France,245,7,0,252
28714,2022,Slovakia,France,140,0,0,140
28715,2022,Syrian Arab Rep.,France,39091,507,0,39598
28716,2022,United Rep. of Tanzania,France,28,19,0,47
28717,2022,Thailand,France,15,5,0,20
28718,2022,Tajikistan,France,135,19,0,154
28719,2022,Turkmenistan,France,41,6,0,47
28720,2022,Togo,France,1124,148,0,1272
28721,2022,Tunisia,France,572,115,0,687
28722,2022,Türkiye,France,17032,5350,0,22382
28723,2022,Uganda,France,225,14,0,239
28724,2022,Ukraine,France,94970,1334,0,96304
28725,2022,United States of America,France,9,5,0,14
28726,2022,Uzbekistan,France,300,24,0,324
28727,2022,Venezuela (Bolivarian Republic of),France,1400,549,0,1949
28728,2022,Western Sahara,France,858,64,0,922
28729,2022,Yemen,France,993,44,0,1037
28730,2022,Zimbabwe,France,86,5,0,91
28731,2022,Stateless,France,1784,175,0,1959
28732,2022,Tibetan,France,32,0,0,32
28733,2022,Unknown ,France,6984,1321,0,8305
28734,2022,Burundi,Gabon,6,0,0,6
28735,2022,Central African Rep.,Gabon,19,9,0,28
28736,2022,Chad,Gabon,65,13,0,78
28737,2022,Cameroon,Gabon,5,5,0,10
28738,2022,Congo,Gabon,60,0,0,60
28739,2022,Dem. Rep. of the Congo,Gabon,73,26,0,99
28740,2022,Mauritania,Gabon,6,0,0,6
28741,2022,Sao Tome and Principe,Gabon,6,0,0,6
28742,2022,Sudan,Gabon,5,0,0,5
28743,2022,Togo,Gabon,6,0,0,6
28744,2022,Central African Rep.,Gambia,10,8,0,18
28745,2022,Congo,Gambia,7,5,0,12
28746,2022,Dem. Rep. of the Congo,Gambia,63,5,0,68
28747,2022,Guinea-Bissau,Gambia,0,10,0,10
28748,2022,Guinea,Gambia,5,5,0,10
28749,2022,Cote d'Ivoire,Gambia,118,6,0,124
28750,2022,Liberia,Gambia,15,0,0,15
28751,2022,Rwanda,Gambia,5,0,0,5
28752,2022,Senegal,Gambia,4082,968,0,5050
28753,2022,Sierra Leone,Gambia,105,11,0,116
28754,2022,Syrian Arab Rep.,Gambia,5,0,0,5
28755,2022,Togo,Gambia,18,0,0,18
28756,2022,Afghanistan,United Kingdom of Great Britain and Northern Ireland,10259,7277,0,17536
28757,2022,Albania,United Kingdom of Great Britain and Northern Ireland,4485,15893,0,20378
28758,2022,Algeria,United Kingdom of Great Britain and Northern Ireland,306,612,0,918
28759,2022,Angola,United Kingdom of Great Britain and Northern Ireland,138,165,0,303
28760,2022,Antigua and Barbuda,United Kingdom of Great Britain and Northern Ireland,7,12,0,19
28761,2022,Egypt,United Kingdom of Great Britain and Northern Ireland,980,1379,0,2359
28762,2022,Argentina,United Kingdom of Great Britain and Northern Ireland,0,32,0,32
28763,2022,Armenia,United Kingdom of Great Britain and Northern Ireland,54,15,0,69
28764,2022,Australia,United Kingdom of Great Britain and Northern Ireland,5,0,0,5
28765,2022,Azerbaijan,United Kingdom of Great Britain and Northern Ireland,143,97,0,240
28766,2022,Bahrain,United Kingdom of Great Britain and Northern Ireland,101,20,0,121
28767,2022,Barbados,United Kingdom of Great Britain and Northern Ireland,15,16,0,31
28768,2022,Burundi,United Kingdom of Great Britain and Northern Ireland,53,19,0,72
28769,2022,Benin,United Kingdom of Great Britain and Northern Ireland,9,33,0,42
28770,2022,Bangladesh,United Kingdom of Great Britain and Northern Ireland,1851,4436,0,6287
28771,2022,Bhutan,United Kingdom of Great Britain and Northern Ireland,19,0,0,19
28772,2022,Burkina Faso,United Kingdom of Great Britain and Northern Ireland,11,14,0,25
28773,2022,Belarus,United Kingdom of Great Britain and Northern Ireland,92,104,0,196
28774,2022,Bolivia (Plurinational State of),United Kingdom of Great Britain and Northern Ireland,23,19,0,42
28775,2022,Botswana,United Kingdom of Great Britain and Northern Ireland,34,136,0,170
28776,2022,Brazil,United Kingdom of Great Britain and Northern Ireland,40,455,0,495
28777,2022,Bosnia and Herzegovina,United Kingdom of Great Britain and Northern Ireland,8,5,0,13
28778,2022,Belize,United Kingdom of Great Britain and Northern Ireland,0,5,0,5
28779,2022,Canada,United Kingdom of Great Britain and Northern Ireland,11,23,0,34
28780,2022,Central African Rep.,United Kingdom of Great Britain and Northern Ireland,11,17,0,28
28781,2022,Chad,United Kingdom of Great Britain and Northern Ireland,130,355,0,485
28782,2022,China,United Kingdom of Great Britain and Northern Ireland,963,2777,0,3740
28783,2022,Chile,United Kingdom of Great Britain and Northern Ireland,0,13,0,13
28784,2022,Cameroon,United Kingdom of Great Britain and Northern Ireland,803,447,0,1250
28785,2022,Congo,United Kingdom of Great Britain and Northern Ireland,88,98,0,186
28786,2022,Dem. Rep. of the Congo,United Kingdom of Great Britain and Northern Ireland,887,259,0,1146
28787,2022,Colombia,United Kingdom of Great Britain and Northern Ireland,14,63,0,77
28788,2022,Costa Rica,United Kingdom of Great Britain and Northern Ireland,0,9,0,9
28789,2022,Cuba,United Kingdom of Great Britain and Northern Ireland,15,23,0,38
28790,2022,Cabo Verde,United Kingdom of Great Britain and Northern Ireland,5,0,0,5
28791,2022,Cyprus,United Kingdom of Great Britain and Northern Ireland,0,9,0,9
28792,2022,Czechia,United Kingdom of Great Britain and Northern Ireland,0,5,0,5
28793,2022,Djibouti,United Kingdom of Great Britain and Northern Ireland,6,6,0,12
28794,2022,Dominica,United Kingdom of Great Britain and Northern Ireland,22,40,0,62
28795,2022,Dominican Rep.,United Kingdom of Great Britain and Northern Ireland,0,5,0,5
28796,2022,Ecuador,United Kingdom of Great Britain and Northern Ireland,5,29,0,34
28797,2022,Equatorial Guinea,United Kingdom of Great Britain and Northern Ireland,5,8,0,13
28798,2022,Eritrea,United Kingdom of Great Britain and Northern Ireland,15615,6886,0,22501
28799,2022,Ethiopia,United Kingdom of Great Britain and Northern Ireland,2015,1530,0,3545
28800,2022,Fiji,United Kingdom of Great Britain and Northern Ireland,5,0,0,5
28801,2022,France,United Kingdom of Great Britain and Northern Ireland,0,5,0,5
28802,2022,Gabon,United Kingdom of Great Britain and Northern Ireland,9,6,0,15
28803,2022,Gambia,United Kingdom of Great Britain and Northern Ireland,829,304,0,1133
28804,2022,Palestinian,United Kingdom of Great Britain and Northern Ireland,646,605,0,1251
28805,2022,United Kingdom of Great Britain and Northern Ireland,United Kingdom of Great Britain and Northern Ireland,20,0,0,20
28806,2022,Georgia,United Kingdom of Great Britain and Northern Ireland,77,1172,0,1249
28807,2022,Germany,United Kingdom of Great Britain and Northern Ireland,0,5,0,5
28808,2022,Ghana,United Kingdom of Great Britain and Northern Ireland,346,490,0,836
28809,2022,Guinea-Bissau,United Kingdom of Great Britain and Northern Ireland,6,8,0,14
28810,2022,Greece,United Kingdom of Great Britain and Northern Ireland,5,5,0,10
28811,2022,Grenada,United Kingdom of Great Britain and Northern Ireland,23,57,0,80
28812,2022,Guatemala,United Kingdom of Great Britain and Northern Ireland,9,35,0,44
28813,2022,Guinea,United Kingdom of Great Britain and Northern Ireland,206,168,0,374
28814,2022,Guyana,United Kingdom of Great Britain and Northern Ireland,19,5,0,24
28815,2022,Haiti,United Kingdom of Great Britain and Northern Ireland,0,10,0,10
28816,2022,"China, Hong Kong SAR",United Kingdom of Great Britain and Northern Ireland,20,30,0,50
28817,2022,Honduras,United Kingdom of Great Britain and Northern Ireland,124,1156,0,1280
28818,2022,Hungary,United Kingdom of Great Britain and Northern Ireland,0,5,0,5
28819,2022,Cote d'Ivoire,United Kingdom of Great Britain and Northern Ireland,188,118,0,306
28820,2022,India,United Kingdom of Great Britain and Northern Ireland,518,3445,0,3963
28821,2022,Indonesia,United Kingdom of Great Britain and Northern Ireland,46,104,0,150
28822,2022,Ireland,United Kingdom of Great Britain and Northern Ireland,13,11,0,24
28823,2022,Iran (Islamic Rep. of),United Kingdom of Great Britain and Northern Ireland,21904,15395,0,37299
28824,2022,Iraq,United Kingdom of Great Britain and Northern Ireland,7699,14033,0,21732
28825,2022,Israel,United Kingdom of Great Britain and Northern Ireland,121,25,0,146
28826,2022,Italy,United Kingdom of Great Britain and Northern Ireland,5,5,0,10
28827,2022,Jamaica,United Kingdom of Great Britain and Northern Ireland,251,204,0,455
28828,2022,Jordan,United Kingdom of Great Britain and Northern Ireland,112,153,0,265
28829,2022,Japan,United Kingdom of Great Britain and Northern Ireland,0,7,0,7
28830,2022,Kazakhstan,United Kingdom of Great Britain and Northern Ireland,49,76,0,125
28831,2022,Kenya,United Kingdom of Great Britain and Northern Ireland,319,372,0,691
28832,2022,Kyrgyzstan,United Kingdom of Great Britain and Northern Ireland,37,31,0,68
28833,2022,Rep. of Korea,United Kingdom of Great Britain and Northern Ireland,5,8,0,13
28834,2022,Dem. People's Rep. of Korea,United Kingdom of Great Britain and Northern Ireland,43,20,0,63
28835,2022,Kuwait,United Kingdom of Great Britain and Northern Ireland,716,1351,0,2067
28836,2022,Lao People's Dem. Rep.,United Kingdom of Great Britain and Northern Ireland,5,0,0,5
28837,2022,Liberia,United Kingdom of Great Britain and Northern Ireland,26,26,0,52
28838,2022,Libya,United Kingdom of Great Britain and Northern Ireland,4565,939,0,5504
28839,2022,Saint Lucia,United Kingdom of Great Britain and Northern Ireland,25,49,0,74
28840,2022,Lebanon,United Kingdom of Great Britain and Northern Ireland,223,199,0,422
28841,2022,Sri Lanka,United Kingdom of Great Britain and Northern Ireland,4418,1822,0,6240
28842,2022,Mauritania,United Kingdom of Great Britain and Northern Ireland,7,7,0,14
28843,2022,North Macedonia,United Kingdom of Great Britain and Northern Ireland,14,14,0,28
28844,2022,Rep. of Moldova,United Kingdom of Great Britain and Northern Ireland,5,6,0,11
28845,2022,Maldives,United Kingdom of Great Britain and Northern Ireland,44,0,0,44
28846,2022,Mexico,United Kingdom of Great Britain and Northern Ireland,14,102,0,116
28847,2022,Mali,United Kingdom of Great Britain and Northern Ireland,31,72,0,103
28848,2022,Malaysia,United Kingdom of Great Britain and Northern Ireland,310,546,0,856
28849,2022,Malawi,United Kingdom of Great Britain and Northern Ireland,267,96,0,363
28850,2022,Mongolia,United Kingdom of Great Britain and Northern Ireland,51,75,0,126
28851,2022,Morocco,United Kingdom of Great Britain and Northern Ireland,235,405,0,640
28852,2022,Mozambique,United Kingdom of Great Britain and Northern Ireland,6,5,0,11
28853,2022,Montenegro,United Kingdom of Great Britain and Northern Ireland,0,5,0,5
28854,2022,Mauritius,United Kingdom of Great Britain and Northern Ireland,64,120,0,184
28855,2022,Myanmar,United Kingdom of Great Britain and Northern Ireland,338,135,0,473
28856,2022,Namibia,United Kingdom of Great Britain and Northern Ireland,207,1009,0,1216
28857,2022,Nepal,United Kingdom of Great Britain and Northern Ireland,73,590,0,663
28858,2022,Netherlands,United Kingdom of Great Britain and Northern Ireland,5,0,0,5
28859,2022,Niger,United Kingdom of Great Britain and Northern Ireland,194,23,0,217
28860,2022,Nicaragua,United Kingdom of Great Britain and Northern Ireland,57,252,0,309
28861,2022,Nigeria,United Kingdom of Great Britain and Northern Ireland,3138,3393,0,6531
28862,2022,Norway,United Kingdom of Great Britain and Northern Ireland,5,5,0,10
28863,2022,Oman,United Kingdom of Great Britain and Northern Ireland,22,29,0,51
28864,2022,Pakistan,United Kingdom of Great Britain and Northern Ireland,8009,5163,0,13172
28865,2022,Panama,United Kingdom of Great Britain and Northern Ireland,0,5,0,5
28866,2022,Peru,United Kingdom of Great Britain and Northern Ireland,0,9,0,9
28867,2022,Philippines,United Kingdom of Great Britain and Northern Ireland,63,772,0,835
28868,2022,Poland,United Kingdom of Great Britain and Northern Ireland,0,11,0,11
28869,2022,Portugal,United Kingdom of Great Britain and Northern Ireland,0,5,0,5
28870,2022,Qatar,United Kingdom of Great Britain and Northern Ireland,17,14,0,31
28871,2022,Romania,United Kingdom of Great Britain and Northern Ireland,0,14,0,14
28872,2022,South Africa,United Kingdom of Great Britain and Northern Ireland,123,144,0,267
28873,2022,Russian Federation,United Kingdom of Great Britain and Northern Ireland,927,797,0,1724
28874,2022,Rwanda,United Kingdom of Great Britain and Northern Ireland,100,46,0,146
28875,2022,El Salvador,United Kingdom of Great Britain and Northern Ireland,979,3177,0,4156
28876,2022,Saudi Arabia,United Kingdom of Great Britain and Northern Ireland,309,258,0,567
28877,2022,Serbia and Kosovo: S/RES/1244 (1999),United Kingdom of Great Britain and Northern Ireland,72,72,0,144
28878,2022,Senegal,United Kingdom of Great Britain and Northern Ireland,94,77,0,171
28879,2022,Seychelles,United Kingdom of Great Britain and Northern Ireland,9,0,0,9
28880,2022,Singapore,United Kingdom of Great Britain and Northern Ireland,5,6,0,11
28881,2022,Sierra Leone,United Kingdom of Great Britain and Northern Ireland,328,325,0,653
28882,2022,Somalia,United Kingdom of Great Britain and Northern Ireland,2425,1311,0,3736
28883,2022,Viet Nam,United Kingdom of Great Britain and Northern Ireland,3107,3851,0,6958
28884,2022,Saint Kitts and Nevis,United Kingdom of Great Britain and Northern Ireland,6,25,0,31
28885,2022,Sudan,United Kingdom of Great Britain and Northern Ireland,11371,4513,0,15884
28886,2022,South Sudan,United Kingdom of Great Britain and Northern Ireland,92,165,0,257
28887,2022,Eswatini,United Kingdom of Great Britain and Northern Ireland,52,5,0,57
28888,2022,Sweden,United Kingdom of Great Britain and Northern Ireland,0,5,0,5
28889,2022,Syrian Arab Rep.,United Kingdom of Great Britain and Northern Ireland,12155,5898,0,18053
28890,2022,United Rep. of Tanzania,United Kingdom of Great Britain and Northern Ireland,111,92,0,203
28891,2022,Thailand,United Kingdom of Great Britain and Northern Ireland,35,131,0,166
28892,2022,Tajikistan,United Kingdom of Great Britain and Northern Ireland,14,56,0,70
28893,2022,Turkmenistan,United Kingdom of Great Britain and Northern Ireland,21,46,0,67
28894,2022,Timor-Leste,United Kingdom of Great Britain and Northern Ireland,0,8,0,8
28895,2022,Togo,United Kingdom of Great Britain and Northern Ireland,16,36,0,52
28896,2022,Trinidad and Tobago,United Kingdom of Great Britain and Northern Ireland,102,218,0,320
28897,2022,Tunisia,United Kingdom of Great Britain and Northern Ireland,69,133,0,202
28898,2022,Türkiye,United Kingdom of Great Britain and Northern Ireland,2802,2226,0,5028
28899,2022,United Arab Emirates,United Kingdom of Great Britain and Northern Ireland,22,15,0,37
28900,2022,Uganda,United Kingdom of Great Britain and Northern Ireland,1122,313,0,1435
28901,2022,Ukraine,United Kingdom of Great Britain and Northern Ireland,91223,709,0,91932
28902,2022,United States of America,United Kingdom of Great Britain and Northern Ireland,67,117,0,184
28903,2022,Uzbekistan,United Kingdom of Great Britain and Northern Ireland,67,107,0,174
28904,2022,Vanuatu,United Kingdom of Great Britain and Northern Ireland,0,6,0,6
28905,2022,Saint Vincent and the Grenadines,United Kingdom of Great Britain and Northern Ireland,39,49,0,88
28906,2022,Venezuela (Bolivarian Republic of),United Kingdom of Great Britain and Northern Ireland,66,44,0,110
28907,2022,Samoa,United Kingdom of Great Britain and Northern Ireland,0,5,0,5
28908,2022,Western Sahara,United Kingdom of Great Britain and Northern Ireland,11,6,0,17
28909,2022,Yemen,United Kingdom of Great Britain and Northern Ireland,1435,926,0,2361
28910,2022,Zambia,United Kingdom of Great Britain and Northern Ireland,82,55,0,137
28911,2022,Zimbabwe,United Kingdom of Great Britain and Northern Ireland,1038,456,0,1494
28912,2022,Stateless,United Kingdom of Great Britain and Northern Ireland,3088,2102,0,5190
28913,2022,Unknown ,United Kingdom of Great Britain and Northern Ireland,1977,203,0,2180
28914,2022,Afghanistan,Georgia,53,29,0,82
28915,2022,Egypt,Georgia,69,45,0,114
28916,2022,Azerbaijan,Georgia,0,5,0,5
28917,2022,Belarus,Georgia,0,12,0,12
28918,2022,Cameroon,Georgia,0,5,0,5
28919,2022,Dem. Rep. of the Congo,Georgia,5,5,0,10
28920,2022,Cuba,Georgia,0,5,0,5
28921,2022,Eritrea,Georgia,10,24,0,34
28922,2022,Ethiopia,Georgia,0,6,0,6
28923,2022,Palestinian,Georgia,0,10,0,10
28924,2022,Georgia,Georgia,0,0,291358,0
28925,2022,Ghana,Georgia,0,9,0,9
28926,2022,India,Georgia,0,5,0,5
28927,2022,Iran (Islamic Rep. of),Georgia,44,372,0,416
28928,2022,Iraq,Georgia,377,25,0,402
28929,2022,Jordan,Georgia,0,32,0,32
28930,2022,Kazakhstan,Georgia,5,10,0,15
28931,2022,Kyrgyzstan,Georgia,0,5,0,5
28932,2022,Lebanon,Georgia,11,29,0,40
28933,2022,Nigeria,Georgia,0,28,0,28
28934,2022,Pakistan,Georgia,12,0,0,12
28935,2022,South Africa,Georgia,0,8,0,8
28936,2022,Russian Federation,Georgia,222,97,0,319
28937,2022,Saudi Arabia,Georgia,0,5,0,5
28938,2022,Somalia,Georgia,7,10,0,17
28939,2022,Sudan,Georgia,6,0,0,6
28940,2022,Syrian Arab Rep.,Georgia,448,17,0,465
28941,2022,Thailand,Georgia,0,5,0,5
28942,2022,Tajikistan,Georgia,5,9,0,14
28943,2022,Turkmenistan,Georgia,0,8,0,8
28944,2022,Türkiye,Georgia,0,182,0,182
28945,2022,Ukraine,Georgia,22647,113,0,22760
28946,2022,Uzbekistan,Georgia,0,5,0,5
28947,2022,Yemen,Georgia,65,16,0,81
28948,2022,Stateless,Georgia,0,0,0,0
28949,2022,Unknown ,Georgia,38,24,0,62
28950,2022,Afghanistan,Germany,183631,41300,0,224931
28951,2022,Albania,Germany,1309,1531,0,2840
28952,2022,Algeria,Germany,986,1102,0,2088
28953,2022,Angola,Germany,846,400,0,1246
28954,2022,Egypt,Germany,2621,1133,0,3754
28955,2022,Argentina,Germany,18,19,0,37
28956,2022,Armenia,Germany,4180,1894,0,6074
28957,2022,Australia,Germany,9,0,0,9
28958,2022,Austria,Germany,5,0,0,5
28959,2022,Azerbaijan,Germany,5532,2399,0,7931
28960,2022,Bahrain,Germany,68,0,0,68
28961,2022,Burundi,Germany,134,57,0,191
28962,2022,Belgium,Germany,7,0,0,7
28963,2022,Benin,Germany,113,139,0,252
28964,2022,Bangladesh,Germany,874,289,0,1163
28965,2022,Bhutan,Germany,21,0,0,21
28966,2022,Burkina Faso,Germany,120,158,0,278
28967,2022,Belarus,Germany,905,396,0,1301
28968,2022,Bolivia (Plurinational State of),Germany,7,11,0,18
28969,2022,Botswana,Germany,6,0,0,6
28970,2022,Brazil,Germany,36,55,0,91
28971,2022,Bosnia and Herzegovina,Germany,1356,873,0,2229
28972,2022,Bulgaria,Germany,81,5,0,86
28973,2022,Cambodia,Germany,34,31,0,65
28974,2022,Canada,Germany,41,0,0,41
28975,2022,Central African Rep.,Germany,54,6,0,60
28976,2022,Chad,Germany,121,190,0,311
28977,2022,China,Germany,2222,337,0,2559
28978,2022,Chile,Germany,156,13,0,169
28979,2022,Cameroon,Germany,1248,1382,0,2630
28980,2022,Congo,Germany,306,61,0,367
28981,2022,Dem. Rep. of the Congo,Germany,1562,535,0,2097
28982,2022,Comoros,Germany,0,13,0,13
28983,2022,Colombia,Germany,113,1386,0,1499
28984,2022,Costa Rica,Germany,0,5,0,5
28985,2022,Cuba,Germany,98,81,0,179
28986,2022,Cabo Verde,Germany,0,5,0,5
28987,2022,Czechia,Germany,397,5,0,402
28988,2022,Djibouti,Germany,45,28,0,73
28989,2022,Dominica,Germany,5,0,0,5
28990,2022,Dominican Rep.,Germany,10,5,0,15
28991,2022,Ecuador,Germany,23,5,0,28
28992,2022,Equatorial Guinea,Germany,28,5,0,33
28993,2022,Eritrea,Germany,64496,2746,0,67242
28994,2022,Ethiopia,Germany,6912,2975,0,9887
28995,2022,France,Germany,12,0,0,12
28996,2022,Gabon,Germany,21,22,0,43
28997,2022,Gambia,Germany,1492,1138,0,2630
28998,2022,Palestinian,Germany,2157,1099,0,3256
28999,2022,United Kingdom of Great Britain and Northern Ireland,Germany,35,0,0,35
29000,2022,Georgia,Germany,1883,5946,0,7829
29001,2022,Ghana,Germany,973,713,0,1686
29002,2022,Guinea-Bissau,Germany,123,74,0,197
29003,2022,Greece,Germany,45,5,0,50
29004,2022,Guatemala,Germany,5,13,0,18
29005,2022,Guinea,Germany,4460,2741,0,7201
29006,2022,Haiti,Germany,17,33,0,50
29007,2022,"China, Hong Kong SAR",Germany,5,7,0,12
29008,2022,Honduras,Germany,81,58,0,139
29009,2022,Croatia,Germany,264,5,0,269
29010,2022,Hungary,Germany,228,5,0,233
29011,2022,Iceland,Germany,92,0,0,92
29012,2022,Cote d'Ivoire,Germany,829,927,0,1756
29013,2022,India,Germany,700,536,0,1236
29014,2022,Indonesia,Germany,17,5,0,22
29015,2022,Iran (Islamic Rep. of),Germany,47658,12419,0,60077
29016,2022,Iraq,Germany,151254,29368,0,180622
29017,2022,Israel,Germany,40,28,0,68
29018,2022,Italy,Germany,35,10,0,45
29019,2022,Jamaica,Germany,80,42,0,122
29020,2022,Jordan,Germany,761,388,0,1149
29021,2022,Japan,Germany,28,5,0,33
29022,2022,Kazakhstan,Germany,309,162,0,471
29023,2022,Kenya,Germany,189,495,0,684
29024,2022,Kyrgyzstan,Germany,434,103,0,537
29025,2022,Rep. of Korea,Germany,25,5,0,30
29026,2022,Dem. People's Rep. of Korea,Germany,91,5,0,96
29027,2022,Kuwait,Germany,45,68,0,113
29028,2022,Lao People's Dem. Rep.,Germany,41,0,0,41
29029,2022,Liberia,Germany,156,238,0,394
29030,2022,Libya,Germany,2932,1044,0,3976
29031,2022,Lebanon,Germany,2514,1807,0,4321
29032,2022,Sri Lanka,Germany,3652,398,0,4050
29033,2022,Lithuania,Germany,10,0,0,10
29034,2022,Latvia,Germany,9,0,0,9
29035,2022,Madagascar,Germany,5,12,0,17
29036,2022,Mauritania,Germany,71,82,0,153
29037,2022,North Macedonia,Germany,624,2569,0,3193
29038,2022,Rep. of Moldova,Germany,1003,2285,0,3288
29039,2022,Mexico,Germany,29,10,0,39
29040,2022,Mali,Germany,404,310,0,714
29041,2022,Malaysia,Germany,19,7,0,26
29042,2022,Malawi,Germany,7,0,0,7
29043,2022,Mongolia,Germany,244,206,0,450
29044,2022,Morocco,Germany,2218,1080,0,3298
29045,2022,Mozambique,Germany,14,26,0,40
29046,2022,Montenegro,Germany,214,231,0,445
29047,2022,Mauritius,Germany,5,0,0,5
29048,2022,Myanmar,Germany,949,399,0,1348
29049,2022,Namibia,Germany,7,55,0,62
29050,2022,Nepal,Germany,67,18,0,85
29051,2022,Netherlands,Germany,32,5,0,37
29052,2022,Niger,Germany,77,99,0,176
29053,2022,Nicaragua,Germany,8,270,0,278
29054,2022,Nigeria,Germany,12155,9715,0,21870
29055,2022,Norway,Germany,5,0,0,5
29056,2022,New Zealand,Germany,7,0,0,7
29057,2022,Oman,Germany,8,10,0,18
29058,2022,Pakistan,Germany,9250,3585,0,12835
29059,2022,Panama,Germany,0,5,0,5
29060,2022,Paraguay,Germany,5,9,0,14
29061,2022,Peru,Germany,50,42,0,92
29062,2022,Philippines,Germany,50,29,0,79
29063,2022,Poland,Germany,569,5,0,574
29064,2022,Portugal,Germany,5,0,0,5
29065,2022,Qatar,Germany,5,0,0,5
29066,2022,Romania,Germany,146,5,0,151
29067,2022,South Africa,Germany,27,44,0,71
29068,2022,Russian Federation,Germany,13334,9445,0,22779
29069,2022,Rwanda,Germany,361,586,0,947
29070,2022,El Salvador,Germany,185,80,0,265
29071,2022,Saudi Arabia,Germany,199,30,0,229
29072,2022,Serbia and Kosovo: S/RES/1244 (1999),Germany,6257,2142,0,8399
29073,2022,Senegal,Germany,224,291,0,515
29074,2022,Singapore,Germany,7,0,0,7
29075,2022,Sierra Leone,Germany,864,558,0,1422
29076,2022,Solomon Islands,Germany,6,0,0,6
29077,2022,Somalia,Germany,32155,6004,0,38159
29078,2022,Spain,Germany,23,9,0,32
29079,2022,Viet Nam,Germany,2284,269,0,2553
29080,2022,Sudan,Germany,3191,905,0,4096
29081,2022,South Sudan,Germany,122,58,0,180
29082,2022,Slovakia,Germany,73,0,0,73
29083,2022,Slovenia,Germany,7,0,0,7
29084,2022,Eswatini,Germany,5,5,0,10
29085,2022,Sweden,Germany,11,0,0,11
29086,2022,Syrian Arab Rep.,Germany,664238,43628,0,707866
29087,2022,United Rep. of Tanzania,Germany,93,255,0,348
29088,2022,Thailand,Germany,35,18,0,53
29089,2022,Tajikistan,Germany,1775,977,0,2752
29090,2022,Turkmenistan,Germany,1096,138,0,1234
29091,2022,Togo,Germany,1023,336,0,1359
29092,2022,Trinidad and Tobago,Germany,7,5,0,12
29093,2022,Tunisia,Germany,478,840,0,1318
29094,2022,Türkiye,Germany,38755,17129,0,55884
29095,2022,United Arab Emirates,Germany,34,0,0,34
29096,2022,Uganda,Germany,286,345,0,631
29097,2022,Ukraine,Germany,876311,1512,0,877823
29098,2022,Uruguay,Germany,13,0,0,13
29099,2022,United States of America,Germany,207,37,0,244
29100,2022,Uzbekistan,Germany,687,128,0,815
29101,2022,Saint Vincent and the Grenadines,Germany,5,0,0,5
29102,2022,Venezuela (Bolivarian Republic of),Germany,1289,1338,0,2627
29103,2022,Yemen,Germany,3647,1180,0,4827
29104,2022,Zambia,Germany,12,9,0,21
29105,2022,Zimbabwe,Germany,347,205,0,552
29106,2022,Stateless,Germany,13106,639,0,13745
29107,2022,Unknown ,Germany,39463,5990,0,45453
29108,2022,Afghanistan,Ghana,7,0,0,7
29109,2022,Egypt,Ghana,0,16,0,16
29110,2022,Burundi,Ghana,14,15,0,29
29111,2022,Benin,Ghana,15,5,0,20
29112,2022,Central African Rep.,Ghana,199,90,0,289
29113,2022,Chad,Ghana,40,22,0,62
29114,2022,Cameroon,Ghana,436,267,0,703
29115,2022,Congo,Ghana,5,0,0,5
29116,2022,Dem. Rep. of the Congo,Ghana,69,19,0,88
29117,2022,Eritrea,Ghana,129,70,0,199
29118,2022,Ethiopia,Ghana,11,6,0,17
29119,2022,Palestinian,Ghana,19,10,0,29
29120,2022,Cote d'Ivoire,Ghana,859,679,0,1538
29121,2022,Iraq,Ghana,16,5,0,21
29122,2022,Liberia,Ghana,632,0,0,632
29123,2022,Libya,Ghana,7,6,0,13
29124,2022,Lebanon,Ghana,11,0,0,11
29125,2022,Mali,Ghana,0,5,0,5
29126,2022,Nigeria,Ghana,16,11,0,27
29127,2022,Pakistan,Ghana,60,10,0,70
29128,2022,Rwanda,Ghana,26,5,0,31
29129,2022,Sierra Leone,Ghana,89,16,0,105
29130,2022,Somalia,Ghana,79,24,0,103
29131,2022,Sudan,Ghana,601,107,0,708
29132,2022,South Sudan,Ghana,7,5,0,12
29133,2022,Syrian Arab Rep.,Ghana,246,75,0,321
29134,2022,Togo,Ghana,3263,69,0,3332
29135,2022,Türkiye,Ghana,72,8,0,80
29136,2022,Uganda,Ghana,11,0,0,11
29137,2022,Ukraine,Ghana,0,5,0,5
29138,2022,Uzbekistan,Ghana,9,0,0,9
29139,2022,Yemen,Ghana,17,9,0,26
29140,2022,Burundi,Guinea-Bissau,5,0,0,5
29141,2022,Cote d'Ivoire,Guinea-Bissau,6,6,0,12
29142,2022,Liberia,Guinea-Bissau,8,0,0,8
29143,2022,Nigeria,Guinea-Bissau,0,6,0,6
29144,2022,Senegal,Guinea-Bissau,0,8,0,8
29145,2022,Sierra Leone,Guinea-Bissau,10,5,0,15
29146,2022,Türkiye,Guinea-Bissau,0,5,0,5
29147,2022,Afghanistan,Greece,33549,3407,0,36956
29148,2022,Albania,Greece,184,803,0,987
29149,2022,Algeria,Greece,137,75,0,212
29150,2022,Angola,Greece,17,51,0,68
29151,2022,Egypt,Greece,432,1875,0,2307
29152,2022,Armenia,Greece,11,32,0,43
29153,2022,Azerbaijan,Greece,5,0,0,5
29154,2022,Burundi,Greece,77,21,0,98
29155,2022,Bangladesh,Greece,352,2794,0,3146
29156,2022,Burkina Faso,Greece,47,22,0,69
29157,2022,Belarus,Greece,6,6,0,12
29158,2022,Central African Rep.,Greece,22,5,0,27
29159,2022,Chad,Greece,13,0,0,13
29160,2022,China,Greece,114,112,0,226
29161,2022,Cameroon,Greece,1047,373,0,1420
29162,2022,Congo,Greece,168,48,0,216
29163,2022,Dem. Rep. of the Congo,Greece,2384,1678,0,4062
29164,2022,Comoros,Greece,8,34,0,42
29165,2022,Cuba,Greece,18,109,0,127
29166,2022,Djibouti,Greece,17,6,0,23
29167,2022,Dominican Rep.,Greece,10,5,0,15
29168,2022,Equatorial Guinea,Greece,5,0,0,5
29169,2022,Eritrea,Greece,1439,199,0,1638
29170,2022,Ethiopia,Greece,547,62,0,609
29171,2022,Gabon,Greece,5,7,0,12
29172,2022,Gambia,Greece,122,70,0,192
29173,2022,Palestinian,Greece,6366,234,0,6600
29174,2022,Georgia,Greece,259,450,0,709
29175,2022,Ghana,Greece,99,196,0,295
29176,2022,Guinea,Greece,230,85,0,315
29177,2022,Haiti,Greece,50,7,0,57
29178,2022,Cote d'Ivoire,Greece,114,31,0,145
29179,2022,India,Greece,49,276,0,325
29180,2022,Indonesia,Greece,14,21,0,35
29181,2022,Iran (Islamic Rep. of),Greece,3491,516,0,4007
29182,2022,Iraq,Greece,14228,846,0,15074
29183,2022,Jordan,Greece,43,6,0,49
29184,2022,Kazakhstan,Greece,5,0,0,5
29185,2022,Kenya,Greece,30,9,0,39
29186,2022,Kuwait,Greece,166,7,0,173
29187,2022,Liberia,Greece,5,0,0,5
29188,2022,Libya,Greece,71,13,0,84
29189,2022,Lebanon,Greece,95,24,0,119
29190,2022,Sri Lanka,Greece,55,23,0,78
29191,2022,Mauritania,Greece,67,5,0,72
29192,2022,North Macedonia,Greece,0,5,0,5
29193,2022,Rep. of Moldova,Greece,14,32,0,46
29194,2022,Mali,Greece,177,37,0,214
29195,2022,Morocco,Greece,234,92,0,326
29196,2022,Myanmar,Greece,103,6,0,109
29197,2022,Nepal,Greece,29,45,0,74
29198,2022,Niger,Greece,19,5,0,24
29199,2022,Nigeria,Greece,378,146,0,524
29200,2022,Pakistan,Greece,1340,2600,0,3940
29201,2022,Philippines,Greece,6,5,0,11
29202,2022,Russian Federation,Greece,21,35,0,56
29203,2022,Rwanda,Greece,9,0,0,9
29204,2022,El Salvador,Greece,12,0,0,12
29205,2022,Saudi Arabia,Greece,8,0,0,8
29206,2022,Serbia and Kosovo: S/RES/1244 (1999),Greece,23,6,0,29
29207,2022,Senegal,Greece,64,40,0,104
29208,2022,Sierra Leone,Greece,302,171,0,473
29209,2022,Somalia,Greece,4698,744,0,5442
29210,2022,Viet Nam,Greece,5,0,0,5
29211,2022,Sudan,Greece,594,50,0,644
29212,2022,South Sudan,Greece,56,9,0,65
29213,2022,Syrian Arab Rep.,Greece,41594,2188,0,43782
29214,2022,United Rep. of Tanzania,Greece,13,5,0,18
29215,2022,Tajikistan,Greece,5,0,0,5
29216,2022,Turkmenistan,Greece,7,5,0,12
29217,2022,Togo,Greece,93,52,0,145
29218,2022,Tunisia,Greece,30,15,0,45
29219,2022,Türkiye,Greece,1502,1026,0,2528
29220,2022,Uganda,Greece,79,37,0,116
29221,2022,Ukraine,Greece,16882,129,0,17011
29222,2022,Uzbekistan,Greece,12,0,0,12
29223,2022,Venezuela (Bolivarian Republic of),Greece,15,5,0,20
29224,2022,Western Sahara,Greece,10,5,0,15
29225,2022,Yemen,Greece,1041,39,0,1080
29226,2022,Zimbabwe,Greece,13,0,0,13
29227,2022,Stateless,Greece,809,35,0,844
29228,2022,Unknown ,Greece,11050,5,0,11055
29229,2022,Venezuela (Bolivarian Republic of),Grenada,0,0,0,0
29230,2022,Brazil,Guatemala,0,5,0,5
29231,2022,Congo,Guatemala,0,5,0,5
29232,2022,Colombia,Guatemala,10,16,0,26
29233,2022,Cuba,Guatemala,11,15,0,26
29234,2022,Guatemala,Guatemala,0,0,0,0
29235,2022,Guinea,Guatemala,0,7,0,7
29236,2022,Haiti,Guatemala,0,0,0,0
29237,2022,Honduras,Guatemala,128,569,0,697
29238,2022,Sri Lanka,Guatemala,0,5,0,5
29239,2022,Mexico,Guatemala,0,9,0,9
29240,2022,Nicaragua,Guatemala,88,220,0,308
29241,2022,Russian Federation,Guatemala,5,0,0,5
29242,2022,El Salvador,Guatemala,317,513,0,830
29243,2022,Ukraine,Guatemala,0,5,0,5
29244,2022,Venezuela (Bolivarian Republic of),Guatemala,52,103,0,155
29245,2022,Burundi,Guinea,6,0,0,6
29246,2022,Central African Rep.,Guinea,31,0,0,31
29247,2022,Cameroon,Guinea,5,0,0,5
29248,2022,Congo,Guinea,9,0,0,9
29249,2022,Dem. Rep. of the Congo,Guinea,60,0,0,60
29250,2022,Eritrea,Guinea,14,0,0,14
29251,2022,Gambia,Guinea,5,0,0,5
29252,2022,Cote d'Ivoire,Guinea,2161,0,0,2161
29253,2022,Liberia,Guinea,335,20,0,355
29254,2022,Sri Lanka,Guinea,10,0,0,10
29255,2022,Mali,Guinea,9,0,0,9
29256,2022,Nigeria,Guinea,10,0,0,10
29257,2022,Rwanda,Guinea,10,0,0,10
29258,2022,Sierra Leone,Guinea,1651,33,0,1684
29259,2022,Somalia,Guinea,6,0,0,6
29260,2022,Syrian Arab Rep.,Guinea,14,0,0,14
29261,2022,Togo,Guinea,8,0,0,8
29262,2022,Afghanistan,Guyana,0,5,0,5
29263,2022,Cuba,Guyana,23,113,0,136
29264,2022,Haiti,Guyana,0,17,0,17
29265,2022,Venezuela (Bolivarian Republic of),Guyana,0,0,0,0
29266,2022,Afghanistan,"China, Hong Kong SAR",11,0,0,11
29267,2022,Egypt,"China, Hong Kong SAR",13,0,0,13
29268,2022,Burundi,"China, Hong Kong SAR",10,0,0,10
29269,2022,Bangladesh,"China, Hong Kong SAR",15,0,0,15
29270,2022,Central African Rep.,"China, Hong Kong SAR",5,0,0,5
29271,2022,Cameroon,"China, Hong Kong SAR",5,0,0,5
29272,2022,Dem. Rep. of the Congo,"China, Hong Kong SAR",7,0,0,7
29273,2022,Ethiopia,"China, Hong Kong SAR",7,0,0,7
29274,2022,Palestinian,"China, Hong Kong SAR",5,0,0,5
29275,2022,Indonesia,"China, Hong Kong SAR",13,0,0,13
29276,2022,Sri Lanka,"China, Hong Kong SAR",20,0,0,20
29277,2022,Nepal,"China, Hong Kong SAR",8,0,0,8
29278,2022,Pakistan,"China, Hong Kong SAR",25,0,0,25
29279,2022,Philippines,"China, Hong Kong SAR",8,0,0,8
29280,2022,Rwanda,"China, Hong Kong SAR",35,0,0,35
29281,2022,Somalia,"China, Hong Kong SAR",32,0,0,32
29282,2022,Sudan,"China, Hong Kong SAR",5,0,0,5
29283,2022,Uganda,"China, Hong Kong SAR",5,0,0,5
29284,2022,Yemen,"China, Hong Kong SAR",44,0,0,44
29285,2022,Zimbabwe,"China, Hong Kong SAR",5,0,0,5
29286,2022,Colombia,Honduras,5,0,0,5
29287,2022,Cuba,Honduras,0,5,0,5
29288,2022,Ecuador,Honduras,0,0,0,0
29289,2022,Haiti,Honduras,0,0,0,0
29290,2022,Honduras,Honduras,0,0,247090,0
29291,2022,Nicaragua,Honduras,124,101,0,225
29292,2022,El Salvador,Honduras,26,0,0,26
29293,2022,Venezuela (Bolivarian Republic of),Honduras,9,5,0,14
29294,2022,Unknown ,Honduras,0,0,0,0
29295,2022,Afghanistan,Croatia,98,483,0,581
29296,2022,Algeria,Croatia,0,5,0,5
29297,2022,Egypt,Croatia,8,0,0,8
29298,2022,Azerbaijan,Croatia,5,0,0,5
29299,2022,Burundi,Croatia,0,33,0,33
29300,2022,Bangladesh,Croatia,7,7,0,14
29301,2022,Belarus,Croatia,5,0,0,5
29302,2022,Cameroon,Croatia,5,23,0,28
29303,2022,Congo,Croatia,5,0,0,5
29304,2022,Dem. Rep. of the Congo,Croatia,7,19,0,26
29305,2022,Cuba,Croatia,0,66,0,66
29306,2022,Eritrea,Croatia,27,0,0,27
29307,2022,Ethiopia,Croatia,0,5,0,5
29308,2022,Palestinian,Croatia,0,5,0,5
29309,2022,Georgia,Croatia,5,0,0,5
29310,2022,Ghana,Croatia,0,0,0,0
29311,2022,Guinea-Bissau,Croatia,0,0,0,0
29312,2022,Guinea,Croatia,0,12,0,12
29313,2022,India,Croatia,0,15,0,15
29314,2022,Iran (Islamic Rep. of),Croatia,42,49,0,91
29315,2022,Iraq,Croatia,119,101,0,220
29316,2022,Jordan,Croatia,0,8,0,8
29317,2022,Kazakhstan,Croatia,5,0,0,5
29318,2022,Libya,Croatia,5,0,0,5
29319,2022,Mauritania,Croatia,5,0,0,5
29320,2022,Montenegro,Croatia,0,5,0,5
29321,2022,Nepal,Croatia,0,15,0,15
29322,2022,Nigeria,Croatia,13,0,0,13
29323,2022,Pakistan,Croatia,11,71,0,82
29324,2022,Russian Federation,Croatia,15,48,0,63
29325,2022,Serbia and Kosovo: S/RES/1244 (1999),Croatia,5,5,0,10
29326,2022,Somalia,Croatia,29,5,0,34
29327,2022,Sudan,Croatia,5,5,0,10
29328,2022,Syrian Arab Rep.,Croatia,552,29,0,581
29329,2022,Tunisia,Croatia,0,8,0,8
29330,2022,Türkiye,Croatia,26,50,0,76
29331,2022,Ukraine,Croatia,15387,0,0,15387
29332,2022,Uzbekistan,Croatia,5,0,0,5
29333,2022,Yemen,Croatia,7,0,0,7
29334,2022,Stateless,Croatia,12,5,0,17
29335,2022,Afghanistan,Hungary,1451,5,0,1456
29336,2022,Algeria,Hungary,14,0,0,14
29337,2022,Angola,Hungary,5,0,0,5
29338,2022,Egypt,Hungary,11,0,0,11
29339,2022,Armenia,Hungary,39,0,0,39
29340,2022,Azerbaijan,Hungary,14,0,0,14
29341,2022,Bangladesh,Hungary,10,0,0,10
29342,2022,China,Hungary,6,0,0,6
29343,2022,Cameroon,Hungary,43,0,0,43
29344,2022,Congo,Hungary,12,0,0,12
29345,2022,Dem. Rep. of the Congo,Hungary,24,0,0,24
29346,2022,Cuba,Hungary,74,0,0,74
29347,2022,Eritrea,Hungary,46,0,0,46
29348,2022,Ethiopia,Hungary,42,0,0,42
29349,2022,Palestinian,Hungary,86,0,0,86
29350,2022,Georgia,Hungary,59,0,0,59
29351,2022,Ghana,Hungary,5,0,0,5
29352,2022,Guinea,Hungary,5,0,0,5
29353,2022,Cote d'Ivoire,Hungary,16,0,0,16
29354,2022,Iran (Islamic Rep. of),Hungary,197,5,0,202
29355,2022,Iraq,Hungary,592,0,0,592
29356,2022,Libya,Hungary,7,0,0,7
29357,2022,Lebanon,Hungary,5,0,0,5
29358,2022,Sri Lanka,Hungary,11,0,0,11
29359,2022,Rep. of Moldova,Hungary,5,0,0,5
29360,2022,Nepal,Hungary,9,0,0,9
29361,2022,Nigeria,Hungary,51,0,0,51
29362,2022,Pakistan,Hungary,91,0,0,91
29363,2022,Russian Federation,Hungary,36,5,0,41
29364,2022,Serbia and Kosovo: S/RES/1244 (1999),Hungary,40,0,0,40
29365,2022,Sierra Leone,Hungary,5,0,0,5
29366,2022,Somalia,Hungary,597,0,0,597
29367,2022,Sudan,Hungary,63,0,0,63
29368,2022,Syrian Arab Rep.,Hungary,826,0,0,826
29369,2022,Tunisia,Hungary,7,0,0,7
29370,2022,Türkiye,Hungary,33,0,0,33
29371,2022,Uganda,Hungary,7,0,0,7
29372,2022,Ukraine,Hungary,25982,5,0,25987
29373,2022,Uzbekistan,Hungary,6,0,0,6
29374,2022,Yemen,Hungary,17,0,0,17
29375,2022,Zimbabwe,Hungary,5,0,0,5
29376,2022,Stateless,Hungary,62,0,0,62
29377,2022,Unknown ,Hungary,894,0,0,894
29378,2022,Afghanistan,Iceland,204,12,0,216
29379,2022,Albania,Iceland,5,0,0,5
29380,2022,Egypt,Iceland,10,0,0,10
29381,2022,Azerbaijan,Iceland,5,0,0,5
29382,2022,Bangladesh,Iceland,5,0,0,5
29383,2022,Belarus,Iceland,0,5,0,5
29384,2022,Chad,Iceland,5,0,0,5
29385,2022,China,Iceland,5,0,0,5
29386,2022,Cameroon,Iceland,5,0,0,5
29387,2022,Dem. Rep. of the Congo,Iceland,5,0,0,5
29388,2022,Eritrea,Iceland,9,0,0,9
29389,2022,Ethiopia,Iceland,11,0,0,11
29390,2022,Palestinian,Iceland,153,30,0,183
29391,2022,Georgia,Iceland,5,10,0,15
29392,2022,Ghana,Iceland,5,0,0,5
29393,2022,Honduras,Iceland,12,10,0,22
29394,2022,Cote d'Ivoire,Iceland,5,0,0,5
29395,2022,Iran (Islamic Rep. of),Iceland,100,0,0,100
29396,2022,Iraq,Iceland,315,30,0,345
29397,2022,Kazakhstan,Iceland,5,0,0,5
29398,2022,Kenya,Iceland,5,0,0,5
29399,2022,Libya,Iceland,13,5,0,18
29400,2022,Sri Lanka,Iceland,5,0,0,5
29401,2022,North Macedonia,Iceland,5,0,0,5
29402,2022,Mali,Iceland,5,0,0,5
29403,2022,Morocco,Iceland,8,0,0,8
29404,2022,Mozambique,Iceland,5,0,0,5
29405,2022,Nigeria,Iceland,66,27,0,93
29406,2022,Pakistan,Iceland,22,0,0,22
29407,2022,Peru,Iceland,5,0,0,5
29408,2022,Russian Federation,Iceland,20,15,0,35
29409,2022,El Salvador,Iceland,20,6,0,26
29410,2022,Senegal,Iceland,5,0,0,5
29411,2022,Somalia,Iceland,110,18,0,128
29412,2022,Sudan,Iceland,7,0,0,7
29413,2022,South Sudan,Iceland,5,0,0,5
29414,2022,Syrian Arab Rep.,Iceland,204,25,0,229
29415,2022,Tajikistan,Iceland,5,0,0,5
29416,2022,Tunisia,Iceland,5,0,0,5
29417,2022,Türkiye,Iceland,10,0,0,10
29418,2022,Uganda,Iceland,17,5,0,22
29419,2022,Ukraine,Iceland,1240,55,0,1295
29420,2022,Venezuela (Bolivarian Republic of),Iceland,590,409,0,999
29421,2022,Yemen,Iceland,12,8,0,20
29422,2022,Stateless,Iceland,20,0,0,20
29423,2022,Unknown ,Iceland,12,0,0,12
29424,2022,Egypt,Cote d'Ivoire,5,5,0,10
29425,2022,Burundi,Cote d'Ivoire,34,0,0,34
29426,2022,Benin,Cote d'Ivoire,0,5,0,5
29427,2022,Burkina Faso,Cote d'Ivoire,3332,5,0,3337
29428,2022,Cambodia,Cote d'Ivoire,7,0,0,7
29429,2022,Central African Rep.,Cote d'Ivoire,570,33,0,603
29430,2022,Chad,Cote d'Ivoire,5,5,0,10
29431,2022,Cameroon,Cote d'Ivoire,16,20,0,36
29432,2022,Congo,Cote d'Ivoire,85,12,0,97
29433,2022,Dem. Rep. of the Congo,Cote d'Ivoire,123,17,0,140
29434,2022,Eritrea,Cote d'Ivoire,8,0,0,8
29435,2022,Ethiopia,Cote d'Ivoire,7,5,0,12
29436,2022,Iran (Islamic Rep. of),Cote d'Ivoire,7,0,0,7
29437,2022,Iraq,Cote d'Ivoire,5,0,0,5
29438,2022,Liberia,Cote d'Ivoire,1076,5,0,1081
29439,2022,Lebanon,Cote d'Ivoire,5,0,0,5
29440,2022,Mauritania,Cote d'Ivoire,5,5,0,10
29441,2022,Mali,Cote d'Ivoire,30,7,0,37
29442,2022,Niger,Cote d'Ivoire,5,0,0,5
29443,2022,Nigeria,Cote d'Ivoire,6,5,0,11
29444,2022,Rwanda,Cote d'Ivoire,50,6,0,56
29445,2022,Senegal,Cote d'Ivoire,0,5,0,5
29446,2022,Somalia,Cote d'Ivoire,5,5,0,10
29447,2022,Viet Nam,Cote d'Ivoire,5,0,0,5
29448,2022,Sudan,Cote d'Ivoire,9,0,0,9
29449,2022,Syrian Arab Rep.,Cote d'Ivoire,148,6,0,154
29450,2022,Togo,Cote d'Ivoire,18,5,0,23
29451,2022,Türkiye,Cote d'Ivoire,34,0,0,34
29452,2022,Yemen,Cote d'Ivoire,5,0,0,5
29453,2022,Stateless,Cote d'Ivoire,0,0,0,0
29454,2022,Afghanistan,India,10064,6255,0,16319
29455,2022,Egypt,India,0,11,0,11
29456,2022,Burundi,India,0,5,0,5
29457,2022,Bangladesh,India,8,0,0,8
29458,2022,China,India,72315,0,0,72315
29459,2022,Cameroon,India,24,237,0,261
29460,2022,Congo,India,11,28,0,39
29461,2022,Dem. Rep. of the Congo,India,67,140,0,207
29462,2022,Eritrea,India,13,13,0,26
29463,2022,Ethiopia,India,28,60,0,88
29464,2022,Palestinian,India,52,14,0,66
29465,2022,Ghana,India,0,63,0,63
29466,2022,Guinea,India,0,11,0,11
29467,2022,Cote d'Ivoire,India,5,198,0,203
29468,2022,Iran (Islamic Rep. of),India,57,48,0,105
29469,2022,Iraq,India,140,45,0,185
29470,2022,Kenya,India,0,35,0,35
29471,2022,Liberia,India,0,5,0,5
29472,2022,Libya,India,8,6,0,14
29473,2022,Sri Lanka,India,92131,0,0,92131
29474,2022,Maldives,India,5,0,0,5
29475,2022,Myanmar,India,57748,6632,0,64380
29476,2022,Nigeria,India,0,509,0,509
29477,2022,Russian Federation,India,0,25,0,25
29478,2022,Rwanda,India,5,10,0,15
29479,2022,Saudi Arabia,India,5,0,0,5
29480,2022,Senegal,India,0,28,0,28
29481,2022,Sierra Leone,India,0,8,0,8
29482,2022,Somalia,India,493,320,0,813
29483,2022,Sudan,India,73,159,0,232
29484,2022,South Sudan,India,5,107,0,112
29485,2022,Syrian Arab Rep.,India,71,65,0,136
29486,2022,United Rep. of Tanzania,India,0,12,0,12
29487,2022,Tajikistan,India,0,5,0,5
29488,2022,Türkiye,India,5,0,0,5
29489,2022,Uganda,India,0,34,0,34
29490,2022,Ukraine,India,0,32,0,32
29491,2022,Uzbekistan,India,0,12,0,12
29492,2022,Venezuela (Bolivarian Republic of),India,5,6,0,11
29493,2022,Yemen,India,15,975,0,990
29494,2022,Stateless,India,0,0,0,0
29495,2022,Afghanistan,Indonesia,5684,1567,0,7251
29496,2022,Angola,Indonesia,7,0,0,7
29497,2022,Egypt,Indonesia,13,20,0,33
29498,2022,China,Indonesia,11,5,0,16
29499,2022,Cameroon,Indonesia,0,19,0,19
29500,2022,Dem. Rep. of the Congo,Indonesia,10,0,0,10
29501,2022,Eritrea,Indonesia,141,116,0,257
29502,2022,Ethiopia,Indonesia,120,35,0,155
29503,2022,Palestinian,Indonesia,161,88,0,249
29504,2022,Cote d'Ivoire,Indonesia,0,10,0,10
29505,2022,Indonesia,Indonesia,0,0,0,0
29506,2022,Iran (Islamic Rep. of),Indonesia,293,19,0,312
29507,2022,Iraq,Indonesia,433,190,0,623
29508,2022,Kuwait,Indonesia,5,0,0,5
29509,2022,Liberia,Indonesia,0,6,0,6
29510,2022,Libya,Indonesia,14,5,0,19
29511,2022,Sri Lanka,Indonesia,402,31,0,433
29512,2022,Mali,Indonesia,0,5,0,5
29513,2022,Mozambique,Indonesia,0,5,0,5
29514,2022,Myanmar,Indonesia,484,418,0,902
29515,2022,Nigeria,Indonesia,0,7,0,7
29516,2022,Pakistan,Indonesia,279,21,0,300
29517,2022,Russian Federation,Indonesia,5,5,0,10
29518,2022,Saudi Arabia,Indonesia,0,8,0,8
29519,2022,Sierra Leone,Indonesia,0,5,0,5
29520,2022,Somalia,Indonesia,1148,206,0,1354
29521,2022,Viet Nam,Indonesia,8,0,0,8
29522,2022,Sudan,Indonesia,401,108,0,509
29523,2022,Syrian Arab Rep.,Indonesia,19,25,0,44
29524,2022,United Rep. of Tanzania,Indonesia,0,6,0,6
29525,2022,Türkiye,Indonesia,0,10,0,10
29526,2022,Uganda,Indonesia,5,22,0,27
29527,2022,Venezuela (Bolivarian Republic of),Indonesia,0,5,0,5
29528,2022,Yemen,Indonesia,93,356,0,449
29529,2022,Stateless,Indonesia,0,0,0,0
29530,2022,Afghanistan,Ireland,665,380,0,1045
29531,2022,Albania,Ireland,232,255,0,487
29532,2022,Algeria,Ireland,77,923,0,1000
29533,2022,Angola,Ireland,52,35,0,87
29534,2022,Egypt,Ireland,57,188,0,245
29535,2022,Argentina,Ireland,0,5,0,5
29536,2022,Armenia,Ireland,14,0,0,14
29537,2022,Azerbaijan,Ireland,5,0,0,5
29538,2022,Bahrain,Ireland,11,0,0,11
29539,2022,Burundi,Ireland,31,5,0,36
29540,2022,Benin,Ireland,5,5,0,10
29541,2022,Bangladesh,Ireland,118,158,0,276
29542,2022,Bhutan,Ireland,10,0,0,10
29543,2022,Belarus,Ireland,23,13,0,36
29544,2022,Bolivia (Plurinational State of),Ireland,25,42,0,67
29545,2022,Botswana,Ireland,13,249,0,262
29546,2022,Brazil,Ireland,37,104,0,141
29547,2022,Bosnia and Herzegovina,Ireland,5,0,0,5
29548,2022,Chad,Ireland,5,0,0,5
29549,2022,China,Ireland,77,39,0,116
29550,2022,Cameroon,Ireland,118,30,0,148
29551,2022,Congo,Ireland,16,0,0,16
29552,2022,Dem. Rep. of the Congo,Ireland,472,172,0,644
29553,2022,Colombia,Ireland,0,5,0,5
29554,2022,Cuba,Ireland,6,0,0,6
29555,2022,Dominica,Ireland,0,5,0,5
29556,2022,Dominican Rep.,Ireland,0,5,0,5
29557,2022,Eritrea,Ireland,110,18,0,128
29558,2022,Ethiopia,Ireland,81,43,0,124
29559,2022,Gambia,Ireland,0,6,0,6
29560,2022,Palestinian,Ireland,140,33,0,173
29561,2022,United Kingdom of Great Britain and Northern Ireland,Ireland,0,5,0,5
29562,2022,Georgia,Ireland,196,1681,0,1877
29563,2022,Ghana,Ireland,41,50,0,91
29564,2022,Guatemala,Ireland,10,12,0,22
29565,2022,Guinea,Ireland,19,9,0,28
29566,2022,Guyana,Ireland,0,5,0,5
29567,2022,Honduras,Ireland,5,6,0,11
29568,2022,Cote d'Ivoire,Ireland,18,5,0,23
29569,2022,India,Ireland,20,49,0,69
29570,2022,Indonesia,Ireland,5,0,0,5
29571,2022,Iran (Islamic Rep. of),Ireland,164,25,0,189
29572,2022,Iraq,Ireland,426,73,0,499
29573,2022,Israel,Ireland,12,5,0,17
29574,2022,Jordan,Ireland,15,23,0,38
29575,2022,Kazakhstan,Ireland,18,0,0,18
29576,2022,Kenya,Ireland,63,33,0,96
29577,2022,Kyrgyzstan,Ireland,5,0,0,5
29578,2022,Dem. People's Rep. of Korea,Ireland,10,5,0,15
29579,2022,Kuwait,Ireland,53,11,0,64
29580,2022,Liberia,Ireland,12,5,0,17
29581,2022,Libya,Ireland,244,7,0,251
29582,2022,Lebanon,Ireland,9,30,0,39
29583,2022,Lesotho,Ireland,5,9,0,14
29584,2022,Sri Lanka,Ireland,25,6,0,31
29585,2022,North Macedonia,Ireland,6,0,0,6
29586,2022,Rep. of Moldova,Ireland,51,0,0,51
29587,2022,Mexico,Ireland,9,6,0,15
29588,2022,Mali,Ireland,5,0,0,5
29589,2022,Malaysia,Ireland,10,34,0,44
29590,2022,Malawi,Ireland,163,110,0,273
29591,2022,Mongolia,Ireland,9,5,0,14
29592,2022,Morocco,Ireland,18,117,0,135
29593,2022,Mozambique,Ireland,5,5,0,10
29594,2022,Montenegro,Ireland,5,0,0,5
29595,2022,Mauritius,Ireland,22,28,0,50
29596,2022,Myanmar,Ireland,15,5,0,20
29597,2022,Nepal,Ireland,11,19,0,30
29598,2022,Niger,Ireland,5,0,0,5
29599,2022,Nicaragua,Ireland,22,23,0,45
29600,2022,Nigeria,Ireland,485,1132,0,1617
29601,2022,Pakistan,Ireland,431,331,0,762
29602,2022,Panama,Ireland,0,5,0,5
29603,2022,South Africa,Ireland,186,448,0,634
29604,2022,Russian Federation,Ireland,88,32,0,120
29605,2022,Rwanda,Ireland,35,0,0,35
29606,2022,El Salvador,Ireland,64,91,0,155
29607,2022,Saudi Arabia,Ireland,20,11,0,31
29608,2022,Serbia and Kosovo: S/RES/1244 (1999),Ireland,56,10,0,66
29609,2022,Senegal,Ireland,6,0,0,6
29610,2022,Sierra Leone,Ireland,77,58,0,135
29611,2022,Somalia,Ireland,634,1130,0,1764
29612,2022,Viet Nam,Ireland,13,26,0,39
29613,2022,Sudan,Ireland,246,50,0,296
29614,2022,South Sudan,Ireland,6,0,0,6
29615,2022,Eswatini,Ireland,26,32,0,58
29616,2022,Syrian Arab Rep.,Ireland,2954,69,0,3023
29617,2022,United Rep. of Tanzania,Ireland,5,6,0,11
29618,2022,Togo,Ireland,21,30,0,51
29619,2022,Tunisia,Ireland,6,16,0,22
29620,2022,Türkiye,Ireland,28,35,0,63
29621,2022,Uganda,Ireland,52,36,0,88
29622,2022,Ukraine,Ireland,41043,205,0,41248
29623,2022,United States of America,Ireland,0,20,0,20
29624,2022,Uzbekistan,Ireland,17,0,0,17
29625,2022,Venezuela (Bolivarian Republic of),Ireland,168,30,0,198
29626,2022,Yemen,Ireland,32,14,0,46
29627,2022,Zambia,Ireland,8,5,0,13
29628,2022,Zimbabwe,Ireland,797,828,0,1625
29629,2022,Stateless,Ireland,7,0,0,7
29630,2022,Afghanistan,Iran (Islamic Rep. of),820714,0,0,820714
29631,2022,Iraq,Iran (Islamic Rep. of),20000,0,0,20000
29632,2022,Kuwait,Iran (Islamic Rep. of),8,0,0,8
29633,2022,Myanmar,Iran (Islamic Rep. of),0,34,0,34
29634,2022,Pakistan,Iran (Islamic Rep. of),10,0,0,10
29635,2022,Uzbekistan,Iran (Islamic Rep. of),7,0,0,7
29636,2022,Afghanistan,Iraq,13,150,0,163
29637,2022,Egypt,Iraq,0,42,0,42
29638,2022,Bahrain,Iraq,0,25,0,25
29639,2022,Eritrea,Iraq,5,30,0,35
29640,2022,Ethiopia,Iraq,0,8,0,8
29641,2022,Palestinian,Iraq,7864,175,0,8039
29642,2022,Indonesia,Iraq,0,5,0,5
29643,2022,Iran (Islamic Rep. of),Iraq,4122,6038,0,10160
29644,2022,Iraq,Iraq,0,0,1177234,0
29645,2022,Kazakhstan,Iraq,0,5,0,5
29646,2022,Kyrgyzstan,Iraq,0,15,0,15
29647,2022,Kuwait,Iraq,0,330,0,330
29648,2022,Lebanon,Iraq,0,19,0,19
29649,2022,Pakistan,Iraq,0,57,0,57
29650,2022,Saudi Arabia,Iraq,0,6,0,6
29651,2022,Somalia,Iraq,6,5,0,11
29652,2022,Sudan,Iraq,94,705,0,799
29653,2022,South Sudan,Iraq,0,15,0,15
29654,2022,Syrian Arab Rep.,Iraq,262756,0,0,262756
29655,2022,Tunisia,Iraq,0,5,0,5
29656,2022,Türkiye,Iraq,13344,5134,0,18478
29657,2022,Ukraine,Iraq,0,5,0,5
29658,2022,Yemen,Iraq,0,166,0,166
29659,2022,Stateless,Iraq,0,5,0,5
29660,2022,Albania,Israel,0,17,0,17
29661,2022,Armenia,Israel,0,25,0,25
29662,2022,Azerbaijan,Israel,0,29,0,29
29663,2022,Benin,Israel,0,5,0,5
29664,2022,Burkina Faso,Israel,0,6,0,6
29665,2022,Belarus,Israel,5,614,0,619
29666,2022,Bolivia (Plurinational State of),Israel,0,5,0,5
29667,2022,Botswana,Israel,0,5,0,5
29668,2022,Brazil,Israel,0,5,0,5
29669,2022,Cambodia,Israel,0,5,0,5
29670,2022,Central African Rep.,Israel,0,15,0,15
29671,2022,Chad,Israel,5,5,0,10
29672,2022,China,Israel,0,578,0,578
29673,2022,Cameroon,Israel,0,48,0,48
29674,2022,Congo,Israel,0,24,0,24
29675,2022,Dem. Rep. of the Congo,Israel,0,214,0,214
29676,2022,Colombia,Israel,0,176,0,176
29677,2022,Ecuador,Israel,0,21,0,21
29678,2022,Eritrea,Israel,223,9972,0,10195
29679,2022,Ethiopia,Israel,109,837,0,946
29680,2022,Georgia,Israel,5,31,0,36
29681,2022,Ghana,Israel,0,273,0,273
29682,2022,Haiti,Israel,0,5,0,5
29683,2022,Honduras,Israel,0,6,0,6
29684,2022,Cote d'Ivoire,Israel,7,13,0,20
29685,2022,India,Israel,0,992,0,992
29686,2022,Iran (Islamic Rep. of),Israel,6,0,0,6
29687,2022,Iraq,Israel,10,0,0,10
29688,2022,Kazakhstan,Israel,0,93,0,93
29689,2022,Kenya,Israel,0,105,0,105
29690,2022,Kyrgyzstan,Israel,0,38,0,38
29691,2022,Dem. People's Rep. of Korea,Israel,5,0,0,5
29692,2022,Liberia,Israel,0,5,0,5
29693,2022,Lesotho,Israel,0,6,0,6
29694,2022,Sri Lanka,Israel,0,891,0,891
29695,2022,North Macedonia,Israel,0,23,0,23
29696,2022,Rep. of Moldova,Israel,0,273,0,273
29697,2022,Mexico,Israel,0,5,0,5
29698,2022,Mali,Israel,0,5,0,5
29699,2022,Malawi,Israel,0,72,0,72
29700,2022,Mozambique,Israel,0,5,0,5
29701,2022,Montenegro,Israel,0,18,0,18
29702,2022,Myanmar,Israel,0,172,0,172
29703,2022,Nepal,Israel,0,95,0,95
29704,2022,Nigeria,Israel,8,832,0,840
29705,2022,Peru,Israel,0,13,0,13
29706,2022,Philippines,Israel,0,69,0,69
29707,2022,Romania,Israel,0,18,0,18
29708,2022,South Africa,Israel,0,298,0,298
29709,2022,Russian Federation,Israel,5,2438,0,2443
29710,2022,Rwanda,Israel,0,41,0,41
29711,2022,Serbia and Kosovo: S/RES/1244 (1999),Israel,0,77,0,77
29712,2022,Sierra Leone,Israel,5,13,0,18
29713,2022,Somalia,Israel,0,11,0,11
29714,2022,Viet Nam,Israel,0,9,0,9
29715,2022,Sudan,Israel,590,4406,0,4996
29716,2022,South Sudan,Israel,72,58,0,130
29717,2022,United Rep. of Tanzania,Israel,0,6,0,6
29718,2022,Thailand,Israel,0,10,0,10
29719,2022,Tajikistan,Israel,0,5,0,5
29720,2022,Turkmenistan,Israel,0,5,0,5
29721,2022,Togo,Israel,0,6,0,6
29722,2022,Türkiye,Israel,5,148,0,153
29723,2022,Uganda,Israel,0,246,0,246
29724,2022,Ukraine,Israel,27,433,0,460
29725,2022,Uzbekistan,Israel,0,227,0,227
29726,2022,Zambia,Israel,0,5,0,5
29727,2022,Zimbabwe,Israel,0,17,0,17
29728,2022,Stateless,Israel,0,0,0,0
29729,2022,Unknown ,Israel,211,39,0,250
29730,2022,Afghanistan,Italy,17706,1545,0,19251
29731,2022,Albania,Italy,1016,435,0,1451
29732,2022,Algeria,Italy,50,118,0,168
29733,2022,Angola,Italy,5,11,0,16
29734,2022,Egypt,Italy,937,4657,0,5594
29735,2022,Argentina,Italy,14,52,0,66
29736,2022,Armenia,Italy,225,107,0,332
29737,2022,Azerbaijan,Italy,5,29,0,34
29738,2022,Burundi,Italy,8,0,0,8
29739,2022,Benin,Italy,179,35,0,214
29740,2022,Bangladesh,Italy,5768,7148,0,12916
29741,2022,Burkina Faso,Italy,894,243,0,1137
29742,2022,Belarus,Italy,74,85,0,159
29743,2022,Bolivia (Plurinational State of),Italy,5,5,0,10
29744,2022,Brazil,Italy,412,228,0,640
29745,2022,Bosnia and Herzegovina,Italy,143,69,0,212
29746,2022,Central African Rep.,Italy,14,7,0,21
29747,2022,Chad,Italy,7,55,0,62
29748,2022,China,Italy,475,156,0,631
29749,2022,Chile,Italy,14,20,0,34
29750,2022,Cameroon,Italy,1762,494,0,2256
29751,2022,Congo,Italy,311,44,0,355
29752,2022,Dem. Rep. of the Congo,Italy,711,64,0,775
29753,2022,Comoros,Italy,0,5,0,5
29754,2022,Colombia,Italy,1114,948,0,2062
29755,2022,Costa Rica,Italy,0,13,0,13
29756,2022,Cuba,Italy,87,137,0,224
29757,2022,Cabo Verde,Italy,5,0,0,5
29758,2022,Dominican Rep.,Italy,16,18,0,34
29759,2022,Ecuador,Italy,26,23,0,49
29760,2022,Eritrea,Italy,3222,5210,0,8432
29761,2022,Ethiopia,Italy,979,85,0,1064
29762,2022,Gabon,Italy,0,6,0,6
29763,2022,Gambia,Italy,6324,736,0,7060
29764,2022,Palestinian,Italy,740,96,0,836
29765,2022,Georgia,Italy,887,2133,0,3020
29766,2022,Ghana,Italy,2713,408,0,3121
29767,2022,Guinea-Bissau,Italy,474,62,0,536
29768,2022,Guatemala,Italy,20,21,0,41
29769,2022,Guinea,Italy,2517,727,0,3244
29770,2022,Honduras,Italy,502,98,0,600
29771,2022,Cote d'Ivoire,Italy,4180,1330,0,5510
29772,2022,India,Italy,290,396,0,686
29773,2022,Indonesia,Italy,0,5,0,5
29774,2022,Iran (Islamic Rep. of),Italy,1261,150,0,1411
29775,2022,Iraq,Italy,5463,1152,0,6615
29776,2022,Israel,Italy,0,5,0,5
29777,2022,Jordan,Italy,5,6,0,11
29778,2022,Kazakhstan,Italy,6,12,0,18
29779,2022,Kenya,Italy,19,14,0,33
29780,2022,Kyrgyzstan,Italy,6,43,0,49
29781,2022,Liberia,Italy,349,37,0,386
29782,2022,Libya,Italy,1185,230,0,1415
29783,2022,Lebanon,Italy,27,63,0,90
29784,2022,Liechtenstein,Italy,5,0,0,5
29785,2022,Sri Lanka,Italy,384,296,0,680
29786,2022,Madagascar,Italy,0,5,0,5
29787,2022,Mauritania,Italy,257,7,0,264
29788,2022,North Macedonia,Italy,41,61,0,102
29789,2022,Rep. of Moldova,Italy,66,184,0,250
29790,2022,Mexico,Italy,5,10,0,15
29791,2022,Mali,Italy,11193,1036,0,12229
29792,2022,Malaysia,Italy,0,5,0,5
29793,2022,Morocco,Italy,1059,1368,0,2427
29794,2022,Montenegro,Italy,19,5,0,24
29795,2022,Mauritius,Italy,7,20,0,27
29796,2022,Myanmar,Italy,8,11,0,19
29797,2022,Nepal,Italy,26,87,0,113
29798,2022,Niger,Italy,472,36,0,508
29799,2022,Nicaragua,Italy,13,24,0,37
29800,2022,Nigeria,Italy,21441,4435,0,25876
29801,2022,Pakistan,Italy,17619,9967,0,27586
29802,2022,Panama,Italy,0,6,0,6
29803,2022,Paraguay,Italy,10,6,0,16
29804,2022,Peru,Italy,867,1427,0,2294
29805,2022,Philippines,Italy,25,53,0,78
29806,2022,South Africa,Italy,0,15,0,15
29807,2022,Russian Federation,Italy,258,287,0,545
29808,2022,Rwanda,Italy,5,0,0,5
29809,2022,El Salvador,Italy,4169,755,0,4924
29810,2022,Saudi Arabia,Italy,0,5,0,5
29811,2022,Serbia and Kosovo: S/RES/1244 (1999),Italy,1449,290,0,1739
29812,2022,Senegal,Italy,4820,626,0,5446
29813,2022,Sierra Leone,Italy,448,118,0,566
29814,2022,Somalia,Italy,8405,1077,0,9482
29815,2022,Viet Nam,Italy,0,5,0,5
29816,2022,Sudan,Italy,1159,383,0,1542
29817,2022,South Sudan,Italy,7,30,0,37
29818,2022,Syrian Arab Rep.,Italy,3525,903,0,4428
29819,2022,United Rep. of Tanzania,Italy,5,7,0,12
29820,2022,Thailand,Italy,0,5,0,5
29821,2022,Togo,Italy,757,94,0,851
29822,2022,Tunisia,Italy,706,1753,0,2459
29823,2022,Türkiye,Italy,1650,670,0,2320
29824,2022,Uganda,Italy,5,0,0,5
29825,2022,Ukraine,Italy,145593,1689,0,147282
29826,2022,Uruguay,Italy,5,5,0,10
29827,2022,United States of America,Italy,5,11,0,16
29828,2022,Uzbekistan,Italy,0,5,0,5
29829,2022,Venezuela (Bolivarian Republic of),Italy,3154,833,0,3987
29830,2022,Western Sahara,Italy,5,0,0,5
29831,2022,Yemen,Italy,16,41,0,57
29832,2022,Stateless,Italy,9,5,0,14
29833,2022,Unknown ,Italy,2682,471,0,3153
29834,2022,Haiti,Jamaica,31,5,0,36
29835,2022,Venezuela (Bolivarian Republic of),Jamaica,0,0,0,0
29836,2022,Afghanistan,Jordan,8,10,0,18
29837,2022,Algeria,Jordan,0,5,0,5
29838,2022,Egypt,Jordan,126,482,0,608
29839,2022,Bangladesh,Jordan,0,5,0,5
29840,2022,Bosnia and Herzegovina,Jordan,9,0,0,9
29841,2022,Bulgaria,Jordan,0,0,0,0
29842,2022,Central African Rep.,Jordan,7,0,0,7
29843,2022,Chad,Jordan,10,17,0,27
29844,2022,Comoros,Jordan,0,5,0,5
29845,2022,Eritrea,Jordan,37,5,0,42
29846,2022,Ethiopia,Jordan,19,20,0,39
29847,2022,Palestinian,Jordan,0,0,0,0
29848,2022,Iran (Islamic Rep. of),Jordan,5,0,0,5
29849,2022,Iraq,Jordan,33951,31949,0,65900
29850,2022,Jordan,Jordan,0,0,0,0
29851,2022,Kenya,Jordan,5,5,0,10
29852,2022,Libya,Jordan,47,104,0,151
29853,2022,Lebanon,Jordan,5,105,0,110
29854,2022,Sri Lanka,Jordan,9,0,0,9
29855,2022,Morocco,Jordan,0,9,0,9
29856,2022,Niger,Jordan,0,5,0,5
29857,2022,Nigeria,Jordan,5,61,0,66
29858,2022,Pakistan,Jordan,5,20,0,25
29859,2022,Philippines,Jordan,5,0,0,5
29860,2022,Russian Federation,Jordan,24,7,0,31
29861,2022,Saudi Arabia,Jordan,0,0,0,0
29862,2022,Senegal,Jordan,0,5,0,5
29863,2022,Somalia,Jordan,602,54,0,656
29864,2022,Sudan,Jordan,3438,2146,0,5584
29865,2022,South Sudan,Jordan,11,8,0,19
29866,2022,Syrian Arab Rep.,Jordan,675433,0,0,675433
29867,2022,Tajikistan,Jordan,0,15,0,15
29868,2022,Tunisia,Jordan,11,8,0,19
29869,2022,Ukraine,Jordan,0,9,0,9
29870,2022,United States of America,Jordan,0,0,0,0
29871,2022,Venezuela (Bolivarian Republic of),Jordan,0,5,0,5
29872,2022,Yemen,Jordan,1668,11236,0,12904
29873,2022,Stateless,Jordan,0,64,0,64
29874,2022,Afghanistan,Japan,84,0,0,84
29875,2022,Burundi,Japan,9,0,0,9
29876,2022,Bangladesh,Japan,18,0,0,18
29877,2022,China,Japan,77,0,0,77
29878,2022,Cameroon,Japan,19,0,0,19
29879,2022,Dem. Rep. of the Congo,Japan,23,0,0,23
29880,2022,Ethiopia,Japan,32,0,0,32
29881,2022,Guinea,Japan,5,0,0,5
29882,2022,Iran (Islamic Rep. of),Japan,19,0,0,19
29883,2022,Iraq,Japan,17,0,0,17
29884,2022,Sri Lanka,Japan,59,0,0,59
29885,2022,Myanmar,Japan,583,0,0,583
29886,2022,Nigeria,Japan,5,0,0,5
29887,2022,Pakistan,Japan,34,0,0,34
29888,2022,Rwanda,Japan,5,0,0,5
29889,2022,Somalia,Japan,5,0,0,5
29890,2022,Sudan,Japan,16,0,0,16
29891,2022,Syrian Arab Rep.,Japan,93,0,0,93
29892,2022,Türkiye,Japan,46,0,0,46
29893,2022,Uganda,Japan,6,0,0,6
29894,2022,Yemen,Japan,15,0,0,15
29895,2022,Stateless,Japan,9,0,0,9
29896,2022,Unknown ,Japan,329,16709,0,17038
29897,2022,Afghanistan,Kazakhstan,325,386,0,711
29898,2022,China,Kazakhstan,6,7,0,13
29899,2022,Iran (Islamic Rep. of),Kazakhstan,0,6,0,6
29900,2022,Kyrgyzstan,Kazakhstan,0,5,0,5
29901,2022,Russian Federation,Kazakhstan,0,5,0,5
29902,2022,Syrian Arab Rep.,Kazakhstan,14,5,0,19
29903,2022,Ukraine,Kazakhstan,0,228,0,228
29904,2022,Uzbekistan,Kazakhstan,5,0,0,5
29905,2022,Stateless,Kazakhstan,0,0,0,0
29906,2022,Afghanistan,Kenya,11,36,0,47
29907,2022,Egypt,Kenya,0,17,0,17
29908,2022,Burundi,Kenya,7697,13121,0,20818
29909,2022,Central African Rep.,Kenya,0,13,0,13
29910,2022,Chad,Kenya,0,5,0,5
29911,2022,Cameroon,Kenya,0,59,0,59
29912,2022,Congo,Kenya,100,81,0,181
29913,2022,Dem. Rep. of the Congo,Kenya,31342,19920,0,51262
29914,2022,Eritrea,Kenya,905,1536,0,2441
29915,2022,Ethiopia,Kenya,21066,10433,0,31499
29916,2022,Cote d'Ivoire,Kenya,0,5,0,5
29917,2022,India,Kenya,0,5,0,5
29918,2022,Sri Lanka,Kenya,9,0,0,9
29919,2022,Mozambique,Kenya,8,0,0,8
29920,2022,Nigeria,Kenya,6,9,0,15
29921,2022,Pakistan,Kenya,10,11,0,21
29922,2022,Rwanda,Kenya,791,1321,0,2112
29923,2022,Somalia,Kenya,279200,8575,0,287775
29924,2022,Sudan,Kenya,5022,5194,0,10216
29925,2022,South Sudan,Kenya,144441,79,0,144520
29926,2022,Syrian Arab Rep.,Kenya,5,5,0,10
29927,2022,United Rep. of Tanzania,Kenya,11,118,0,129
29928,2022,Türkiye,Kenya,137,67,0,204
29929,2022,Uganda,Kenya,800,2664,0,3464
29930,2022,Yemen,Kenya,95,220,0,315
29931,2022,Zimbabwe,Kenya,6,6,0,12
29932,2022,Stateless,Kenya,0,0,0,0
29933,2022,Afghanistan,Kyrgyzstan,208,491,0,699
29934,2022,Palestinian,Kyrgyzstan,0,5,0,5
29935,2022,Iraq,Kyrgyzstan,5,0,0,5
29936,2022,Pakistan,Kyrgyzstan,0,5,0,5
29937,2022,Philippines,Kyrgyzstan,0,5,0,5
29938,2022,Syrian Arab Rep.,Kyrgyzstan,69,9,0,78
29939,2022,Turkmenistan,Kyrgyzstan,5,0,0,5
29940,2022,Türkiye,Kyrgyzstan,0,283,0,283
29941,2022,Ukraine,Kyrgyzstan,17,6,0,23
29942,2022,Venezuela (Bolivarian Republic of),Kyrgyzstan,0,5,0,5
29943,2022,Stateless,Kyrgyzstan,0,0,0,0
29944,2022,Afghanistan,Rep. of Korea,46,59,0,105
29945,2022,Algeria,Rep. of Korea,6,73,0,79
29946,2022,Angola,Rep. of Korea,9,18,0,27
29947,2022,Egypt,Rep. of Korea,72,753,0,825
29948,2022,Argentina,Rep. of Korea,0,8,0,8
29949,2022,Azerbaijan,Rep. of Korea,0,8,0,8
29950,2022,Burundi,Rep. of Korea,47,15,0,62
29951,2022,Bangladesh,Rep. of Korea,129,1004,0,1133
29952,2022,Burkina Faso,Rep. of Korea,0,5,0,5
29953,2022,Bolivia (Plurinational State of),Rep. of Korea,0,5,0,5
29954,2022,Brazil,Rep. of Korea,0,13,0,13
29955,2022,Cambodia,Rep. of Korea,0,47,0,47
29956,2022,China,Rep. of Korea,50,1121,0,1171
29957,2022,Cameroon,Rep. of Korea,23,164,0,187
29958,2022,Congo,Rep. of Korea,0,8,0,8
29959,2022,Dem. Rep. of the Congo,Rep. of Korea,62,24,0,86
29960,2022,Colombia,Rep. of Korea,0,5,0,5
29961,2022,Eritrea,Rep. of Korea,10,0,0,10
29962,2022,Ethiopia,Rep. of Korea,171,164,0,335
29963,2022,Gambia,Rep. of Korea,0,44,0,44
29964,2022,Palestinian,Rep. of Korea,8,6,0,14
29965,2022,Ghana,Rep. of Korea,7,195,0,202
29966,2022,Guinea,Rep. of Korea,5,116,0,121
29967,2022,Haiti,Rep. of Korea,0,23,0,23
29968,2022,Cote d'Ivoire,Rep. of Korea,38,22,0,60
29969,2022,India,Rep. of Korea,0,1294,0,1294
29970,2022,Indonesia,Rep. of Korea,0,29,0,29
29971,2022,Iran (Islamic Rep. of),Rep. of Korea,62,54,0,116
29972,2022,Iraq,Rep. of Korea,28,84,0,112
29973,2022,Jordan,Rep. of Korea,7,16,0,23
29974,2022,Kazakhstan,Rep. of Korea,5,669,0,674
29975,2022,Kenya,Rep. of Korea,5,36,0,41
29976,2022,Kyrgyzstan,Rep. of Korea,0,101,0,101
29977,2022,Liberia,Rep. of Korea,12,164,0,176
29978,2022,Libya,Rep. of Korea,15,60,0,75
29979,2022,Sri Lanka,Rep. of Korea,8,191,0,199
29980,2022,Mali,Rep. of Korea,8,78,0,86
29981,2022,Malaysia,Rep. of Korea,0,875,0,875
29982,2022,Mongolia,Rep. of Korea,0,177,0,177
29983,2022,Morocco,Rep. of Korea,5,176,0,181
29984,2022,Mozambique,Rep. of Korea,0,7,0,7
29985,2022,Myanmar,Rep. of Korea,396,107,0,503
29986,2022,Nepal,Rep. of Korea,5,391,0,396
29987,2022,Nigeria,Rep. of Korea,13,343,0,356
29988,2022,Pakistan,Rep. of Korea,118,938,0,1056
29989,2022,Peru,Rep. of Korea,0,9,0,9
29990,2022,Philippines,Rep. of Korea,0,331,0,331
29991,2022,South Africa,Rep. of Korea,0,50,0,50
29992,2022,Russian Federation,Rep. of Korea,13,1000,0,1013
29993,2022,Rwanda,Rep. of Korea,0,30,0,30
29994,2022,Saudi Arabia,Rep. of Korea,0,5,0,5
29995,2022,Senegal,Rep. of Korea,0,50,0,50
29996,2022,Sierra Leone,Rep. of Korea,0,26,0,26
29997,2022,Somalia,Rep. of Korea,5,0,0,5
29998,2022,Viet Nam,Rep. of Korea,0,63,0,63
29999,2022,Sudan,Rep. of Korea,32,46,0,78
30000,2022,Syrian Arab Rep.,Rep. of Korea,1250,28,0,1278
30001,2022,United Rep. of Tanzania,Rep. of Korea,5,34,0,39
30002,2022,Thailand,Rep. of Korea,10,179,0,189
30003,2022,Tajikistan,Rep. of Korea,0,24,0,24
30004,2022,Togo,Rep. of Korea,0,14,0,14
30005,2022,Tunisia,Rep. of Korea,0,55,0,55
30006,2022,Türkiye,Rep. of Korea,0,186,0,186
30007,2022,Uganda,Rep. of Korea,38,50,0,88
30008,2022,Ukraine,Rep. of Korea,14,24,0,38
30009,2022,United States of America,Rep. of Korea,0,5,0,5
30010,2022,Uzbekistan,Rep. of Korea,9,201,0,210
30011,2022,Venezuela (Bolivarian Republic of),Rep. of Korea,0,12,0,12
30012,2022,Yemen,Rep. of Korea,813,18,0,831
30013,2022,Zimbabwe,Rep. of Korea,0,6,0,6
30014,2022,Stateless,Rep. of Korea,0,5,0,5
30015,2022,Unknown ,Rep. of Korea,0,5,0,5
30016,2022,Afghanistan,Kuwait,0,17,0,17
30017,2022,Egypt,Kuwait,6,19,0,25
30018,2022,Djibouti,Kuwait,0,5,0,5
30019,2022,Eritrea,Kuwait,5,28,0,33
30020,2022,Ethiopia,Kuwait,0,7,0,7
30021,2022,Palestinian,Kuwait,5,5,0,10
30022,2022,Iran (Islamic Rep. of),Kuwait,9,83,0,92
30023,2022,Iraq,Kuwait,334,307,0,641
30024,2022,Jordan,Kuwait,0,6,0,6
30025,2022,Lebanon,Kuwait,0,5,0,5
30026,2022,Sri Lanka,Kuwait,0,6,0,6
30027,2022,Pakistan,Kuwait,0,12,0,12
30028,2022,Philippines,Kuwait,0,5,0,5
30029,2022,Somalia,Kuwait,189,444,0,633
30030,2022,Sudan,Kuwait,0,17,0,17
30031,2022,Syrian Arab Rep.,Kuwait,147,107,0,254
30032,2022,Ukraine,Kuwait,0,5,0,5
30033,2022,Yemen,Kuwait,9,10,0,19
30034,2022,Stateless,Kuwait,0,0,0,0
30035,2022,Unknown ,Kuwait,0,0,0,0
30036,2022,Central African Rep.,Liberia,5,0,0,5
30037,2022,Cameroon,Liberia,6,0,0,6
30038,2022,Dem. Rep. of the Congo,Liberia,28,5,0,33
30039,2022,Guinea,Liberia,0,5,0,5
30040,2022,Cote d'Ivoire,Liberia,3114,1320,0,4434
30041,2022,Mali,Liberia,19,0,0,19
30042,2022,Nigeria,Liberia,0,6,0,6
30043,2022,Pakistan,Liberia,6,0,0,6
30044,2022,Rwanda,Liberia,5,0,0,5
30045,2022,Sierra Leone,Liberia,5,0,0,5
30046,2022,Somalia,Liberia,5,0,0,5
30047,2022,Sudan,Liberia,11,0,0,11
30048,2022,South Sudan,Liberia,5,0,0,5
30049,2022,Syrian Arab Rep.,Liberia,28,33,0,61
30050,2022,Togo,Liberia,5,0,0,5
30051,2022,Türkiye,Liberia,16,0,0,16
30052,2022,Afghanistan,Libya,0,5,0,5
30053,2022,Chad,Libya,0,5,0,5
30054,2022,Eritrea,Libya,355,4037,0,4392
30055,2022,Ethiopia,Libya,34,1293,0,1327
30056,2022,Palestinian,Libya,161,695,0,856
30057,2022,Cote d'Ivoire,Libya,0,7,0,7
30058,2022,Iraq,Libya,201,102,0,303
30059,2022,Libya,Libya,0,0,159996,0
30060,2022,Nigeria,Libya,0,25,0,25
30061,2022,Somalia,Libya,22,788,0,810
30062,2022,Sudan,Libya,1436,16078,0,17514
30063,2022,South Sudan,Libya,5,352,0,357
30064,2022,Syrian Arab Rep.,Libya,480,13682,0,14162
30065,2022,Yemen,Libya,11,115,0,126
30066,2022,Afghanistan,Lebanon,36,5,0,41
30067,2022,Algeria,Lebanon,5,6,0,11
30068,2022,Egypt,Lebanon,129,446,0,575
30069,2022,Armenia,Lebanon,0,11,0,11
30070,2022,Bahrain,Lebanon,14,5,0,19
30071,2022,Bangladesh,Lebanon,0,120,0,120
30072,2022,Cameroon,Lebanon,10,17,0,27
30073,2022,Congo,Lebanon,0,5,0,5
30074,2022,Dem. Rep. of the Congo,Lebanon,5,13,0,18
30075,2022,Eritrea,Lebanon,19,20,0,39
30076,2022,Ethiopia,Lebanon,93,1101,0,1194
30077,2022,Gambia,Lebanon,0,5,0,5
30078,2022,Palestinian,Lebanon,0,0,0,0
30079,2022,Ghana,Lebanon,0,7,0,7
30080,2022,Cote d'Ivoire,Lebanon,0,9,0,9
30081,2022,India,Lebanon,0,13,0,13
30082,2022,Iran (Islamic Rep. of),Lebanon,33,56,0,89
30083,2022,Iraq,Lebanon,3389,4756,0,8145
30084,2022,Jordan,Lebanon,38,90,0,128
30085,2022,Kenya,Lebanon,5,18,0,23
30086,2022,Kuwait,Lebanon,9,0,0,9
30087,2022,Libya,Lebanon,11,15,0,26
30088,2022,Lebanon,Lebanon,0,0,0,0
30089,2022,Sri Lanka,Lebanon,0,24,0,24
30090,2022,Madagascar,Lebanon,0,13,0,13
30091,2022,Morocco,Lebanon,5,9,0,14
30092,2022,Nigeria,Lebanon,5,75,0,80
30093,2022,Pakistan,Lebanon,6,14,0,20
30094,2022,Philippines,Lebanon,0,33,0,33
30095,2022,Saudi Arabia,Lebanon,7,7,0,14
30096,2022,Sierra Leone,Lebanon,0,5,0,5
30097,2022,Somalia,Lebanon,11,0,0,11
30098,2022,Sudan,Lebanon,745,1641,0,2386
30099,2022,South Sudan,Lebanon,38,0,0,38
30100,2022,Syrian Arab Rep.,Lebanon,831053,0,0,831053
30101,2022,Togo,Lebanon,0,10,0,10
30102,2022,Tunisia,Lebanon,9,0,0,9
30103,2022,Türkiye,Lebanon,8,6,0,14
30104,2022,Ukraine,Lebanon,0,12,0,12
30105,2022,Venezuela (Bolivarian Republic of),Lebanon,0,5,0,5
30106,2022,Yemen,Lebanon,31,98,0,129
30107,2022,Unknown ,Lebanon,0,5,0,5
30108,2022,Cambodia,Lesotho,5,0,0,5
30109,2022,Cameroon,Lesotho,0,13,0,13
30110,2022,Congo,Lesotho,0,5,0,5
30111,2022,Dem. Rep. of the Congo,Lesotho,178,173,0,351
30112,2022,Eritrea,Lesotho,31,45,0,76
30113,2022,Ethiopia,Lesotho,6,11,0,17
30114,2022,Lesotho,Lesotho,0,0,0,0
30115,2022,Nigeria,Lesotho,0,6,0,6
30116,2022,Pakistan,Lesotho,0,5,0,5
30117,2022,Somalia,Lesotho,0,5,0,5
30118,2022,Uganda,Lesotho,9,5,0,14
30119,2022,Zambia,Lesotho,5,0,0,5
30120,2022,Zimbabwe,Lesotho,0,10,0,10
30121,2022,Belarus,Liechtenstein,0,5,0,5
30122,2022,Bosnia and Herzegovina,Liechtenstein,5,0,0,5
30123,2022,China,Liechtenstein,54,0,0,54
30124,2022,Eritrea,Liechtenstein,22,0,0,22
30125,2022,Georgia,Liechtenstein,0,5,0,5
30126,2022,Iran (Islamic Rep. of),Liechtenstein,18,0,0,18
30127,2022,Iraq,Liechtenstein,14,0,0,14
30128,2022,Kazakhstan,Liechtenstein,0,5,0,5
30129,2022,Libya,Liechtenstein,0,5,0,5
30130,2022,North Macedonia,Liechtenstein,0,5,0,5
30131,2022,Morocco,Liechtenstein,0,9,0,9
30132,2022,Russian Federation,Liechtenstein,0,5,0,5
30133,2022,Somalia,Liechtenstein,46,0,0,46
30134,2022,Sudan,Liechtenstein,0,9,0,9
30135,2022,Syrian Arab Rep.,Liechtenstein,65,0,0,65
30136,2022,Tunisia,Liechtenstein,0,5,0,5
30137,2022,Ukraine,Liechtenstein,280,0,0,280
30138,2022,Stateless,Liechtenstein,0,5,0,5
30139,2022,Afghanistan,Sri Lanka,111,5,0,116
30140,2022,Palestinian,Sri Lanka,5,0,0,5
30141,2022,India,Sri Lanka,0,5,0,5
30142,2022,Iran (Islamic Rep. of),Sri Lanka,15,0,0,15
30143,2022,Sri Lanka,Sri Lanka,0,0,8540,0
30144,2022,Maldives,Sri Lanka,0,5,0,5
30145,2022,Myanmar,Sri Lanka,35,0,0,35
30146,2022,Nigeria,Sri Lanka,0,10,0,10
30147,2022,Pakistan,Sri Lanka,551,134,0,685
30148,2022,Sudan,Sri Lanka,5,5,0,10
30149,2022,Yemen,Sri Lanka,14,5,0,19
30150,2022,Stateless,Sri Lanka,0,0,0,0
30151,2022,Afghanistan,Lithuania,238,18,0,256
30152,2022,Azerbaijan,Lithuania,17,0,0,17
30153,2022,Belarus,Lithuania,121,210,0,331
30154,2022,Chile,Lithuania,0,5,0,5
30155,2022,Cameroon,Lithuania,6,0,0,6
30156,2022,Cuba,Lithuania,5,5,0,10
30157,2022,Eritrea,Lithuania,40,0,0,40
30158,2022,Ethiopia,Lithuania,5,0,0,5
30159,2022,Georgia,Lithuania,5,0,0,5
30160,2022,Iran (Islamic Rep. of),Lithuania,14,0,0,14
30161,2022,Iraq,Lithuania,74,0,0,74
30162,2022,Kazakhstan,Lithuania,0,5,0,5
30163,2022,Sri Lanka,Lithuania,10,12,0,22
30164,2022,Nigeria,Lithuania,5,0,0,5
30165,2022,Pakistan,Lithuania,5,0,0,5
30166,2022,Russian Federation,Lithuania,698,67,0,765
30167,2022,Somalia,Lithuania,24,0,0,24
30168,2022,South Sudan,Lithuania,5,0,0,5
30169,2022,Syrian Arab Rep.,Lithuania,479,35,0,514
30170,2022,Tajikistan,Lithuania,87,10,0,97
30171,2022,Türkiye,Lithuania,69,0,0,69
30172,2022,Ukraine,Lithuania,47569,9,0,47578
30173,2022,Uzbekistan,Lithuania,17,0,0,17
30174,2022,Yemen,Lithuania,5,5,0,10
30175,2022,Stateless,Lithuania,37,0,0,37
30176,2022,Afghanistan,Luxembourg,413,189,0,602
30177,2022,Albania,Luxembourg,28,10,0,38
30178,2022,Algeria,Luxembourg,30,15,0,45
30179,2022,Angola,Luxembourg,9,11,0,20
30180,2022,Egypt,Luxembourg,5,5,0,10
30181,2022,Armenia,Luxembourg,5,0,0,5
30182,2022,Azerbaijan,Luxembourg,12,0,0,12
30183,2022,Bhutan,Luxembourg,5,0,0,5
30184,2022,Burkina Faso,Luxembourg,0,5,0,5
30185,2022,Belarus,Luxembourg,0,10,0,10
30186,2022,Bosnia and Herzegovina,Luxembourg,5,6,0,11
30187,2022,China,Luxembourg,7,0,0,7
30188,2022,Cameroon,Luxembourg,36,36,0,72
30189,2022,Dem. Rep. of the Congo,Luxembourg,42,11,0,53
30190,2022,Colombia,Luxembourg,0,30,0,30
30191,2022,Eritrea,Luxembourg,1440,200,0,1640
30192,2022,Ethiopia,Luxembourg,59,48,0,107
30193,2022,Gambia,Luxembourg,6,0,0,6
30194,2022,Georgia,Luxembourg,5,8,0,13
30195,2022,Guinea,Luxembourg,9,0,0,9
30196,2022,Cote d'Ivoire,Luxembourg,5,15,0,20
30197,2022,Iran (Islamic Rep. of),Luxembourg,196,76,0,272
30198,2022,Iraq,Luxembourg,652,97,0,749
30199,2022,Kyrgyzstan,Luxembourg,5,0,0,5
30200,2022,Rep. of Korea,Luxembourg,9,0,0,9
30201,2022,Kuwait,Luxembourg,0,6,0,6
30202,2022,Libya,Luxembourg,5,21,0,26
30203,2022,Lebanon,Luxembourg,0,15,0,15
30204,2022,Sri Lanka,Luxembourg,5,0,0,5
30205,2022,Mali,Luxembourg,0,5,0,5
30206,2022,Morocco,Luxembourg,5,5,0,10
30207,2022,Montenegro,Luxembourg,6,5,0,11
30208,2022,Myanmar,Luxembourg,0,5,0,5
30209,2022,Niger,Luxembourg,0,5,0,5
30210,2022,Nigeria,Luxembourg,10,8,0,18
30211,2022,Pakistan,Luxembourg,0,5,0,5
30212,2022,Russian Federation,Luxembourg,30,22,0,52
30213,2022,Rwanda,Luxembourg,8,5,0,13
30214,2022,El Salvador,Luxembourg,0,9,0,9
30215,2022,Serbia and Kosovo: S/RES/1244 (1999),Luxembourg,97,5,0,102
30216,2022,Senegal,Luxembourg,5,9,0,14
30217,2022,Somalia,Luxembourg,60,32,0,92
30218,2022,Sudan,Luxembourg,55,42,0,97
30219,2022,Syrian Arab Rep.,Luxembourg,2049,537,0,2586
30220,2022,United Rep. of Tanzania,Luxembourg,0,5,0,5
30221,2022,Tajikistan,Luxembourg,0,5,0,5
30222,2022,Turkmenistan,Luxembourg,5,0,0,5
30223,2022,Togo,Luxembourg,8,7,0,15
30224,2022,Tunisia,Luxembourg,7,18,0,25
30225,2022,Türkiye,Luxembourg,139,49,0,188
30226,2022,Uganda,Luxembourg,5,0,0,5
30227,2022,Ukraine,Luxembourg,4259,10,0,4269
30228,2022,Venezuela (Bolivarian Republic of),Luxembourg,5,151,0,156
30229,2022,Yemen,Luxembourg,28,7,0,35
30230,2022,Stateless,Luxembourg,94,0,0,94
30231,2022,Unknown ,Luxembourg,0,30,0,30
30232,2022,Afghanistan,Latvia,147,46,0,193
30233,2022,Egypt,Latvia,5,0,0,5
30234,2022,Azerbaijan,Latvia,11,12,0,23
30235,2022,Belarus,Latvia,102,23,0,125
30236,2022,China,Latvia,5,0,0,5
30237,2022,Eritrea,Latvia,35,0,0,35
30238,2022,Palestinian,Latvia,7,0,0,7
30239,2022,Iran (Islamic Rep. of),Latvia,17,0,0,17
30240,2022,Iraq,Latvia,44,12,0,56
30241,2022,Kazakhstan,Latvia,5,0,0,5
30242,2022,Kyrgyzstan,Latvia,5,0,0,5
30243,2022,Lebanon,Latvia,5,0,0,5
30244,2022,Sri Lanka,Latvia,5,13,0,18
30245,2022,Morocco,Latvia,0,5,0,5
30246,2022,Pakistan,Latvia,0,5,0,5
30247,2022,Russian Federation,Latvia,62,38,0,100
30248,2022,Somalia,Latvia,5,0,0,5
30249,2022,Syrian Arab Rep.,Latvia,317,0,0,317
30250,2022,Tajikistan,Latvia,5,5,0,10
30251,2022,Türkiye,Latvia,31,0,0,31
30252,2022,Ukraine,Latvia,34256,5,0,34261
30253,2022,Uzbekistan,Latvia,12,6,0,18
30254,2022,Stateless,Latvia,0,0,0,0
30255,2022,Afghanistan,Madagascar,19,0,0,19
30256,2022,Burundi,Madagascar,5,0,0,5
30257,2022,Congo,Madagascar,0,5,0,5
30258,2022,Dem. Rep. of the Congo,Madagascar,11,0,0,11
30259,2022,Guinea,Madagascar,6,0,0,6
30260,2022,Madagascar,Madagascar,0,0,0,0
30261,2022,Pakistan,Madagascar,125,87,0,212
30262,2022,Syrian Arab Rep.,Madagascar,5,0,0,5
30263,2022,Yemen,Madagascar,14,12,0,26
30264,2022,Benin,Mauritania,0,8,0,8
30265,2022,Burkina Faso,Mauritania,17,92,0,109
30266,2022,Central African Rep.,Mauritania,651,109,0,760
30267,2022,Chad,Mauritania,0,13,0,13
30268,2022,China,Mauritania,5,0,0,5
30269,2022,Cameroon,Mauritania,18,150,0,168
30270,2022,Congo,Mauritania,7,19,0,26
30271,2022,Dem. Rep. of the Congo,Mauritania,31,30,0,61
30272,2022,Ethiopia,Mauritania,8,8,0,16
30273,2022,Gambia,Mauritania,0,8,0,8
30274,2022,Palestinian,Mauritania,78,35,0,113
30275,2022,Ghana,Mauritania,0,9,0,9
30276,2022,Guinea,Mauritania,18,198,0,216
30277,2022,Cote d'Ivoire,Mauritania,274,201,0,475
30278,2022,Iraq,Mauritania,24,0,0,24
30279,2022,Liberia,Mauritania,7,24,0,31
30280,2022,Libya,Mauritania,8,5,0,13
30281,2022,Lebanon,Mauritania,0,30,0,30
30282,2022,Mali,Mauritania,86315,2668,0,88983
30283,2022,Niger,Mauritania,5,37,0,42
30284,2022,Nigeria,Mauritania,13,100,0,113
30285,2022,Russian Federation,Mauritania,11,0,0,11
30286,2022,Rwanda,Mauritania,0,5,0,5
30287,2022,Senegal,Mauritania,118,229,0,347
30288,2022,Sierra Leone,Mauritania,0,189,0,189
30289,2022,Somalia,Mauritania,5,5,0,10
30290,2022,Sudan,Mauritania,13,36,0,49
30291,2022,Syrian Arab Rep.,Mauritania,381,183,0,564
30292,2022,Togo,Mauritania,17,157,0,174
30293,2022,Türkiye,Mauritania,5,15,0,20
30294,2022,Western Sahara,Mauritania,26000,0,0,26000
30295,2022,Yemen,Mauritania,45,29,0,74
30296,2022,Congo,North Macedonia,5,0,0,5
30297,2022,Iraq,North Macedonia,0,5,0,5
30298,2022,Morocco,North Macedonia,0,5,0,5
30299,2022,Serbia and Kosovo: S/RES/1244 (1999),North Macedonia,251,0,0,251
30300,2022,Syrian Arab Rep.,North Macedonia,0,0,0,0
30301,2022,Türkiye,North Macedonia,0,5,0,5
30302,2022,Ukraine,North Macedonia,1174,0,0,1174
30303,2022,Stateless,North Macedonia,0,0,0,0
30304,2022,Iraq,Monaco,5,0,0,5
30305,2022,Viet Nam,Monaco,7,0,0,7
30306,2022,Syrian Arab Rep.,Monaco,5,0,0,5
30307,2022,Afghanistan,Rep. of Moldova,17,9,0,26
30308,2022,Algeria,Rep. of Moldova,0,25,0,25
30309,2022,Egypt,Rep. of Moldova,5,5,0,10
30310,2022,Armenia,Rep. of Moldova,118,7,0,125
30311,2022,Australia,Rep. of Moldova,5,0,0,5
30312,2022,Austria,Rep. of Moldova,8,0,0,8
30313,2022,Azerbaijan,Rep. of Moldova,709,57,0,766
30314,2022,Belgium,Rep. of Moldova,5,0,0,5
30315,2022,Belarus,Rep. of Moldova,66,7,0,73
30316,2022,Bulgaria,Rep. of Moldova,175,0,0,175
30317,2022,Canada,Rep. of Moldova,13,0,0,13
30318,2022,China,Rep. of Moldova,72,5,0,77
30319,2022,Cameroon,Rep. of Moldova,0,5,0,5
30320,2022,Cuba,Rep. of Moldova,0,8,0,8
30321,2022,Ecuador,Rep. of Moldova,0,5,0,5
30322,2022,Finland,Rep. of Moldova,5,0,0,5
30323,2022,France,Rep. of Moldova,18,0,0,18
30324,2022,Palestinian,Rep. of Moldova,5,0,0,5
30325,2022,United Kingdom of Great Britain and Northern Ireland,Rep. of Moldova,21,0,0,21
30326,2022,Georgia,Rep. of Moldova,144,24,0,168
30327,2022,Germany,Rep. of Moldova,33,0,0,33
30328,2022,Greece,Rep. of Moldova,16,0,0,16
30329,2022,Hungary,Rep. of Moldova,8,0,0,8
30330,2022,India,Rep. of Moldova,0,33,0,33
30331,2022,Ireland,Rep. of Moldova,10,0,0,10
30332,2022,Iran (Islamic Rep. of),Rep. of Moldova,0,16,0,16
30333,2022,Iraq,Rep. of Moldova,17,24,0,41
30334,2022,Israel,Rep. of Moldova,86,19,0,105
30335,2022,Italy,Rep. of Moldova,33,0,0,33
30336,2022,Jordan,Rep. of Moldova,0,5,0,5
30337,2022,Japan,Rep. of Moldova,5,0,0,5
30338,2022,Kazakhstan,Rep. of Moldova,27,0,0,27
30339,2022,Kyrgyzstan,Rep. of Moldova,21,5,0,26
30340,2022,Libya,Rep. of Moldova,5,0,0,5
30341,2022,Lebanon,Rep. of Moldova,8,7,0,15
30342,2022,Lithuania,Rep. of Moldova,7,0,0,7
30343,2022,Latvia,Rep. of Moldova,13,0,0,13
30344,2022,Martinique,Rep. of Moldova,0,361,0,361
30345,2022,Netherlands,Rep. of Moldova,5,0,0,5
30346,2022,Nigeria,Rep. of Moldova,0,57,0,57
30347,2022,Pakistan,Rep. of Moldova,0,5,0,5
30348,2022,Philippines,Rep. of Moldova,0,5,0,5
30349,2022,Poland,Rep. of Moldova,13,0,0,13
30350,2022,Portugal,Rep. of Moldova,6,0,0,6
30351,2022,Romania,Rep. of Moldova,804,5,0,809
30352,2022,Russian Federation,Rep. of Moldova,664,56,0,720
30353,2022,Spain,Rep. of Moldova,10,0,0,10
30354,2022,Viet Nam,Rep. of Moldova,0,89,0,89
30355,2022,Sudan,Rep. of Moldova,9,0,0,9
30356,2022,Sweden,Rep. of Moldova,5,0,0,5
30357,2022,Switzerland,Rep. of Moldova,5,0,0,5
30358,2022,Syrian Arab Rep.,Rep. of Moldova,166,46,0,212
30359,2022,Tajikistan,Rep. of Moldova,23,5,0,28
30360,2022,Turkmenistan,Rep. of Moldova,23,9,0,32
30361,2022,Tunisia,Rep. of Moldova,0,56,0,56
30362,2022,Türkiye,Rep. of Moldova,182,30,0,212
30363,2022,Ukraine,Rep. of Moldova,75762,7108,0,82870
30364,2022,United States of America,Rep. of Moldova,69,0,0,69
30365,2022,Uzbekistan,Rep. of Moldova,45,11,0,56
30366,2022,Yemen,Rep. of Moldova,11,0,0,11
30367,2022,Zimbabwe,Rep. of Moldova,0,8,0,8
30368,2022,Stateless,Rep. of Moldova,0,0,0,0
30369,2022,Afghanistan,Mexico,5,62,0,67
30370,2022,Albania,Mexico,8,0,0,8
30371,2022,Algeria,Mexico,5,5,0,10
30372,2022,Angola,Mexico,13,1054,0,1067
30373,2022,Egypt,Mexico,5,17,0,22
30374,2022,Argentina,Mexico,5,237,0,242
30375,2022,Benin,Mexico,5,31,0,36
30376,2022,Bangladesh,Mexico,10,119,0,129
30377,2022,Burkina Faso,Mexico,17,97,0,114
30378,2022,Belarus,Mexico,0,5,0,5
30379,2022,Bolivia (Plurinational State of),Mexico,0,43,0,43
30380,2022,Brazil,Mexico,264,4845,0,5109
30381,2022,Belize,Mexico,28,57,0,85
30382,2022,Cambodia,Mexico,24,47,0,71
30383,2022,Canada,Mexico,0,23,0,23
30384,2022,Central African Rep.,Mexico,0,5,0,5
30385,2022,Chad,Mexico,0,8,0,8
30386,2022,China,Mexico,5,32,0,37
30387,2022,Chile,Mexico,489,6623,0,7112
30388,2022,Cameroon,Mexico,30,568,0,598
30389,2022,Congo,Mexico,25,130,0,155
30390,2022,Dem. Rep. of the Congo,Mexico,75,662,0,737
30391,2022,Colombia,Mexico,560,2611,0,3171
30392,2022,Costa Rica,Mexico,41,153,0,194
30393,2022,Cuba,Mexico,4226,18011,0,22237
30394,2022,Cabo Verde,Mexico,0,5,0,5
30395,2022,Dominica,Mexico,0,14,0,14
30396,2022,Dominican Rep.,Mexico,37,749,0,786
30397,2022,Ecuador,Mexico,62,610,0,672
30398,2022,Equatorial Guinea,Mexico,0,9,0,9
30399,2022,Eritrea,Mexico,7,108,0,115
30400,2022,Ethiopia,Mexico,6,36,0,42
30401,2022,French Guiana,Mexico,7,81,0,88
30402,2022,Finland,Mexico,0,5,0,5
30403,2022,France,Mexico,0,21,0,21
30404,2022,Gambia,Mexico,0,29,0,29
30405,2022,Palestinian,Mexico,5,8,0,13
30406,2022,United Kingdom of Great Britain and Northern Ireland,Mexico,0,5,0,5
30407,2022,Germany,Mexico,0,13,0,13
30408,2022,Ghana,Mexico,45,599,0,644
30409,2022,Guinea-Bissau,Mexico,0,14,0,14
30410,2022,Guatemala,Mexico,3609,6421,0,10030
30411,2022,Guinea,Mexico,45,235,0,280
30412,2022,Guyana,Mexico,0,30,0,30
30413,2022,Haiti,Mexico,4465,50867,0,55332
30414,2022,Honduras,Mexico,35755,48563,0,84318
30415,2022,Cote d'Ivoire,Mexico,6,44,0,50
30416,2022,India,Mexico,14,87,0,101
30417,2022,Iran (Islamic Rep. of),Mexico,41,14,0,55
30418,2022,Iraq,Mexico,44,9,0,53
30419,2022,Israel,Mexico,0,19,0,19
30420,2022,Italy,Mexico,0,10,0,10
30421,2022,Jamaica,Mexico,7,22,0,29
30422,2022,Kazakhstan,Mexico,0,49,0,49
30423,2022,Kyrgyzstan,Mexico,8,24,0,32
30424,2022,Rep. of Korea,Mexico,0,5,0,5
30425,2022,Liberia,Mexico,0,5,0,5
30426,2022,Saint Lucia,Mexico,0,5,0,5
30427,2022,Lebanon,Mexico,0,7,0,7
30428,2022,Sri Lanka,Mexico,20,27,0,47
30429,2022,Mauritania,Mexico,7,86,0,93
30430,2022,Mali,Mexico,5,69,0,74
30431,2022,Morocco,Mexico,5,15,0,20
30432,2022,Mozambique,Mexico,0,5,0,5
30433,2022,Nepal,Mexico,0,17,0,17
30434,2022,Niger,Mexico,0,5,0,5
30435,2022,Nicaragua,Mexico,1850,7123,0,8973
30436,2022,Nigeria,Mexico,48,173,0,221
30437,2022,Pakistan,Mexico,12,53,0,65
30438,2022,Panama,Mexico,63,156,0,219
30439,2022,Paraguay,Mexico,0,7,0,7
30440,2022,Peru,Mexico,39,241,0,280
30441,2022,Poland,Mexico,0,7,0,7
30442,2022,Portugal,Mexico,5,7,0,12
30443,2022,Romania,Mexico,7,5,0,12
30444,2022,South Africa,Mexico,0,15,0,15
30445,2022,Russian Federation,Mexico,44,179,0,223
30446,2022,Rwanda,Mexico,0,5,0,5
30447,2022,El Salvador,Mexico,13531,12284,0,25815
30448,2022,Senegal,Mexico,0,1282,0,1282
30449,2022,Sierra Leone,Mexico,12,93,0,105
30450,2022,Somalia,Mexico,5,70,0,75
30451,2022,Spain,Mexico,5,23,0,28
30452,2022,Sudan,Mexico,0,19,0,19
30453,2022,Suriname,Mexico,0,8,0,8
30454,2022,Syrian Arab Rep.,Mexico,35,37,0,72
30455,2022,Tajikistan,Mexico,0,9,0,9
30456,2022,Togo,Mexico,19,110,0,129
30457,2022,Trinidad and Tobago,Mexico,5,5,0,10
30458,2022,Türkiye,Mexico,8,8,0,16
30459,2022,Uganda,Mexico,0,45,0,45
30460,2022,Ukraine,Mexico,20,114,0,134
30461,2022,Uruguay,Mexico,14,58,0,72
30462,2022,United States of America,Mexico,46,128,0,174
30463,2022,Uzbekistan,Mexico,0,64,0,64
30464,2022,Venezuela (Bolivarian Republic of),Mexico,18761,13468,0,32229
30465,2022,Yemen,Mexico,25,77,0,102
30466,2022,Stateless,Mexico,0,0,0,0
30467,2022,Burundi,Mali,17,0,0,17
30468,2022,Bangladesh,Mali,0,32,0,32
30469,2022,Burkina Faso,Mali,22052,0,0,22052
30470,2022,Central African Rep.,Mali,1172,228,0,1400
30471,2022,Chad,Mali,0,5,0,5
30472,2022,Cameroon,Mali,6,6,0,12
30473,2022,Congo,Mali,32,15,0,47
30474,2022,Dem. Rep. of the Congo,Mali,267,34,0,301
30475,2022,Eritrea,Mali,5,0,0,5
30476,2022,Guinea,Mali,0,12,0,12
30477,2022,Cote d'Ivoire,Mali,488,41,0,529
30478,2022,Mauritania,Mali,14950,0,0,14950
30479,2022,Mali,Mali,0,0,377519,0
30480,2022,Niger,Mali,13585,0,0,13585
30481,2022,Nigeria,Mali,0,5,0,5
30482,2022,Pakistan,Mali,11,0,0,11
30483,2022,Rwanda,Mali,19,0,0,19
30484,2022,Syrian Arab Rep.,Mali,24,433,0,457
30485,2022,Togo,Mali,30,0,0,30
30486,2022,Türkiye,Mali,22,5,0,27
30487,2022,Afghanistan,Malaysia,1858,1209,0,3067
30488,2022,Algeria,Malaysia,0,15,0,15
30489,2022,Egypt,Malaysia,18,83,0,101
30490,2022,Australia,Malaysia,0,5,0,5
30491,2022,Bangladesh,Malaysia,43,21,0,64
30492,2022,Cambodia,Malaysia,74,12,0,86
30493,2022,Central African Rep.,Malaysia,5,0,0,5
30494,2022,China,Malaysia,46,8,0,54
30495,2022,Cameroon,Malaysia,11,23,0,34
30496,2022,Dem. Rep. of the Congo,Malaysia,10,0,0,10
30497,2022,Eritrea,Malaysia,25,10,0,35
30498,2022,Ethiopia,Malaysia,12,12,0,24
30499,2022,Palestinian,Malaysia,249,538,0,787
30500,2022,United Kingdom of Great Britain and Northern Ireland,Malaysia,0,7,0,7
30501,2022,Guinea,Malaysia,12,19,0,31
30502,2022,Cote d'Ivoire,Malaysia,5,0,0,5
30503,2022,India,Malaysia,5,19,0,24
30504,2022,Indonesia,Malaysia,926,86,0,1012
30505,2022,Iran (Islamic Rep. of),Malaysia,273,146,0,419
30506,2022,Iraq,Malaysia,414,790,0,1204
30507,2022,Jordan,Malaysia,5,5,0,10
30508,2022,Liberia,Malaysia,22,8,0,30
30509,2022,Libya,Malaysia,14,13,0,27
30510,2022,Lebanon,Malaysia,5,0,0,5
30511,2022,Sri Lanka,Malaysia,797,864,0,1661
30512,2022,Mali,Malaysia,5,0,0,5
30513,2022,Myanmar,Malaysia,123282,37247,0,160529
30514,2022,Nepal,Malaysia,9,0,0,9
30515,2022,Nigeria,Malaysia,5,41,0,46
30516,2022,Pakistan,Malaysia,4059,2618,0,6677
30517,2022,Philippines,Malaysia,13,11,0,24
30518,2022,Russian Federation,Malaysia,6,0,0,6
30519,2022,Sierra Leone,Malaysia,9,30,0,39
30520,2022,Somalia,Malaysia,2273,1014,0,3287
30521,2022,Sudan,Malaysia,190,115,0,305
30522,2022,South Sudan,Malaysia,32,24,0,56
30523,2022,Syrian Arab Rep.,Malaysia,474,2868,0,3342
30524,2022,Thailand,Malaysia,26,24,0,50
30525,2022,Uganda,Malaysia,6,15,0,21
30526,2022,United States of America,Malaysia,0,8,0,8
30527,2022,Uzbekistan,Malaysia,0,7,0,7
30528,2022,Yemen,Malaysia,370,3473,0,3843
30529,2022,Zimbabwe,Malaysia,5,5,0,10
30530,2022,Stateless,Malaysia,0,0,0,0
30531,2022,Burundi,Malawi,5760,6960,0,12720
30532,2022,Dem. Rep. of the Congo,Malawi,23629,10464,0,34093
30533,2022,Eritrea,Malawi,0,7,0,7
30534,2022,Ethiopia,Malawi,9,76,0,85
30535,2022,Cote d'Ivoire,Malawi,5,0,0,5
30536,2022,Mozambique,Malawi,0,5,0,5
30537,2022,Rwanda,Malawi,2687,4948,0,7635
30538,2022,Somalia,Malawi,90,70,0,160
30539,2022,South Sudan,Malawi,5,0,0,5
30540,2022,United Rep. of Tanzania,Malawi,0,6,0,6
30541,2022,Türkiye,Malawi,31,24,0,55
30542,2022,Uganda,Malawi,0,16,0,16
30543,2022,Zimbabwe,Malawi,0,8,0,8
30544,2022,Afghanistan,Mongolia,0,5,0,5
30545,2022,China,Mongolia,5,0,0,5
30546,2022,Mongolia,Mongolia,0,0,0,0
30547,2022,Stateless,Mongolia,0,0,0,0
30548,2022,Afghanistan,Morocco,12,5,0,17
30549,2022,Algeria,Morocco,10,13,0,23
30550,2022,Angola,Morocco,0,6,0,6
30551,2022,Egypt,Morocco,5,11,0,16
30552,2022,Burundi,Morocco,8,0,0,8
30553,2022,Benin,Morocco,0,6,0,6
30554,2022,Bangladesh,Morocco,0,40,0,40
30555,2022,Burkina Faso,Morocco,7,37,0,44
30556,2022,Central African Rep.,Morocco,604,507,0,1111
30557,2022,Chad,Morocco,5,85,0,90
30558,2022,Cameroon,Morocco,178,816,0,994
30559,2022,Congo,Morocco,16,62,0,78
30560,2022,Dem. Rep. of the Congo,Morocco,187,169,0,356
30561,2022,Eritrea,Morocco,42,41,0,83
30562,2022,Ethiopia,Morocco,0,13,0,13
30563,2022,Gabon,Morocco,0,8,0,8
30564,2022,Gambia,Morocco,0,145,0,145
30565,2022,Palestinian,Morocco,90,177,0,267
30566,2022,Ghana,Morocco,0,11,0,11
30567,2022,Guinea-Bissau,Morocco,0,65,0,65
30568,2022,Guinea,Morocco,158,2484,0,2642
30569,2022,Cote d'Ivoire,Morocco,365,922,0,1287
30570,2022,Iraq,Morocco,128,8,0,136
30571,2022,Jordan,Morocco,0,5,0,5
30572,2022,Liberia,Morocco,6,47,0,53
30573,2022,Libya,Morocco,51,10,0,61
30574,2022,Lebanon,Morocco,5,38,0,43
30575,2022,Sri Lanka,Morocco,0,5,0,5
30576,2022,Mauritania,Morocco,7,15,0,22
30577,2022,Mali,Morocco,60,790,0,850
30578,2022,Niger,Morocco,5,13,0,18
30579,2022,Nigeria,Morocco,27,397,0,424
30580,2022,Pakistan,Morocco,16,5,0,21
30581,2022,Senegal,Morocco,111,1248,0,1359
30582,2022,Sierra Leone,Morocco,0,65,0,65
30583,2022,Somalia,Morocco,25,15,0,40
30584,2022,Sudan,Morocco,130,1197,0,1327
30585,2022,South Sudan,Morocco,42,392,0,434
30586,2022,Syrian Arab Rep.,Morocco,5250,0,0,5250
30587,2022,Togo,Morocco,0,13,0,13
30588,2022,Tunisia,Morocco,5,0,0,5
30589,2022,Türkiye,Morocco,5,30,0,35
30590,2022,Yemen,Morocco,19,1179,0,1198
30591,2022,Angola,Mozambique,5,0,0,5
30592,2022,Burundi,Mozambique,909,8306,0,9215
30593,2022,Central African Rep.,Mozambique,0,8,0,8
30594,2022,Congo,Mozambique,15,36,0,51
30595,2022,Dem. Rep. of the Congo,Mozambique,2984,7699,0,10683
30596,2022,Comoros,Mozambique,0,502,0,502
30597,2022,Eritrea,Mozambique,0,31,0,31
30598,2022,Ethiopia,Mozambique,9,15,0,24
30599,2022,Palestinian,Mozambique,0,9,0,9
30600,2022,Guinea,Mozambique,0,5,0,5
30601,2022,Mauritania,Mozambique,0,5,0,5
30602,2022,Mozambique,Mozambique,0,0,872188,0
30603,2022,New Zealand,Mozambique,0,6,0,6
30604,2022,Rwanda,Mozambique,707,3229,0,3936
30605,2022,Somalia,Mozambique,154,3978,0,4132
30606,2022,Sudan,Mozambique,5,30,0,35
30607,2022,South Sudan,Mozambique,0,5,0,5
30608,2022,Uganda,Mozambique,5,37,0,42
30609,2022,Afghanistan,Malta,0,10,0,10
30610,2022,Albania,Malta,0,5,0,5
30611,2022,Algeria,Malta,0,20,0,20
30612,2022,Egypt,Malta,74,94,0,168
30613,2022,Armenia,Malta,0,5,0,5
30614,2022,Bangladesh,Malta,15,182,0,197
30615,2022,Burkina Faso,Malta,5,12,0,17
30616,2022,Belarus,Malta,9,0,0,9
30617,2022,Central African Rep.,Malta,0,5,0,5
30618,2022,Chad,Malta,10,28,0,38
30619,2022,China,Malta,17,0,0,17
30620,2022,Cameroon,Malta,10,53,0,63
30621,2022,Dem. Rep. of the Congo,Malta,5,7,0,12
30622,2022,Colombia,Malta,0,37,0,37
30623,2022,Eritrea,Malta,903,254,0,1157
30624,2022,Ethiopia,Malta,173,40,0,213
30625,2022,Gambia,Malta,26,130,0,156
30626,2022,Palestinian,Malta,72,23,0,95
30627,2022,Georgia,Malta,5,31,0,36
30628,2022,Ghana,Malta,8,44,0,52
30629,2022,Guinea-Bissau,Malta,0,5,0,5
30630,2022,Guinea,Malta,0,89,0,89
30631,2022,Cote d'Ivoire,Malta,13,68,0,81
30632,2022,India,Malta,0,5,0,5
30633,2022,Iran (Islamic Rep. of),Malta,31,11,0,42
30634,2022,Iraq,Malta,81,5,0,86
30635,2022,Jordan,Malta,5,0,0,5
30636,2022,Liberia,Malta,6,0,0,6
30637,2022,Libya,Malta,2853,233,0,3086
30638,2022,Lebanon,Malta,0,5,0,5
30639,2022,Sri Lanka,Malta,7,5,0,12
30640,2022,North Macedonia,Malta,5,7,0,12
30641,2022,Mali,Malta,20,97,0,117
30642,2022,Morocco,Malta,30,88,0,118
30643,2022,Nepal,Malta,0,26,0,26
30644,2022,Niger,Malta,0,26,0,26
30645,2022,Nigeria,Malta,124,152,0,276
30646,2022,Pakistan,Malta,59,54,0,113
30647,2022,Russian Federation,Malta,18,9,0,27
30648,2022,Saudi Arabia,Malta,5,0,0,5
30649,2022,Serbia and Kosovo: S/RES/1244 (1999),Malta,7,5,0,12
30650,2022,Senegal,Malta,5,38,0,43
30651,2022,Sierra Leone,Malta,5,39,0,44
30652,2022,Somalia,Malta,1773,240,0,2013
30653,2022,Sudan,Malta,225,388,0,613
30654,2022,South Sudan,Malta,22,29,0,51
30655,2022,Syrian Arab Rep.,Malta,1920,417,0,2337
30656,2022,Togo,Malta,5,5,0,10
30657,2022,Tunisia,Malta,13,10,0,23
30658,2022,Türkiye,Malta,7,11,0,18
30659,2022,Ukraine,Malta,1337,112,0,1449
30660,2022,Venezuela (Bolivarian Republic of),Malta,24,96,0,120
30661,2022,Yemen,Malta,5,7,0,12
30662,2022,Zimbabwe,Malta,5,0,0,5
30663,2022,Stateless,Malta,0,0,0,0
30664,2022,Unknown ,Malta,626,0,0,626
30665,2022,Afghanistan,Montenegro,0,6,0,6
30666,2022,Algeria,Montenegro,0,0,0,0
30667,2022,Bangladesh,Montenegro,0,0,0,0
30668,2022,Belarus,Montenegro,5,5,0,10
30669,2022,Bosnia and Herzegovina,Montenegro,5,0,0,5
30670,2022,Cuba,Montenegro,0,33,0,33
30671,2022,Ecuador,Montenegro,0,5,0,5
30672,2022,Ghana,Montenegro,5,0,0,5
30673,2022,Croatia,Montenegro,5,0,0,5
30674,2022,India,Montenegro,0,0,0,0
30675,2022,Iran (Islamic Rep. of),Montenegro,13,8,0,21
30676,2022,Libya,Montenegro,0,0,0,0
30677,2022,Morocco,Montenegro,0,6,0,6
30678,2022,Nepal,Montenegro,0,0,0,0
30679,2022,Pakistan,Montenegro,0,10,0,10
30680,2022,Russian Federation,Montenegro,9,38,0,47
30681,2022,Serbia and Kosovo: S/RES/1244 (1999),Montenegro,54,5,0,59
30682,2022,Syrian Arab Rep.,Montenegro,0,0,0,0
30683,2022,Türkiye,Montenegro,0,0,0,0
30684,2022,Ukraine,Montenegro,9133,0,0,9133
30685,2022,Venezuela (Bolivarian Republic of),Montenegro,0,5,0,5
30686,2022,Yemen,Montenegro,7,0,0,7
30687,2022,Stateless,Montenegro,0,0,0,0
30688,2022,Unknown ,Montenegro,0,0,0,0
30689,2022,Pakistan,Mauritius,5,0,0,5
30690,2022,South Africa,Mauritius,5,0,0,5
30691,2022,Myanmar,Myanmar,0,0,1099103,0
30692,2022,Stateless,Myanmar,0,0,0,0
30693,2022,Angola,Namibia,5,0,0,5
30694,2022,Burundi,Namibia,325,131,0,456
30695,2022,Central African Rep.,Namibia,5,8,0,13
30696,2022,Cameroon,Namibia,24,20,0,44
30697,2022,Congo,Namibia,5,10,0,15
30698,2022,Dem. Rep. of the Congo,Namibia,3467,2515,0,5982
30699,2022,Ethiopia,Namibia,0,5,0,5
30700,2022,Kenya,Namibia,5,5,0,10
30701,2022,Namibia,Namibia,0,0,0,0
30702,2022,Nigeria,Namibia,0,5,0,5
30703,2022,Rwanda,Namibia,135,34,0,169
30704,2022,Somalia,Namibia,5,5,0,10
30705,2022,Sudan,Namibia,7,0,0,7
30706,2022,Uganda,Namibia,8,7,0,15
30707,2022,Zimbabwe,Namibia,53,37,0,90
30708,2022,Afghanistan,Nepal,52,0,0,52
30709,2022,Bangladesh,Nepal,5,0,0,5
30710,2022,Bhutan,Nepal,6365,0,0,6365
30711,2022,India,Nepal,0,0,0,0
30712,2022,Iran (Islamic Rep. of),Nepal,9,0,0,9
30713,2022,Sri Lanka,Nepal,19,0,0,19
30714,2022,Myanmar,Nepal,375,123,0,498
30715,2022,Nepal,Nepal,0,0,0,0
30716,2022,Pakistan,Nepal,187,17,0,204
30717,2022,Somalia,Nepal,21,11,0,32
30718,2022,Yemen,Nepal,0,5,0,5
30719,2022,Stateless,Nepal,0,0,0,0
30720,2022,Tibetan,Nepal,12540,0,0,12540
30721,2022,Afghanistan,Netherlands,7759,1067,0,8826
30722,2022,Albania,Netherlands,20,12,0,32
30723,2022,Algeria,Netherlands,390,609,0,999
30724,2022,Angola,Netherlands,215,8,0,223
30725,2022,Egypt,Netherlands,458,188,0,646
30726,2022,Argentina,Netherlands,10,5,0,15
30727,2022,Armenia,Netherlands,136,32,0,168
30728,2022,Azerbaijan,Netherlands,264,102,0,366
30729,2022,Bahrain,Netherlands,22,5,0,27
30730,2022,Burundi,Netherlands,255,5,0,260
30731,2022,Benin,Netherlands,0,9,0,9
30732,2022,Bangladesh,Netherlands,46,12,0,58
30733,2022,Bhutan,Netherlands,33,0,0,33
30734,2022,Burkina Faso,Netherlands,12,0,0,12
30735,2022,Belarus,Netherlands,51,94,0,145
30736,2022,Bolivia (Plurinational State of),Netherlands,5,0,0,5
30737,2022,Brazil,Netherlands,6,6,0,12
30738,2022,Bosnia and Herzegovina,Netherlands,1085,0,0,1085
30739,2022,Cambodia,Netherlands,17,0,0,17
30740,2022,Central African Rep.,Netherlands,24,5,0,29
30741,2022,Chad,Netherlands,9,13,0,22
30742,2022,China,Netherlands,960,104,0,1064
30743,2022,Chile,Netherlands,101,5,0,106
30744,2022,Cameroon,Netherlands,74,26,0,100
30745,2022,Congo,Netherlands,266,26,0,292
30746,2022,Dem. Rep. of the Congo,Netherlands,774,28,0,802
30747,2022,Colombia,Netherlands,246,304,0,550
30748,2022,Cuba,Netherlands,84,12,0,96
30749,2022,Czechia,Netherlands,5,0,0,5
30750,2022,Ecuador,Netherlands,5,0,0,5
30751,2022,Eritrea,Netherlands,19204,867,0,20071
30752,2022,Ethiopia,Netherlands,658,244,0,902
30753,2022,Gambia,Netherlands,87,121,0,208
30754,2022,Palestinian,Netherlands,0,21,0,21
30755,2022,Georgia,Netherlands,52,25,0,77
30756,2022,Germany,Netherlands,5,0,0,5
30757,2022,Ghana,Netherlands,24,21,0,45
30758,2022,Guinea-Bissau,Netherlands,6,5,0,11
30759,2022,Guatemala,Netherlands,5,0,0,5
30760,2022,Guinea,Netherlands,377,100,0,477
30761,2022,Guyana,Netherlands,8,0,0,8
30762,2022,Haiti,Netherlands,0,5,0,5
30763,2022,Honduras,Netherlands,13,7,0,20
30764,2022,Croatia,Netherlands,125,0,0,125
30765,2022,Cote d'Ivoire,Netherlands,96,15,0,111
30766,2022,India,Netherlands,0,35,0,35
30767,2022,Indonesia,Netherlands,33,0,0,33
30768,2022,Iran (Islamic Rep. of),Netherlands,5593,556,0,6149
30769,2022,Iraq,Netherlands,5152,760,0,5912
30770,2022,Jamaica,Netherlands,178,9,0,187
30771,2022,Jordan,Netherlands,188,60,0,248
30772,2022,Kazakhstan,Netherlands,66,25,0,91
30773,2022,Kenya,Netherlands,19,6,0,25
30774,2022,Kyrgyzstan,Netherlands,17,5,0,22
30775,2022,Rep. of Korea,Netherlands,5,0,0,5
30776,2022,Dem. People's Rep. of Korea,Netherlands,36,0,0,36
30777,2022,Kuwait,Netherlands,7,5,0,12
30778,2022,Lao People's Dem. Rep.,Netherlands,5,0,0,5
30779,2022,Liberia,Netherlands,96,6,0,102
30780,2022,Libya,Netherlands,245,81,0,326
30781,2022,Lebanon,Netherlands,228,71,0,299
30782,2022,Sri Lanka,Netherlands,328,47,0,375
30783,2022,Mauritania,Netherlands,16,5,0,21
30784,2022,North Macedonia,Netherlands,8,0,0,8
30785,2022,Rep. of Moldova,Netherlands,14,77,0,91
30786,2022,Mexico,Netherlands,9,16,0,25
30787,2022,Mali,Netherlands,8,18,0,26
30788,2022,Malaysia,Netherlands,12,5,0,17
30789,2022,Mongolia,Netherlands,38,7,0,45
30790,2022,Morocco,Netherlands,819,364,0,1183
30791,2022,Montenegro,Netherlands,6,0,0,6
30792,2022,Myanmar,Netherlands,450,45,0,495
30793,2022,Namibia,Netherlands,5,0,0,5
30794,2022,Nepal,Netherlands,96,5,0,101
30795,2022,Niger,Netherlands,10,17,0,27
30796,2022,Nicaragua,Netherlands,50,25,0,75
30797,2022,Nigeria,Netherlands,1638,480,0,2118
30798,2022,Oman,Netherlands,5,0,0,5
30799,2022,Pakistan,Netherlands,1426,662,0,2088
30800,2022,Peru,Netherlands,11,5,0,16
30801,2022,Philippines,Netherlands,17,5,0,22
30802,2022,Poland,Netherlands,5,0,0,5
30803,2022,Portugal,Netherlands,5,0,0,5
30804,2022,Romania,Netherlands,10,0,0,10
30805,2022,South Africa,Netherlands,7,15,0,22
30806,2022,Russian Federation,Netherlands,697,330,0,1027
30807,2022,Rwanda,Netherlands,88,6,0,94
30808,2022,El Salvador,Netherlands,75,51,0,126
30809,2022,Saudi Arabia,Netherlands,47,23,0,70
30810,2022,Serbia and Kosovo: S/RES/1244 (1999),Netherlands,81,12,0,93
30811,2022,Senegal,Netherlands,46,23,0,69
30812,2022,Sierra Leone,Netherlands,414,80,0,494
30813,2022,Somalia,Netherlands,3506,1138,0,4644
30814,2022,Viet Nam,Netherlands,86,5,0,91
30815,2022,Sudan,Netherlands,1098,171,0,1269
30816,2022,Suriname,Netherlands,9,0,0,9
30817,2022,South Sudan,Netherlands,99,10,0,109
30818,2022,Slovakia,Netherlands,10,0,0,10
30819,2022,Syrian Arab Rep.,Netherlands,53496,7271,0,60767
30820,2022,United Rep. of Tanzania,Netherlands,13,5,0,18
30821,2022,Thailand,Netherlands,9,0,0,9
30822,2022,Tajikistan,Netherlands,33,37,0,70
30823,2022,Turkmenistan,Netherlands,30,20,0,50
30824,2022,Togo,Netherlands,25,5,0,30
30825,2022,Trinidad and Tobago,Netherlands,94,19,0,113
30826,2022,Tunisia,Netherlands,41,162,0,203
30827,2022,Türkiye,Netherlands,7106,1455,0,8561
30828,2022,United Arab Emirates,Netherlands,7,0,0,7
30829,2022,Uganda,Netherlands,563,108,0,671
30830,2022,Ukraine,Netherlands,67612,96,0,67708
30831,2022,United States of America,Netherlands,66,11,0,77
30832,2022,Uzbekistan,Netherlands,33,42,0,75
30833,2022,Venezuela (Bolivarian Republic of),Netherlands,171,139,0,310
30834,2022,Yemen,Netherlands,3798,1534,0,5332
30835,2022,Zambia,Netherlands,9,6,0,15
30836,2022,Zimbabwe,Netherlands,44,6,0,50
30837,2022,Stateless,Netherlands,3119,40,0,3159
30838,2022,Unknown ,Netherlands,5029,740,0,5769
30839,2022,Benin,Niger,0,5,0,5
30840,2022,Burkina Faso,Niger,0,17844,0,17844
30841,2022,Central African Rep.,Niger,141,79,0,220
30842,2022,Chad,Niger,110,3420,0,3530
30843,2022,Cameroon,Niger,20,206,0,226
30844,2022,Congo,Niger,5,0,0,5
30845,2022,Dem. Rep. of the Congo,Niger,48,38,0,86
30846,2022,Eritrea,Niger,39,204,0,243
30847,2022,Ethiopia,Niger,20,28,0,48
30848,2022,Ghana,Niger,0,5,0,5
30849,2022,Guinea,Niger,0,23,0,23
30850,2022,Cote d'Ivoire,Niger,26,14,0,40
30851,2022,Liberia,Niger,0,9,0,9
30852,2022,Libya,Niger,6,0,0,6
30853,2022,Mali,Niger,62904,97,0,63001
30854,2022,Niger,Niger,0,0,264257,0
30855,2022,Nigeria,Niger,187134,16463,0,203597
30856,2022,Pakistan,Niger,0,6,0,6
30857,2022,Rwanda,Niger,12,0,0,12
30858,2022,Somalia,Niger,38,31,0,69
30859,2022,Sudan,Niger,949,1818,0,2767
30860,2022,South Sudan,Niger,10,8,0,18
30861,2022,Syrian Arab Rep.,Niger,5,11,0,16
30862,2022,Togo,Niger,5,20,0,25
30863,2022,Yemen,Niger,0,20,0,20
30864,2022,Colombia,Nicaragua,6,0,0,6
30865,2022,Cuba,Nicaragua,14,0,0,14
30866,2022,Guatemala,Nicaragua,7,0,0,7
30867,2022,Honduras,Nicaragua,74,26,0,100
30868,2022,Mexico,Nicaragua,0,0,0,0
30869,2022,El Salvador,Nicaragua,210,100,0,310
30870,2022,Unknown ,Nicaragua,0,0,0,0
30871,2022,Afghanistan,Nigeria,5,0,0,5
30872,2022,Egypt,Nigeria,0,7,0,7
30873,2022,Benin,Nigeria,5,0,0,5
30874,2022,Central African Rep.,Nigeria,915,233,0,1148
30875,2022,Chad,Nigeria,88,19,0,107
30876,2022,Cameroon,Nigeria,78321,245,0,78566
30877,2022,Congo,Nigeria,5,5,0,10
30878,2022,Dem. Rep. of the Congo,Nigeria,666,101,0,767
30879,2022,Eritrea,Nigeria,41,9,0,50
30880,2022,Ethiopia,Nigeria,8,5,0,13
30881,2022,Palestinian,Nigeria,21,20,0,41
30882,2022,Ghana,Nigeria,5,5,0,10
30883,2022,Guinea-Bissau,Nigeria,5,0,0,5
30884,2022,Guinea,Nigeria,18,5,0,23
30885,2022,Cote d'Ivoire,Nigeria,136,5,0,141
30886,2022,Iran (Islamic Rep. of),Nigeria,5,0,0,5
30887,2022,Liberia,Nigeria,11,0,0,11
30888,2022,Libya,Nigeria,5,5,0,10
30889,2022,Lebanon,Nigeria,13,40,0,53
30890,2022,Mali,Nigeria,150,29,0,179
30891,2022,Niger,Nigeria,1439,0,0,1439
30892,2022,Nigeria,Nigeria,0,0,3098404,0
30893,2022,Sierra Leone,Nigeria,23,0,0,23
30894,2022,Sudan,Nigeria,53,7,0,60
30895,2022,Syrian Arab Rep.,Nigeria,512,595,0,1107
30896,2022,Turkmenistan,Nigeria,5,0,0,5
30897,2022,Togo,Nigeria,27,10,0,37
30898,2022,Türkiye,Nigeria,286,176,0,462
30899,2022,Yemen,Nigeria,5,8,0,13
30900,2022,Afghanistan,Norway,3248,250,0,3498
30901,2022,Albania,Norway,18,5,0,23
30902,2022,Algeria,Norway,6,0,0,6
30903,2022,Angola,Norway,5,0,0,5
30904,2022,Egypt,Norway,43,0,0,43
30905,2022,Armenia,Norway,5,5,0,10
30906,2022,Azerbaijan,Norway,15,14,0,29
30907,2022,Burundi,Norway,31,0,0,31
30908,2022,Bangladesh,Norway,5,0,0,5
30909,2022,Belarus,Norway,5,15,0,20
30910,2022,Bulgaria,Norway,5,5,0,10
30911,2022,Central African Rep.,Norway,15,0,0,15
30912,2022,China,Norway,298,45,0,343
30913,2022,Cameroon,Norway,16,0,0,16
30914,2022,Congo,Norway,5,0,0,5
30915,2022,Dem. Rep. of the Congo,Norway,368,5,0,373
30916,2022,Colombia,Norway,27,84,0,111
30917,2022,Eritrea,Norway,10883,140,0,11023
30918,2022,Ethiopia,Norway,1192,76,0,1268
30919,2022,Gambia,Norway,13,0,0,13
30920,2022,Georgia,Norway,0,12,0,12
30921,2022,Ghana,Norway,6,0,0,6
30922,2022,Guinea-Bissau,Norway,5,0,0,5
30923,2022,Guinea,Norway,27,0,0,27
30924,2022,Honduras,Norway,6,0,0,6
30925,2022,Cote d'Ivoire,Norway,13,0,0,13
30926,2022,Iran (Islamic Rep. of),Norway,1429,130,0,1559
30927,2022,Iraq,Norway,984,77,0,1061
30928,2022,Israel,Norway,8,0,0,8
30929,2022,Jordan,Norway,5,0,0,5
30930,2022,Kazakhstan,Norway,10,5,0,15
30931,2022,Kenya,Norway,7,5,0,12
30932,2022,Kyrgyzstan,Norway,12,5,0,17
30933,2022,Liberia,Norway,5,0,0,5
30934,2022,Libya,Norway,55,11,0,66
30935,2022,Lebanon,Norway,25,0,0,25
30936,2022,Sri Lanka,Norway,43,10,0,53
30937,2022,Rep. of Moldova,Norway,5,5,0,10
30938,2022,Mali,Norway,8,0,0,8
30939,2022,Morocco,Norway,14,11,0,25
30940,2022,Myanmar,Norway,22,5,0,27
30941,2022,Nepal,Norway,5,0,0,5
30942,2022,Nicaragua,Norway,10,0,0,10
30943,2022,Nigeria,Norway,109,11,0,120
30944,2022,Pakistan,Norway,77,14,0,91
30945,2022,Poland,Norway,0,10,0,10
30946,2022,South Africa,Norway,0,5,0,5
30947,2022,Russian Federation,Norway,286,101,0,387
30948,2022,Rwanda,Norway,13,0,0,13
30949,2022,El Salvador,Norway,9,5,0,14
30950,2022,Saudi Arabia,Norway,8,6,0,14
30951,2022,Serbia and Kosovo: S/RES/1244 (1999),Norway,26,5,0,31
30952,2022,Sierra Leone,Norway,8,0,0,8
30953,2022,Somalia,Norway,3060,16,0,3076
30954,2022,Viet Nam,Norway,38,5,0,43
30955,2022,Sudan,Norway,1515,14,0,1529
30956,2022,South Sudan,Norway,49,0,0,49
30957,2022,Syrian Arab Rep.,Norway,15901,414,0,16315
30958,2022,Tajikistan,Norway,5,6,0,11
30959,2022,Turkmenistan,Norway,5,5,0,10
30960,2022,Türkiye,Norway,1149,70,0,1219
30961,2022,United Arab Emirates,Norway,0,5,0,5
30962,2022,Uganda,Norway,101,0,0,101
30963,2022,Ukraine,Norway,19916,2308,0,22224
30964,2022,Uzbekistan,Norway,145,14,0,159
30965,2022,Venezuela (Bolivarian Republic of),Norway,27,64,0,91
30966,2022,Yemen,Norway,199,10,0,209
30967,2022,Zimbabwe,Norway,11,0,0,11
30968,2022,Stateless,Norway,2247,62,0,2309
30969,2022,Unknown ,Norway,28,5,0,33
30970,2022,Afghanistan,Nauru,26,0,0,26
30971,2022,Bangladesh,Nauru,17,21,0,38
30972,2022,India,Nauru,7,5,0,12
30973,2022,Indonesia,Nauru,5,5,0,10
30974,2022,Iran (Islamic Rep. of),Nauru,505,11,0,516
30975,2022,Iraq,Nauru,41,0,0,41
30976,2022,Kuwait,Nauru,5,0,0,5
30977,2022,Lebanon,Nauru,12,5,0,17
30978,2022,Sri Lanka,Nauru,80,10,0,90
30979,2022,Malaysia,Nauru,5,0,0,5
30980,2022,Myanmar,Nauru,71,0,0,71
30981,2022,Nepal,Nauru,11,5,0,16
30982,2022,Pakistan,Nauru,30,18,0,48
30983,2022,Somalia,Nauru,75,5,0,80
30984,2022,Sudan,Nauru,5,0,0,5
30985,2022,Syrian Arab Rep.,Nauru,0,5,0,5
30986,2022,Stateless,Nauru,61,8,0,69
30987,2022,Afghanistan,New Zealand,63,9,0,72
30988,2022,Egypt,New Zealand,23,5,0,28
30989,2022,Bahrain,New Zealand,8,6,0,14
30990,2022,Bangladesh,New Zealand,10,12,0,22
30991,2022,Brazil,New Zealand,0,5,0,5
30992,2022,China,New Zealand,262,88,0,350
30993,2022,Chile,New Zealand,5,5,0,10
30994,2022,Cameroon,New Zealand,5,0,0,5
30995,2022,Dem. Rep. of the Congo,New Zealand,5,0,0,5
30996,2022,Colombia,New Zealand,31,8,0,39
30997,2022,Czechia,New Zealand,10,0,0,10
30998,2022,Eritrea,New Zealand,6,5,0,11
30999,2022,Ethiopia,New Zealand,14,0,0,14
31000,2022,Fiji,New Zealand,15,17,0,32
31001,2022,Palestinian,New Zealand,10,0,0,10
31002,2022,Hungary,New Zealand,6,0,0,6
31003,2022,India,New Zealand,17,141,0,158
31004,2022,Indonesia,New Zealand,6,15,0,21
31005,2022,Ireland,New Zealand,0,5,0,5
31006,2022,Iran (Islamic Rep. of),New Zealand,96,7,0,103
31007,2022,Iraq,New Zealand,54,0,0,54
31008,2022,Jordan,New Zealand,7,0,0,7
31009,2022,Kiribati,New Zealand,0,5,0,5
31010,2022,Kuwait,New Zealand,5,0,0,5
31011,2022,Libya,New Zealand,20,0,0,20
31012,2022,Sri Lanka,New Zealand,45,56,0,101
31013,2022,Maldives,New Zealand,5,0,0,5
31014,2022,Malaysia,New Zealand,17,14,0,31
31015,2022,Mongolia,New Zealand,5,0,0,5
31016,2022,Myanmar,New Zealand,17,14,0,31
31017,2022,Nepal,New Zealand,5,0,0,5
31018,2022,Pakistan,New Zealand,49,6,0,55
31019,2022,Philippines,New Zealand,11,5,0,16
31020,2022,Papua New Guinea,New Zealand,5,0,0,5
31021,2022,South Africa,New Zealand,5,9,0,14
31022,2022,Russian Federation,New Zealand,34,18,0,52
31023,2022,Saudi Arabia,New Zealand,62,0,0,62
31024,2022,Somalia,New Zealand,9,0,0,9
31025,2022,Viet Nam,New Zealand,7,5,0,12
31026,2022,Sudan,New Zealand,6,5,0,11
31027,2022,Syrian Arab Rep.,New Zealand,66,0,0,66
31028,2022,Tonga,New Zealand,0,5,0,5
31029,2022,Türkiye,New Zealand,56,0,0,56
31030,2022,Uganda,New Zealand,5,5,0,10
31031,2022,Ukraine,New Zealand,0,6,0,6
31032,2022,Uruguay,New Zealand,0,7,0,7
31033,2022,United States of America,New Zealand,0,5,0,5
31034,2022,Venezuela (Bolivarian Republic of),New Zealand,5,0,0,5
31035,2022,Yemen,New Zealand,11,0,0,11
31036,2022,Zimbabwe,New Zealand,12,0,0,12
31037,2022,Stateless,New Zealand,5,0,0,5
31038,2022,Unknown ,New Zealand,678,90,0,768
31039,2022,Iraq,Oman,282,459,0,741
31040,2022,Pakistan,Oman,5,0,0,5
31041,2022,Sudan,Oman,0,7,0,7
31042,2022,Syrian Arab Rep.,Oman,8,27,0,35
31043,2022,Afghanistan,Pakistan,1539046,24559,0,1563605
31044,2022,Algeria,Pakistan,22,0,0,22
31045,2022,China,Pakistan,0,16,0,16
31046,2022,Palestinian,Pakistan,21,0,0,21
31047,2022,India,Pakistan,0,5,0,5
31048,2022,Iran (Islamic Rep. of),Pakistan,39,14,0,53
31049,2022,Iraq,Pakistan,21,7,0,28
31050,2022,Sri Lanka,Pakistan,0,11,0,11
31051,2022,Myanmar,Pakistan,24,31,0,55
31052,2022,Pakistan,Pakistan,0,0,98898,0
31053,2022,Russian Federation,Pakistan,6,0,0,6
31054,2022,Somalia,Pakistan,175,27,0,202
31055,2022,Syrian Arab Rep.,Pakistan,50,23,0,73
31056,2022,United Rep. of Tanzania,Pakistan,0,5,0,5
31057,2022,Tajikistan,Pakistan,7,0,0,7
31058,2022,Türkiye,Pakistan,6,0,0,6
31059,2022,Yemen,Pakistan,137,31,0,168
31060,2022,Stateless,Pakistan,0,0,0,0
31061,2022,Afghanistan,Panama,5,6,0,11
31062,2022,Armenia,Panama,0,5,0,5
31063,2022,Bangladesh,Panama,0,15,0,15
31064,2022,Belarus,Panama,7,0,0,7
31065,2022,Bosnia and Herzegovina,Panama,5,0,0,5
31066,2022,Cameroon,Panama,9,5,0,14
31067,2022,Dem. Rep. of the Congo,Panama,5,0,0,5
31068,2022,Colombia,Panama,1666,1064,0,2730
31069,2022,Cuba,Panama,120,1517,0,1637
31070,2022,Dominican Rep.,Panama,5,0,0,5
31071,2022,Ecuador,Panama,0,16,0,16
31072,2022,Eritrea,Panama,0,38,0,38
31073,2022,Guatemala,Panama,12,8,0,20
31074,2022,Haiti,Panama,19,0,0,19
31075,2022,Honduras,Panama,6,90,0,96
31076,2022,Croatia,Panama,5,0,0,5
31077,2022,Cote d'Ivoire,Panama,0,5,0,5
31078,2022,India,Panama,0,7,0,7
31079,2022,Iran (Islamic Rep. of),Panama,5,0,0,5
31080,2022,Italy,Panama,0,5,0,5
31081,2022,Jamaica,Panama,0,6,0,6
31082,2022,Liberia,Panama,5,0,0,5
31083,2022,Sri Lanka,Panama,0,7,0,7
31084,2022,Mexico,Panama,5,0,0,5
31085,2022,Nepal,Panama,0,14,0,14
31086,2022,Nicaragua,Panama,183,4987,0,5170
31087,2022,Nigeria,Panama,10,34,0,44
31088,2022,Pakistan,Panama,0,15,0,15
31089,2022,Peru,Panama,23,0,0,23
31090,2022,Russian Federation,Panama,0,5,0,5
31091,2022,El Salvador,Panama,393,945,0,1338
31092,2022,Sierra Leone,Panama,5,0,0,5
31093,2022,Somalia,Panama,0,101,0,101
31094,2022,Sudan,Panama,5,0,0,5
31095,2022,Ukraine,Panama,9,6,0,15
31096,2022,Venezuela (Bolivarian Republic of),Panama,61,2352,0,2413
31097,2022,Afghanistan,Paraguay,0,5,0,5
31098,2022,Argentina,Paraguay,0,17,0,17
31099,2022,Bangladesh,Paraguay,0,5,0,5
31100,2022,Bolivia (Plurinational State of),Paraguay,16,17,0,33
31101,2022,Brazil,Paraguay,0,11,0,11
31102,2022,Chile,Paraguay,0,5,0,5
31103,2022,Cameroon,Paraguay,0,5,0,5
31104,2022,Colombia,Paraguay,17,254,0,271
31105,2022,Cuba,Paraguay,926,134,0,1060
31106,2022,Dominican Rep.,Paraguay,0,11,0,11
31107,2022,Ecuador,Paraguay,0,8,0,8
31108,2022,Guatemala,Paraguay,0,6,0,6
31109,2022,Haiti,Paraguay,0,5,0,5
31110,2022,Iraq,Paraguay,6,0,0,6
31111,2022,Lebanon,Paraguay,0,6,0,6
31112,2022,Nigeria,Paraguay,0,5,0,5
31113,2022,Peru,Paraguay,0,41,0,41
31114,2022,South Africa,Paraguay,0,5,0,5
31115,2022,El Salvador,Paraguay,12,5,0,17
31116,2022,Syrian Arab Rep.,Paraguay,79,17,0,96
31117,2022,Türkiye,Paraguay,5,5,0,10
31118,2022,Ukraine,Paraguay,0,5,0,5
31119,2022,Uruguay,Paraguay,0,6,0,6
31120,2022,Venezuela (Bolivarian Republic of),Paraguay,3412,1016,0,4428
31121,2022,Afghanistan,Peru,0,5,0,5
31122,2022,Angola,Peru,0,10,0,10
31123,2022,Argentina,Peru,0,15,0,15
31124,2022,Bangladesh,Peru,26,0,0,26
31125,2022,Bolivia (Plurinational State of),Peru,20,31,0,51
31126,2022,Brazil,Peru,5,12,0,17
31127,2022,China,Peru,0,13,0,13
31128,2022,Chile,Peru,0,12,0,12
31129,2022,Cameroon,Peru,20,0,0,20
31130,2022,Congo,Peru,0,9,0,9
31131,2022,Dem. Rep. of the Congo,Peru,8,0,0,8
31132,2022,Colombia,Peru,714,1742,0,2456
31133,2022,Costa Rica,Peru,0,5,0,5
31134,2022,Cuba,Peru,520,2744,0,3264
31135,2022,Dominica,Peru,0,5,0,5
31136,2022,Dominican Rep.,Peru,20,55,0,75
31137,2022,Ecuador,Peru,5,270,0,275
31138,2022,Ethiopia,Peru,5,0,0,5
31139,2022,Gambia,Peru,5,0,0,5
31140,2022,Palestinian,Peru,41,8,0,49
31141,2022,Germany,Peru,0,5,0,5
31142,2022,Ghana,Peru,5,0,0,5
31143,2022,Haiti,Peru,85,57,0,142
31144,2022,Honduras,Peru,0,7,0,7
31145,2022,India,Peru,6,5,0,11
31146,2022,Iran (Islamic Rep. of),Peru,6,0,0,6
31147,2022,Iraq,Peru,42,0,0,42
31148,2022,Italy,Peru,0,5,0,5
31149,2022,Jordan,Peru,0,5,0,5
31150,2022,Sri Lanka,Peru,0,7,0,7
31151,2022,Mexico,Peru,0,11,0,11
31152,2022,Morocco,Peru,0,5,0,5
31153,2022,Nepal,Peru,0,5,0,5
31154,2022,Nicaragua,Peru,7,7,0,14
31155,2022,Nigeria,Peru,24,19,0,43
31156,2022,Pakistan,Peru,0,10,0,10
31157,2022,Panama,Peru,0,11,0,11
31158,2022,Paraguay,Peru,0,5,0,5
31159,2022,Philippines,Peru,0,21,0,21
31160,2022,Poland,Peru,0,5,0,5
31161,2022,Portugal,Peru,0,16,0,16
31162,2022,South Africa,Peru,0,5,0,5
31163,2022,Russian Federation,Peru,0,7,0,7
31164,2022,El Salvador,Peru,10,5,0,15
31165,2022,Spain,Peru,0,18,0,18
31166,2022,Syrian Arab Rep.,Peru,47,12,0,59
31167,2022,Turkmenistan,Peru,0,8,0,8
31168,2022,Türkiye,Peru,46,40,0,86
31169,2022,Ukraine,Peru,23,12,0,35
31170,2022,Uruguay,Peru,0,5,0,5
31171,2022,United States of America,Peru,0,5,0,5
31172,2022,Venezuela (Bolivarian Republic of),Peru,4250,531632,0,535882
31173,2022,Yemen,Peru,0,63,0,63
31174,2022,Anguilla,Peru,0,5,0,5
31175,2022,Unknown ,Peru,16,6,0,22
31176,2022,Afghanistan,Philippines,10,0,0,10
31177,2022,Egypt,Philippines,0,6,0,6
31178,2022,Burundi,Philippines,13,0,0,13
31179,2022,Cambodia,Philippines,13,0,0,13
31180,2022,Chad,Philippines,0,8,0,8
31181,2022,China,Philippines,5,5,0,10
31182,2022,Cameroon,Philippines,34,97,0,131
31183,2022,Congo,Philippines,5,17,0,22
31184,2022,Dem. Rep. of the Congo,Philippines,12,22,0,34
31185,2022,Eritrea,Philippines,21,20,0,41
31186,2022,Ethiopia,Philippines,5,6,0,11
31187,2022,France,Philippines,0,5,0,5
31188,2022,Palestinian,Philippines,63,16,0,79
31189,2022,Ghana,Philippines,5,0,0,5
31190,2022,Guinea,Philippines,0,11,0,11
31191,2022,Cote d'Ivoire,Philippines,30,37,0,67
31192,2022,Iran (Islamic Rep. of),Philippines,76,22,0,98
31193,2022,Iraq,Philippines,54,14,0,68
31194,2022,Kenya,Philippines,0,5,0,5
31195,2022,Liberia,Philippines,5,6,0,11
31196,2022,Libya,Philippines,0,5,0,5
31197,2022,Lebanon,Philippines,5,15,0,20
31198,2022,Sri Lanka,Philippines,18,0,0,18
31199,2022,Malaysia,Philippines,0,5,0,5
31200,2022,Morocco,Philippines,5,0,0,5
31201,2022,Myanmar,Philippines,10,0,0,10
31202,2022,Nigeria,Philippines,7,16,0,23
31203,2022,Pakistan,Philippines,103,26,0,129
31204,2022,Philippines,Philippines,0,0,99970,0
31205,2022,Russian Federation,Philippines,5,8,0,13
31206,2022,Rwanda,Philippines,18,0,0,18
31207,2022,Saudi Arabia,Philippines,0,13,0,13
31208,2022,Somalia,Philippines,30,33,0,63
31209,2022,Viet Nam,Philippines,18,7,0,25
31210,2022,Sudan,Philippines,7,58,0,65
31211,2022,Syrian Arab Rep.,Philippines,132,56,0,188
31212,2022,Thailand,Philippines,5,0,0,5
31213,2022,Türkiye,Philippines,56,19,0,75
31214,2022,United Arab Emirates,Philippines,6,7,0,13
31215,2022,Uganda,Philippines,5,0,0,5
31216,2022,Ukraine,Philippines,0,5,0,5
31217,2022,United States of America,Philippines,0,7,0,7
31218,2022,Yemen,Philippines,31,95,0,126
31219,2022,Stateless,Philippines,5,0,0,5
31220,2022,Unknown ,Philippines,0,6,0,6
31221,2022,Afghanistan,Papua New Guinea,30,0,0,30
31222,2022,Bangladesh,Papua New Guinea,15,6,0,21
31223,2022,India,Papua New Guinea,0,5,0,5
31224,2022,Indonesia,Papua New Guinea,11432,340,0,11772
31225,2022,Iran (Islamic Rep. of),Papua New Guinea,74,73,0,147
31226,2022,Iraq,Papua New Guinea,32,5,0,37
31227,2022,Sri Lanka,Papua New Guinea,6,8,0,14
31228,2022,Myanmar,Papua New Guinea,5,5,0,10
31229,2022,Pakistan,Papua New Guinea,26,5,0,31
31230,2022,Papua New Guinea,Papua New Guinea,0,0,24000,0
31231,2022,Somalia,Papua New Guinea,12,0,0,12
31232,2022,Sudan,Papua New Guinea,34,0,0,34
31233,2022,Stateless,Papua New Guinea,5,0,0,5
31234,2022,Afghanistan,Poland,900,214,0,1114
31235,2022,Algeria,Poland,31,5,0,36
31236,2022,Angola,Poland,5,0,0,5
31237,2022,Egypt,Poland,91,28,0,119
31238,2022,Argentina,Poland,5,0,0,5
31239,2022,Armenia,Poland,155,23,0,178
31240,2022,Australia,Poland,5,0,0,5
31241,2022,Azerbaijan,Poland,234,26,0,260
31242,2022,Bangladesh,Poland,13,12,0,25
31243,2022,Belarus,Poland,3865,724,0,4589
31244,2022,Brazil,Poland,5,0,0,5
31245,2022,Bosnia and Herzegovina,Poland,7,0,0,7
31246,2022,Bulgaria,Poland,5,0,0,5
31247,2022,Canada,Poland,16,0,0,16
31248,2022,Central African Rep.,Poland,5,0,0,5
31249,2022,China,Poland,45,0,0,45
31250,2022,Cameroon,Poland,7,5,0,12
31251,2022,Congo,Poland,6,0,0,6
31252,2022,Dem. Rep. of the Congo,Poland,5,10,0,15
31253,2022,Comoros,Poland,0,5,0,5
31254,2022,Costa Rica,Poland,5,0,0,5
31255,2022,Cuba,Poland,15,9,0,24
31256,2022,Ecuador,Poland,5,0,0,5
31257,2022,Eritrea,Poland,5,0,0,5
31258,2022,Estonia,Poland,5,0,0,5
31259,2022,Ethiopia,Poland,8,6,0,14
31260,2022,France,Poland,5,0,0,5
31261,2022,Palestinian,Poland,11,11,0,22
31262,2022,United Kingdom of Great Britain and Northern Ireland,Poland,17,0,0,17
31263,2022,Georgia,Poland,274,40,0,314
31264,2022,Germany,Poland,8,0,0,8
31265,2022,Ghana,Poland,5,0,0,5
31266,2022,Guinea,Poland,5,15,0,20
31267,2022,India,Poland,48,5,0,53
31268,2022,Iran (Islamic Rep. of),Poland,80,13,0,93
31269,2022,Iraq,Poland,134,320,0,454
31270,2022,Israel,Poland,50,0,0,50
31271,2022,Italy,Poland,5,0,0,5
31272,2022,Jordan,Poland,9,5,0,14
31273,2022,Japan,Poland,5,0,0,5
31274,2022,Kazakhstan,Poland,96,17,0,113
31275,2022,Kyrgyzstan,Poland,46,24,0,70
31276,2022,Rep. of Korea,Poland,5,0,0,5
31277,2022,Lao People's Dem. Rep.,Poland,5,0,0,5
31278,2022,Libya,Poland,30,0,0,30
31279,2022,Lebanon,Poland,21,9,0,30
31280,2022,Sri Lanka,Poland,11,7,0,18
31281,2022,Lithuania,Poland,9,0,0,9
31282,2022,Rep. of Moldova,Poland,207,0,0,207
31283,2022,Mexico,Poland,5,0,0,5
31284,2022,Mongolia,Poland,5,0,0,5
31285,2022,Morocco,Poland,19,13,0,32
31286,2022,Nepal,Poland,7,5,0,12
31287,2022,Nigeria,Poland,37,13,0,50
31288,2022,Pakistan,Poland,39,38,0,77
31289,2022,Philippines,Poland,5,0,0,5
31290,2022,Romania,Poland,5,0,0,5
31291,2022,South Africa,Poland,5,0,0,5
31292,2022,Russian Federation,Poland,2303,684,0,2987
31293,2022,Rwanda,Poland,5,6,0,11
31294,2022,Serbia and Kosovo: S/RES/1244 (1999),Poland,5,0,0,5
31295,2022,Senegal,Poland,0,5,0,5
31296,2022,Sierra Leone,Poland,7,0,0,7
31297,2022,Somalia,Poland,19,11,0,30
31298,2022,Viet Nam,Poland,86,6,0,92
31299,2022,Sudan,Poland,5,11,0,16
31300,2022,Syrian Arab Rep.,Poland,273,36,0,309
31301,2022,Tajikistan,Poland,206,72,0,278
31302,2022,Turkmenistan,Poland,102,15,0,117
31303,2022,Tunisia,Poland,11,5,0,16
31304,2022,Türkiye,Poland,309,49,0,358
31305,2022,Ukraine,Poland,1200207,939,0,1201146
31306,2022,United States of America,Poland,87,0,0,87
31307,2022,Uzbekistan,Poland,136,26,0,162
31308,2022,Venezuela (Bolivarian Republic of),Poland,21,0,0,21
31309,2022,Yemen,Poland,27,16,0,43
31310,2022,Stateless,Poland,100,7,0,107
31311,2022,Unknown ,Poland,12,17,0,29
31312,2022,Afghanistan,Portugal,174,771,0,945
31313,2022,Albania,Portugal,0,6,0,6
31314,2022,Algeria,Portugal,437,21,0,458
31315,2022,Angola,Portugal,110,225,0,335
31316,2022,Egypt,Portugal,38,18,0,56
31317,2022,Armenia,Portugal,14,0,0,14
31318,2022,Australia,Portugal,5,0,0,5
31319,2022,Azerbaijan,Portugal,10,5,0,15
31320,2022,Benin,Portugal,5,5,0,10
31321,2022,Bangladesh,Portugal,135,30,0,165
31322,2022,Belarus,Portugal,394,16,0,410
31323,2022,Brazil,Portugal,19,29,0,48
31324,2022,Bosnia and Herzegovina,Portugal,5,0,0,5
31325,2022,Canada,Portugal,13,5,0,18
31326,2022,Central African Rep.,Portugal,8,0,0,8
31327,2022,China,Portugal,47,0,0,47
31328,2022,Cameroon,Portugal,161,43,0,204
31329,2022,Congo,Portugal,37,10,0,47
31330,2022,Dem. Rep. of the Congo,Portugal,121,79,0,200
31331,2022,Comoros,Portugal,0,5,0,5
31332,2022,Colombia,Portugal,24,44,0,68
31333,2022,Cuba,Portugal,5,10,0,15
31334,2022,Dominican Rep.,Portugal,0,47,0,47
31335,2022,Ecuador,Portugal,24,0,0,24
31336,2022,Eritrea,Portugal,202,0,0,202
31337,2022,Ethiopia,Portugal,15,5,0,20
31338,2022,Gabon,Portugal,5,0,0,5
31339,2022,Gambia,Portugal,21,144,0,165
31340,2022,Palestinian,Portugal,6,13,0,19
31341,2022,United Kingdom of Great Britain and Northern Ireland,Portugal,7,0,0,7
31342,2022,Georgia,Portugal,20,9,0,29
31343,2022,Ghana,Portugal,445,39,0,484
31344,2022,Guinea-Bissau,Portugal,9,113,0,122
31345,2022,Guinea,Portugal,85,115,0,200
31346,2022,Haiti,Portugal,0,5,0,5
31347,2022,Cote d'Ivoire,Portugal,51,35,0,86
31348,2022,India,Portugal,684,136,0,820
31349,2022,Iran (Islamic Rep. of),Portugal,76,27,0,103
31350,2022,Iraq,Portugal,211,0,0,211
31351,2022,Israel,Portugal,20,0,0,20
31352,2022,Jamaica,Portugal,11,0,0,11
31353,2022,Jordan,Portugal,7,14,0,21
31354,2022,Kazakhstan,Portugal,13,0,0,13
31355,2022,Kenya,Portugal,15,0,0,15
31356,2022,Liberia,Portugal,18,0,0,18
31357,2022,Libya,Portugal,19,0,0,19
31358,2022,Lebanon,Portugal,9,0,0,9
31359,2022,Sri Lanka,Portugal,34,7,0,41
31360,2022,Mauritania,Portugal,0,5,0,5
31361,2022,Rep. of Moldova,Portugal,35,0,0,35
31362,2022,Mexico,Portugal,5,0,0,5
31363,2022,Mali,Portugal,23,25,0,48
31364,2022,Malawi,Portugal,5,0,0,5
31365,2022,Morocco,Portugal,627,168,0,795
31366,2022,Mauritius,Portugal,0,5,0,5
31367,2022,Namibia,Portugal,12,0,0,12
31368,2022,Nepal,Portugal,143,5,0,148
31369,2022,Nigeria,Portugal,3459,66,0,3525
31370,2022,Pakistan,Portugal,446,69,0,515
31371,2022,Philippines,Portugal,5,0,0,5
31372,2022,South Africa,Portugal,5,0,0,5
31373,2022,Russian Federation,Portugal,413,20,0,433
31374,2022,Rwanda,Portugal,6,0,0,6
31375,2022,Senegal,Portugal,5,81,0,86
31376,2022,Sierra Leone,Portugal,38,46,0,84
31377,2022,Somalia,Portugal,53,0,0,53
31378,2022,Sudan,Portugal,86,5,0,91
31379,2022,South Sudan,Portugal,31,0,0,31
31380,2022,Eswatini,Portugal,23,0,0,23
31381,2022,Syrian Arab Rep.,Portugal,906,0,0,906
31382,2022,United Rep. of Tanzania,Portugal,10,0,0,10
31383,2022,Turkmenistan,Portugal,5,0,0,5
31384,2022,Togo,Portugal,8,15,0,23
31385,2022,Tunisia,Portugal,24,5,0,29
31386,2022,Türkiye,Portugal,54,21,0,75
31387,2022,Uganda,Portugal,8,0,0,8
31388,2022,Ukraine,Portugal,38272,195,0,38467
31389,2022,United States of America,Portugal,55,5,0,60
31390,2022,Uzbekistan,Portugal,14,0,0,14
31391,2022,Venezuela (Bolivarian Republic of),Portugal,5,80,0,85
31392,2022,Yemen,Portugal,11,0,0,11
31393,2022,Zambia,Portugal,18,0,0,18
31394,2022,Zimbabwe,Portugal,45,0,0,45
31395,2022,Stateless,Portugal,31,0,0,31
31396,2022,Unknown ,Portugal,15,11,0,26
31397,2022,Afghanistan,Qatar,0,9,0,9
31398,2022,Egypt,Qatar,13,18,0,31
31399,2022,Eritrea,Qatar,0,5,0,5
31400,2022,Palestinian,Qatar,0,7,0,7
31401,2022,Iraq,Qatar,136,126,0,262
31402,2022,Pakistan,Qatar,5,0,0,5
31403,2022,Somalia,Qatar,8,5,0,13
31404,2022,Sudan,Qatar,0,15,0,15
31405,2022,Syrian Arab Rep.,Qatar,30,117,0,147
31406,2022,Yemen,Qatar,5,9,0,14
31407,2022,Stateless,Qatar,0,0,0,0
31408,2022,Afghanistan,Romania,404,192,0,596
31409,2022,Angola,Romania,10,0,0,10
31410,2022,Egypt,Romania,19,15,0,34
31411,2022,Armenia,Romania,18,0,0,18
31412,2022,Burundi,Romania,6,0,0,6
31413,2022,Bangladesh,Romania,11,80,0,91
31414,2022,Belarus,Romania,31,7,0,38
31415,2022,Central African Rep.,Romania,5,0,0,5
31416,2022,China,Romania,41,5,0,46
31417,2022,Cameroon,Romania,23,5,0,28
31418,2022,Congo,Romania,5,0,0,5
31419,2022,Dem. Rep. of the Congo,Romania,17,0,0,17
31420,2022,Cuba,Romania,6,5,0,11
31421,2022,Eritrea,Romania,73,0,0,73
31422,2022,Ethiopia,Romania,6,0,0,6
31423,2022,Gambia,Romania,5,0,0,5
31424,2022,Palestinian,Romania,63,0,0,63
31425,2022,Georgia,Romania,14,0,0,14
31426,2022,Guinea,Romania,11,6,0,17
31427,2022,India,Romania,14,67,0,81
31428,2022,Iran (Islamic Rep. of),Romania,126,7,0,133
31429,2022,Iraq,Romania,497,29,0,526
31430,2022,Jordan,Romania,9,0,0,9
31431,2022,Kazakhstan,Romania,5,0,0,5
31432,2022,Kuwait,Romania,5,0,0,5
31433,2022,Libya,Romania,5,5,0,10
31434,2022,Lebanon,Romania,19,8,0,27
31435,2022,Sri Lanka,Romania,0,7,0,7
31436,2022,Rep. of Moldova,Romania,68,0,0,68
31437,2022,Mali,Romania,5,0,0,5
31438,2022,Mongolia,Romania,0,6,0,6
31439,2022,Morocco,Romania,9,13,0,22
31440,2022,Myanmar,Romania,31,0,0,31
31441,2022,Nepal,Romania,0,23,0,23
31442,2022,Nigeria,Romania,9,13,0,22
31443,2022,Pakistan,Romania,35,66,0,101
31444,2022,Russian Federation,Romania,146,13,0,159
31445,2022,Rwanda,Romania,12,0,0,12
31446,2022,Sierra Leone,Romania,5,0,0,5
31447,2022,Somalia,Romania,357,64,0,421
31448,2022,Sudan,Romania,24,16,0,40
31449,2022,Syrian Arab Rep.,Romania,2357,65,0,2422
31450,2022,United Rep. of Tanzania,Romania,0,5,0,5
31451,2022,Turkmenistan,Romania,11,0,0,11
31452,2022,Tunisia,Romania,6,11,0,17
31453,2022,Türkiye,Romania,80,65,0,145
31454,2022,Uganda,Romania,6,0,0,6
31455,2022,Ukraine,Romania,83326,65,0,83391
31456,2022,Uzbekistan,Romania,10,0,0,10
31457,2022,Yemen,Romania,68,5,0,73
31458,2022,Stateless,Romania,124,7,0,131
31459,2022,Afghanistan,South Africa,5,16,0,21
31460,2022,Algeria,South Africa,5,181,0,186
31461,2022,Angola,South Africa,24,11,0,35
31462,2022,Egypt,South Africa,7,227,0,234
31463,2022,Bahrain,South Africa,0,5,0,5
31464,2022,Burundi,South Africa,2607,6669,0,9276
31465,2022,Benin,South Africa,5,35,0,40
31466,2022,Bangladesh,South Africa,200,24428,0,24628
31467,2022,Bahamas,South Africa,0,14,0,14
31468,2022,Burkina Faso,South Africa,0,39,0,39
31469,2022,Central African Rep.,South Africa,9,5,0,14
31470,2022,Chad,South Africa,5,5,0,10
31471,2022,China,South Africa,0,69,0,69
31472,2022,Cameroon,South Africa,324,1646,0,1970
31473,2022,Congo,South Africa,4369,7683,0,12052
31474,2022,Dem. Rep. of the Congo,South Africa,22471,33609,0,56080
31475,2022,Comoros,South Africa,0,13,0,13
31476,2022,Eritrea,South Africa,1347,1023,0,2370
31477,2022,Estonia,South Africa,5,7,0,12
31478,2022,Ethiopia,South Africa,15240,45365,0,60605
31479,2022,Gabon,South Africa,0,11,0,11
31480,2022,Gambia,South Africa,0,5,0,5
31481,2022,Palestinian,South Africa,33,10,0,43
31482,2022,Ghana,South Africa,7,1283,0,1290
31483,2022,Guinea-Bissau,South Africa,0,9,0,9
31484,2022,Guinea,South Africa,0,50,0,50
31485,2022,Hungary,South Africa,0,5,0,5
31486,2022,Cote d'Ivoire,South Africa,26,163,0,189
31487,2022,India,South Africa,5,3961,0,3966
31488,2022,Iraq,South Africa,14,6,0,20
31489,2022,Jordan,South Africa,5,5,0,10
31490,2022,Kenya,South Africa,140,946,0,1086
31491,2022,Liberia,South Africa,47,52,0,99
31492,2022,Lesotho,South Africa,0,16,0,16
31493,2022,Sri Lanka,South Africa,10,12,0,22
31494,2022,Mali,South Africa,5,113,0,118
31495,2022,Malawi,South Africa,8,1466,0,1474
31496,2022,Morocco,South Africa,5,6,0,11
31497,2022,Mozambique,South Africa,0,255,0,255
31498,2022,Nepal,South Africa,0,85,0,85
31499,2022,Niger,South Africa,0,675,0,675
31500,2022,Nigeria,South Africa,11,5061,0,5072
31501,2022,Pakistan,South Africa,11,8502,0,8513
31502,2022,Russian Federation,South Africa,10,0,0,10
31503,2022,Rwanda,South Africa,985,1026,0,2011
31504,2022,Senegal,South Africa,5,750,0,755
31505,2022,Sierra Leone,South Africa,19,13,0,32
31506,2022,Solomon Islands,South Africa,7,0,0,7
31507,2022,Somalia,South Africa,22388,4539,0,26927
31508,2022,Sudan,South Africa,86,60,0,146
31509,2022,Eswatini,South Africa,7,18,0,25
31510,2022,Syrian Arab Rep.,South Africa,38,20,0,58
31511,2022,United Rep. of Tanzania,South Africa,31,479,0,510
31512,2022,Thailand,South Africa,0,46,0,46
31513,2022,Timor-Leste,South Africa,0,7,0,7
31514,2022,Togo,South Africa,11,30,0,41
31515,2022,Türkiye,South Africa,5,10,0,15
31516,2022,Uganda,South Africa,456,3879,0,4335
31517,2022,Ukraine,South Africa,5,0,0,5
31518,2022,Yemen,South Africa,5,5,0,10
31519,2022,Zambia,South Africa,60,200,0,260
31520,2022,Zimbabwe,South Africa,3962,10218,0,14180
31521,2022,Afghanistan,Russian Federation,1084,109,0,1193
31522,2022,Egypt,Russian Federation,5,0,0,5
31523,2022,Armenia,Russian Federation,21,5,0,26
31524,2022,Azerbaijan,Russian Federation,28,5,0,33
31525,2022,Belgium,Russian Federation,0,8,0,8
31526,2022,Bangladesh,Russian Federation,5,0,0,5
31527,2022,China,Russian Federation,23,5,0,28
31528,2022,Dem. Rep. of the Congo,Russian Federation,14,0,0,14
31529,2022,Cuba,Russian Federation,6,5,0,11
31530,2022,Estonia,Russian Federation,5,0,0,5
31531,2022,Palestinian,Russian Federation,6,0,0,6
31532,2022,Georgia,Russian Federation,122,5,0,127
31533,2022,Germany,Russian Federation,15,5,0,20
31534,2022,Iran (Islamic Rep. of),Russian Federation,6,0,0,6
31535,2022,Iraq,Russian Federation,15,0,0,15
31536,2022,Israel,Russian Federation,5,0,0,5
31537,2022,Kazakhstan,Russian Federation,36,5,0,41
31538,2022,Kyrgyzstan,Russian Federation,38,0,0,38
31539,2022,Rep. of Korea,Russian Federation,5,0,0,5
31540,2022,Dem. People's Rep. of Korea,Russian Federation,40,10,0,50
31541,2022,Libya,Russian Federation,5,0,0,5
31542,2022,Lebanon,Russian Federation,5,0,0,5
31543,2022,Lithuania,Russian Federation,7,0,0,7
31544,2022,Latvia,Russian Federation,9,0,0,9
31545,2022,Rep. of Moldova,Russian Federation,21,5,0,26
31546,2022,Pakistan,Russian Federation,7,0,0,7
31547,2022,Philippines,Russian Federation,5,0,0,5
31548,2022,Sudan,Russian Federation,5,0,0,5
31549,2022,Syrian Arab Rep.,Russian Federation,280,42,0,322
31550,2022,Tajikistan,Russian Federation,34,17,0,51
31551,2022,Turkmenistan,Russian Federation,60,5,0,65
31552,2022,Türkiye,Russian Federation,6,0,0,6
31553,2022,Ukraine,Russian Federation,1456250,4400,0,1460650
31554,2022,United States of America,Russian Federation,6,7,0,13
31555,2022,Uzbekistan,Russian Federation,86,7,0,93
31556,2022,Yemen,Russian Federation,84,5,0,89
31557,2022,Stateless,Russian Federation,28,5,0,33
31558,2022,Unknown ,Russian Federation,11,7,0,18
31559,2022,Angola,Rwanda,9,0,0,9
31560,2022,Burundi,Rwanda,48218,54,0,48272
31561,2022,Chad,Rwanda,6,0,0,6
31562,2022,Cameroon,Rwanda,0,7,0,7
31563,2022,Dem. Rep. of the Congo,Rwanda,73297,149,0,73446
31564,2022,Eritrea,Rwanda,210,77,0,287
31565,2022,Ethiopia,Rwanda,17,5,0,22
31566,2022,Rwanda,Rwanda,0,0,0,0
31567,2022,Somalia,Rwanda,12,7,0,19
31568,2022,Sudan,Rwanda,95,49,0,144
31569,2022,South Sudan,Rwanda,10,8,0,18
31570,2022,Stateless,Rwanda,0,0,0,0
31571,2022,Colombia,El Salvador,15,5,0,20
31572,2022,Cuba,El Salvador,0,5,0,5
31573,2022,Guatemala,El Salvador,0,7,0,7
31574,2022,Honduras,El Salvador,24,8,0,32
31575,2022,Iraq,El Salvador,5,0,0,5
31576,2022,Nicaragua,El Salvador,23,21,0,44
31577,2022,El Salvador,El Salvador,0,0,71500,0
31578,2022,United States of America,El Salvador,5,0,0,5
31579,2022,Venezuela (Bolivarian Republic of),El Salvador,12,8,0,20
31580,2022,Afghanistan,Saudi Arabia,0,279,0,279
31581,2022,Egypt,Saudi Arabia,0,24,0,24
31582,2022,Burkina Faso,Saudi Arabia,0,11,0,11
31583,2022,Chad,Saudi Arabia,0,95,0,95
31584,2022,China,Saudi Arabia,14,24,0,38
31585,2022,Eritrea,Saudi Arabia,36,143,0,179
31586,2022,Ethiopia,Saudi Arabia,0,11,0,11
31587,2022,Palestinian,Saudi Arabia,14,474,0,488
31588,2022,Iraq,Saudi Arabia,32,197,0,229
31589,2022,Jordan,Saudi Arabia,0,19,0,19
31590,2022,Liberia,Saudi Arabia,9,0,0,9
31591,2022,Libya,Saudi Arabia,0,8,0,8
31592,2022,Lebanon,Saudi Arabia,0,13,0,13
31593,2022,Mali,Saudi Arabia,0,5,0,5
31594,2022,Myanmar,Saudi Arabia,0,131,0,131
31595,2022,Nigeria,Saudi Arabia,0,9,0,9
31596,2022,Pakistan,Saudi Arabia,0,27,0,27
31597,2022,Somalia,Saudi Arabia,16,74,0,90
31598,2022,Sudan,Saudi Arabia,0,122,0,122
31599,2022,South Sudan,Saudi Arabia,0,7,0,7
31600,2022,Syrian Arab Rep.,Saudi Arabia,194,10625,0,10819
31601,2022,Turkmenistan,Saudi Arabia,0,5,0,5
31602,2022,Tunisia,Saudi Arabia,6,0,0,6
31603,2022,Ukraine,Saudi Arabia,0,5,0,5
31604,2022,Yemen,Saudi Arabia,14,1150,0,1164
31605,2022,Stateless,Saudi Arabia,0,0,0,0
31606,2022,Unknown ,Saudi Arabia,0,25,0,25
31607,2022,Afghanistan,Serbia and Kosovo: S/RES/1244 (1999),27,8,0,35
31608,2022,Algeria,Serbia and Kosovo: S/RES/1244 (1999),0,5,0,5
31609,2022,Armenia,Serbia and Kosovo: S/RES/1244 (1999),5,0,0,5
31610,2022,Burundi,Serbia and Kosovo: S/RES/1244 (1999),8,115,0,123
31611,2022,Bangladesh,Serbia and Kosovo: S/RES/1244 (1999),0,0,0,0
31612,2022,Bosnia and Herzegovina,Serbia and Kosovo: S/RES/1244 (1999),7997,0,0,7997
31613,2022,Cameroon,Serbia and Kosovo: S/RES/1244 (1999),0,5,0,5
31614,2022,Congo,Serbia and Kosovo: S/RES/1244 (1999),0,5,0,5
31615,2022,Dem. Rep. of the Congo,Serbia and Kosovo: S/RES/1244 (1999),0,7,0,7
31616,2022,Cuba,Serbia and Kosovo: S/RES/1244 (1999),7,16,0,23
31617,2022,Ethiopia,Serbia and Kosovo: S/RES/1244 (1999),5,0,0,5
31618,2022,Palestinian,Serbia and Kosovo: S/RES/1244 (1999),6,0,0,6
31619,2022,Guinea-Bissau,Serbia and Kosovo: S/RES/1244 (1999),0,5,0,5
31620,2022,Guinea,Serbia and Kosovo: S/RES/1244 (1999),0,5,0,5
31621,2022,Croatia,Serbia and Kosovo: S/RES/1244 (1999),17334,0,0,17334
31622,2022,India,Serbia and Kosovo: S/RES/1244 (1999),0,0,0,0
31623,2022,Iran (Islamic Rep. of),Serbia and Kosovo: S/RES/1244 (1999),19,20,0,39
31624,2022,Iraq,Serbia and Kosovo: S/RES/1244 (1999),16,5,0,21
31625,2022,Jordan,Serbia and Kosovo: S/RES/1244 (1999),0,7,0,7
31626,2022,Libya,Serbia and Kosovo: S/RES/1244 (1999),47,5,0,52
31627,2022,North Macedonia,Serbia and Kosovo: S/RES/1244 (1999),0,0,0,0
31628,2022,Morocco,Serbia and Kosovo: S/RES/1244 (1999),0,11,0,11
31629,2022,Nigeria,Serbia and Kosovo: S/RES/1244 (1999),0,6,0,6
31630,2022,Pakistan,Serbia and Kosovo: S/RES/1244 (1999),5,0,0,5
31631,2022,South Africa,Serbia and Kosovo: S/RES/1244 (1999),0,5,0,5
31632,2022,Russian Federation,Serbia and Kosovo: S/RES/1244 (1999),18,8,0,26
31633,2022,Serbia and Kosovo: S/RES/1244 (1999),Serbia and Kosovo: S/RES/1244 (1999),0,0,211740,0
31634,2022,Somalia,Serbia and Kosovo: S/RES/1244 (1999),7,15,0,22
31635,2022,Sudan,Serbia and Kosovo: S/RES/1244 (1999),5,0,0,5
31636,2022,Syrian Arab Rep.,Serbia and Kosovo: S/RES/1244 (1999),40,7,0,47
31637,2022,Tunisia,Serbia and Kosovo: S/RES/1244 (1999),0,5,0,5
31638,2022,Türkiye,Serbia and Kosovo: S/RES/1244 (1999),99,12,0,111
31639,2022,Ukraine,Serbia and Kosovo: S/RES/1244 (1999),772,5,0,777
31640,2022,Stateless,Serbia and Kosovo: S/RES/1244 (1999),0,0,0,0
31641,2022,Unknown ,Serbia and Kosovo: S/RES/1244 (1999),0,0,0,0
31642,2022,Burundi,Senegal,5,0,0,5
31643,2022,Central African Rep.,Senegal,261,120,0,381
31644,2022,Chad,Senegal,5,12,0,17
31645,2022,Congo,Senegal,0,9,0,9
31646,2022,Dem. Rep. of the Congo,Senegal,7,16,0,23
31647,2022,Comoros,Senegal,0,10,0,10
31648,2022,Gambia,Senegal,7,49,0,56
31649,2022,Guinea,Senegal,5,16,0,21
31650,2022,Cote d'Ivoire,Senegal,5,0,0,5
31651,2022,Liberia,Senegal,0,5,0,5
31652,2022,Mauritania,Senegal,11474,7,0,11481
31653,2022,Mali,Senegal,0,5,0,5
31654,2022,Nigeria,Senegal,5,0,0,5
31655,2022,Rwanda,Senegal,5,0,0,5
31656,2022,Sierra Leone,Senegal,0,6,0,6
31657,2022,Togo,Senegal,0,7,0,7
31658,2022,Türkiye,Senegal,0,5,0,5
31659,2022,Stateless,Singapore,0,0,0,0
31660,2022,Cote d'Ivoire,Sierra Leone,10,0,0,10
31661,2022,Egypt,Somalia,0,5,0,5
31662,2022,Bangladesh,Somalia,6,0,0,6
31663,2022,Cameroon,Somalia,5,0,0,5
31664,2022,Djibouti,Somalia,0,7,0,7
31665,2022,Eritrea,Somalia,57,38,0,95
31666,2022,Ethiopia,Somalia,4816,17866,0,22682
31667,2022,Palestinian,Somalia,8,0,0,8
31668,2022,Jordan,Somalia,0,5,0,5
31669,2022,Mozambique,Somalia,0,5,0,5
31670,2022,Somalia,Somalia,0,0,2967500,0
31671,2022,Sudan,Somalia,0,12,0,12
31672,2022,Syrian Arab Rep.,Somalia,1018,98,0,1116
31673,2022,United Rep. of Tanzania,Somalia,0,139,0,139
31674,2022,Yemen,Somalia,9208,0,0,9208
31675,2022,Afghanistan,Spain,2111,685,0,2796
31676,2022,Albania,Spain,12,100,0,112
31677,2022,Algeria,Spain,159,1095,0,1254
31678,2022,Angola,Spain,39,25,0,64
31679,2022,Egypt,Spain,113,205,0,318
31680,2022,Argentina,Spain,45,790,0,835
31681,2022,Armenia,Spain,132,320,0,452
31682,2022,Australia,Spain,5,0,0,5
31683,2022,Azerbaijan,Spain,71,45,0,116
31684,2022,Burundi,Spain,8,0,0,8
31685,2022,Benin,Spain,5,10,0,15
31686,2022,Bangladesh,Spain,26,155,0,181
31687,2022,Burkina Faso,Spain,47,345,0,392
31688,2022,Belarus,Spain,193,260,0,453
31689,2022,Bolivia (Plurinational State of),Spain,12,75,0,87
31690,2022,Brazil,Spain,63,895,0,958
31691,2022,Bosnia and Herzegovina,Spain,5,5,0,10
31692,2022,Canada,Spain,11,5,0,16
31693,2022,Central African Rep.,Spain,143,30,0,173
31694,2022,Chad,Spain,34,20,0,54
31695,2022,China,Spain,62,845,0,907
31696,2022,Chile,Spain,41,365,0,406
31697,2022,Cameroon,Spain,136,580,0,716
31698,2022,Congo,Spain,69,25,0,94
31699,2022,Dem. Rep. of the Congo,Spain,88,80,0,168
31700,2022,Colombia,Spain,2641,29500,0,32141
31701,2022,Costa Rica,Spain,6,90,0,96
31702,2022,Cuba,Spain,199,3115,0,3314
31703,2022,Djibouti,Spain,0,5,0,5
31704,2022,Dominican Rep.,Spain,30,95,0,125
31705,2022,Ecuador,Spain,71,580,0,651
31706,2022,Equatorial Guinea,Spain,35,120,0,155
31707,2022,Eritrea,Spain,312,75,0,387
31708,2022,Estonia,Spain,5,0,0,5
31709,2022,Ethiopia,Spain,39,30,0,69
31710,2022,France,Spain,0,5,0,5
31711,2022,Gabon,Spain,5,5,0,10
31712,2022,Gambia,Spain,69,435,0,504
31713,2022,Palestinian,Spain,1381,345,0,1726
31714,2022,United Kingdom of Great Britain and Northern Ireland,Spain,15,0,0,15
31715,2022,Georgia,Spain,155,1755,0,1910
31716,2022,Ghana,Spain,22,130,0,152
31717,2022,Guinea-Bissau,Spain,9,55,0,64
31718,2022,Guatemala,Spain,111,570,0,681
31719,2022,Guinea,Spain,238,855,0,1093
31720,2022,Haiti,Spain,8,180,0,188
31721,2022,Honduras,Spain,1871,6385,0,8256
31722,2022,Cote d'Ivoire,Spain,385,820,0,1205
31723,2022,India,Spain,47,40,0,87
31724,2022,Iran (Islamic Rep. of),Spain,145,95,0,240
31725,2022,Iraq,Spain,298,110,0,408
31726,2022,Israel,Spain,36,20,0,56
31727,2022,Jamaica,Spain,61,20,0,81
31728,2022,Jordan,Spain,28,35,0,63
31729,2022,Kazakhstan,Spain,34,60,0,94
31730,2022,Kenya,Spain,15,5,0,20
31731,2022,Kyrgyzstan,Spain,11,15,0,26
31732,2022,Rep. of Korea,Spain,0,5,0,5
31733,2022,Kuwait,Spain,5,5,0,10
31734,2022,Liberia,Spain,7,40,0,47
31735,2022,Libya,Spain,171,25,0,196
31736,2022,Lebanon,Spain,35,40,0,75
31737,2022,Sri Lanka,Spain,66,20,0,86
31738,2022,Latvia,Spain,7,0,0,7
31739,2022,Mauritania,Spain,28,165,0,193
31740,2022,North Macedonia,Spain,0,15,0,15
31741,2022,Rep. of Moldova,Spain,100,110,0,210
31742,2022,Mexico,Spain,50,205,0,255
31743,2022,Mali,Spain,2650,5900,0,8550
31744,2022,Mongolia,Spain,17,0,0,17
31745,2022,Morocco,Spain,967,5965,0,6932
31746,2022,Mozambique,Spain,5,0,0,5
31747,2022,Myanmar,Spain,11,0,0,11
31748,2022,Nepal,Spain,0,5,0,5
31749,2022,Netherlands,Spain,0,5,0,5
31750,2022,Niger,Spain,25,5,0,30
31751,2022,Nicaragua,Spain,2049,4725,0,6774
31752,2022,Nigeria,Spain,255,1105,0,1360
31753,2022,Pakistan,Spain,490,600,0,1090
31754,2022,Panama,Spain,35,135,0,170
31755,2022,Paraguay,Spain,60,760,0,820
31756,2022,Peru,Spain,337,6755,0,7092
31757,2022,Philippines,Spain,6,5,0,11
31758,2022,Qatar,Spain,0,5,0,5
31759,2022,Romania,Spain,8,0,0,8
31760,2022,South Africa,Spain,5,0,0,5
31761,2022,Russian Federation,Spain,1185,1875,0,3060
31762,2022,Rwanda,Spain,5,0,0,5
31763,2022,El Salvador,Spain,992,3980,0,4972
31764,2022,Saudi Arabia,Spain,5,5,0,10
31765,2022,Serbia and Kosovo: S/RES/1244 (1999),Spain,13,30,0,43
31766,2022,Senegal,Spain,54,2940,0,2994
31767,2022,Sierra Leone,Spain,28,50,0,78
31768,2022,Somalia,Spain,705,205,0,910
31769,2022,Viet Nam,Spain,11,20,0,31
31770,2022,Saint Kitts and Nevis,Spain,0,5,0,5
31771,2022,Sudan,Spain,622,245,0,867
31772,2022,South Sudan,Spain,5,10,0,15
31773,2022,Syrian Arab Rep.,Spain,14994,1080,0,16074
31774,2022,United Rep. of Tanzania,Spain,0,5,0,5
31775,2022,Tajikistan,Spain,7,5,0,12
31776,2022,Turkmenistan,Spain,10,10,0,20
31777,2022,Togo,Spain,5,45,0,50
31778,2022,Trinidad and Tobago,Spain,5,10,0,15
31779,2022,Tunisia,Spain,75,110,0,185
31780,2022,Türkiye,Spain,217,430,0,647
31781,2022,Uganda,Spain,7,5,0,12
31782,2022,Ukraine,Spain,128129,1700,0,129829
31783,2022,Uruguay,Spain,16,215,0,231
31784,2022,United States of America,Spain,92,75,0,167
31785,2022,Uzbekistan,Spain,24,15,0,39
31786,2022,Venezuela (Bolivarian Republic of),Spain,96786,31490,0,128276
31787,2022,Western Sahara,Spain,17,0,0,17
31788,2022,Yemen,Spain,460,285,0,745
31789,2022,Stateless,Spain,6,10,0,16
31790,2022,Tibetan,Spain,5,0,0,5
31791,2022,Unknown ,Spain,22,65,0,87
31792,2022,Stateless,Viet Nam,0,0,0,0
31793,2022,Venezuela (Bolivarian Republic of),Saint Kitts and Nevis,0,0,0,0
31794,2022,Afghanistan,Sudan,0,0,0,0
31795,2022,Andorra,Sudan,5,0,0,5
31796,2022,Egypt,Sudan,18,11,0,29
31797,2022,Burundi,Sudan,11,8,0,19
31798,2022,Central African Rep.,Sudan,28035,7,0,28042
31799,2022,Chad,Sudan,4628,5,0,4633
31800,2022,Cameroon,Sudan,7,0,0,7
31801,2022,Congo,Sudan,18,5,0,23
31802,2022,Dem. Rep. of the Congo,Sudan,425,342,0,767
31803,2022,Eritrea,Sudan,117955,13236,0,131191
31804,2022,Ethiopia,Sudan,57682,14533,0,72215
31805,2022,Palestinian,Sudan,49,24,0,73
31806,2022,India,Sudan,0,5,0,5
31807,2022,Iraq,Sudan,9,13,0,22
31808,2022,Jordan,Sudan,0,0,0,0
31809,2022,Kuwait,Sudan,0,0,0,0
31810,2022,Nigeria,Sudan,12,0,0,12
31811,2022,Saudi Arabia,Sudan,0,0,0,0
31812,2022,Somalia,Sudan,409,156,0,565
31813,2022,Sudan,Sudan,0,0,3036593,0
31814,2022,South Sudan,Sudan,807532,0,0,807532
31815,2022,Syrian Arab Rep.,Sudan,93480,0,0,93480
31816,2022,Türkiye,Sudan,5,0,0,5
31817,2022,Uganda,Sudan,5,0,0,5
31818,2022,Yemen,Sudan,1881,388,0,2269
31819,2022,Unknown ,Sudan,137,5,0,142
31820,2022,Colombia,Suriname,0,10,0,10
31821,2022,Cuba,Suriname,17,2017,0,2034
31822,2022,Dominican Rep.,Suriname,0,6,0,6
31823,2022,Haiti,Suriname,0,5,0,5
31824,2022,Nigeria,Suriname,0,5,0,5
31825,2022,Venezuela (Bolivarian Republic of),Suriname,13,413,0,426
31826,2022,Burundi,South Sudan,306,882,0,1188
31827,2022,Central African Rep.,South Sudan,2409,0,0,2409
31828,2022,Dem. Rep. of the Congo,South Sudan,18854,20,0,18874
31829,2022,Eritrea,South Sudan,832,2396,0,3228
31830,2022,Ethiopia,South Sudan,4610,901,0,5511
31831,2022,Liberia,South Sudan,0,5,0,5
31832,2022,Somalia,South Sudan,5,31,0,36
31833,2022,Sudan,South Sudan,310104,21,0,310125
31834,2022,South Sudan,South Sudan,0,0,2229657,0
31835,2022,Stateless,South Sudan,0,0,0,0
31836,2022,Afghanistan,Slovakia,366,0,0,366
31837,2022,Algeria,Slovakia,5,0,0,5
31838,2022,Angola,Slovakia,24,0,0,24
31839,2022,Egypt,Slovakia,18,0,0,18
31840,2022,Armenia,Slovakia,55,0,0,55
31841,2022,Azerbaijan,Slovakia,23,0,0,23
31842,2022,Burundi,Slovakia,5,0,0,5
31843,2022,Bangladesh,Slovakia,0,18,0,18
31844,2022,Belarus,Slovakia,39,5,0,44
31845,2022,Bosnia and Herzegovina,Slovakia,36,0,0,36
31846,2022,Bulgaria,Slovakia,8,0,0,8
31847,2022,Cambodia,Slovakia,5,0,0,5
31848,2022,China,Slovakia,16,0,0,16
31849,2022,Cameroon,Slovakia,11,0,0,11
31850,2022,Dem. Rep. of the Congo,Slovakia,17,0,0,17
31851,2022,Cuba,Slovakia,32,0,0,32
31852,2022,Palestinian,Slovakia,9,0,0,9
31853,2022,Georgia,Slovakia,12,0,0,12
31854,2022,India,Slovakia,11,0,0,11
31855,2022,Iran (Islamic Rep. of),Slovakia,43,0,0,43
31856,2022,Iraq,Slovakia,217,0,0,217
31857,2022,Israel,Slovakia,8,0,0,8
31858,2022,Jordan,Slovakia,7,0,0,7
31859,2022,Kazakhstan,Slovakia,9,0,0,9
31860,2022,Kyrgyzstan,Slovakia,6,0,0,6
31861,2022,Liberia,Slovakia,5,0,0,5
31862,2022,Libya,Slovakia,9,0,0,9
31863,2022,Sri Lanka,Slovakia,0,5,0,5
31864,2022,Rep. of Moldova,Slovakia,18,0,0,18
31865,2022,Morocco,Slovakia,10,0,0,10
31866,2022,Nigeria,Slovakia,19,5,0,24
31867,2022,Pakistan,Slovakia,8,0,0,8
31868,2022,Romania,Slovakia,37,0,0,37
31869,2022,Russian Federation,Slovakia,273,9,0,282
31870,2022,Serbia and Kosovo: S/RES/1244 (1999),Slovakia,47,0,0,47
31871,2022,Somalia,Slovakia,34,0,0,34
31872,2022,Viet Nam,Slovakia,24,0,0,24
31873,2022,Syrian Arab Rep.,Slovakia,26,0,0,26
31874,2022,Tajikistan,Slovakia,8,0,0,8
31875,2022,Tunisia,Slovakia,5,0,0,5
31876,2022,Türkiye,Slovakia,13,0,0,13
31877,2022,Uganda,Slovakia,5,0,0,5
31878,2022,Ukraine,Slovakia,83297,8,0,83305
31879,2022,United States of America,Slovakia,21,0,0,21
31880,2022,Uzbekistan,Slovakia,9,0,0,9
31881,2022,Yemen,Slovakia,25,0,0,25
31882,2022,Stateless,Slovakia,10,0,0,10
31883,2022,Afghanistan,Slovenia,64,229,0,293
31884,2022,Albania,Slovenia,0,5,0,5
31885,2022,Algeria,Slovenia,0,7,0,7
31886,2022,Egypt,Slovenia,0,5,0,5
31887,2022,Azerbaijan,Slovenia,5,0,0,5
31888,2022,Burundi,Slovenia,0,83,0,83
31889,2022,Bangladesh,Slovenia,0,37,0,37
31890,2022,Burkina Faso,Slovenia,0,7,0,7
31891,2022,Belarus,Slovenia,5,0,0,5
31892,2022,Bosnia and Herzegovina,Slovenia,7,0,0,7
31893,2022,Cameroon,Slovenia,10,30,0,40
31894,2022,Congo,Slovenia,0,9,0,9
31895,2022,Dem. Rep. of the Congo,Slovenia,6,19,0,25
31896,2022,Cuba,Slovenia,0,86,0,86
31897,2022,Eritrea,Slovenia,86,0,0,86
31898,2022,Ethiopia,Slovenia,0,5,0,5
31899,2022,Gambia,Slovenia,0,7,0,7
31900,2022,Palestinian,Slovenia,27,0,0,27
31901,2022,Ghana,Slovenia,0,25,0,25
31902,2022,Guinea-Bissau,Slovenia,0,7,0,7
31903,2022,Guinea,Slovenia,0,20,0,20
31904,2022,India,Slovenia,0,49,0,49
31905,2022,Iran (Islamic Rep. of),Slovenia,83,22,0,105
31906,2022,Iraq,Slovenia,53,84,0,137
31907,2022,Jordan,Slovenia,0,5,0,5
31908,2022,Kazakhstan,Slovenia,21,0,0,21
31909,2022,Sri Lanka,Slovenia,0,5,0,5
31910,2022,Mali,Slovenia,0,9,0,9
31911,2022,Morocco,Slovenia,5,8,0,13
31912,2022,Nepal,Slovenia,0,36,0,36
31913,2022,Nigeria,Slovenia,8,5,0,13
31914,2022,Pakistan,Slovenia,5,69,0,74
31915,2022,Russian Federation,Slovenia,50,11,0,61
31916,2022,Serbia and Kosovo: S/RES/1244 (1999),Slovenia,11,0,0,11
31917,2022,Senegal,Slovenia,0,5,0,5
31918,2022,Somalia,Slovenia,52,5,0,57
31919,2022,Sudan,Slovenia,6,0,0,6
31920,2022,Syrian Arab Rep.,Slovenia,326,20,0,346
31921,2022,Tunisia,Slovenia,0,6,0,6
31922,2022,Türkiye,Slovenia,61,27,0,88
31923,2022,Ukraine,Slovenia,6652,38,0,6690
31924,2022,United States of America,Slovenia,5,5,0,10
31925,2022,Yemen,Slovenia,6,0,0,6
31926,2022,Unknown ,Slovenia,16,0,0,16
31927,2022,Angola,Eswatini,12,0,0,12
31928,2022,Burundi,Eswatini,186,76,0,262
31929,2022,Cameroon,Eswatini,0,6,0,6
31930,2022,Congo,Eswatini,16,23,0,39
31931,2022,Dem. Rep. of the Congo,Eswatini,467,206,0,673
31932,2022,Eritrea,Eswatini,5,15,0,20
31933,2022,Ethiopia,Eswatini,16,83,0,99
31934,2022,Rwanda,Eswatini,173,69,0,242
31935,2022,Somalia,Eswatini,145,291,0,436
31936,2022,Eswatini,Eswatini,0,0,0,0
31937,2022,United Rep. of Tanzania,Eswatini,0,5,0,5
31938,2022,Uganda,Eswatini,6,0,0,6
31939,2022,Zimbabwe,Eswatini,9,0,0,9
31940,2022,Afghanistan,Sweden,26857,1904,0,28761
31941,2022,Albania,Sweden,260,138,0,398
31942,2022,Algeria,Sweden,64,69,0,133
31943,2022,Angola,Sweden,22,10,0,32
31944,2022,Egypt,Sweden,424,127,0,551
31945,2022,Argentina,Sweden,0,5,0,5
31946,2022,Armenia,Sweden,344,135,0,479
31947,2022,Azerbaijan,Sweden,658,217,0,875
31948,2022,Bahrain,Sweden,16,5,0,21
31949,2022,Burundi,Sweden,223,5,0,228
31950,2022,Benin,Sweden,10,0,0,10
31951,2022,Bangladesh,Sweden,243,105,0,348
31952,2022,Burkina Faso,Sweden,5,0,0,5
31953,2022,Belarus,Sweden,114,113,0,227
31954,2022,Bolivia (Plurinational State of),Sweden,51,15,0,66
31955,2022,Brazil,Sweden,7,18,0,25
31956,2022,Bosnia and Herzegovina,Sweden,59,56,0,115
31957,2022,Bulgaria,Sweden,11,0,0,11
31958,2022,Canada,Sweden,5,5,0,10
31959,2022,Central African Rep.,Sweden,71,0,0,71
31960,2022,Chad,Sweden,18,0,0,18
31961,2022,China,Sweden,223,29,0,252
31962,2022,Chile,Sweden,9,11,0,20
31963,2022,Cameroon,Sweden,235,126,0,361
31964,2022,Congo,Sweden,30,17,0,47
31965,2022,Dem. Rep. of the Congo,Sweden,823,68,0,891
31966,2022,Comoros,Sweden,5,0,0,5
31967,2022,Colombia,Sweden,39,262,0,301
31968,2022,Cuba,Sweden,23,8,0,31
31969,2022,Djibouti,Sweden,30,19,0,49
31970,2022,Ecuador,Sweden,6,0,0,6
31971,2022,Equatorial Guinea,Sweden,5,0,0,5
31972,2022,Eritrea,Sweden,25849,309,0,26158
31973,2022,Ethiopia,Sweden,2530,314,0,2844
31974,2022,Gambia,Sweden,177,74,0,251
31975,2022,Palestinian,Sweden,1345,325,0,1670
31976,2022,United Kingdom of Great Britain and Northern Ireland,Sweden,5,5,0,10
31977,2022,Georgia,Sweden,131,92,0,223
31978,2022,Ghana,Sweden,67,35,0,102
31979,2022,Guinea-Bissau,Sweden,7,0,0,7
31980,2022,Greece,Sweden,18,0,0,18
31981,2022,Guatemala,Sweden,8,5,0,13
31982,2022,Guinea,Sweden,62,13,0,75
31983,2022,Haiti,Sweden,0,5,0,5
31984,2022,Honduras,Sweden,29,14,0,43
31985,2022,Croatia,Sweden,0,5,0,5
31986,2022,Hungary,Sweden,5,0,0,5
31987,2022,Cote d'Ivoire,Sweden,30,5,0,35
31988,2022,India,Sweden,25,31,0,56
31989,2022,Indonesia,Sweden,15,0,0,15
31990,2022,Iran (Islamic Rep. of),Sweden,7146,582,0,7728
31991,2022,Iraq,Sweden,10464,1391,0,11855
31992,2022,Israel,Sweden,22,10,0,32
31993,2022,Jamaica,Sweden,5,0,0,5
31994,2022,Jordan,Sweden,291,152,0,443
31995,2022,Kazakhstan,Sweden,206,81,0,287
31996,2022,Kenya,Sweden,84,18,0,102
31997,2022,Kyrgyzstan,Sweden,162,67,0,229
31998,2022,Rep. of Korea,Sweden,8,5,0,13
31999,2022,Kuwait,Sweden,31,5,0,36
32000,2022,Liberia,Sweden,11,0,0,11
32001,2022,Libya,Sweden,255,46,0,301
32002,2022,Lebanon,Sweden,528,216,0,744
32003,2022,Sri Lanka,Sweden,26,23,0,49
32004,2022,Lithuania,Sweden,0,7,0,7
32005,2022,Mauritania,Sweden,13,0,0,13
32006,2022,North Macedonia,Sweden,37,25,0,62
32007,2022,Rep. of Moldova,Sweden,26,19,0,45
32008,2022,Mexico,Sweden,0,5,0,5
32009,2022,Mali,Sweden,39,5,0,44
32010,2022,Malaysia,Sweden,13,0,0,13
32011,2022,Mongolia,Sweden,240,101,0,341
32012,2022,Morocco,Sweden,263,137,0,400
32013,2022,Montenegro,Sweden,21,10,0,31
32014,2022,Myanmar,Sweden,6,8,0,14
32015,2022,Nepal,Sweden,8,5,0,13
32016,2022,Niger,Sweden,5,0,0,5
32017,2022,Nicaragua,Sweden,62,99,0,161
32018,2022,Nigeria,Sweden,639,313,0,952
32019,2022,Pakistan,Sweden,595,175,0,770
32020,2022,Panama,Sweden,0,5,0,5
32021,2022,Paraguay,Sweden,0,5,0,5
32022,2022,Peru,Sweden,9,111,0,120
32023,2022,Philippines,Sweden,5,11,0,16
32024,2022,Poland,Sweden,5,0,0,5
32025,2022,Romania,Sweden,38,0,0,38
32026,2022,Russian Federation,Sweden,1439,515,0,1954
32027,2022,Rwanda,Sweden,54,34,0,88
32028,2022,El Salvador,Sweden,139,77,0,216
32029,2022,Saudi Arabia,Sweden,62,5,0,67
32030,2022,Serbia and Kosovo: S/RES/1244 (1999),Sweden,516,191,0,707
32031,2022,Senegal,Sweden,55,16,0,71
32032,2022,Sierra Leone,Sweden,65,13,0,78
32033,2022,Somalia,Sweden,9315,412,0,9727
32034,2022,Viet Nam,Sweden,51,49,0,100
32035,2022,Sudan,Sweden,1077,68,0,1145
32036,2022,South Sudan,Sweden,64,0,0,64
32037,2022,Eswatini,Sweden,5,0,0,5
32038,2022,Syrian Arab Rep.,Sweden,113213,1227,0,114440
32039,2022,United Rep. of Tanzania,Sweden,65,29,0,94
32040,2022,Thailand,Sweden,5,10,0,15
32041,2022,Tajikistan,Sweden,85,50,0,135
32042,2022,Turkmenistan,Sweden,36,21,0,57
32043,2022,Tunisia,Sweden,47,44,0,91
32044,2022,Türkiye,Sweden,2531,368,0,2899
32045,2022,United Arab Emirates,Sweden,5,0,0,5
32046,2022,Uganda,Sweden,722,70,0,792
32047,2022,Ukraine,Sweden,40129,1345,0,41474
32048,2022,United States of America,Sweden,34,7,0,41
32049,2022,Uzbekistan,Sweden,525,391,0,916
32050,2022,Venezuela (Bolivarian Republic of),Sweden,41,60,0,101
32051,2022,Yemen,Sweden,1715,69,0,1784
32052,2022,Zambia,Sweden,12,0,0,12
32053,2022,Zimbabwe,Sweden,15,5,0,20
32054,2022,Stateless,Sweden,21382,522,0,21904
32055,2022,Unknown ,Sweden,521,197,0,718
32056,2022,Afghanistan,Switzerland,11441,1768,0,13209
32057,2022,Albania,Switzerland,89,60,0,149
32058,2022,Algeria,Switzerland,99,159,0,258
32059,2022,Angola,Switzerland,640,38,0,678
32060,2022,Egypt,Switzerland,22,12,0,34
32061,2022,Armenia,Switzerland,148,28,0,176
32062,2022,Azerbaijan,Switzerland,60,75,0,135
32063,2022,Burundi,Switzerland,71,20,0,91
32064,2022,Benin,Switzerland,9,5,0,14
32065,2022,Bangladesh,Switzerland,22,12,0,34
32066,2022,Burkina Faso,Switzerland,14,5,0,19
32067,2022,Belarus,Switzerland,32,30,0,62
32068,2022,Brazil,Switzerland,9,5,0,14
32069,2022,Bosnia and Herzegovina,Switzerland,302,13,0,315
32070,2022,Bulgaria,Switzerland,5,0,0,5
32071,2022,Canada,Switzerland,0,5,0,5
32072,2022,Central African Rep.,Switzerland,12,0,0,12
32073,2022,Chad,Switzerland,10,13,0,23
32074,2022,China,Switzerland,2723,85,0,2808
32075,2022,Cameroon,Switzerland,142,43,0,185
32076,2022,Congo,Switzerland,17,9,0,26
32077,2022,Dem. Rep. of the Congo,Switzerland,838,64,0,902
32078,2022,Colombia,Switzerland,41,111,0,152
32079,2022,Cuba,Switzerland,18,52,0,70
32080,2022,Ecuador,Switzerland,5,5,0,10
32081,2022,Equatorial Guinea,Switzerland,5,0,0,5
32082,2022,Eritrea,Switzerland,14726,284,0,15010
32083,2022,Ethiopia,Switzerland,1028,174,0,1202
32084,2022,France,Switzerland,5,0,0,5
32085,2022,Gambia,Switzerland,30,13,0,43
32086,2022,Georgia,Switzerland,230,265,0,495
32087,2022,Ghana,Switzerland,18,13,0,31
32088,2022,Guinea-Bissau,Switzerland,41,0,0,41
32089,2022,Greece,Switzerland,5,0,0,5
32090,2022,Guatemala,Switzerland,5,0,0,5
32091,2022,Guinea,Switzerland,139,27,0,166
32092,2022,Haiti,Switzerland,0,5,0,5
32093,2022,Honduras,Switzerland,5,10,0,15
32094,2022,Cote d'Ivoire,Switzerland,113,15,0,128
32095,2022,India,Switzerland,34,18,0,52
32096,2022,Indonesia,Switzerland,0,6,0,6
32097,2022,Iran (Islamic Rep. of),Switzerland,1221,661,0,1882
32098,2022,Iraq,Switzerland,2338,388,0,2726
32099,2022,Jordan,Switzerland,20,6,0,26
32100,2022,Kazakhstan,Switzerland,19,12,0,31
32101,2022,Kenya,Switzerland,22,0,0,22
32102,2022,Kyrgyzstan,Switzerland,5,15,0,20
32103,2022,Liberia,Switzerland,17,0,0,17
32104,2022,Libya,Switzerland,132,29,0,161
32105,2022,Lebanon,Switzerland,30,23,0,53
32106,2022,Sri Lanka,Switzerland,1341,637,0,1978
32107,2022,Mauritania,Switzerland,9,0,0,9
32108,2022,North Macedonia,Switzerland,137,41,0,178
32109,2022,Rep. of Moldova,Switzerland,8,0,0,8
32110,2022,Mali,Switzerland,23,0,0,23
32111,2022,Malawi,Switzerland,0,5,0,5
32112,2022,Mongolia,Switzerland,158,6,0,164
32113,2022,Morocco,Switzerland,53,52,0,105
32114,2022,Montenegro,Switzerland,46,15,0,61
32115,2022,Myanmar,Switzerland,34,13,0,47
32116,2022,Nepal,Switzerland,12,6,0,18
32117,2022,Niger,Switzerland,13,0,0,13
32118,2022,Nicaragua,Switzerland,0,10,0,10
32119,2022,Nigeria,Switzerland,272,87,0,359
32120,2022,Pakistan,Switzerland,171,87,0,258
32121,2022,Paraguay,Switzerland,5,0,0,5
32122,2022,Peru,Switzerland,0,5,0,5
32123,2022,Philippines,Switzerland,11,0,0,11
32124,2022,Romania,Switzerland,0,5,0,5
32125,2022,South Africa,Switzerland,6,0,0,6
32126,2022,Russian Federation,Switzerland,287,137,0,424
32127,2022,Rwanda,Switzerland,11,15,0,26
32128,2022,El Salvador,Switzerland,9,0,0,9
32129,2022,Saudi Arabia,Switzerland,15,5,0,20
32130,2022,Serbia and Kosovo: S/RES/1244 (1999),Switzerland,1531,61,0,1592
32131,2022,Senegal,Switzerland,44,11,0,55
32132,2022,Sierra Leone,Switzerland,34,6,0,40
32133,2022,Somalia,Switzerland,2608,179,0,2787
32134,2022,Spain,Switzerland,5,0,0,5
32135,2022,Viet Nam,Switzerland,7,0,0,7
32136,2022,Sudan,Switzerland,153,14,0,167
32137,2022,South Sudan,Switzerland,13,0,0,13
32138,2022,Syrian Arab Rep.,Switzerland,8039,272,0,8311
32139,2022,United Rep. of Tanzania,Switzerland,12,0,0,12
32140,2022,Tajikistan,Switzerland,0,6,0,6
32141,2022,Turkmenistan,Switzerland,0,5,0,5
32142,2022,Togo,Switzerland,60,13,0,73
32143,2022,Tunisia,Switzerland,34,53,0,87
32144,2022,Türkiye,Switzerland,1171,1623,0,2794
32145,2022,Uganda,Switzerland,32,24,0,56
32146,2022,Ukraine,Switzerland,57697,23,0,57720
32147,2022,Uzbekistan,Switzerland,17,5,0,22
32148,2022,Venezuela (Bolivarian Republic of),Switzerland,38,39,0,77
32149,2022,Western Sahara,Switzerland,5,0,0,5
32150,2022,Yemen,Switzerland,130,7,0,137
32151,2022,Zimbabwe,Switzerland,8,5,0,13
32152,2022,Stateless,Switzerland,784,0,0,784
32153,2022,Unknown ,Switzerland,835,69,0,904
32154,2022,Afghanistan,Syrian Arab Rep.,1162,21,0,1183
32155,2022,Algeria,Syrian Arab Rep.,5,0,0,5
32156,2022,Egypt,Syrian Arab Rep.,31,16,0,47
32157,2022,Bahrain,Syrian Arab Rep.,5,0,0,5
32158,2022,Burkina Faso,Syrian Arab Rep.,0,5,0,5
32159,2022,Chad,Syrian Arab Rep.,9,0,0,9
32160,2022,Eritrea,Syrian Arab Rep.,16,0,0,16
32161,2022,Ethiopia,Syrian Arab Rep.,13,0,0,13
32162,2022,United Kingdom of Great Britain and Northern Ireland,Syrian Arab Rep.,0,5,0,5
32163,2022,Guinea,Syrian Arab Rep.,56,5,0,61
32164,2022,Iran (Islamic Rep. of),Syrian Arab Rep.,49,11,0,60
32165,2022,Iraq,Syrian Arab Rep.,11121,7269,0,18390
32166,2022,Jordan,Syrian Arab Rep.,18,7,0,25
32167,2022,Libya,Syrian Arab Rep.,10,10,0,20
32168,2022,Lebanon,Syrian Arab Rep.,23,19,0,42
32169,2022,Sri Lanka,Syrian Arab Rep.,0,5,0,5
32170,2022,Morocco,Syrian Arab Rep.,0,5,0,5
32171,2022,Nigeria,Syrian Arab Rep.,0,6,0,6
32172,2022,Pakistan,Syrian Arab Rep.,224,15,0,239
32173,2022,Saudi Arabia,Syrian Arab Rep.,5,0,0,5
32174,2022,Sierra Leone,Syrian Arab Rep.,17,0,0,17
32175,2022,Somalia,Syrian Arab Rep.,346,13,0,359
32176,2022,Sudan,Syrian Arab Rep.,736,95,0,831
32177,2022,South Sudan,Syrian Arab Rep.,77,0,0,77
32178,2022,Syrian Arab Rep.,Syrian Arab Rep.,0,0,6754277,0
32179,2022,Tunisia,Syrian Arab Rep.,5,5,0,10
32180,2022,Türkiye,Syrian Arab Rep.,5,8,0,13
32181,2022,Yemen,Syrian Arab Rep.,177,142,0,319
32182,2022,Stateless,Syrian Arab Rep.,0,0,0,0
32183,2022,Unknown ,Syrian Arab Rep.,5,0,0,5
32184,2022,Burundi,United Rep. of Tanzania,155996,8957,0,164953
32185,2022,Dem. Rep. of the Congo,United Rep. of Tanzania,51987,19203,0,71190
32186,2022,Iran (Islamic Rep. of),United Rep. of Tanzania,5,0,0,5
32187,2022,Kenya,United Rep. of Tanzania,0,5,0,5
32188,2022,Lebanon,United Rep. of Tanzania,5,0,0,5
32189,2022,Rwanda,United Rep. of Tanzania,73,29,0,102
32190,2022,Somalia,United Rep. of Tanzania,162,0,0,162
32191,2022,Sudan,United Rep. of Tanzania,0,6,0,6
32192,2022,South Sudan,United Rep. of Tanzania,6,0,0,6
32193,2022,Syrian Arab Rep.,United Rep. of Tanzania,9,20,0,29
32194,2022,United Rep. of Tanzania,United Rep. of Tanzania,6,0,0,6
32195,2022,Türkiye,United Rep. of Tanzania,0,6,0,6
32196,2022,Uganda,United Rep. of Tanzania,14,6,0,20
32197,2022,Yemen,United Rep. of Tanzania,9,62,0,71
32198,2022,Sri Lanka,Turks and Caicos Islands,7,0,0,7
32199,2022,Afghanistan,Thailand,156,10,0,166
32200,2022,Egypt,Thailand,17,0,0,17
32201,2022,Cambodia,Thailand,247,87,0,334
32202,2022,China,Thailand,177,11,0,188
32203,2022,Cameroon,Thailand,62,17,0,79
32204,2022,Dem. Rep. of the Congo,Thailand,18,0,0,18
32205,2022,Ethiopia,Thailand,10,11,0,21
32206,2022,Palestinian,Thailand,237,5,0,242
32207,2022,Guinea,Thailand,0,5,0,5
32208,2022,Cote d'Ivoire,Thailand,18,0,0,18
32209,2022,Iran (Islamic Rep. of),Thailand,88,13,0,101
32210,2022,Iraq,Thailand,148,12,0,160
32211,2022,Lao People's Dem. Rep.,Thailand,6,0,0,6
32212,2022,Sri Lanka,Thailand,103,15,0,118
32213,2022,Morocco,Thailand,5,0,0,5
32214,2022,Myanmar,Thailand,92078,0,0,92078
32215,2022,Nepal,Thailand,5,0,0,5
32216,2022,Nigeria,Thailand,5,12,0,17
32217,2022,Pakistan,Thailand,1502,102,0,1604
32218,2022,Russian Federation,Thailand,5,0,0,5
32219,2022,Somalia,Thailand,162,5,0,167
32220,2022,Viet Nam,Thailand,998,362,0,1360
32221,2022,Sudan,Thailand,0,5,0,5
32222,2022,Syrian Arab Rep.,Thailand,212,8,0,220
32223,2022,United Rep. of Tanzania,Thailand,5,0,0,5
32224,2022,Yemen,Thailand,36,0,0,36
32225,2022,Zimbabwe,Thailand,9,0,0,9
32226,2022,Stateless,Thailand,0,0,0,0
32227,2022,Afghanistan,Tajikistan,9624,1638,0,11262
32228,2022,Iran (Islamic Rep. of),Tajikistan,5,0,0,5
32229,2022,Stateless,Tajikistan,0,0,0,0
32230,2022,Afghanistan,Turkmenistan,9,0,0,9
32231,2022,Azerbaijan,Turkmenistan,5,0,0,5
32232,2022,Stateless,Turkmenistan,0,0,0,0
32233,2022,Burundi,Togo,5,0,0,5
32234,2022,Benin,Togo,36,15,0,51
32235,2022,Central African Rep.,Togo,244,232,0,476
32236,2022,Chad,Togo,13,16,0,29
32237,2022,Cameroon,Togo,7,18,0,25
32238,2022,Congo,Togo,32,40,0,72
32239,2022,Dem. Rep. of the Congo,Togo,94,94,0,188
32240,2022,Gabon,Togo,0,6,0,6
32241,2022,Palestinian,Togo,0,5,0,5
32242,2022,Ghana,Togo,8513,0,0,8513
32243,2022,Cote d'Ivoire,Togo,1290,125,0,1415
32244,2022,Iraq,Togo,5,0,0,5
32245,2022,Liberia,Togo,0,6,0,6
32246,2022,Lebanon,Togo,11,23,0,34
32247,2022,Sri Lanka,Togo,0,5,0,5
32248,2022,Mali,Togo,76,42,0,118
32249,2022,Niger,Togo,10,0,0,10
32250,2022,Nigeria,Togo,15,8,0,23
32251,2022,Rwanda,Togo,111,7,0,118
32252,2022,Syrian Arab Rep.,Togo,19,9,0,28
32253,2022,Türkiye,Togo,63,10,0,73
32254,2022,Bangladesh,Trinidad and Tobago,8,82,0,90
32255,2022,China,Trinidad and Tobago,0,126,0,126
32256,2022,Cameroon,Trinidad and Tobago,0,6,0,6
32257,2022,Colombia,Trinidad and Tobago,8,54,0,62
32258,2022,Cuba,Trinidad and Tobago,163,1221,0,1384
32259,2022,Dominican Rep.,Trinidad and Tobago,0,100,0,100
32260,2022,Ghana,Trinidad and Tobago,0,49,0,49
32261,2022,Guyana,Trinidad and Tobago,13,73,0,86
32262,2022,Haiti,Trinidad and Tobago,5,13,0,18
32263,2022,India,Trinidad and Tobago,0,5,0,5
32264,2022,Jamaica,Trinidad and Tobago,37,209,0,246
32265,2022,Sri Lanka,Trinidad and Tobago,5,0,0,5
32266,2022,Mexico,Trinidad and Tobago,6,0,0,6
32267,2022,Nigeria,Trinidad and Tobago,5,154,0,159
32268,2022,Pakistan,Trinidad and Tobago,9,20,0,29
32269,2022,Peru,Trinidad and Tobago,0,10,0,10
32270,2022,Philippines,Trinidad and Tobago,0,5,0,5
32271,2022,Viet Nam,Trinidad and Tobago,0,7,0,7
32272,2022,Syrian Arab Rep.,Trinidad and Tobago,53,35,0,88
32273,2022,Tajikistan,Trinidad and Tobago,0,5,0,5
32274,2022,Trinidad and Tobago,Trinidad and Tobago,0,0,0,0
32275,2022,Saint Vincent and the Grenadines,Trinidad and Tobago,5,0,0,5
32276,2022,Venezuela (Bolivarian Republic of),Trinidad and Tobago,3160,16320,0,19480
32277,2022,Algeria,Tunisia,11,10,0,21
32278,2022,Egypt,Tunisia,0,15,0,15
32279,2022,Burundi,Tunisia,0,7,0,7
32280,2022,Benin,Tunisia,0,7,0,7
32281,2022,Bangladesh,Tunisia,0,6,0,6
32282,2022,Burkina Faso,Tunisia,15,61,0,76
32283,2022,Central African Rep.,Tunisia,16,28,0,44
32284,2022,Chad,Tunisia,5,28,0,33
32285,2022,Cameroon,Tunisia,43,490,0,533
32286,2022,Congo,Tunisia,0,9,0,9
32287,2022,Dem. Rep. of the Congo,Tunisia,0,103,0,103
32288,2022,Comoros,Tunisia,0,7,0,7
32289,2022,Eritrea,Tunisia,135,162,0,297
32290,2022,Ethiopia,Tunisia,5,44,0,49
32291,2022,Gambia,Tunisia,0,20,0,20
32292,2022,Palestinian,Tunisia,34,35,0,69
32293,2022,Ghana,Tunisia,0,7,0,7
32294,2022,Guinea,Tunisia,10,483,0,493
32295,2022,Cote d'Ivoire,Tunisia,63,3416,0,3479
32296,2022,Iran (Islamic Rep. of),Tunisia,8,0,0,8
32297,2022,Iraq,Tunisia,18,12,0,30
32298,2022,Liberia,Tunisia,5,77,0,82
32299,2022,Libya,Tunisia,54,131,0,185
32300,2022,Lebanon,Tunisia,6,21,0,27
32301,2022,Mauritania,Tunisia,0,5,0,5
32302,2022,Mali,Tunisia,17,110,0,127
32303,2022,Morocco,Tunisia,0,5,0,5
32304,2022,Niger,Tunisia,0,6,0,6
32305,2022,Nigeria,Tunisia,0,113,0,113
32306,2022,Senegal,Tunisia,0,35,0,35
32307,2022,Sierra Leone,Tunisia,0,133,0,133
32308,2022,Somalia,Tunisia,21,131,0,152
32309,2022,Sudan,Tunisia,168,377,0,545
32310,2022,South Sudan,Tunisia,5,28,0,33
32311,2022,Syrian Arab Rep.,Tunisia,2669,0,0,2669
32312,2022,Togo,Tunisia,0,14,0,14
32313,2022,Yemen,Tunisia,14,26,0,40
32314,2022,Unknown ,Tunisia,0,16,0,16
32315,2022,Afghanistan,Türkiye,8384,135445,0,143829
32316,2022,Iran (Islamic Rep. of),Türkiye,4485,15135,0,19620
32317,2022,Iraq,Türkiye,10244,132166,0,142410
32318,2022,Syrian Arab Rep.,Türkiye,3648983,0,0,3648983
32319,2022,Unknown ,Türkiye,1712,11332,0,13044
32320,2022,Afghanistan,United Arab Emirates,10,25,0,35
32321,2022,Algeria,United Arab Emirates,0,0,0,0
32322,2022,Egypt,United Arab Emirates,5,7,0,12
32323,2022,Chad,United Arab Emirates,7,0,0,7
32324,2022,Eritrea,United Arab Emirates,0,7,0,7
32325,2022,Ethiopia,United Arab Emirates,8,5,0,13
32326,2022,Palestinian,United Arab Emirates,16,0,0,16
32327,2022,Iran (Islamic Rep. of),United Arab Emirates,5,7,0,12
32328,2022,Iraq,United Arab Emirates,798,544,0,1342
32329,2022,Jordan,United Arab Emirates,7,0,0,7
32330,2022,Kuwait,United Arab Emirates,5,0,0,5
32331,2022,Lebanon,United Arab Emirates,16,10,0,26
32332,2022,Morocco,United Arab Emirates,0,0,0,0
32333,2022,Philippines,United Arab Emirates,0,0,0,0
32334,2022,Russian Federation,United Arab Emirates,0,5,0,5
32335,2022,Somalia,United Arab Emirates,21,0,0,21
32336,2022,Sudan,United Arab Emirates,14,6,0,20
32337,2022,Syrian Arab Rep.,United Arab Emirates,487,6486,0,6973
32338,2022,Yemen,United Arab Emirates,6,50,0,56
32339,2022,Afghanistan,Uganda,0,19,0,19
32340,2022,Egypt,Uganda,8,5,0,13
32341,2022,Burundi,Uganda,39663,1961,0,41624
32342,2022,Central African Rep.,Uganda,36,6,0,42
32343,2022,Chad,Uganda,6,6,0,12
32344,2022,Cameroon,Uganda,5,8,0,13
32345,2022,Congo,Uganda,36,0,0,36
32346,2022,Dem. Rep. of the Congo,Uganda,434413,6071,0,440484
32347,2022,Eritrea,Uganda,12228,12403,0,24631
32348,2022,Ethiopia,Uganda,2992,1904,0,4896
32349,2022,Palestinian,Uganda,5,0,0,5
32350,2022,Guinea,Uganda,5,0,0,5
32351,2022,Iran (Islamic Rep. of),Uganda,5,0,0,5
32352,2022,Kenya,Uganda,232,21,0,253
32353,2022,Mali,Uganda,5,0,0,5
32354,2022,Pakistan,Uganda,234,5,0,239
32355,2022,Romania,Uganda,5,0,0,5
32356,2022,Rwanda,Uganda,18679,7429,0,26108
32357,2022,Senegal,Uganda,9,0,0,9
32358,2022,Somalia,Uganda,50086,8992,0,59078
32359,2022,Sudan,Uganda,2985,808,0,3793
32360,2022,South Sudan,Uganda,927777,46,0,927823
32361,2022,Syrian Arab Rep.,Uganda,21,10,0,31
32362,2022,United Rep. of Tanzania,Uganda,18,0,0,18
32363,2022,Türkiye,Uganda,76,5,0,81
32364,2022,Yemen,Uganda,30,14,0,44
32365,2022,Stateless,Uganda,0,0,0,0
32366,2022,Afghanistan,Ukraine,893,483,0,1376
32367,2022,Algeria,Ukraine,0,8,0,8
32368,2022,Angola,Ukraine,23,0,0,23
32369,2022,Egypt,Ukraine,5,6,0,11
32370,2022,Armenia,Ukraine,52,0,0,52
32371,2022,Azerbaijan,Ukraine,70,17,0,87
32372,2022,Bangladesh,Ukraine,5,136,0,141
32373,2022,Belarus,Ukraine,45,13,0,58
32374,2022,China,Ukraine,0,5,0,5
32375,2022,Cameroon,Ukraine,0,21,0,21
32376,2022,Congo,Ukraine,26,7,0,33
32377,2022,Dem. Rep. of the Congo,Ukraine,18,0,0,18
32378,2022,Eritrea,Ukraine,11,21,0,32
32379,2022,Ethiopia,Ukraine,25,5,0,30
32380,2022,Palestinian,Ukraine,9,22,0,31
32381,2022,Georgia,Ukraine,25,0,0,25
32382,2022,Ghana,Ukraine,0,10,0,10
32383,2022,Guinea,Ukraine,5,5,0,10
32384,2022,Haiti,Ukraine,0,5,0,5
32385,2022,Cote d'Ivoire,Ukraine,0,13,0,13
32386,2022,India,Ukraine,7,17,0,24
32387,2022,Iran (Islamic Rep. of),Ukraine,74,5,0,79
32388,2022,Iraq,Ukraine,72,40,0,112
32389,2022,Jordan,Ukraine,5,5,0,10
32390,2022,Kazakhstan,Ukraine,8,5,0,13
32391,2022,Kyrgyzstan,Ukraine,11,18,0,29
32392,2022,Libya,Ukraine,5,0,0,5
32393,2022,Lebanon,Ukraine,9,5,0,14
32394,2022,Sri Lanka,Ukraine,8,26,0,34
32395,2022,Rep. of Moldova,Ukraine,0,5,0,5
32396,2022,Morocco,Ukraine,0,9,0,9
32397,2022,Myanmar,Ukraine,0,6,0,6
32398,2022,Nigeria,Ukraine,7,22,0,29
32399,2022,Pakistan,Ukraine,10,48,0,58
32400,2022,Russian Federation,Ukraine,167,115,0,282
32401,2022,Rwanda,Ukraine,5,0,0,5
32402,2022,Serbia and Kosovo: S/RES/1244 (1999),Ukraine,5,0,0,5
32403,2022,Senegal,Ukraine,0,5,0,5
32404,2022,Sierra Leone,Ukraine,5,0,0,5
32405,2022,Somalia,Ukraine,73,62,0,135
32406,2022,Viet Nam,Ukraine,0,13,0,13
32407,2022,Sudan,Ukraine,26,6,0,32
32408,2022,Syrian Arab Rep.,Ukraine,513,28,0,541
32409,2022,Tajikistan,Ukraine,18,39,0,57
32410,2022,Turkmenistan,Ukraine,7,0,0,7
32411,2022,Tunisia,Ukraine,0,5,0,5
32412,2022,Türkiye,Ukraine,6,0,0,6
32413,2022,Ukraine,Ukraine,0,0,6275000,0
32414,2022,Uzbekistan,Ukraine,40,31,0,71
32415,2022,Yemen,Ukraine,5,23,0,28
32416,2022,Stateless,Ukraine,47,10,0,57
32417,2022,Afghanistan,Uruguay,5,6,0,11
32418,2022,Angola,Uruguay,14,0,0,14
32419,2022,Egypt,Uruguay,0,6,0,6
32420,2022,Argentina,Uruguay,0,11,0,11
32421,2022,Bangladesh,Uruguay,0,140,0,140
32422,2022,Bolivia (Plurinational State of),Uruguay,6,7,0,13
32423,2022,Brazil,Uruguay,0,24,0,24
32424,2022,Chile,Uruguay,0,7,0,7
32425,2022,Cameroon,Uruguay,12,5,0,17
32426,2022,Congo,Uruguay,5,0,0,5
32427,2022,Colombia,Uruguay,162,110,0,272
32428,2022,Cuba,Uruguay,33,9079,0,9112
32429,2022,Dominican Rep.,Uruguay,0,441,0,441
32430,2022,Ecuador,Uruguay,8,31,0,39
32431,2022,Palestinian,Uruguay,0,5,0,5
32432,2022,Ghana,Uruguay,0,24,0,24
32433,2022,Guinea-Bissau,Uruguay,0,5,0,5
32434,2022,Guatemala,Uruguay,5,0,0,5
32435,2022,Guinea,Uruguay,0,11,0,11
32436,2022,Haiti,Uruguay,5,26,0,31
32437,2022,India,Uruguay,0,6,0,6
32438,2022,Libya,Uruguay,5,0,0,5
32439,2022,Latvia,Uruguay,5,0,0,5
32440,2022,Mauritania,Uruguay,0,5,0,5
32441,2022,Mexico,Uruguay,5,5,0,10
32442,2022,Morocco,Uruguay,0,20,0,20
32443,2022,Nicaragua,Uruguay,9,5,0,14
32444,2022,Nigeria,Uruguay,22,34,0,56
32445,2022,Pakistan,Uruguay,0,39,0,39
32446,2022,Paraguay,Uruguay,5,5,0,10
32447,2022,Peru,Uruguay,8,54,0,62
32448,2022,South Africa,Uruguay,0,5,0,5
32449,2022,Russian Federation,Uruguay,13,5,0,18
32450,2022,El Salvador,Uruguay,48,8,0,56
32451,2022,Senegal,Uruguay,0,226,0,226
32452,2022,Somalia,Uruguay,5,0,0,5
32453,2022,Syrian Arab Rep.,Uruguay,66,5,0,71
32454,2022,Türkiye,Uruguay,13,5,0,18
32455,2022,Ukraine,Uruguay,15,5,0,20
32456,2022,Venezuela (Bolivarian Republic of),Uruguay,509,2738,0,3247
32457,2022,Stateless,Uruguay,0,0,0,0
32458,2022,Afghanistan,United States of America,2478,3047,0,5525
32459,2022,Albania,United States of America,1351,2714,0,4065
32460,2022,Algeria,United States of America,138,537,0,675
32461,2022,Angola,United States of America,323,3644,0,3967
32462,2022,Antigua and Barbuda,United States of America,6,15,0,21
32463,2022,Egypt,United States of America,13909,9501,0,23410
32464,2022,Argentina,United States of America,21,579,0,600
32465,2022,Armenia,United States of America,1415,6351,0,7766
32466,2022,Australia,United States of America,0,19,0,19
32467,2022,Austria,United States of America,13,5,0,18
32468,2022,Azerbaijan,United States of America,540,1701,0,2241
32469,2022,Bahrain,United States of America,30,60,0,90
32470,2022,Barbados,United States of America,0,5,0,5
32471,2022,Burundi,United States of America,812,751,0,1563
32472,2022,Belgium,United States of America,10,60,0,70
32473,2022,Benin,United States of America,77,282,0,359
32474,2022,Bangladesh,United States of America,2667,10703,0,13370
32475,2022,Bahamas,United States of America,183,255,0,438
32476,2022,Bhutan,United States of America,32,417,0,449
32477,2022,Burkina Faso,United States of America,1425,3476,0,4901
32478,2022,Belarus,United States of America,1498,4160,0,5658
32479,2022,Bolivia (Plurinational State of),United States of America,80,935,0,1015
32480,2022,Botswana,United States of America,0,7,0,7
32481,2022,Brazil,United States of America,1131,27491,0,28622
32482,2022,Bosnia and Herzegovina,United States of America,86,216,0,302
32483,2022,Bulgaria,United States of America,154,306,0,460
32484,2022,Belize,United States of America,36,333,0,369
32485,2022,Cambodia,United States of America,116,82,0,198
32486,2022,Canada,United States of America,11,109,0,120
32487,2022,Central African Rep.,United States of America,172,145,0,317
32488,2022,Cayman Islands,United States of America,5,0,0,5
32489,2022,Chad,United States of America,221,265,0,486
32490,2022,China,United States of America,66603,87599,0,154202
32491,2022,Chile,United States of America,29,1760,0,1789
32492,2022,Cameroon,United States of America,5123,5383,0,10506
32493,2022,Congo,United States of America,990,2583,0,3573
32494,2022,Dem. Rep. of the Congo,United States of America,1487,2775,0,4262
32495,2022,Comoros,United States of America,0,10,0,10
32496,2022,Colombia,United States of America,2794,46881,0,49675
32497,2022,Costa Rica,United States of America,178,749,0,927
32498,2022,Cuba,United States of America,2810,48245,0,51055
32499,2022,Cabo Verde,United States of America,0,55,0,55
32500,2022,Cyprus,United States of America,0,7,0,7
32501,2022,Czechia,United States of America,8,52,0,60
32502,2022,Denmark,United States of America,0,10,0,10
32503,2022,Djibouti,United States of America,363,633,0,996
32504,2022,Dominica,United States of America,13,66,0,79
32505,2022,Dominican Rep.,United States of America,251,1411,0,1662
32506,2022,Ecuador,United States of America,1929,32665,0,34594
32507,2022,Equatorial Guinea,United States of America,17,112,0,129
32508,2022,Eritrea,United States of America,5165,1173,0,6338
32509,2022,Estonia,United States of America,137,45,0,182
32510,2022,Ethiopia,United States of America,7655,9120,0,16775
32511,2022,French Guiana,United States of America,0,8,0,8
32512,2022,Fiji,United States of America,100,467,0,567
32513,2022,Finland,United States of America,0,5,0,5
32514,2022,France,United States of America,17,138,0,155
32515,2022,Gabon,United States of America,48,371,0,419
32516,2022,Gambia,United States of America,1296,755,0,2051
32517,2022,Palestinian,United States of America,19,131,0,150
32518,2022,United Kingdom of Great Britain and Northern Ireland,United States of America,22,145,0,167
32519,2022,Georgia,United States of America,496,3044,0,3540
32520,2022,Germany,United States of America,27,191,0,218
32521,2022,Ghana,United States of America,507,1257,0,1764
32522,2022,Guinea-Bissau,United States of America,18,51,0,69
32523,2022,Greece,United States of America,13,98,0,111
32524,2022,Grenada,United States of America,18,34,0,52
32525,2022,Guatemala,United States of America,24298,154811,0,179109
32526,2022,Guinea,United States of America,1539,1266,0,2805
32527,2022,Guyana,United States of America,114,526,0,640
32528,2022,Haiti,United States of America,14566,51626,0,66192
32529,2022,"China, Hong Kong SAR",United States of America,14,230,0,244
32530,2022,Honduras,United States of America,18141,122064,0,140205
32531,2022,Croatia,United States of America,18,36,0,54
32532,2022,Hungary,United States of America,9,413,0,422
32533,2022,Cote d'Ivoire,United States of America,854,1389,0,2243
32534,2022,India,United States of America,10458,50090,0,60548
32535,2022,Indonesia,United States of America,880,3297,0,4177
32536,2022,Ireland,United States of America,0,43,0,43
32537,2022,Iran (Islamic Rep. of),United States of America,5290,3426,0,8716
32538,2022,Iraq,United States of America,5372,4192,0,9564
32539,2022,Israel,United States of America,96,637,0,733
32540,2022,Italy,United States of America,7,547,0,554
32541,2022,Jamaica,United States of America,900,1630,0,2530
32542,2022,Jordan,United States of America,702,3821,0,4523
32543,2022,Japan,United States of America,6,96,0,102
32544,2022,Kazakhstan,United States of America,1171,4806,0,5977
32545,2022,Kenya,United States of America,1576,7248,0,8824
32546,2022,Kyrgyzstan,United States of America,1619,2414,0,4033
32547,2022,Rep. of Korea,United States of America,20,281,0,301
32548,2022,Dem. People's Rep. of Korea,United States of America,5,45,0,50
32549,2022,Kuwait,United States of America,137,292,0,429
32550,2022,Lao People's Dem. Rep.,United States of America,60,176,0,236
32551,2022,Liberia,United States of America,1205,1124,0,2329
32552,2022,Libya,United States of America,418,1845,0,2263
32553,2022,Saint Lucia,United States of America,5,22,0,27
32554,2022,Lebanon,United States of America,406,2081,0,2487
32555,2022,Lesotho,United States of America,5,0,0,5
32556,2022,Sri Lanka,United States of America,984,2257,0,3241
32557,2022,Lithuania,United States of America,14,74,0,88
32558,2022,Latvia,United States of America,15,112,0,127
32559,2022,"China, Macao SAR",United States of America,0,5,0,5
32560,2022,Madagascar,United States of America,6,21,0,27
32561,2022,Mauritania,United States of America,912,1136,0,2048
32562,2022,North Macedonia,United States of America,103,227,0,330
32563,2022,Rep. of Moldova,United States of America,1300,3054,0,4354
32564,2022,Maldives,United States of America,5,5,0,10
32565,2022,Mexico,United States of America,12943,107083,0,120026
32566,2022,Marshall Islands,United States of America,6,5,0,11
32567,2022,Mali,United States of America,843,643,0,1486
32568,2022,Malaysia,United States of America,85,382,0,467
32569,2022,Malawi,United States of America,33,196,0,229
32570,2022,Mongolia,United States of America,638,3474,0,4112
32571,2022,Morocco,United States of America,127,326,0,453
32572,2022,Mozambique,United States of America,31,57,0,88
32573,2022,Malta,United States of America,0,5,0,5
32574,2022,Montenegro,United States of America,84,547,0,631
32575,2022,Mauritius,United States of America,30,45,0,75
32576,2022,Myanmar,United States of America,1299,3373,0,4672
32577,2022,Namibia,United States of America,18,53,0,71
32578,2022,Nepal,United States of America,6242,7747,0,13989
32579,2022,Netherlands,United States of America,6,76,0,82
32580,2022,Niger,United States of America,141,442,0,583
32581,2022,Nicaragua,United States of America,2640,18916,0,21556
32582,2022,Nigeria,United States of America,3190,26632,0,29822
32583,2022,Niue,United States of America,9,5,0,14
32584,2022,Oman,United States of America,19,30,0,49
32585,2022,Pakistan,United States of America,3913,9668,0,13581
32586,2022,Panama,United States of America,10,308,0,318
32587,2022,Paraguay,United States of America,12,117,0,129
32588,2022,Peru,United States of America,494,4570,0,5064
32589,2022,Philippines,United States of America,162,1586,0,1748
32590,2022,Poland,United States of America,8,863,0,871
32591,2022,Portugal,United States of America,0,301,0,301
32592,2022,Qatar,United States of America,19,24,0,43
32593,2022,Romania,United States of America,461,4706,0,5167
32594,2022,South Africa,United States of America,53,1339,0,1392
32595,2022,Russian Federation,United States of America,7141,27011,0,34152
32596,2022,Rwanda,United States of America,1233,1515,0,2748
32597,2022,El Salvador,United States of America,30417,127505,0,157922
32598,2022,Saudi Arabia,United States of America,634,1042,0,1676
32599,2022,Serbia and Kosovo: S/RES/1244 (1999),United States of America,723,1780,0,2503
32600,2022,Senegal,United States of America,382,898,0,1280
32601,2022,Singapore,United States of America,5,47,0,52
32602,2022,Sierra Leone,United States of America,398,531,0,929
32603,2022,Somalia,United States of America,1463,418,0,1881
32604,2022,Spain,United States of America,6,330,0,336
32605,2022,Viet Nam,United States of America,415,1535,0,1950
32606,2022,Saint Kitts and Nevis,United States of America,5,6,0,11
32607,2022,Sudan,United States of America,1388,1203,0,2591
32608,2022,Suriname,United States of America,11,58,0,69
32609,2022,South Sudan,United States of America,59,91,0,150
32610,2022,Slovakia,United States of America,5,37,0,42
32611,2022,Slovenia,United States of America,5,10,0,15
32612,2022,Eswatini,United States of America,5,10,0,15
32613,2022,Sweden,United States of America,0,42,0,42
32614,2022,Switzerland,United States of America,0,16,0,16
32615,2022,Syrian Arab Rep.,United States of America,8843,3231,0,12074
32616,2022,United Rep. of Tanzania,United States of America,102,315,0,417
32617,2022,Turks and Caicos Islands,United States of America,14,0,0,14
32618,2022,Thailand,United States of America,31,500,0,531
32619,2022,Tajikistan,United States of America,305,835,0,1140
32620,2022,Turkmenistan,United States of America,208,486,0,694
32621,2022,Timor-Leste,United States of America,0,15,0,15
32622,2022,Togo,United States of America,525,743,0,1268
32623,2022,Trinidad and Tobago,United States of America,36,270,0,306
32624,2022,Tunisia,United States of America,99,425,0,524
32625,2022,Türkiye,United States of America,4893,7601,0,12494
32626,2022,United Arab Emirates,United States of America,80,148,0,228
32627,2022,Uganda,United States of America,1824,3654,0,5478
32628,2022,Ukraine,United States of America,2794,12142,0,14936
32629,2022,Uruguay,United States of America,5,241,0,246
32630,2022,Uzbekistan,United States of America,1282,4426,0,5708
32631,2022,Vanuatu,United States of America,0,27,0,27
32632,2022,Saint Vincent and the Grenadines,United States of America,29,19,0,48
32633,2022,Venezuela (Bolivarian Republic of),United States of America,20771,286058,0,306829
32634,2022,Samoa,United States of America,0,5,0,5
32635,2022,Yemen,United States of America,700,1118,0,1818
32636,2022,Zambia,United States of America,38,189,0,227
32637,2022,Zimbabwe,United States of America,682,1314,0,1996
32638,2022,Stateless,United States of America,47,0,0,47
32639,2022,Guadeloupe,United States of America,0,85,0,85
32640,2022,Curacao ,United States of America,35,0,0,35
32641,2022,Unknown ,United States of America,6394,4637,0,11031
32642,2022,Afghanistan,Uzbekistan,13031,0,0,13031
32643,2022,Stateless,Uzbekistan,0,0,0,0
32644,2022,Venezuela (Bolivarian Republic of),Saint Vincent and the Grenadines,0,0,0,0
32645,2022,Afghanistan,Venezuela (Bolivarian Republic of),10,0,0,10
32646,2022,Chile,Venezuela (Bolivarian Republic of),10,0,0,10
32647,2022,Congo,Venezuela (Bolivarian Republic of),5,0,0,5
32648,2022,Colombia,Venezuela (Bolivarian Republic of),39185,1045,0,40230
32649,2022,Palestinian,Venezuela (Bolivarian Republic of),7,0,0,7
32650,2022,Haiti,Venezuela (Bolivarian Republic of),12,0,0,12
32651,2022,Iraq,Venezuela (Bolivarian Republic of),18,0,0,18
32652,2022,Liberia,Venezuela (Bolivarian Republic of),9,0,0,9
32653,2022,Libya,Venezuela (Bolivarian Republic of),5,0,0,5
32654,2022,Lebanon,Venezuela (Bolivarian Republic of),12,0,0,12
32655,2022,Nigeria,Venezuela (Bolivarian Republic of),7,0,0,7
32656,2022,Peru,Venezuela (Bolivarian Republic of),5,0,0,5
32657,2022,Rwanda,Venezuela (Bolivarian Republic of),5,0,0,5
32658,2022,Sierra Leone,Venezuela (Bolivarian Republic of),5,0,0,5
32659,2022,Syrian Arab Rep.,Venezuela (Bolivarian Republic of),33,0,0,33
32660,2022,Türkiye,Venezuela (Bolivarian Republic of),6,0,0,6
32661,2022,Venezuela (Bolivarian Republic of),Venezuela (Bolivarian Republic of),0,0,0,0
32662,2022,Western Sahara,Venezuela (Bolivarian Republic of),11,0,0,11
32663,2022,Egypt,Yemen,18,8,0,26
32664,2022,Cameroon,Yemen,0,5,0,5
32665,2022,Congo,Yemen,0,7,0,7
32666,2022,Djibouti,Yemen,5,6,0,11
32667,2022,Eritrea,Yemen,1306,483,0,1789
32668,2022,Ethiopia,Yemen,6514,11799,0,18313
32669,2022,Palestinian,Yemen,577,307,0,884
32670,2022,Iran (Islamic Rep. of),Yemen,5,0,0,5
32671,2022,Iraq,Yemen,3149,72,0,3221
32672,2022,Jordan,Yemen,14,12,0,26
32673,2022,Lebanon,Yemen,0,5,0,5
32674,2022,Mali,Yemen,0,5,0,5
32675,2022,Pakistan,Yemen,0,9,0,9
32676,2022,Somalia,Yemen,69230,155,0,69385
32677,2022,Viet Nam,Yemen,15,0,0,15
32678,2022,Sudan,Yemen,109,507,0,616
32679,2022,Syrian Arab Rep.,Yemen,2574,422,0,2996
32680,2022,United Rep. of Tanzania,Yemen,0,0,0,0
32681,2022,Yemen,Yemen,0,0,4288739,0
32682,2022,Angola,Zambia,0,0,0,0
32683,2022,Burundi,Zambia,7729,1187,0,8916
32684,2022,Cameroon,Zambia,19,26,0,45
32685,2022,Dem. Rep. of the Congo,Zambia,63062,4505,0,67567
32686,2022,Eritrea,Zambia,101,18,0,119
32687,2022,Ethiopia,Zambia,45,8,0,53
32688,2022,Palestinian,Zambia,15,0,0,15
32689,2022,Ghana,Zambia,0,9,0,9
32690,2022,Kenya,Zambia,5,0,0,5
32691,2022,Liberia,Zambia,7,0,0,7
32692,2022,South Africa,Zambia,6,0,0,6
32693,2022,Rwanda,Zambia,754,23,0,777
32694,2022,Sierra Leone,Zambia,5,0,0,5
32695,2022,Somalia,Zambia,3334,566,0,3900
32696,2022,Sudan,Zambia,28,0,0,28
32697,2022,South Sudan,Zambia,5,0,0,5
32698,2022,Syrian Arab Rep.,Zambia,38,7,0,45
32699,2022,Türkiye,Zambia,70,0,0,70
32700,2022,Uganda,Zambia,214,43,0,257
32701,2022,Unknown ,Zambia,71,0,0,71
32702,2022,Angola,Zimbabwe,0,6,0,6
32703,2022,Burundi,Zimbabwe,701,209,0,910
32704,2022,Central African Rep.,Zimbabwe,0,5,0,5
32705,2022,Cameroon,Zimbabwe,0,10,0,10
32706,2022,Congo,Zimbabwe,20,0,0,20
32707,2022,Dem. Rep. of the Congo,Zimbabwe,8411,3047,0,11458
32708,2022,Eritrea,Zimbabwe,21,5,0,26
32709,2022,Ethiopia,Zimbabwe,70,18,0,88
32710,2022,Cote d'Ivoire,Zimbabwe,12,25,0,37
32711,2022,Kenya,Zimbabwe,0,8,0,8
32712,2022,Mali,Zimbabwe,6,118,0,124
32713,2022,Mozambique,Zimbabwe,0,8270,0,8270
32714,2022,South Africa,Zimbabwe,0,0,0,0
32715,2022,Rwanda,Zimbabwe,661,66,0,727
32716,2022,Sierra Leone,Zimbabwe,0,7,0,7
32717,2022,Somalia,Zimbabwe,13,21,0,34
32718,2022,Sudan,Zimbabwe,6,0,0,6
32719,2022,South Sudan,Zimbabwe,8,25,0,33
32720,2022,Uganda,Zimbabwe,10,0,0,10
32721,2022,Zambia,Zimbabwe,0,0,0,0
32722,2022,Zimbabwe,Zimbabwe,0,0,0,0
32723,2022,Haiti,Anguilla,0,0,0,0
32724,2022,Venezuela (Bolivarian Republic of),Anguilla,0,0,0,0
32725,2022,Venezuela (Bolivarian Republic of),Aruba,0,0,0,0
32726,2022,Venezuela (Bolivarian Republic of),Curacao ,0,0,0,0
32727,2022,Venezuela (Bolivarian Republic of),Sint Maarten (Dutch part),0,87,0,87
32728,2022,Unknown ,Sint Maarten (Dutch part),0,5,0,5
