,Year,Country of origin,Country of asylum,Refugees under UNHCR's mandate,Asylum-seekers,IDPs of concern to UNHCR,International total
15820,2020,Afghanistan,Afghanistan,0,0,2886317,0
15821,2020,Benin,Afghanistan,0,5,0,5
15822,2020,Iran (Islamic Rep. of),Afghanistan,37,26,0,63
15823,2020,Pakistan,Afghanistan,72185,136,0,72321
15824,2020,Türkiye,Afghanistan,56,0,0,56
15825,2020,Afghanistan,Albania,0,0,0,0
15826,2020,Egypt,Albania,5,0,0,5
15827,2020,China,Albania,14,0,0,14
15828,2020,Palestinian,Albania,5,0,0,5
15829,2020,Iraq,Albania,5,0,0,5
15830,2020,Serbia and Kosovo: S/RES/1244 (1999),Albania,57,0,0,57
15831,2020,Syrian Arab Rep.,Albania,9,0,0,9
15832,2020,Uzbekistan,Albania,5,0,0,5
15833,2020,Venezuela (Bolivarian Republic of),Albania,5,0,0,5
15834,2020,Stateless,Albania,0,0,0,0
15835,2020,Benin,Algeria,0,54,0,54
15836,2020,Burkina Faso,Algeria,0,14,0,14
15837,2020,Central African Rep.,Algeria,81,36,0,117
15838,2020,Chad,Algeria,0,31,0,31
15839,2020,Cameroon,Algeria,127,348,0,475
15840,2020,Congo,Algeria,0,5,0,5
15841,2020,Dem. Rep. of the Congo,Algeria,72,107,0,179
15842,2020,Eritrea,Algeria,0,6,0,6
15843,2020,Gambia,Algeria,0,5,0,5
15844,2020,Palestinian,Algeria,185,0,0,185
15845,2020,Ghana,Algeria,0,8,0,8
15846,2020,Guinea-Bissau,Algeria,0,5,0,5
15847,2020,Guinea,Algeria,32,355,0,387
15848,2020,Cote d'Ivoire,Algeria,79,216,0,295
15849,2020,Iraq,Algeria,12,5,0,17
15850,2020,Liberia,Algeria,0,50,0,50
15851,2020,Libya,Algeria,20,19,0,39
15852,2020,Mali,Algeria,131,395,0,526
15853,2020,Niger,Algeria,6,128,0,134
15854,2020,Nigeria,Algeria,5,238,0,243
15855,2020,Senegal,Algeria,0,7,0,7
15856,2020,Sierra Leone,Algeria,0,23,0,23
15857,2020,Sudan,Algeria,13,33,0,46
15858,2020,Syrian Arab Rep.,Algeria,6627,0,0,6627
15859,2020,Togo,Algeria,0,14,0,14
15860,2020,Türkiye,Algeria,0,22,0,22
15861,2020,Western Sahara,Algeria,90000,0,0,90000
15862,2020,Yemen,Algeria,261,0,0,261
15863,2020,Angola,Angola,0,0,0,0
15864,2020,Burundi,Angola,18,99,0,117
15865,2020,Central African Rep.,Angola,7,77,0,84
15866,2020,Chad,Angola,190,779,0,969
15867,2020,Congo,Angola,65,58,0,123
15868,2020,Dem. Rep. of the Congo,Angola,22905,501,0,23406
15869,2020,Eritrea,Angola,78,1789,0,1867
15870,2020,Ethiopia,Angola,0,57,0,57
15871,2020,Guinea-Bissau,Angola,7,268,0,275
15872,2020,Guinea,Angola,128,9146,0,9274
15873,2020,Cote d'Ivoire,Angola,417,5940,0,6357
15874,2020,Liberia,Angola,164,478,0,642
15875,2020,Mauritania,Angola,323,5402,0,5725
15876,2020,Rwanda,Angola,506,142,0,648
15877,2020,Sierra Leone,Angola,413,1497,0,1910
15878,2020,Somalia,Angola,270,1731,0,2001
15879,2020,Sudan,Angola,279,1670,0,1949
15880,2020,Syrian Arab Rep.,Angola,0,5,0,5
15881,2020,United Rep. of Tanzania,Angola,5,0,0,5
15882,2020,Türkiye,Angola,0,37,0,37
15883,2020,Uganda,Angola,0,6,0,6
15884,2020,Western Sahara,Angola,16,596,0,612
15885,2020,Afghanistan,Egypt,34,44,0,78
15886,2020,Burundi,Egypt,55,58,0,113
15887,2020,Brunei Darussalam,Egypt,0,5,0,5
15888,2020,Central African Rep.,Egypt,40,29,0,69
15889,2020,Chad,Egypt,56,37,0,93
15890,2020,China,Egypt,0,71,0,71
15891,2020,Cameroon,Egypt,17,29,0,46
15892,2020,Congo,Egypt,14,21,0,35
15893,2020,Dem. Rep. of the Congo,Egypt,52,26,0,78
15894,2020,Djibouti,Egypt,13,16,0,29
15895,2020,Eritrea,Egypt,13528,5551,0,19079
15896,2020,Ethiopia,Egypt,5296,10803,0,16099
15897,2020,Palestinian,Egypt,70022,0,0,70022
15898,2020,Guinea,Egypt,10,51,0,61
15899,2020,Cote d'Ivoire,Egypt,93,5,0,98
15900,2020,Iraq,Egypt,4660,2144,0,6804
15901,2020,Jordan,Egypt,11,10,0,21
15902,2020,Kenya,Egypt,8,5,0,13
15903,2020,Liberia,Egypt,0,7,0,7
15904,2020,Libya,Egypt,5,0,0,5
15905,2020,Sri Lanka,Egypt,0,5,0,5
15906,2020,Mali,Egypt,0,12,0,12
15907,2020,Nigeria,Egypt,24,157,0,181
15908,2020,Russian Federation,Egypt,8,21,0,29
15909,2020,Rwanda,Egypt,5,0,0,5
15910,2020,Saudi Arabia,Egypt,14,7,0,21
15911,2020,Sierra Leone,Egypt,5,9,0,14
15912,2020,Somalia,Egypt,4580,2150,0,6730
15913,2020,Sudan,Egypt,25283,23966,0,49249
15914,2020,South Sudan,Egypt,18179,1626,0,19805
15915,2020,Syrian Arab Rep.,Egypt,130577,0,0,130577
15916,2020,Tajikistan,Egypt,12,13,0,25
15917,2020,Turkmenistan,Egypt,5,0,0,5
15918,2020,Togo,Egypt,0,7,0,7
15919,2020,Tunisia,Egypt,5,0,0,5
15920,2020,Türkiye,Egypt,0,385,0,385
15921,2020,Uganda,Egypt,13,19,0,32
15922,2020,Uzbekistan,Egypt,0,17,0,17
15923,2020,Yemen,Egypt,154,9113,0,9267
15924,2020,Zimbabwe,Egypt,43,21,0,64
15925,2020,Stateless,Egypt,5,0,0,5
15926,2020,Unknown ,Egypt,0,6,0,6
15927,2020,Afghanistan,Argentina,12,0,0,12
15928,2020,Albania,Argentina,18,0,0,18
15929,2020,Algeria,Argentina,30,22,0,52
15930,2020,Angola,Argentina,14,14,0,28
15931,2020,Egypt,Argentina,5,21,0,26
15932,2020,Armenia,Argentina,77,183,0,260
15933,2020,Burundi,Argentina,5,0,0,5
15934,2020,Bangladesh,Argentina,5,87,0,92
15935,2020,Bolivia (Plurinational State of),Argentina,65,56,0,121
15936,2020,Brazil,Argentina,0,10,0,10
15937,2020,Bosnia and Herzegovina,Argentina,6,0,0,6
15938,2020,China,Argentina,0,120,0,120
15939,2020,Chile,Argentina,34,5,0,39
15940,2020,Cameroon,Argentina,7,42,0,49
15941,2020,Dem. Rep. of the Congo,Argentina,26,25,0,51
15942,2020,Colombia,Argentina,560,226,0,786
15943,2020,Costa Rica,Argentina,5,0,0,5
15944,2020,Cuba,Argentina,259,821,0,1080
15945,2020,Cabo Verde,Argentina,0,5,0,5
15946,2020,Czechia,Argentina,0,5,0,5
15947,2020,Dominican Rep.,Argentina,5,578,0,583
15948,2020,Ecuador,Argentina,16,18,0,34
15949,2020,Ethiopia,Argentina,5,0,0,5
15950,2020,Gambia,Argentina,0,10,0,10
15951,2020,Palestinian,Argentina,19,10,0,29
15952,2020,Georgia,Argentina,5,0,0,5
15953,2020,Ghana,Argentina,38,142,0,180
15954,2020,Guinea-Bissau,Argentina,8,5,0,13
15955,2020,Guatemala,Argentina,6,0,0,6
15956,2020,Guinea,Argentina,10,9,0,19
15957,2020,Haiti,Argentina,74,766,0,840
15958,2020,Honduras,Argentina,5,12,0,17
15959,2020,Hungary,Argentina,0,5,0,5
15960,2020,Cote d'Ivoire,Argentina,20,0,0,20
15961,2020,India,Argentina,23,131,0,154
15962,2020,Iran (Islamic Rep. of),Argentina,24,12,0,36
15963,2020,Iraq,Argentina,22,0,0,22
15964,2020,Jamaica,Argentina,12,0,0,12
15965,2020,Jordan,Argentina,5,0,0,5
15966,2020,Kazakhstan,Argentina,18,13,0,31
15967,2020,Kyrgyzstan,Argentina,5,0,0,5
15968,2020,Liberia,Argentina,42,0,0,42
15969,2020,Libya,Argentina,0,8,0,8
15970,2020,Sri Lanka,Argentina,36,0,0,36
15971,2020,North Macedonia,Argentina,9,0,0,9
15972,2020,Mexico,Argentina,0,6,0,6
15973,2020,Mali,Argentina,9,0,0,9
15974,2020,Morocco,Argentina,0,13,0,13
15975,2020,Nepal,Argentina,0,5,0,5
15976,2020,Nicaragua,Argentina,11,19,0,30
15977,2020,Nigeria,Argentina,42,63,0,105
15978,2020,Pakistan,Argentina,39,19,0,58
15979,2020,Paraguay,Argentina,9,20,0,29
15980,2020,Peru,Argentina,545,49,0,594
15981,2020,Romania,Argentina,51,0,0,51
15982,2020,South Africa,Argentina,0,15,0,15
15983,2020,Russian Federation,Argentina,79,89,0,168
15984,2020,El Salvador,Argentina,46,34,0,80
15985,2020,Senegal,Argentina,41,1413,0,1454
15986,2020,Sierra Leone,Argentina,37,5,0,42
15987,2020,Somalia,Argentina,5,0,0,5
15988,2020,Spain,Argentina,0,7,0,7
15989,2020,Sudan,Argentina,5,0,0,5
15990,2020,Syrian Arab Rep.,Argentina,407,83,0,490
15991,2020,Tunisia,Argentina,0,5,0,5
15992,2020,Türkiye,Argentina,7,0,0,7
15993,2020,Ukraine,Argentina,118,88,0,206
15994,2020,United States of America,Argentina,5,10,0,15
15995,2020,Venezuela (Bolivarian Republic of),Argentina,312,3826,0,4138
15996,2020,Yemen,Argentina,19,5,0,24
15997,2020,Unknown ,Argentina,643,41,0,684
15998,2020,Afghanistan,Armenia,5,0,0,5
15999,2020,Egypt,Armenia,5,0,0,5
16000,2020,Azerbaijan,Armenia,91766,5,0,91771
16001,2020,Congo,Armenia,5,0,0,5
16002,2020,Cuba,Armenia,0,26,0,26
16003,2020,Palestinian,Armenia,7,0,0,7
16004,2020,Georgia,Armenia,8,5,0,13
16005,2020,Cote d'Ivoire,Armenia,6,0,0,6
16006,2020,India,Armenia,0,5,0,5
16007,2020,Iran (Islamic Rep. of),Armenia,102,66,0,168
16008,2020,Iraq,Armenia,1086,0,0,1086
16009,2020,Lebanon,Armenia,25,5,0,30
16010,2020,Nigeria,Armenia,5,0,0,5
16011,2020,Russian Federation,Armenia,0,5,0,5
16012,2020,Syrian Arab Rep.,Armenia,14741,5,0,14746
16013,2020,Türkiye,Armenia,13,14,0,27
16014,2020,Ukraine,Armenia,115,0,0,115
16015,2020,Yemen,Armenia,21,0,0,21
16016,2020,Stateless,Armenia,0,0,0,0
16017,2020,Afghanistan,Australia,10659,1761,0,12420
16018,2020,Albania,Australia,45,92,0,137
16019,2020,Algeria,Australia,8,26,0,34
16020,2020,Egypt,Australia,1494,338,0,1832
16021,2020,Argentina,Australia,0,29,0,29
16022,2020,Azerbaijan,Australia,9,12,0,21
16023,2020,Bahrain,Australia,89,6,0,95
16024,2020,Burundi,Australia,48,27,0,75
16025,2020,Bangladesh,Australia,410,1246,0,1656
16026,2020,Bhutan,Australia,5,17,0,22
16027,2020,Belarus,Australia,6,0,0,6
16028,2020,Brazil,Australia,8,183,0,191
16029,2020,Brunei Darussalam,Australia,0,5,0,5
16030,2020,Bosnia and Herzegovina,Australia,0,5,0,5
16031,2020,Cambodia,Australia,70,515,0,585
16032,2020,China,Australia,1780,16811,0,18591
16033,2020,Chile,Australia,0,54,0,54
16034,2020,Cameroon,Australia,29,61,0,90
16035,2020,Congo,Australia,12,59,0,71
16036,2020,Dem. Rep. of the Congo,Australia,62,22,0,84
16037,2020,Colombia,Australia,103,317,0,420
16038,2020,Czechia,Australia,0,5,0,5
16039,2020,Djibouti,Australia,5,0,0,5
16040,2020,Eritrea,Australia,119,13,0,132
16041,2020,Ethiopia,Australia,301,266,0,567
16042,2020,Fiji,Australia,340,2318,0,2658
16043,2020,France,Australia,0,15,0,15
16044,2020,Gambia,Australia,8,11,0,19
16045,2020,Palestinian,Australia,508,154,0,662
16046,2020,United Kingdom of Great Britain and Northern Ireland,Australia,5,59,0,64
16047,2020,Georgia,Australia,14,26,0,40
16048,2020,Germany,Australia,10,5,0,15
16049,2020,Ghana,Australia,35,215,0,250
16050,2020,Greece,Australia,6,39,0,45
16051,2020,Guinea,Australia,8,5,0,13
16052,2020,"China, Hong Kong SAR",Australia,5,315,0,320
16053,2020,Honduras,Australia,5,5,0,10
16054,2020,Hungary,Australia,0,5,0,5
16055,2020,India,Australia,474,6471,0,6945
16056,2020,Indonesia,Australia,236,2054,0,2290
16057,2020,Ireland,Australia,0,28,0,28
16058,2020,Iran (Islamic Rep. of),Australia,12606,3837,0,16443
16059,2020,Iraq,Australia,4886,1149,0,6035
16060,2020,Israel,Australia,9,21,0,30
16061,2020,Italy,Australia,5,38,0,43
16062,2020,Jamaica,Australia,5,0,0,5
16063,2020,Jordan,Australia,129,213,0,342
16064,2020,Japan,Australia,11,18,0,29
16065,2020,Kazakhstan,Australia,7,0,0,7
16066,2020,Kenya,Australia,101,292,0,393
16067,2020,Kyrgyzstan,Australia,13,5,0,18
16068,2020,Rep. of Korea,Australia,28,171,0,199
16069,2020,Dem. People's Rep. of Korea,Australia,7,9,0,16
16070,2020,Kuwait,Australia,44,0,0,44
16071,2020,Lao People's Dem. Rep.,Australia,5,283,0,288
16072,2020,Liberia,Australia,44,18,0,62
16073,2020,Libya,Australia,1226,88,0,1314
16074,2020,Lebanon,Australia,540,874,0,1414
16075,2020,Sri Lanka,Australia,4194,2640,0,6834
16076,2020,North Macedonia,Australia,5,76,0,81
16077,2020,Maldives,Australia,16,16,0,32
16078,2020,Mexico,Australia,14,26,0,40
16079,2020,Malaysia,Australia,598,18764,0,19362
16080,2020,Mongolia,Australia,18,367,0,385
16081,2020,Morocco,Australia,12,19,0,31
16082,2020,Mozambique,Australia,5,5,0,10
16083,2020,Mauritius,Australia,10,119,0,129
16084,2020,Myanmar,Australia,477,310,0,787
16085,2020,Nepal,Australia,127,649,0,776
16086,2020,Nigeria,Australia,208,561,0,769
16087,2020,Nauru,Australia,5,16,0,21
16088,2020,New Zealand,Australia,27,27,0,54
16089,2020,Oman,Australia,5,0,0,5
16090,2020,Pakistan,Australia,5416,2569,0,7985
16091,2020,Peru,Australia,20,63,0,83
16092,2020,Philippines,Australia,48,1413,0,1461
16093,2020,Papua New Guinea,Australia,505,650,0,1155
16094,2020,Poland,Australia,0,21,0,21
16095,2020,Portugal,Australia,0,8,0,8
16096,2020,Romania,Australia,0,5,0,5
16097,2020,South Africa,Australia,33,454,0,487
16098,2020,Russian Federation,Australia,57,80,0,137
16099,2020,Rwanda,Australia,94,51,0,145
16100,2020,El Salvador,Australia,10,30,0,40
16101,2020,Saudi Arabia,Australia,199,78,0,277
16102,2020,Serbia and Kosovo: S/RES/1244 (1999),Australia,0,28,0,28
16103,2020,Singapore,Australia,6,26,0,32
16104,2020,Sierra Leone,Australia,28,140,0,168
16105,2020,Solomon Islands,Australia,24,267,0,291
16106,2020,Somalia,Australia,534,135,0,669
16107,2020,Viet Nam,Australia,298,3196,0,3494
16108,2020,Sudan,Australia,554,149,0,703
16109,2020,South Sudan,Australia,13,45,0,58
16110,2020,Eswatini,Australia,0,16,0,16
16111,2020,Syrian Arab Rep.,Australia,645,58,0,703
16112,2020,United Rep. of Tanzania,Australia,8,31,0,39
16113,2020,Thailand,Australia,20,2682,0,2702
16114,2020,Timor-Leste,Australia,6,299,0,305
16115,2020,Tonga,Australia,31,726,0,757
16116,2020,Tunisia,Australia,5,9,0,14
16117,2020,Türkiye,Australia,846,479,0,1325
16118,2020,United Arab Emirates,Australia,6,0,0,6
16119,2020,Uganda,Australia,60,96,0,156
16120,2020,Ukraine,Australia,24,97,0,121
16121,2020,United States of America,Australia,17,52,0,69
16122,2020,Uzbekistan,Australia,22,49,0,71
16123,2020,Vanuatu,Australia,0,81,0,81
16124,2020,Venezuela (Bolivarian Republic of),Australia,139,310,0,449
16125,2020,Samoa,Australia,0,123,0,123
16126,2020,Yemen,Australia,160,100,0,260
16127,2020,Zambia,Australia,12,25,0,37
16128,2020,Zimbabwe,Australia,417,213,0,630
16129,2020,Stateless,Australia,3924,1251,0,5175
16130,2020,Tibetan,Australia,10,0,0,10
16131,2020,Unknown ,Australia,917,490,0,1407
16132,2020,Afghanistan,Austria,40096,6473,0,46569
16133,2020,Albania,Austria,60,23,0,83
16134,2020,Algeria,Austria,34,123,0,157
16135,2020,Angola,Austria,51,5,0,56
16136,2020,Egypt,Austria,231,141,0,372
16137,2020,Armenia,Austria,377,238,0,615
16138,2020,Azerbaijan,Austria,170,165,0,335
16139,2020,Burundi,Austria,14,0,0,14
16140,2020,Benin,Austria,5,24,0,29
16141,2020,Bangladesh,Austria,334,207,0,541
16142,2020,Burkina Faso,Austria,7,5,0,12
16143,2020,Belarus,Austria,35,16,0,51
16144,2020,Bosnia and Herzegovina,Austria,65,7,0,72
16145,2020,Canada,Austria,5,0,0,5
16146,2020,China,Austria,660,97,0,757
16147,2020,Cameroon,Austria,197,44,0,241
16148,2020,Congo,Austria,98,10,0,108
16149,2020,Dem. Rep. of the Congo,Austria,343,68,0,411
16150,2020,Colombia,Austria,0,19,0,19
16151,2020,Cuba,Austria,13,8,0,21
16152,2020,Eritrea,Austria,441,32,0,473
16153,2020,Ethiopia,Austria,231,60,0,291
16154,2020,Gabon,Austria,5,0,0,5
16155,2020,Gambia,Austria,115,86,0,201
16156,2020,Georgia,Austria,335,251,0,586
16157,2020,Ghana,Austria,17,28,0,45
16158,2020,Guinea-Bissau,Austria,5,5,0,10
16159,2020,Guatemala,Austria,6,0,0,6
16160,2020,Guinea,Austria,142,34,0,176
16161,2020,Hungary,Austria,0,5,0,5
16162,2020,Cote d'Ivoire,Austria,68,14,0,82
16163,2020,India,Austria,40,216,0,256
16164,2020,Iran (Islamic Rep. of),Austria,6878,1441,0,8319
16165,2020,Iraq,Austria,9152,3467,0,12619
16166,2020,Israel,Austria,10,0,0,10
16167,2020,Jordan,Austria,76,28,0,104
16168,2020,Kazakhstan,Austria,115,30,0,145
16169,2020,Kenya,Austria,26,11,0,37
16170,2020,Kyrgyzstan,Austria,154,26,0,180
16171,2020,Kuwait,Austria,9,14,0,23
16172,2020,Liberia,Austria,10,5,0,15
16173,2020,Libya,Austria,139,54,0,193
16174,2020,Lebanon,Austria,112,73,0,185
16175,2020,Sri Lanka,Austria,66,27,0,93
16176,2020,Madagascar,Austria,5,0,0,5
16177,2020,Mauritania,Austria,5,0,0,5
16178,2020,North Macedonia,Austria,19,9,0,28
16179,2020,Rep. of Moldova,Austria,27,20,0,47
16180,2020,Mali,Austria,13,11,0,24
16181,2020,Mongolia,Austria,132,110,0,242
16182,2020,Morocco,Austria,39,187,0,226
16183,2020,Montenegro,Austria,5,0,0,5
16184,2020,Myanmar,Austria,35,5,0,40
16185,2020,Nepal,Austria,19,44,0,63
16186,2020,Nicaragua,Austria,5,0,0,5
16187,2020,Nigeria,Austria,417,443,0,860
16188,2020,Pakistan,Austria,348,428,0,776
16189,2020,Philippines,Austria,18,10,0,28
16190,2020,Romania,Austria,5,0,0,5
16191,2020,South Africa,Austria,5,0,0,5
16192,2020,Russian Federation,Austria,7513,958,0,8471
16193,2020,Rwanda,Austria,15,6,0,21
16194,2020,Saudi Arabia,Austria,6,0,0,6
16195,2020,Serbia and Kosovo: S/RES/1244 (1999),Austria,563,144,0,707
16196,2020,Senegal,Austria,15,8,0,23
16197,2020,Sierra Leone,Austria,21,10,0,31
16198,2020,Somalia,Austria,8074,729,0,8803
16199,2020,Viet Nam,Austria,5,7,0,12
16200,2020,Sudan,Austria,336,18,0,354
16201,2020,South Sudan,Austria,6,0,0,6
16202,2020,Syrian Arab Rep.,Austria,54903,2820,0,57723
16203,2020,United Rep. of Tanzania,Austria,5,0,0,5
16204,2020,Tajikistan,Austria,243,36,0,279
16205,2020,Turkmenistan,Austria,7,0,0,7
16206,2020,Togo,Austria,7,0,0,7
16207,2020,Tunisia,Austria,7,58,0,65
16208,2020,Türkiye,Austria,574,390,0,964
16209,2020,Uganda,Austria,31,5,0,36
16210,2020,Ukraine,Austria,251,182,0,433
16211,2020,United States of America,Austria,5,0,0,5
16212,2020,Uzbekistan,Austria,55,69,0,124
16213,2020,Venezuela (Bolivarian Republic of),Austria,61,34,0,95
16214,2020,Yemen,Austria,355,79,0,434
16215,2020,Zambia,Austria,5,0,0,5
16216,2020,Zimbabwe,Austria,6,0,0,6
16217,2020,Stateless,Austria,2125,0,0,2125
16218,2020,Unknown ,Austria,4578,310,0,4888
16219,2020,Afghanistan,Azerbaijan,1087,24,0,1111
16220,2020,Azerbaijan,Azerbaijan,0,0,653921,0
16221,2020,Palestinian,Azerbaijan,5,0,0,5
16222,2020,Iran (Islamic Rep. of),Azerbaijan,43,0,0,43
16223,2020,Iraq,Azerbaijan,10,0,0,10
16224,2020,Libya,Azerbaijan,5,0,0,5
16225,2020,Pakistan,Azerbaijan,17,0,0,17
16226,2020,Russian Federation,Azerbaijan,350,24,0,374
16227,2020,Syrian Arab Rep.,Azerbaijan,34,0,0,34
16228,2020,Ukraine,Azerbaijan,5,0,0,5
16229,2020,Uzbekistan,Azerbaijan,5,0,0,5
16230,2020,Yemen,Azerbaijan,11,0,0,11
16231,2020,Stateless,Azerbaijan,0,0,0,0
16232,2020,Egypt,Bahrain,0,5,0,5
16233,2020,Palestinian,Bahrain,0,6,0,6
16234,2020,Iraq,Bahrain,242,59,0,301
16235,2020,Jordan,Bahrain,5,0,0,5
16236,2020,Syrian Arab Rep.,Bahrain,0,23,0,23
16237,2020,Tunisia,Bahrain,0,6,0,6
16238,2020,Yemen,Bahrain,9,5,0,14
16239,2020,Venezuela (Bolivarian Republic of),Barbados,0,5,0,5
16240,2020,Burundi,Burundi,0,0,21863,0
16241,2020,Benin,Burundi,0,0,0,0
16242,2020,Dem. Rep. of the Congo,Burundi,74928,4525,0,79453
16243,2020,Mali,Burundi,12,0,0,12
16244,2020,Oman,Burundi,0,0,0,0
16245,2020,Rwanda,Burundi,480,389,0,869
16246,2020,Somalia,Burundi,5,0,0,5
16247,2020,South Sudan,Burundi,8,0,0,8
16248,2020,United Rep. of Tanzania,Burundi,0,0,0,0
16249,2020,Türkiye,Burundi,21,0,0,21
16250,2020,Uganda,Burundi,7,0,0,7
16251,2020,Stateless,Burundi,0,0,0,0
16252,2020,Afghanistan,Belgium,4689,4215,0,8904
16253,2020,Albania,Belgium,669,400,0,1069
16254,2020,Algeria,Belgium,70,205,0,275
16255,2020,Angola,Belgium,88,310,0,398
16256,2020,Egypt,Belgium,98,95,0,193
16257,2020,Armenia,Belgium,144,230,0,374
16258,2020,Azerbaijan,Belgium,85,55,0,140
16259,2020,Burundi,Belgium,1611,555,0,2166
16260,2020,Benin,Belgium,38,60,0,98
16261,2020,Bangladesh,Belgium,21,20,0,41
16262,2020,Burkina Faso,Belgium,106,125,0,231
16263,2020,Belarus,Belgium,41,55,0,96
16264,2020,Brazil,Belgium,10,285,0,295
16265,2020,Bosnia and Herzegovina,Belgium,44,55,0,99
16266,2020,Bulgaria,Belgium,17,10,0,27
16267,2020,Cambodia,Belgium,13,0,0,13
16268,2020,Canada,Belgium,0,5,0,5
16269,2020,Central African Rep.,Belgium,62,25,0,87
16270,2020,Chad,Belgium,46,60,0,106
16271,2020,China,Belgium,1151,60,0,1211
16272,2020,Chile,Belgium,44,10,0,54
16273,2020,Cameroon,Belgium,478,755,0,1233
16274,2020,Congo,Belgium,25,40,0,65
16275,2020,Dem. Rep. of the Congo,Belgium,1508,895,0,2403
16276,2020,Colombia,Belgium,105,410,0,515
16277,2020,Costa Rica,Belgium,0,5,0,5
16278,2020,Cuba,Belgium,10,15,0,25
16279,2020,Czechia,Belgium,5,5,0,10
16280,2020,Djibouti,Belgium,373,65,0,438
16281,2020,Dominican Rep.,Belgium,0,5,0,5
16282,2020,Ecuador,Belgium,0,10,0,10
16283,2020,Equatorial Guinea,Belgium,0,5,0,5
16284,2020,Eritrea,Belgium,2764,1205,0,3969
16285,2020,Ethiopia,Belgium,175,70,0,245
16286,2020,Gabon,Belgium,26,40,0,66
16287,2020,Gambia,Belgium,31,125,0,156
16288,2020,Palestinian,Belgium,1224,3275,0,4499
16289,2020,Georgia,Belgium,139,235,0,374
16290,2020,Germany,Belgium,0,5,0,5
16291,2020,Ghana,Belgium,19,55,0,74
16292,2020,Guinea-Bissau,Belgium,7,10,0,17
16293,2020,Guatemala,Belgium,39,40,0,79
16294,2020,Guinea,Belgium,3446,1390,0,4836
16295,2020,Guyana,Belgium,5,0,0,5
16296,2020,Haiti,Belgium,5,5,0,10
16297,2020,Honduras,Belgium,18,20,0,38
16298,2020,Croatia,Belgium,5,5,0,10
16299,2020,Hungary,Belgium,29,0,0,29
16300,2020,Cote d'Ivoire,Belgium,208,260,0,468
16301,2020,India,Belgium,14,40,0,54
16302,2020,Iran (Islamic Rep. of),Belgium,1648,765,0,2413
16303,2020,Iraq,Belgium,5515,1235,0,6750
16304,2020,Israel,Belgium,0,5,0,5
16305,2020,Jamaica,Belgium,5,0,0,5
16306,2020,Jordan,Belgium,23,70,0,93
16307,2020,Japan,Belgium,0,5,0,5
16308,2020,Kazakhstan,Belgium,60,45,0,105
16309,2020,Kenya,Belgium,15,20,0,35
16310,2020,Kyrgyzstan,Belgium,65,35,0,100
16311,2020,Dem. People's Rep. of Korea,Belgium,32,5,0,37
16312,2020,Kuwait,Belgium,6,10,0,16
16313,2020,Lao People's Dem. Rep.,Belgium,10,0,0,10
16314,2020,Liberia,Belgium,15,30,0,45
16315,2020,Libya,Belgium,75,130,0,205
16316,2020,Lebanon,Belgium,105,165,0,270
16317,2020,Sri Lanka,Belgium,304,55,0,359
16318,2020,Lithuania,Belgium,5,0,0,5
16319,2020,Latvia,Belgium,0,5,0,5
16320,2020,Madagascar,Belgium,0,5,0,5
16321,2020,Mauritania,Belgium,269,185,0,454
16322,2020,North Macedonia,Belgium,128,115,0,243
16323,2020,Rep. of Moldova,Belgium,5,75,0,80
16324,2020,Mali,Belgium,99,85,0,184
16325,2020,Mongolia,Belgium,0,15,0,15
16326,2020,Morocco,Belgium,142,275,0,417
16327,2020,Mozambique,Belgium,0,10,0,10
16328,2020,Montenegro,Belgium,13,5,0,18
16329,2020,Mauritius,Belgium,0,5,0,5
16330,2020,Myanmar,Belgium,8,0,0,8
16331,2020,Namibia,Belgium,0,5,0,5
16332,2020,Nepal,Belgium,6,10,0,16
16333,2020,Netherlands,Belgium,0,5,0,5
16334,2020,Niger,Belgium,126,160,0,286
16335,2020,Nicaragua,Belgium,16,25,0,41
16336,2020,Nigeria,Belgium,55,220,0,275
16337,2020,Pakistan,Belgium,300,205,0,505
16338,2020,Peru,Belgium,0,50,0,50
16339,2020,Philippines,Belgium,0,5,0,5
16340,2020,Poland,Belgium,98,0,0,98
16341,2020,Romania,Belgium,36,15,0,51
16342,2020,South Africa,Belgium,5,0,0,5
16343,2020,Russian Federation,Belgium,2560,585,0,3145
16344,2020,Rwanda,Belgium,781,440,0,1221
16345,2020,El Salvador,Belgium,442,1570,0,2012
16346,2020,Saudi Arabia,Belgium,8,5,0,13
16347,2020,Serbia and Kosovo: S/RES/1244 (1999),Belgium,898,285,0,1183
16348,2020,Senegal,Belgium,371,370,0,741
16349,2020,Sierra Leone,Belgium,27,50,0,77
16350,2020,Somalia,Belgium,2316,935,0,3251
16351,2020,Spain,Belgium,0,5,0,5
16352,2020,Viet Nam,Belgium,23,15,0,38
16353,2020,Sudan,Belgium,259,230,0,489
16354,2020,Suriname,Belgium,0,60,0,60
16355,2020,South Sudan,Belgium,5,15,0,20
16356,2020,Slovakia,Belgium,0,15,0,15
16357,2020,Syrian Arab Rep.,Belgium,17693,2165,0,19858
16358,2020,United Rep. of Tanzania,Belgium,43,40,0,83
16359,2020,Tajikistan,Belgium,11,10,0,21
16360,2020,Togo,Belgium,163,140,0,303
16361,2020,Tunisia,Belgium,53,80,0,133
16362,2020,Türkiye,Belgium,2646,1030,0,3676
16363,2020,Uganda,Belgium,24,25,0,49
16364,2020,Ukraine,Belgium,254,155,0,409
16365,2020,United States of America,Belgium,0,15,0,15
16366,2020,Uzbekistan,Belgium,37,10,0,47
16367,2020,Venezuela (Bolivarian Republic of),Belgium,399,505,0,904
16368,2020,Yemen,Belgium,77,200,0,277
16369,2020,Stateless,Belgium,304,20,0,324
16370,2020,Tibetan,Belgium,6,0,0,6
16371,2020,Unknown ,Belgium,6679,450,0,7129
16372,2020,Burundi,Benin,7,0,0,7
16373,2020,Central African Rep.,Benin,1050,171,0,1221
16374,2020,Chad,Benin,15,25,0,40
16375,2020,Cameroon,Benin,35,64,0,99
16376,2020,Congo,Benin,0,10,0,10
16377,2020,Dem. Rep. of the Congo,Benin,11,51,0,62
16378,2020,Eritrea,Benin,5,0,0,5
16379,2020,Guinea,Benin,0,13,0,13
16380,2020,Cote d'Ivoire,Benin,167,28,0,195
16381,2020,Liberia,Benin,0,5,0,5
16382,2020,Sri Lanka,Benin,5,0,0,5
16383,2020,Mali,Benin,36,19,0,55
16384,2020,Niger,Benin,0,5,0,5
16385,2020,Nigeria,Benin,0,26,0,26
16386,2020,Pakistan,Benin,5,0,0,5
16387,2020,Rwanda,Benin,0,5,0,5
16388,2020,Senegal,Benin,5,0,0,5
16389,2020,Sudan,Benin,9,8,0,17
16390,2020,Syrian Arab Rep.,Benin,22,9,0,31
16391,2020,Togo,Benin,0,25,0,25
16392,2020,Türkiye,Benin,10,0,0,10
16393,2020,Yemen,Benin,14,0,0,14
16394,2020,Bangladesh,Bangladesh,0,0,0,0
16395,2020,Myanmar,Bangladesh,866518,0,0,866518
16396,2020,Somalia,Bangladesh,11,10,0,21
16397,2020,Türkiye,Bangladesh,0,8,0,8
16398,2020,Yemen,Bangladesh,5,0,0,5
16399,2020,Stateless,Bangladesh,0,0,0,0
16400,2020,Cambodia,Bahamas,0,5,0,5
16401,2020,Colombia,Bahamas,5,0,0,5
16402,2020,Cuba,Bahamas,5,0,0,5
16403,2020,Jamaica,Bahamas,5,0,0,5
16404,2020,South Africa,Bahamas,0,8,0,8
16405,2020,Burundi,Burkina Faso,28,0,0,28
16406,2020,Benin,Burkina Faso,8,0,0,8
16407,2020,Burkina Faso,Burkina Faso,0,0,1074993,0
16408,2020,Central African Rep.,Burkina Faso,193,25,0,218
16409,2020,Chad,Burkina Faso,81,0,0,81
16410,2020,Cameroon,Burkina Faso,7,0,0,7
16411,2020,Congo,Burkina Faso,26,0,0,26
16412,2020,Dem. Rep. of the Congo,Burkina Faso,33,0,0,33
16413,2020,Cote d'Ivoire,Burkina Faso,5,0,0,5
16414,2020,Mali,Burkina Faso,19816,0,0,19816
16415,2020,Rwanda,Burkina Faso,16,0,0,16
16416,2020,South Sudan,Burkina Faso,0,5,0,5
16417,2020,Syrian Arab Rep.,Burkina Faso,5,0,0,5
16418,2020,Togo,Burkina Faso,15,0,0,15
16419,2020,Türkiye,Burkina Faso,19,0,0,19
16420,2020,Afghanistan,Belarus,222,0,0,222
16421,2020,Armenia,Belarus,5,5,0,10
16422,2020,Azerbaijan,Belarus,5,0,0,5
16423,2020,Cameroon,Belarus,5,5,0,10
16424,2020,Ethiopia,Belarus,5,0,0,5
16425,2020,Palestinian,Belarus,5,0,0,5
16426,2020,Georgia,Belarus,50,0,0,50
16427,2020,Iran (Islamic Rep. of),Belarus,5,0,0,5
16428,2020,Iraq,Belarus,12,5,0,17
16429,2020,Libya,Belarus,7,0,0,7
16430,2020,Russian Federation,Belarus,0,7,0,7
16431,2020,Syrian Arab Rep.,Belarus,64,8,0,72
16432,2020,Tajikistan,Belarus,11,0,0,11
16433,2020,Turkmenistan,Belarus,0,5,0,5
16434,2020,Türkiye,Belarus,5,6,0,11
16435,2020,Ukraine,Belarus,2471,96,0,2567
16436,2020,Yemen,Belarus,28,6,0,34
16437,2020,Stateless,Belarus,0,0,0,0
16438,2020,Argentina,Bolivia (Plurinational State of),13,0,0,13
16439,2020,Colombia,Bolivia (Plurinational State of),202,0,0,202
16440,2020,Cuba,Bolivia (Plurinational State of),48,0,0,48
16441,2020,Ecuador,Bolivia (Plurinational State of),5,0,0,5
16442,2020,Cote d'Ivoire,Bolivia (Plurinational State of),5,0,0,5
16443,2020,Iraq,Bolivia (Plurinational State of),16,0,0,16
16444,2020,Niger,Bolivia (Plurinational State of),5,0,0,5
16445,2020,Pakistan,Bolivia (Plurinational State of),5,0,0,5
16446,2020,Peru,Bolivia (Plurinational State of),524,0,0,524
16447,2020,Russian Federation,Bolivia (Plurinational State of),14,0,0,14
16448,2020,Syrian Arab Rep.,Bolivia (Plurinational State of),22,0,0,22
16449,2020,Ukraine,Bolivia (Plurinational State of),5,0,0,5
16450,2020,Uruguay,Bolivia (Plurinational State of),10,0,0,10
16451,2020,Venezuela (Bolivarian Republic of),Bolivia (Plurinational State of),242,157,0,399
16452,2020,Angola,Botswana,0,0,0,0
16453,2020,Burundi,Botswana,73,0,0,73
16454,2020,Dem. Rep. of the Congo,Botswana,159,94,0,253
16455,2020,Eritrea,Botswana,5,0,0,5
16456,2020,Ethiopia,Botswana,5,0,0,5
16457,2020,Kenya,Botswana,5,0,0,5
16458,2020,Rwanda,Botswana,18,0,0,18
16459,2020,Somalia,Botswana,307,36,0,343
16460,2020,Sudan,Botswana,5,0,0,5
16461,2020,Uganda,Botswana,20,0,0,20
16462,2020,Zimbabwe,Botswana,20,292,0,312
16463,2020,Afghanistan,Brazil,143,173,0,316
16464,2020,Albania,Brazil,0,7,0,7
16465,2020,Algeria,Brazil,7,37,0,44
16466,2020,Andorra,Brazil,0,5,0,5
16467,2020,Angola,Brazil,1150,5177,0,6327
16468,2020,Egypt,Brazil,57,483,0,540
16469,2020,Argentina,Brazil,6,149,0,155
16470,2020,Armenia,Brazil,5,7,0,12
16471,2020,Burundi,Brazil,46,24,0,70
16472,2020,Belgium,Brazil,0,6,0,6
16473,2020,Benin,Brazil,0,279,0,279
16474,2020,Bangladesh,Brazil,18,5617,0,5635
16475,2020,Bhutan,Brazil,30,36,0,66
16476,2020,Burkina Faso,Brazil,5,310,0,315
16477,2020,Bolivia (Plurinational State of),Brazil,153,455,0,608
16478,2020,Bosnia and Herzegovina,Brazil,5,0,0,5
16479,2020,Bulgaria,Brazil,0,5,0,5
16480,2020,Cambodia,Brazil,0,5,0,5
16481,2020,Canada,Brazil,0,7,0,7
16482,2020,Central African Rep.,Brazil,5,7,0,12
16483,2020,China,Brazil,11,5143,0,5154
16484,2020,Chile,Brazil,21,134,0,155
16485,2020,Cameroon,Brazil,75,593,0,668
16486,2020,Congo,Brazil,20,100,0,120
16487,2020,Dem. Rep. of the Congo,Brazil,1668,2685,0,4353
16488,2020,Colombia,Brazil,1297,1986,0,3283
16489,2020,Costa Rica,Brazil,0,15,0,15
16490,2020,Cuba,Brazil,359,15392,0,15751
16491,2020,Cabo Verde,Brazil,0,210,0,210
16492,2020,Cyprus,Brazil,0,5,0,5
16493,2020,Czechia,Brazil,0,6,0,6
16494,2020,Denmark,Brazil,0,12,0,12
16495,2020,Djibouti,Brazil,0,11,0,11
16496,2020,Dominica,Brazil,0,18,0,18
16497,2020,Dominican Rep.,Brazil,6,1295,0,1301
16498,2020,Ecuador,Brazil,58,98,0,156
16499,2020,Equatorial Guinea,Brazil,0,11,0,11
16500,2020,Eritrea,Brazil,25,117,0,142
16501,2020,Ethiopia,Brazil,29,89,0,118
16502,2020,French Guiana,Brazil,0,19,0,19
16503,2020,Fiji,Brazil,0,20,0,20
16504,2020,France,Brazil,0,40,0,40
16505,2020,Gambia,Brazil,6,357,0,363
16506,2020,Palestinian,Brazil,571,378,0,949
16507,2020,United Kingdom of Great Britain and Northern Ireland,Brazil,0,13,0,13
16508,2020,Georgia,Brazil,10,5,0,15
16509,2020,Germany,Brazil,0,8,0,8
16510,2020,Ghana,Brazil,35,2447,0,2482
16511,2020,Guinea-Bissau,Brazil,24,1699,0,1723
16512,2020,Greece,Brazil,0,6,0,6
16513,2020,Guatemala,Brazil,0,22,0,22
16514,2020,Guinea,Brazil,107,908,0,1015
16515,2020,Guyana,Brazil,5,149,0,154
16516,2020,Haiti,Brazil,8,38130,0,38138
16517,2020,Honduras,Brazil,5,17,0,22
16518,2020,Croatia,Brazil,5,0,0,5
16519,2020,Hungary,Brazil,5,5,0,10
16520,2020,Cote d'Ivoire,Brazil,55,189,0,244
16521,2020,India,Brazil,9,1062,0,1071
16522,2020,Indonesia,Brazil,0,8,0,8
16523,2020,Iran (Islamic Rep. of),Brazil,69,190,0,259
16524,2020,Iraq,Brazil,308,419,0,727
16525,2020,Israel,Brazil,0,33,0,33
16526,2020,Italy,Brazil,0,27,0,27
16527,2020,Jamaica,Brazil,0,11,0,11
16528,2020,Jordan,Brazil,11,95,0,106
16529,2020,Japan,Brazil,0,6,0,6
16530,2020,Kazakhstan,Brazil,0,10,0,10
16531,2020,Kenya,Brazil,10,78,0,88
16532,2020,Rep. of Korea,Brazil,0,269,0,269
16533,2020,Kuwait,Brazil,0,7,0,7
16534,2020,Liberia,Brazil,259,33,0,292
16535,2020,Libya,Brazil,6,51,0,57
16536,2020,Lebanon,Brazil,413,1923,0,2336
16537,2020,Lesotho,Brazil,0,5,0,5
16538,2020,Sri Lanka,Brazil,19,73,0,92
16539,2020,Lithuania,Brazil,0,7,0,7
16540,2020,"China, Macao SAR",Brazil,0,28,0,28
16541,2020,Mauritania,Brazil,50,244,0,294
16542,2020,North Macedonia,Brazil,6,5,0,11
16543,2020,Mexico,Brazil,6,48,0,54
16544,2020,Mali,Brazil,92,428,0,520
16545,2020,Malaysia,Brazil,0,5,0,5
16546,2020,Mongolia,Brazil,0,7,0,7
16547,2020,Morocco,Brazil,27,732,0,759
16548,2020,Mozambique,Brazil,0,91,0,91
16549,2020,Malta,Brazil,0,5,0,5
16550,2020,Myanmar,Brazil,0,6,0,6
16551,2020,Namibia,Brazil,0,39,0,39
16552,2020,Nepal,Brazil,12,380,0,392
16553,2020,Netherlands,Brazil,0,6,0,6
16554,2020,Niger,Brazil,0,7,0,7
16555,2020,Nicaragua,Brazil,0,40,0,40
16556,2020,Nigeria,Brazil,140,3466,0,3606
16557,2020,Norway,Brazil,0,6,0,6
16558,2020,New Zealand,Brazil,0,5,0,5
16559,2020,Pakistan,Brazil,356,1758,0,2114
16560,2020,Panama,Brazil,0,8,0,8
16561,2020,Paraguay,Brazil,5,176,0,181
16562,2020,Peru,Brazil,46,243,0,289
16563,2020,Philippines,Brazil,5,564,0,569
16564,2020,Poland,Brazil,0,13,0,13
16565,2020,Portugal,Brazil,0,104,0,104
16566,2020,Romania,Brazil,0,15,0,15
16567,2020,South Africa,Brazil,5,446,0,451
16568,2020,Russian Federation,Brazil,19,43,0,62
16569,2020,Rwanda,Brazil,18,5,0,23
16570,2020,El Salvador,Brazil,59,5,0,64
16571,2020,Saudi Arabia,Brazil,0,21,0,21
16572,2020,Serbia and Kosovo: S/RES/1244 (1999),Brazil,92,7,0,99
16573,2020,Senegal,Brazil,15,6367,0,6382
16574,2020,Sierra Leone,Brazil,164,363,0,527
16575,2020,Somalia,Brazil,48,575,0,623
16576,2020,Spain,Brazil,0,51,0,51
16577,2020,Viet Nam,Brazil,5,0,0,5
16578,2020,Sao Tome and Principe,Brazil,0,23,0,23
16579,2020,Sudan,Brazil,76,144,0,220
16580,2020,Suriname,Brazil,0,22,0,22
16581,2020,Sweden,Brazil,0,6,0,6
16582,2020,Switzerland,Brazil,0,5,0,5
16583,2020,Syrian Arab Rep.,Brazil,3924,4086,0,8010
16584,2020,United Rep. of Tanzania,Brazil,8,114,0,122
16585,2020,Thailand,Brazil,0,46,0,46
16586,2020,Togo,Brazil,52,642,0,694
16587,2020,Trinidad and Tobago,Brazil,0,7,0,7
16588,2020,Tunisia,Brazil,5,132,0,137
16589,2020,Türkiye,Brazil,6,279,0,285
16590,2020,Uganda,Brazil,6,34,0,40
16591,2020,Ukraine,Brazil,19,80,0,99
16592,2020,Uruguay,Brazil,0,36,0,36
16593,2020,United States of America,Brazil,0,50,0,50
16594,2020,Uzbekistan,Brazil,0,5,0,5
16595,2020,Vanuatu,Brazil,0,57,0,57
16596,2020,Holy See,Brazil,0,12,0,12
16597,2020,Venezuela (Bolivarian Republic of),Brazil,46675,90934,0,137609
16598,2020,Yemen,Brazil,7,150,0,157
16599,2020,Zambia,Brazil,0,7,0,7
16600,2020,Zimbabwe,Brazil,5,13,0,18
16601,2020,Stateless,Brazil,0,0,0,0
16602,2020,Unknown ,Brazil,0,37,0,37
16603,2020,Stateless,Brunei Darussalam,0,0,0,0
16604,2020,Afghanistan,Bosnia and Herzegovina,0,33,0,33
16605,2020,Algeria,Bosnia and Herzegovina,0,5,0,5
16606,2020,Egypt,Bosnia and Herzegovina,0,0,0,0
16607,2020,Azerbaijan,Bosnia and Herzegovina,5,0,0,5
16608,2020,Bangladesh,Bosnia and Herzegovina,0,5,0,5
16609,2020,Bosnia and Herzegovina,Bosnia and Herzegovina,0,0,96305,0
16610,2020,China,Bosnia and Herzegovina,0,0,0,0
16611,2020,Cameroon,Bosnia and Herzegovina,0,7,0,7
16612,2020,Eritrea,Bosnia and Herzegovina,0,0,0,0
16613,2020,Palestinian,Bosnia and Herzegovina,0,5,0,5
16614,2020,Ghana,Bosnia and Herzegovina,0,0,0,0
16615,2020,Croatia,Bosnia and Herzegovina,5112,0,0,5112
16616,2020,India,Bosnia and Herzegovina,0,7,0,7
16617,2020,Iran (Islamic Rep. of),Bosnia and Herzegovina,0,29,0,29
16618,2020,Iraq,Bosnia and Herzegovina,0,37,0,37
16619,2020,Kuwait,Bosnia and Herzegovina,0,0,0,0
16620,2020,Libya,Bosnia and Herzegovina,0,5,0,5
16621,2020,North Macedonia,Bosnia and Herzegovina,0,5,0,5
16622,2020,Morocco,Bosnia and Herzegovina,0,15,0,15
16623,2020,Myanmar,Bosnia and Herzegovina,0,0,0,0
16624,2020,Nepal,Bosnia and Herzegovina,0,0,0,0
16625,2020,Pakistan,Bosnia and Herzegovina,0,32,0,32
16626,2020,Russian Federation,Bosnia and Herzegovina,0,5,0,5
16627,2020,Serbia and Kosovo: S/RES/1244 (1999),Bosnia and Herzegovina,54,0,0,54
16628,2020,Somalia,Bosnia and Herzegovina,0,5,0,5
16629,2020,Sudan,Bosnia and Herzegovina,0,0,0,0
16630,2020,Syrian Arab Rep.,Bosnia and Herzegovina,22,10,0,32
16631,2020,Tunisia,Bosnia and Herzegovina,0,0,0,0
16632,2020,Türkiye,Bosnia and Herzegovina,33,44,0,77
16633,2020,Western Sahara,Bosnia and Herzegovina,0,0,0,0
16634,2020,Yemen,Bosnia and Herzegovina,6,7,0,13
16635,2020,Stateless,Bosnia and Herzegovina,0,0,0,0
16636,2020,Unknown ,Bosnia and Herzegovina,0,0,0,0
16637,2020,Afghanistan,Bulgaria,244,942,0,1186
16638,2020,Algeria,Bulgaria,0,13,0,13
16639,2020,Egypt,Bulgaria,14,12,0,26
16640,2020,Armenia,Bulgaria,13,14,0,27
16641,2020,Bangladesh,Bulgaria,9,10,0,19
16642,2020,China,Bulgaria,0,14,0,14
16643,2020,Congo,Bulgaria,9,0,0,9
16644,2020,Dem. Rep. of the Congo,Bulgaria,0,6,0,6
16645,2020,Eritrea,Bulgaria,12,0,0,12
16646,2020,Ethiopia,Bulgaria,10,0,0,10
16647,2020,Ghana,Bulgaria,0,6,0,6
16648,2020,Guinea,Bulgaria,5,0,0,5
16649,2020,Cote d'Ivoire,Bulgaria,5,5,0,10
16650,2020,India,Bulgaria,5,0,0,5
16651,2020,Iran (Islamic Rep. of),Bulgaria,77,55,0,132
16652,2020,Iraq,Bulgaria,1235,27,0,1262
16653,2020,Jordan,Bulgaria,6,0,0,6
16654,2020,Kyrgyzstan,Bulgaria,0,6,0,6
16655,2020,Lebanon,Bulgaria,29,9,0,38
16656,2020,Mali,Bulgaria,5,5,0,10
16657,2020,Morocco,Bulgaria,5,19,0,24
16658,2020,Nepal,Bulgaria,0,5,0,5
16659,2020,Nigeria,Bulgaria,0,5,0,5
16660,2020,Pakistan,Bulgaria,26,83,0,109
16661,2020,Russian Federation,Bulgaria,0,20,0,20
16662,2020,Somalia,Bulgaria,50,5,0,55
16663,2020,Sudan,Bulgaria,12,0,0,12
16664,2020,Syrian Arab Rep.,Bulgaria,18310,593,0,18903
16665,2020,Tunisia,Bulgaria,5,11,0,16
16666,2020,Türkiye,Bulgaria,11,5,0,16
16667,2020,Ukraine,Bulgaria,0,32,0,32
16668,2020,Venezuela (Bolivarian Republic of),Bulgaria,0,5,0,5
16669,2020,Yemen,Bulgaria,15,7,0,22
16670,2020,Stateless,Bulgaria,1001,24,0,1025
16671,2020,Cuba,Belize,0,5,0,5
16672,2020,Guatemala,Belize,0,434,0,434
16673,2020,Honduras,Belize,5,485,0,490
16674,2020,Nicaragua,Belize,0,11,0,11
16675,2020,Peru,Belize,0,5,0,5
16676,2020,El Salvador,Belize,24,1309,0,1333
16677,2020,Unknown ,Belize,0,0,0,0
16678,2020,Viet Nam,Cambodia,0,12,0,12
16679,2020,Stateless,Cambodia,0,0,0,0
16680,2020,Afghanistan,Canada,2261,507,0,2768
16681,2020,Albania,Canada,729,229,0,958
16682,2020,Algeria,Canada,592,847,0,1439
16683,2020,Angola,Canada,314,1225,0,1539
16684,2020,Antigua and Barbuda,Canada,96,22,0,118
16685,2020,Egypt,Canada,2940,756,0,3696
16686,2020,Argentina,Canada,0,50,0,50
16687,2020,Armenia,Canada,35,0,0,35
16688,2020,Azerbaijan,Canada,622,117,0,739
16689,2020,Bahrain,Canada,56,0,0,56
16690,2020,Barbados,Canada,216,106,0,322
16691,2020,Burundi,Canada,2796,294,0,3090
16692,2020,Belgium,Canada,5,0,0,5
16693,2020,Benin,Canada,48,69,0,117
16694,2020,Bangladesh,Canada,1288,1292,0,2580
16695,2020,Bahamas,Canada,353,554,0,907
16696,2020,Burkina Faso,Canada,83,157,0,240
16697,2020,Belarus,Canada,45,0,0,45
16698,2020,Bolivia (Plurinational State of),Canada,21,30,0,51
16699,2020,Botswana,Canada,144,0,0,144
16700,2020,Brazil,Canada,116,508,0,624
16701,2020,Bulgaria,Canada,109,42,0,151
16702,2020,Belize,Canada,19,0,0,19
16703,2020,Cambodia,Canada,42,26,0,68
16704,2020,Central African Rep.,Canada,49,34,0,83
16705,2020,Chad,Canada,577,410,0,987
16706,2020,China,Canada,5916,1945,0,7861
16707,2020,Chile,Canada,63,298,0,361
16708,2020,Cameroon,Canada,964,611,0,1575
16709,2020,Congo,Canada,259,179,0,438
16710,2020,Dem. Rep. of the Congo,Canada,1039,2230,0,3269
16711,2020,Colombia,Canada,4577,4501,0,9078
16712,2020,Costa Rica,Canada,12,32,0,44
16713,2020,Cuba,Canada,504,292,0,796
16714,2020,Czechia,Canada,346,78,0,424
16715,2020,Denmark,Canada,5,0,0,5
16716,2020,Djibouti,Canada,1156,81,0,1237
16717,2020,Dominica,Canada,6,0,0,6
16718,2020,Dominican Rep.,Canada,107,156,0,263
16719,2020,Ecuador,Canada,34,111,0,145
16720,2020,Equatorial Guinea,Canada,18,0,0,18
16721,2020,Eritrea,Canada,2151,275,0,2426
16722,2020,Estonia,Canada,5,0,0,5
16723,2020,Ethiopia,Canada,1420,599,0,2019
16724,2020,Fiji,Canada,18,0,0,18
16725,2020,France,Canada,0,33,0,33
16726,2020,Gabon,Canada,32,39,0,71
16727,2020,Gambia,Canada,79,98,0,177
16728,2020,Palestinian,Canada,1777,754,0,2531
16729,2020,Georgia,Canada,337,258,0,595
16730,2020,Ghana,Canada,300,321,0,621
16731,2020,Guinea-Bissau,Canada,8,0,0,8
16732,2020,Grenada,Canada,24,0,0,24
16733,2020,Guatemala,Canada,423,225,0,648
16734,2020,Guinea,Canada,372,365,0,737
16735,2020,Guyana,Canada,93,52,0,145
16736,2020,Haiti,Canada,4587,4662,0,9249
16737,2020,"China, Hong Kong SAR",Canada,0,27,0,27
16738,2020,Honduras,Canada,905,421,0,1326
16739,2020,Croatia,Canada,265,0,0,265
16740,2020,Hungary,Canada,4261,275,0,4536
16741,2020,Cote d'Ivoire,Canada,158,235,0,393
16742,2020,India,Canada,1598,10116,0,11714
16743,2020,Indonesia,Canada,97,56,0,153
16744,2020,Ireland,Canada,0,33,0,33
16745,2020,Iran (Islamic Rep. of),Canada,5085,2426,0,7511
16746,2020,Iraq,Canada,70,394,0,464
16747,2020,Israel,Canada,134,56,0,190
16748,2020,Italy,Canada,5,76,0,81
16749,2020,Jamaica,Canada,896,318,0,1214
16750,2020,Jordan,Canada,377,611,0,988
16751,2020,Kazakhstan,Canada,143,61,0,204
16752,2020,Kenya,Canada,229,517,0,746
16753,2020,Kyrgyzstan,Canada,64,0,0,64
16754,2020,Rep. of Korea,Canada,46,0,0,46
16755,2020,Dem. People's Rep. of Korea,Canada,370,0,0,370
16756,2020,Kuwait,Canada,22,40,0,62
16757,2020,Lao People's Dem. Rep.,Canada,5,0,0,5
16758,2020,Liberia,Canada,27,178,0,205
16759,2020,Libya,Canada,1719,258,0,1977
16760,2020,Saint Lucia,Canada,688,22,0,710
16761,2020,Lebanon,Canada,743,559,0,1302
16762,2020,Sri Lanka,Canada,2065,1038,0,3103
16763,2020,Lithuania,Canada,21,0,0,21
16764,2020,Latvia,Canada,71,0,0,71
16765,2020,Madagascar,Canada,15,21,0,36
16766,2020,Mauritania,Canada,134,201,0,335
16767,2020,North Macedonia,Canada,16,0,0,16
16768,2020,Rep. of Moldova,Canada,82,0,0,82
16769,2020,Mexico,Canada,3173,6770,0,9943
16770,2020,Mali,Canada,194,158,0,352
16771,2020,Malawi,Canada,10,74,0,84
16772,2020,Mongolia,Canada,135,45,0,180
16773,2020,Morocco,Canada,138,143,0,281
16774,2020,Malta,Canada,5,0,0,5
16775,2020,Mauritius,Canada,11,20,0,31
16776,2020,Namibia,Canada,286,0,0,286
16777,2020,Nepal,Canada,25,180,0,205
16778,2020,Netherlands,Canada,8,0,0,8
16779,2020,Niger,Canada,55,87,0,142
16780,2020,Nicaragua,Canada,338,464,0,802
16781,2020,Nigeria,Canada,8082,9148,0,17230
16782,2020,Pakistan,Canada,6085,2741,0,8826
16783,2020,Panama,Canada,21,0,0,21
16784,2020,Paraguay,Canada,15,0,0,15
16785,2020,Peru,Canada,112,303,0,415
16786,2020,Philippines,Canada,60,124,0,184
16787,2020,Poland,Canada,69,105,0,174
16788,2020,Portugal,Canada,5,23,0,28
16789,2020,Romania,Canada,423,526,0,949
16790,2020,South Africa,Canada,0,215,0,215
16791,2020,Russian Federation,Canada,675,153,0,828
16792,2020,Rwanda,Canada,811,643,0,1454
16793,2020,El Salvador,Canada,1540,570,0,2110
16794,2020,Saudi Arabia,Canada,463,116,0,579
16795,2020,Serbia and Kosovo: S/RES/1244 (1999),Canada,205,41,0,246
16796,2020,Senegal,Canada,217,324,0,541
16797,2020,Seychelles,Canada,5,0,0,5
16798,2020,Singapore,Canada,10,0,0,10
16799,2020,Sierra Leone,Canada,24,68,0,92
16800,2020,Somalia,Canada,2039,377,0,2416
16801,2020,Spain,Canada,11,28,0,39
16802,2020,Viet Nam,Canada,0,96,0,96
16803,2020,Saint Kitts and Nevis,Canada,44,0,0,44
16804,2020,Sudan,Canada,1776,549,0,2325
16805,2020,South Sudan,Canada,6,0,0,6
16806,2020,Slovakia,Canada,1180,138,0,1318
16807,2020,Slovenia,Canada,6,0,0,6
16808,2020,Eswatini,Canada,101,0,0,101
16809,2020,Syrian Arab Rep.,Canada,131,180,0,311
16810,2020,United Rep. of Tanzania,Canada,138,160,0,298
16811,2020,Tajikistan,Canada,33,0,0,33
16812,2020,Turkmenistan,Canada,22,0,0,22
16813,2020,Timor-Leste,Canada,5,0,0,5
16814,2020,Togo,Canada,79,104,0,183
16815,2020,Trinidad and Tobago,Canada,66,47,0,113
16816,2020,Tunisia,Canada,164,146,0,310
16817,2020,Türkiye,Canada,6387,974,0,7361
16818,2020,United Arab Emirates,Canada,24,0,0,24
16819,2020,Uganda,Canada,660,646,0,1306
16820,2020,Ukraine,Canada,1205,190,0,1395
16821,2020,United States of America,Canada,12,1932,0,1944
16822,2020,Uzbekistan,Canada,139,0,0,139
16823,2020,Saint Vincent and the Grenadines,Canada,666,0,0,666
16824,2020,Venezuela (Bolivarian Republic of),Canada,3524,1000,0,4524
16825,2020,Yemen,Canada,1949,184,0,2133
16826,2020,Zambia,Canada,0,28,0,28
16827,2020,Zimbabwe,Canada,629,334,0,963
16828,2020,Stateless,Canada,179,170,0,349
16829,2020,Unknown ,Canada,4340,11619,0,15959
16830,2020,Angola,Central African Rep.,13,0,0,13
16831,2020,Burundi,Central African Rep.,22,0,0,22
16832,2020,Central African Rep.,Central African Rep.,0,0,681930,0
16833,2020,Chad,Central African Rep.,1041,19,0,1060
16834,2020,Cameroon,Central African Rep.,19,23,0,42
16835,2020,Congo,Central African Rep.,17,8,0,25
16836,2020,Dem. Rep. of the Congo,Central African Rep.,5541,218,0,5759
16837,2020,Guinea,Central African Rep.,6,0,0,6
16838,2020,Cote d'Ivoire,Central African Rep.,6,0,0,6
16839,2020,Liberia,Central African Rep.,5,0,0,5
16840,2020,Rwanda,Central African Rep.,212,0,0,212
16841,2020,Sudan,Central African Rep.,387,12,0,399
16842,2020,South Sudan,Central African Rep.,1802,5,0,1807
16843,2020,Türkiye,Central African Rep.,5,0,0,5
16844,2020,Uganda,Central African Rep.,7,0,0,7
16845,2020,Cuba,Cayman Islands,38,28,0,66
16846,2020,Venezuela (Bolivarian Republic of),Cayman Islands,0,0,0,0
16847,2020,Burundi,Chad,5,0,0,5
16848,2020,Central African Rep.,Chad,96883,2366,0,99249
16849,2020,Chad,Chad,0,0,336124,0
16850,2020,Cameroon,Chad,6,16,0,22
16851,2020,Congo,Chad,11,0,0,11
16852,2020,Dem. Rep. of the Congo,Chad,243,25,0,268
16853,2020,Eritrea,Chad,6,15,0,21
16854,2020,Ethiopia,Chad,19,11,0,30
16855,2020,Cote d'Ivoire,Chad,5,0,0,5
16856,2020,Iran (Islamic Rep. of),Chad,5,0,0,5
16857,2020,Libya,Chad,24,20,0,44
16858,2020,Mali,Chad,7,0,0,7
16859,2020,Niger,Chad,707,0,0,707
16860,2020,Nigeria,Chad,16126,332,0,16458
16861,2020,Rwanda,Chad,14,0,0,14
16862,2020,Somalia,Chad,7,0,0,7
16863,2020,Sudan,Chad,364535,1769,0,366304
16864,2020,South Sudan,Chad,9,0,0,9
16865,2020,Syrian Arab Rep.,Chad,32,6,0,38
16866,2020,Yemen,Chad,5,8,0,13
16867,2020,Afghanistan,China,20,12,0,32
16868,2020,Burundi,China,7,0,0,7
16869,2020,Cameroon,China,5,377,0,382
16870,2020,Dem. Rep. of the Congo,China,10,20,0,30
16871,2020,Eritrea,China,9,0,0,9
16872,2020,Palestinian,China,13,9,0,22
16873,2020,Ghana,China,0,11,0,11
16874,2020,Cote d'Ivoire,China,0,8,0,8
16875,2020,Iran (Islamic Rep. of),China,5,0,0,5
16876,2020,Iraq,China,17,0,0,17
16877,2020,Kenya,China,0,29,0,29
16878,2020,Liberia,China,0,6,0,6
16879,2020,Morocco,China,0,5,0,5
16880,2020,Nigeria,China,0,17,0,17
16881,2020,Pakistan,China,32,9,0,41
16882,2020,Rwanda,China,0,9,0,9
16883,2020,Sierra Leone,China,0,7,0,7
16884,2020,Somalia,China,120,5,0,125
16885,2020,Viet Nam,China,303095,0,0,303095
16886,2020,Syrian Arab Rep.,China,41,13,0,54
16887,2020,Uganda,China,5,98,0,103
16888,2020,Yemen,China,21,13,0,34
16889,2020,Zambia,China,0,5,0,5
16890,2020,Zimbabwe,China,5,90,0,95
16891,2020,Afghanistan,Chile,13,13,0,26
16892,2020,Angola,Chile,0,5,0,5
16893,2020,Bangladesh,Chile,0,7,0,7
16894,2020,Bolivia (Plurinational State of),Chile,0,21,0,21
16895,2020,Congo,Chile,8,5,0,13
16896,2020,Dem. Rep. of the Congo,Chile,5,0,0,5
16897,2020,Colombia,Chile,1231,3332,0,4563
16898,2020,Costa Rica,Chile,5,0,0,5
16899,2020,Cuba,Chile,19,1597,0,1616
16900,2020,Dominican Rep.,Chile,0,116,0,116
16901,2020,Ecuador,Chile,23,29,0,52
16902,2020,Palestinian,Chile,15,7,0,22
16903,2020,Ghana,Chile,0,8,0,8
16904,2020,Guatemala,Chile,0,5,0,5
16905,2020,Haiti,Chile,0,26,0,26
16906,2020,Honduras,Chile,5,0,0,5
16907,2020,Iraq,Chile,0,14,0,14
16908,2020,Kenya,Chile,5,0,0,5
16909,2020,Rep. of Korea,Chile,0,5,0,5
16910,2020,Sri Lanka,Chile,5,0,0,5
16911,2020,Nicaragua,Chile,0,5,0,5
16912,2020,Pakistan,Chile,0,7,0,7
16913,2020,Peru,Chile,113,15,0,128
16914,2020,Russian Federation,Chile,5,7,0,12
16915,2020,El Salvador,Chile,9,27,0,36
16916,2020,Senegal,Chile,5,0,0,5
16917,2020,Sierra Leone,Chile,0,5,0,5
16918,2020,Syrian Arab Rep.,Chile,113,32,0,145
16919,2020,Türkiye,Chile,27,5,0,32
16920,2020,United States of America,Chile,0,5,0,5
16921,2020,Venezuela (Bolivarian Republic of),Chile,14,2763,0,2777
16922,2020,Unknown ,Chile,433,8,0,441
16923,2020,Angola,Cameroon,5,0,0,5
16924,2020,Burundi,Cameroon,70,20,0,90
16925,2020,Burkina Faso,Cameroon,0,40,0,40
16926,2020,Central African Rep.,Cameroon,316128,4541,0,320669
16927,2020,Chad,Cameroon,1600,375,0,1975
16928,2020,Cameroon,Cameroon,0,0,1032942,0
16929,2020,Congo,Cameroon,53,5,0,58
16930,2020,Dem. Rep. of the Congo,Cameroon,525,140,0,665
16931,2020,Ethiopia,Cameroon,0,5,0,5
16932,2020,Gambia,Cameroon,0,5,0,5
16933,2020,Guinea-Bissau,Cameroon,0,11,0,11
16934,2020,Guinea,Cameroon,14,278,0,292
16935,2020,Cote d'Ivoire,Cameroon,73,99,0,172
16936,2020,Iran (Islamic Rep. of),Cameroon,5,0,0,5
16937,2020,Liberia,Cameroon,9,5,0,14
16938,2020,Mauritania,Cameroon,5,5,0,10
16939,2020,Mali,Cameroon,21,255,0,276
16940,2020,Morocco,Cameroon,7,0,0,7
16941,2020,Niger,Cameroon,0,743,0,743
16942,2020,Nigeria,Cameroon,117422,41,0,117463
16943,2020,Rwanda,Cameroon,298,124,0,422
16944,2020,Senegal,Cameroon,0,27,0,27
16945,2020,Sierra Leone,Cameroon,0,10,0,10
16946,2020,Sudan,Cameroon,102,33,0,135
16947,2020,South Sudan,Cameroon,13,0,0,13
16948,2020,Syrian Arab Rep.,Cameroon,24,5,0,29
16949,2020,Togo,Cameroon,17,17,0,34
16950,2020,Türkiye,Cameroon,0,25,0,25
16951,2020,Yemen,Cameroon,5,0,0,5
16952,2020,Angola,Congo,13,46,0,59
16953,2020,Egypt,Congo,0,0,0,0
16954,2020,Burundi,Congo,71,8,0,79
16955,2020,Central African Rep.,Congo,16378,2907,0,19285
16956,2020,Chad,Congo,26,18,0,44
16957,2020,Cameroon,Congo,5,20,0,25
16958,2020,Congo,Congo,0,0,134430,0
16959,2020,Dem. Rep. of the Congo,Congo,9752,10035,0,19787
16960,2020,Guinea,Congo,0,5,0,5
16961,2020,Cote d'Ivoire,Congo,5,5,0,10
16962,2020,Liberia,Congo,0,5,0,5
16963,2020,Mauritania,Congo,5,45,0,50
16964,2020,Mali,Congo,5,0,0,5
16965,2020,Nigeria,Congo,5,0,0,5
16966,2020,Rwanda,Congo,796,477,0,1273
16967,2020,Sudan,Congo,31,38,0,69
16968,2020,Syrian Arab Rep.,Congo,5,13,0,18
16969,2020,Angola,Dem. Rep. of the Congo,414,25,0,439
16970,2020,Burundi,Dem. Rep. of the Congo,46829,536,0,47365
16971,2020,Central African Rep.,Dem. Rep. of the Congo,173731,590,0,174321
16972,2020,Chad,Dem. Rep. of the Congo,5,15,0,20
16973,2020,Cameroon,Dem. Rep. of the Congo,0,19,0,19
16974,2020,Congo,Dem. Rep. of the Congo,637,25,0,662
16975,2020,Dem. Rep. of the Congo,Dem. Rep. of the Congo,0,0,5198131,0
16976,2020,Eritrea,Dem. Rep. of the Congo,6,0,0,6
16977,2020,Ethiopia,Dem. Rep. of the Congo,0,5,0,5
16978,2020,Palestinian,Dem. Rep. of the Congo,0,6,0,6
16979,2020,Cote d'Ivoire,Dem. Rep. of the Congo,7,9,0,16
16980,2020,Kenya,Dem. Rep. of the Congo,0,5,0,5
16981,2020,Liberia,Dem. Rep. of the Congo,5,10,0,15
16982,2020,Lebanon,Dem. Rep. of the Congo,0,5,0,5
16983,2020,Mali,Dem. Rep. of the Congo,0,11,0,11
16984,2020,Niger,Dem. Rep. of the Congo,0,5,0,5
16985,2020,Romania,Dem. Rep. of the Congo,0,5,0,5
16986,2020,Rwanda,Dem. Rep. of the Congo,213777,133,0,213910
16987,2020,Somalia,Dem. Rep. of the Congo,14,55,0,69
16988,2020,Sudan,Dem. Rep. of the Congo,32,8,0,40
16989,2020,South Sudan,Dem. Rep. of the Congo,54755,0,0,54755
16990,2020,Syrian Arab Rep.,Dem. Rep. of the Congo,8,13,0,21
16991,2020,Uganda,Dem. Rep. of the Congo,23,0,0,23
16992,2020,Afghanistan,Colombia,9,0,0,9
16993,2020,Bolivia (Plurinational State of),Colombia,5,0,0,5
16994,2020,Cameroon,Colombia,0,6,0,6
16995,2020,Colombia,Colombia,0,0,8252788,0
16996,2020,Cuba,Colombia,77,137,0,214
16997,2020,Ecuador,Colombia,7,5,0,12
16998,2020,Eritrea,Colombia,5,0,0,5
16999,2020,Ethiopia,Colombia,7,0,0,7
17000,2020,Palestinian,Colombia,0,5,0,5
17001,2020,Ghana,Colombia,0,5,0,5
17002,2020,Honduras,Colombia,5,0,0,5
17003,2020,Hungary,Colombia,5,0,0,5
17004,2020,Iraq,Colombia,7,5,0,12
17005,2020,Nicaragua,Colombia,9,0,0,9
17006,2020,Nigeria,Colombia,0,5,0,5
17007,2020,El Salvador,Colombia,11,0,0,11
17008,2020,Serbia and Kosovo: S/RES/1244 (1999),Colombia,5,0,0,5
17009,2020,Sierra Leone,Colombia,5,0,0,5
17010,2020,Somalia,Colombia,11,0,0,11
17011,2020,Syrian Arab Rep.,Colombia,8,8,0,16
17012,2020,Türkiye,Colombia,5,34,0,39
17013,2020,Venezuela (Bolivarian Republic of),Colombia,771,19587,0,20358
17014,2020,Yemen,Colombia,0,7,0,7
17015,2020,Stateless,Colombia,0,0,0,0
17016,2020,Unknown ,Colombia,5,129,0,134
17017,2020,Angola,Costa Rica,0,52,0,52
17018,2020,Argentina,Costa Rica,0,8,0,8
17019,2020,Burundi,Costa Rica,9,0,0,9
17020,2020,Bangladesh,Costa Rica,0,16,0,16
17021,2020,Burkina Faso,Costa Rica,0,5,0,5
17022,2020,Bolivia (Plurinational State of),Costa Rica,0,5,0,5
17023,2020,Brazil,Costa Rica,0,13,0,13
17024,2020,China,Costa Rica,0,205,0,205
17025,2020,Chile,Costa Rica,0,16,0,16
17026,2020,Cameroon,Costa Rica,0,22,0,22
17027,2020,Congo,Costa Rica,0,57,0,57
17028,2020,Dem. Rep. of the Congo,Costa Rica,12,42,0,54
17029,2020,Colombia,Costa Rica,2322,1042,0,3364
17030,2020,Cuba,Costa Rica,417,3206,0,3623
17031,2020,Dominican Rep.,Costa Rica,0,71,0,71
17032,2020,Ecuador,Costa Rica,0,16,0,16
17033,2020,Eritrea,Costa Rica,0,7,0,7
17034,2020,Ethiopia,Costa Rica,5,0,0,5
17035,2020,Gambia,Costa Rica,0,5,0,5
17036,2020,Germany,Costa Rica,0,5,0,5
17037,2020,Ghana,Costa Rica,0,57,0,57
17038,2020,Guatemala,Costa Rica,25,36,0,61
17039,2020,Haiti,Costa Rica,12,128,0,140
17040,2020,Honduras,Costa Rica,205,702,0,907
17041,2020,Cote d'Ivoire,Costa Rica,0,5,0,5
17042,2020,India,Costa Rica,0,5,0,5
17043,2020,Indonesia,Costa Rica,5,0,0,5
17044,2020,Iran (Islamic Rep. of),Costa Rica,5,0,0,5
17045,2020,Iraq,Costa Rica,5,0,0,5
17046,2020,Israel,Costa Rica,0,5,0,5
17047,2020,Italy,Costa Rica,0,5,0,5
17048,2020,Jamaica,Costa Rica,0,13,0,13
17049,2020,Lebanon,Costa Rica,0,5,0,5
17050,2020,Mexico,Costa Rica,13,11,0,24
17051,2020,Nepal,Costa Rica,0,102,0,102
17052,2020,Niger,Costa Rica,0,5,0,5
17053,2020,Nicaragua,Costa Rica,3811,38700,0,42511
17054,2020,Nigeria,Costa Rica,17,0,0,17
17055,2020,Pakistan,Costa Rica,5,11,0,16
17056,2020,Panama,Costa Rica,5,17,0,22
17057,2020,Peru,Costa Rica,13,7,0,20
17058,2020,Russian Federation,Costa Rica,27,0,0,27
17059,2020,El Salvador,Costa Rica,1384,141,0,1525
17060,2020,Senegal,Costa Rica,0,5,0,5
17061,2020,Somalia,Costa Rica,7,7,0,14
17062,2020,Spain,Costa Rica,0,6,0,6
17063,2020,Syrian Arab Rep.,Costa Rica,5,21,0,26
17064,2020,Ukraine,Costa Rica,13,0,0,13
17065,2020,United States of America,Costa Rica,5,30,0,35
17066,2020,Venezuela (Bolivarian Republic of),Costa Rica,1266,5422,0,6688
17067,2020,Zimbabwe,Costa Rica,0,5,0,5
17068,2020,Stateless,Costa Rica,0,0,0,0
17069,2020,Unknown ,Costa Rica,0,39500,0,39500
17070,2020,Afghanistan,Cuba,28,0,0,28
17071,2020,Eritrea,Cuba,12,0,0,12
17072,2020,Ethiopia,Cuba,6,0,0,6
17073,2020,Haiti,Cuba,5,0,0,5
17074,2020,Iran (Islamic Rep. of),Cuba,11,5,0,16
17075,2020,Sudan,Cuba,10,0,0,10
17076,2020,Syrian Arab Rep.,Cuba,40,5,0,45
17077,2020,Western Sahara,Cuba,95,0,0,95
17078,2020,Yemen,Cuba,15,0,0,15
17079,2020,Stateless,Cabo Verde,0,0,0,0
17080,2020,Afghanistan,Cyprus,16,17,0,33
17081,2020,Albania,Cyprus,0,5,0,5
17082,2020,Algeria,Cyprus,8,7,0,15
17083,2020,Egypt,Cyprus,119,842,0,961
17084,2020,Armenia,Cyprus,26,18,0,44
17085,2020,Burundi,Cyprus,0,5,0,5
17086,2020,Bangladesh,Cyprus,5,1594,0,1599
17087,2020,Burkina Faso,Cyprus,0,5,0,5
17088,2020,Belarus,Cyprus,0,5,0,5
17089,2020,Bosnia and Herzegovina,Cyprus,15,0,0,15
17090,2020,China,Cyprus,5,9,0,14
17091,2020,Cameroon,Cyprus,83,2350,0,2433
17092,2020,Congo,Cyprus,10,88,0,98
17093,2020,Dem. Rep. of the Congo,Cyprus,25,771,0,796
17094,2020,Comoros,Cyprus,0,7,0,7
17095,2020,Eritrea,Cyprus,53,5,0,58
17096,2020,Ethiopia,Cyprus,10,14,0,24
17097,2020,Gambia,Cyprus,6,56,0,62
17098,2020,Palestinian,Cyprus,2105,247,0,2352
17099,2020,Georgia,Cyprus,85,957,0,1042
17100,2020,Ghana,Cyprus,0,29,0,29
17101,2020,Guinea,Cyprus,5,222,0,227
17102,2020,Haiti,Cyprus,0,12,0,12
17103,2020,Cote d'Ivoire,Cyprus,5,70,0,75
17104,2020,India,Cyprus,9,2089,0,2098
17105,2020,Iran (Islamic Rep. of),Cyprus,584,581,0,1165
17106,2020,Iraq,Cyprus,962,228,0,1190
17107,2020,Jordan,Cyprus,40,94,0,134
17108,2020,Kazakhstan,Cyprus,5,0,0,5
17109,2020,Kenya,Cyprus,0,5,0,5
17110,2020,Kyrgyzstan,Cyprus,5,5,0,10
17111,2020,Liberia,Cyprus,0,5,0,5
17112,2020,Libya,Cyprus,12,5,0,17
17113,2020,Lebanon,Cyprus,52,106,0,158
17114,2020,Sri Lanka,Cyprus,27,561,0,588
17115,2020,Rep. of Moldova,Cyprus,18,10,0,28
17116,2020,Mali,Cyprus,0,11,0,11
17117,2020,Morocco,Cyprus,0,6,0,6
17118,2020,Nepal,Cyprus,0,582,0,582
17119,2020,Nigeria,Cyprus,14,815,0,829
17120,2020,Pakistan,Cyprus,18,916,0,934
17121,2020,Philippines,Cyprus,12,179,0,191
17122,2020,Russian Federation,Cyprus,77,76,0,153
17123,2020,Rwanda,Cyprus,5,6,0,11
17124,2020,Serbia and Kosovo: S/RES/1244 (1999),Cyprus,59,9,0,68
17125,2020,Senegal,Cyprus,0,26,0,26
17126,2020,Sierra Leone,Cyprus,24,157,0,181
17127,2020,Somalia,Cyprus,320,312,0,632
17128,2020,Viet Nam,Cyprus,5,640,0,645
17129,2020,Sudan,Cyprus,13,5,0,18
17130,2020,Syrian Arab Rep.,Cyprus,8797,4415,0,13212
17131,2020,Turkmenistan,Cyprus,0,5,0,5
17132,2020,Togo,Cyprus,0,12,0,12
17133,2020,Türkiye,Cyprus,240,224,0,464
17134,2020,Ukraine,Cyprus,30,139,0,169
17135,2020,Uzbekistan,Cyprus,5,13,0,18
17136,2020,Yemen,Cyprus,27,20,0,47
17137,2020,Zimbabwe,Cyprus,0,24,0,24
17138,2020,Stateless,Cyprus,56,0,0,56
17139,2020,Unknown ,Cyprus,0,867,0,867
17140,2020,Afghanistan,Czechia,39,5,0,44
17141,2020,Algeria,Czechia,0,5,0,5
17142,2020,Egypt,Czechia,8,6,0,14
17143,2020,Armenia,Czechia,28,22,0,50
17144,2020,Azerbaijan,Czechia,21,23,0,44
17145,2020,Burundi,Czechia,5,0,0,5
17146,2020,Belarus,Czechia,134,63,0,197
17147,2020,Bosnia and Herzegovina,Czechia,5,0,0,5
17148,2020,China,Czechia,22,54,0,76
17149,2020,Cameroon,Czechia,0,5,0,5
17150,2020,Dem. Rep. of the Congo,Czechia,6,5,0,11
17151,2020,Cuba,Czechia,43,16,0,59
17152,2020,Eritrea,Czechia,11,0,0,11
17153,2020,Ethiopia,Czechia,5,0,0,5
17154,2020,Georgia,Czechia,14,23,0,37
17155,2020,Guinea,Czechia,5,0,0,5
17156,2020,Iran (Islamic Rep. of),Czechia,5,6,0,11
17157,2020,Iraq,Czechia,109,5,0,114
17158,2020,Kazakhstan,Czechia,109,23,0,132
17159,2020,Kyrgyzstan,Czechia,21,11,0,32
17160,2020,Libya,Czechia,20,7,0,27
17161,2020,Lebanon,Czechia,5,0,0,5
17162,2020,Sri Lanka,Czechia,6,0,0,6
17163,2020,Rep. of Moldova,Czechia,18,14,0,32
17164,2020,Mongolia,Czechia,6,10,0,16
17165,2020,Morocco,Czechia,5,0,0,5
17166,2020,Myanmar,Czechia,145,0,0,145
17167,2020,Nigeria,Czechia,8,10,0,18
17168,2020,Pakistan,Czechia,14,5,0,19
17169,2020,Russian Federation,Czechia,177,23,0,200
17170,2020,Saudi Arabia,Czechia,6,0,0,6
17171,2020,Serbia and Kosovo: S/RES/1244 (1999),Czechia,7,0,0,7
17172,2020,Sierra Leone,Czechia,5,0,0,5
17173,2020,Somalia,Czechia,14,0,0,14
17174,2020,Viet Nam,Czechia,15,23,0,38
17175,2020,Sudan,Czechia,9,0,0,9
17176,2020,Syrian Arab Rep.,Czechia,386,12,0,398
17177,2020,Turkmenistan,Czechia,8,0,0,8
17178,2020,Togo,Czechia,5,0,0,5
17179,2020,Tunisia,Czechia,0,7,0,7
17180,2020,Türkiye,Czechia,11,22,0,33
17181,2020,Uganda,Czechia,5,0,0,5
17182,2020,Ukraine,Czechia,284,121,0,405
17183,2020,Uzbekistan,Czechia,53,37,0,90
17184,2020,Venezuela (Bolivarian Republic of),Czechia,5,13,0,18
17185,2020,Yemen,Czechia,24,5,0,29
17186,2020,Stateless,Czechia,88,8,0,96
17187,2020,Unknown ,Czechia,0,948,0,948
17188,2020,Afghanistan,Denmark,2134,82,0,2216
17189,2020,Albania,Denmark,0,5,0,5
17190,2020,Algeria,Denmark,0,16,0,16
17191,2020,Egypt,Denmark,16,10,0,26
17192,2020,Armenia,Denmark,80,12,0,92
17193,2020,Azerbaijan,Denmark,32,0,0,32
17194,2020,Burundi,Denmark,5,0,0,5
17195,2020,Bangladesh,Denmark,18,6,0,24
17196,2020,Belarus,Denmark,5,11,0,16
17197,2020,Bosnia and Herzegovina,Denmark,5,0,0,5
17198,2020,China,Denmark,17,5,0,22
17199,2020,Cameroon,Denmark,7,10,0,17
17200,2020,Congo,Denmark,5,0,0,5
17201,2020,Dem. Rep. of the Congo,Denmark,71,7,0,78
17202,2020,Colombia,Denmark,5,17,0,22
17203,2020,Eritrea,Denmark,5399,203,0,5602
17204,2020,Ethiopia,Denmark,95,10,0,105
17205,2020,Gambia,Denmark,5,5,0,10
17206,2020,Palestinian,Denmark,9,0,0,9
17207,2020,Georgia,Denmark,0,30,0,30
17208,2020,Ghana,Denmark,5,5,0,10
17209,2020,Guinea-Bissau,Denmark,5,0,0,5
17210,2020,Cote d'Ivoire,Denmark,14,0,0,14
17211,2020,India,Denmark,5,11,0,16
17212,2020,Iran (Islamic Rep. of),Denmark,3051,127,0,3178
17213,2020,Iraq,Denmark,289,49,0,338
17214,2020,Jordan,Denmark,0,5,0,5
17215,2020,Kenya,Denmark,5,0,0,5
17216,2020,Kyrgyzstan,Denmark,5,0,0,5
17217,2020,Dem. People's Rep. of Korea,Denmark,6,0,0,6
17218,2020,Libya,Denmark,5,6,0,11
17219,2020,Lebanon,Denmark,30,6,0,36
17220,2020,Sri Lanka,Denmark,44,6,0,50
17221,2020,North Macedonia,Denmark,0,9,0,9
17222,2020,Mongolia,Denmark,0,5,0,5
17223,2020,Morocco,Denmark,9,50,0,59
17224,2020,Myanmar,Denmark,21,0,0,21
17225,2020,Nepal,Denmark,5,0,0,5
17226,2020,Nicaragua,Denmark,9,0,0,9
17227,2020,Nigeria,Denmark,10,7,0,17
17228,2020,Pakistan,Denmark,65,31,0,96
17229,2020,Russian Federation,Denmark,748,30,0,778
17230,2020,Rwanda,Denmark,14,6,0,20
17231,2020,El Salvador,Denmark,5,0,0,5
17232,2020,Serbia and Kosovo: S/RES/1244 (1999),Denmark,0,5,0,5
17233,2020,Somalia,Denmark,1321,80,0,1401
17234,2020,Sudan,Denmark,63,5,0,68
17235,2020,Syrian Arab Rep.,Denmark,19878,281,0,20159
17236,2020,United Rep. of Tanzania,Denmark,5,0,0,5
17237,2020,Thailand,Denmark,5,0,0,5
17238,2020,Tajikistan,Denmark,6,0,0,6
17239,2020,Tunisia,Denmark,0,5,0,5
17240,2020,Türkiye,Denmark,15,27,0,42
17241,2020,Uganda,Denmark,74,9,0,83
17242,2020,Ukraine,Denmark,29,28,0,57
17243,2020,Uzbekistan,Denmark,9,5,0,14
17244,2020,Venezuela (Bolivarian Republic of),Denmark,5,11,0,16
17245,2020,Yemen,Denmark,7,0,0,7
17246,2020,Zambia,Denmark,5,0,0,5
17247,2020,Zimbabwe,Denmark,8,0,0,8
17248,2020,Stateless,Denmark,2955,93,0,3048
17249,2020,Dem. Rep. of the Congo,Djibouti,5,9,0,14
17250,2020,Djibouti,Djibouti,0,0,0,0
17251,2020,Eritrea,Djibouti,515,438,0,953
17252,2020,Ethiopia,Djibouti,1413,10225,0,11638
17253,2020,Iraq,Djibouti,19,0,0,19
17254,2020,Mali,Djibouti,0,5,0,5
17255,2020,Somalia,Djibouti,13558,129,0,13687
17256,2020,Sudan,Djibouti,7,5,0,12
17257,2020,Syrian Arab Rep.,Djibouti,10,0,0,10
17258,2020,Yemen,Djibouti,5666,0,0,5666
17259,2020,Afghanistan,Dominican Rep.,0,8,0,8
17260,2020,Colombia,Dominican Rep.,0,5,0,5
17261,2020,Cuba,Dominican Rep.,0,49,0,49
17262,2020,Haiti,Dominican Rep.,162,273,0,435
17263,2020,Honduras,Dominican Rep.,0,5,0,5
17264,2020,Sri Lanka,Dominican Rep.,0,5,0,5
17265,2020,Nicaragua,Dominican Rep.,0,5,0,5
17266,2020,Venezuela (Bolivarian Republic of),Dominican Rep.,0,275,0,275
17267,2020,Afghanistan,Ecuador,146,5,0,151
17268,2020,Albania,Ecuador,6,0,0,6
17269,2020,Angola,Ecuador,5,18,0,23
17270,2020,Egypt,Ecuador,0,8,0,8
17271,2020,Argentina,Ecuador,0,6,0,6
17272,2020,Bangladesh,Ecuador,5,14,0,19
17273,2020,Brazil,Ecuador,5,15,0,20
17274,2020,China,Ecuador,12,5,0,17
17275,2020,Chile,Ecuador,6,5,0,11
17276,2020,Cameroon,Ecuador,19,26,0,45
17277,2020,Congo,Ecuador,5,5,0,10
17278,2020,Dem. Rep. of the Congo,Ecuador,8,13,0,21
17279,2020,Colombia,Ecuador,102931,11401,0,114332
17280,2020,Cuba,Ecuador,214,330,0,544
17281,2020,Dominican Rep.,Ecuador,5,43,0,48
17282,2020,Eritrea,Ecuador,11,5,0,16
17283,2020,Ethiopia,Ecuador,5,0,0,5
17284,2020,Gambia,Ecuador,0,5,0,5
17285,2020,Palestinian,Ecuador,9,9,0,18
17286,2020,Ghana,Ecuador,5,5,0,10
17287,2020,Guinea,Ecuador,9,5,0,14
17288,2020,Haiti,Ecuador,21,36,0,57
17289,2020,Honduras,Ecuador,0,5,0,5
17290,2020,Cote d'Ivoire,Ecuador,0,5,0,5
17291,2020,India,Ecuador,5,23,0,28
17292,2020,Iran (Islamic Rep. of),Ecuador,62,20,0,82
17293,2020,Iraq,Ecuador,56,18,0,74
17294,2020,Jordan,Ecuador,0,5,0,5
17295,2020,Liberia,Ecuador,6,0,0,6
17296,2020,Lebanon,Ecuador,19,14,0,33
17297,2020,Sri Lanka,Ecuador,18,14,0,32
17298,2020,Mali,Ecuador,5,5,0,10
17299,2020,Morocco,Ecuador,5,0,0,5
17300,2020,Nepal,Ecuador,5,5,0,10
17301,2020,Nicaragua,Ecuador,5,0,0,5
17302,2020,Nigeria,Ecuador,37,6,0,43
17303,2020,Pakistan,Ecuador,29,10,0,39
17304,2020,Peru,Ecuador,82,116,0,198
17305,2020,Romania,Ecuador,0,5,0,5
17306,2020,South Africa,Ecuador,0,7,0,7
17307,2020,Russian Federation,Ecuador,34,8,0,42
17308,2020,Rwanda,Ecuador,5,0,0,5
17309,2020,El Salvador,Ecuador,23,8,0,31
17310,2020,Saudi Arabia,Ecuador,8,0,0,8
17311,2020,Somalia,Ecuador,8,0,0,8
17312,2020,Spain,Ecuador,5,0,0,5
17313,2020,Viet Nam,Ecuador,5,0,0,5
17314,2020,Sudan,Ecuador,5,8,0,13
17315,2020,Syrian Arab Rep.,Ecuador,142,29,0,171
17316,2020,Türkiye,Ecuador,5,0,0,5
17317,2020,United Arab Emirates,Ecuador,0,5,0,5
17318,2020,Ukraine,Ecuador,15,5,0,20
17319,2020,United States of America,Ecuador,8,6,0,14
17320,2020,Uzbekistan,Ecuador,5,0,0,5
17321,2020,Venezuela (Bolivarian Republic of),Ecuador,410,13648,0,14058
17322,2020,Western Sahara,Ecuador,5,0,0,5
17323,2020,Yemen,Ecuador,102,53,0,155
17324,2020,Zimbabwe,Ecuador,5,9,0,14
17325,2020,Unknown ,Ecuador,31,5,0,36
17326,2020,Eritrea,Eritrea,0,0,0,0
17327,2020,Ethiopia,Eritrea,15,0,0,15
17328,2020,Somalia,Eritrea,80,0,0,80
17329,2020,Sudan,Eritrea,99,0,0,99
17330,2020,South Sudan,Eritrea,7,0,0,7
17331,2020,Egypt,Estonia,5,0,0,5
17332,2020,Azerbaijan,Estonia,5,0,0,5
17333,2020,Eritrea,Estonia,8,0,0,8
17334,2020,Georgia,Estonia,5,0,0,5
17335,2020,Iran (Islamic Rep. of),Estonia,5,0,0,5
17336,2020,Iraq,Estonia,22,0,0,22
17337,2020,Pakistan,Estonia,5,0,0,5
17338,2020,Russian Federation,Estonia,40,5,0,45
17339,2020,Serbia and Kosovo: S/RES/1244 (1999),Estonia,6,0,0,6
17340,2020,Sudan,Estonia,14,0,0,14
17341,2020,Syrian Arab Rep.,Estonia,105,0,0,105
17342,2020,Türkiye,Estonia,23,0,0,23
17343,2020,Ukraine,Estonia,29,0,0,29
17344,2020,Yemen,Estonia,5,0,0,5
17345,2020,Stateless,Estonia,0,0,0,0
17346,2020,Egypt,Ethiopia,5,0,0,5
17347,2020,Burundi,Ethiopia,59,72,0,131
17348,2020,Cameroon,Ethiopia,0,5,0,5
17349,2020,Dem. Rep. of the Congo,Ethiopia,738,282,0,1020
17350,2020,Cuba,Ethiopia,5,0,0,5
17351,2020,Djibouti,Ethiopia,49,0,0,49
17352,2020,Eritrea,Ethiopia,181091,180,0,181271
17353,2020,Ethiopia,Ethiopia,0,0,2733628,0
17354,2020,Palestinian,Ethiopia,0,5,0,5
17355,2020,Cote d'Ivoire,Ethiopia,5,0,0,5
17356,2020,Iraq,Ethiopia,10,0,0,10
17357,2020,Jordan,Ethiopia,0,10,0,10
17358,2020,Kenya,Ethiopia,4022,0,0,4022
17359,2020,Nigeria,Ethiopia,0,5,0,5
17360,2020,Rwanda,Ethiopia,13,7,0,20
17361,2020,Somalia,Ethiopia,203803,46,0,203849
17362,2020,Sudan,Ethiopia,43566,532,0,44098
17363,2020,South Sudan,Ethiopia,365030,206,0,365236
17364,2020,Syrian Arab Rep.,Ethiopia,6,424,0,430
17365,2020,Uganda,Ethiopia,7,5,0,12
17366,2020,Yemen,Ethiopia,2045,122,0,2167
17367,2020,Afghanistan,Fiji,8,0,0,8
17368,2020,Bangladesh,Fiji,0,5,0,5
17369,2020,Pakistan,Fiji,6,0,0,6
17370,2020,Afghanistan,Finland,3331,928,0,4259
17371,2020,Albania,Finland,5,7,0,12
17372,2020,Algeria,Finland,10,5,0,15
17373,2020,Angola,Finland,91,5,0,96
17374,2020,Egypt,Finland,26,28,0,54
17375,2020,Azerbaijan,Finland,60,15,0,75
17376,2020,Burundi,Finland,5,5,0,10
17377,2020,Bangladesh,Finland,29,24,0,53
17378,2020,Burkina Faso,Finland,5,0,0,5
17379,2020,Belarus,Finland,14,6,0,20
17380,2020,Brazil,Finland,5,0,0,5
17381,2020,Cambodia,Finland,5,0,0,5
17382,2020,Central African Rep.,Finland,6,0,0,6
17383,2020,China,Finland,186,16,0,202
17384,2020,Cameroon,Finland,117,67,0,184
17385,2020,Congo,Finland,7,5,0,12
17386,2020,Dem. Rep. of the Congo,Finland,110,39,0,149
17387,2020,Colombia,Finland,0,26,0,26
17388,2020,Cuba,Finland,5,22,0,27
17389,2020,Dominican Rep.,Finland,5,0,0,5
17390,2020,Eritrea,Finland,856,19,0,875
17391,2020,Ethiopia,Finland,146,38,0,184
17392,2020,Gambia,Finland,31,29,0,60
17393,2020,Georgia,Finland,5,11,0,16
17394,2020,Ghana,Finland,47,32,0,79
17395,2020,Guatemala,Finland,5,0,0,5
17396,2020,Guinea,Finland,24,7,0,31
17397,2020,Honduras,Finland,28,6,0,34
17398,2020,Cote d'Ivoire,Finland,9,6,0,15
17399,2020,India,Finland,5,16,0,21
17400,2020,Indonesia,Finland,5,0,0,5
17401,2020,Iran (Islamic Rep. of),Finland,942,265,0,1207
17402,2020,Iraq,Finland,8938,2633,0,11571
17403,2020,Jordan,Finland,5,0,0,5
17404,2020,Kazakhstan,Finland,14,6,0,20
17405,2020,Kenya,Finland,18,12,0,30
17406,2020,Kyrgyzstan,Finland,19,0,0,19
17407,2020,Rep. of Korea,Finland,0,5,0,5
17408,2020,Liberia,Finland,5,0,0,5
17409,2020,Libya,Finland,32,5,0,37
17410,2020,Lebanon,Finland,13,5,0,18
17411,2020,Sri Lanka,Finland,38,23,0,61
17412,2020,Rep. of Moldova,Finland,6,0,0,6
17413,2020,Mexico,Finland,0,8,0,8
17414,2020,Mali,Finland,6,0,0,6
17415,2020,Malaysia,Finland,0,5,0,5
17416,2020,Morocco,Finland,43,21,0,64
17417,2020,Myanmar,Finland,33,6,0,39
17418,2020,Nepal,Finland,0,5,0,5
17419,2020,Nicaragua,Finland,53,22,0,75
17420,2020,Nigeria,Finland,148,114,0,262
17421,2020,Pakistan,Finland,75,31,0,106
17422,2020,Philippines,Finland,0,5,0,5
17423,2020,South Africa,Finland,0,5,0,5
17424,2020,Russian Federation,Finland,885,545,0,1430
17425,2020,Rwanda,Finland,35,26,0,61
17426,2020,El Salvador,Finland,10,5,0,15
17427,2020,Serbia and Kosovo: S/RES/1244 (1999),Finland,47,0,0,47
17428,2020,Senegal,Finland,5,5,0,10
17429,2020,Sierra Leone,Finland,6,11,0,17
17430,2020,Somalia,Finland,2509,637,0,3146
17431,2020,Viet Nam,Finland,5,5,0,10
17432,2020,Sudan,Finland,50,11,0,61
17433,2020,South Sudan,Finland,8,0,0,8
17434,2020,Syrian Arab Rep.,Finland,2620,84,0,2704
17435,2020,United Rep. of Tanzania,Finland,5,5,0,10
17436,2020,Tajikistan,Finland,7,5,0,12
17437,2020,Togo,Finland,5,0,0,5
17438,2020,Tunisia,Finland,5,10,0,15
17439,2020,Türkiye,Finland,729,203,0,932
17440,2020,Uganda,Finland,34,5,0,39
17441,2020,Ukraine,Finland,11,43,0,54
17442,2020,United States of America,Finland,0,5,0,5
17443,2020,Uzbekistan,Finland,11,0,0,11
17444,2020,Venezuela (Bolivarian Republic of),Finland,7,9,0,16
17445,2020,Yemen,Finland,297,27,0,324
17446,2020,Zimbabwe,Finland,6,0,0,6
17447,2020,Stateless,Finland,427,28,0,455
17448,2020,Unknown ,Finland,133,109,0,242
17449,2020,Afghanistan,France,31546,13560,0,45106
17450,2020,Albania,France,6229,1721,0,7950
17451,2020,Algeria,France,2134,1200,0,3334
17452,2020,Angola,France,3774,1961,0,5735
17453,2020,Egypt,France,1121,556,0,1677
17454,2020,Argentina,France,5,0,0,5
17455,2020,Armenia,France,4297,978,0,5275
17456,2020,Azerbaijan,France,2956,520,0,3476
17457,2020,Bahrain,France,10,0,0,10
17458,2020,Burundi,France,1286,585,0,1871
17459,2020,Benin,France,108,310,0,418
17460,2020,Bangladesh,France,6496,8979,0,15475
17461,2020,Bhutan,France,127,0,0,127
17462,2020,Burkina Faso,France,341,405,0,746
17463,2020,Belarus,France,536,146,0,682
17464,2020,Bolivia (Plurinational State of),France,39,6,0,45
17465,2020,Brazil,France,31,13,0,44
17466,2020,Bosnia and Herzegovina,France,4113,571,0,4684
17467,2020,Bulgaria,France,70,0,0,70
17468,2020,Cambodia,France,10894,14,0,10908
17469,2020,Central African Rep.,France,3718,527,0,4245
17470,2020,Chad,France,2114,1457,0,3571
17471,2020,China,France,8343,263,0,8606
17472,2020,Chile,France,67,0,0,67
17473,2020,Cameroon,France,1791,1490,0,3281
17474,2020,Congo,France,3808,1229,0,5037
17475,2020,Dem. Rep. of the Congo,France,18332,4995,0,23327
17476,2020,Comoros,France,722,2095,0,2817
17477,2020,Colombia,France,644,690,0,1334
17478,2020,Costa Rica,France,5,0,0,5
17479,2020,Cuba,France,225,223,0,448
17480,2020,Czechia,France,24,0,0,24
17481,2020,Djibouti,France,358,181,0,539
17482,2020,Dominica,France,5,0,0,5
17483,2020,Dominican Rep.,France,95,85,0,180
17484,2020,Ecuador,France,24,0,0,24
17485,2020,Equatorial Guinea,France,42,0,0,42
17486,2020,Eritrea,France,7318,1669,0,8987
17487,2020,Estonia,France,5,0,0,5
17488,2020,Ethiopia,France,1963,907,0,2870
17489,2020,Gabon,France,305,638,0,943
17490,2020,Gambia,France,365,574,0,939
17491,2020,Palestinian,France,1256,177,0,1433
17492,2020,Georgia,France,3701,1426,0,5127
17493,2020,Germany,France,5,0,0,5
17494,2020,Ghana,France,521,178,0,699
17495,2020,Guinea-Bissau,France,909,187,0,1096
17496,2020,Guatemala,France,19,0,0,19
17497,2020,Guinea,France,13277,7755,0,21032
17498,2020,Guyana,France,19,0,0,19
17499,2020,Haiti,France,4128,1935,0,6063
17500,2020,Honduras,France,30,5,0,35
17501,2020,Croatia,France,56,0,0,56
17502,2020,Hungary,France,54,0,0,54
17503,2020,Cote d'Ivoire,France,7023,6407,0,13430
17504,2020,India,France,242,344,0,586
17505,2020,Indonesia,France,8,0,0,8
17506,2020,Iran (Islamic Rep. of),France,3122,740,0,3862
17507,2020,Iraq,France,9075,1307,0,10382
17508,2020,Israel,France,8,0,0,8
17509,2020,Jamaica,France,20,0,0,20
17510,2020,Jordan,France,33,5,0,38
17511,2020,Kazakhstan,France,633,211,0,844
17512,2020,Kenya,France,141,14,0,155
17513,2020,Kyrgyzstan,France,314,10,0,324
17514,2020,Rep. of Korea,France,0,5,0,5
17515,2020,Kuwait,France,224,310,0,534
17516,2020,Lao People's Dem. Rep.,France,6397,0,0,6397
17517,2020,Liberia,France,252,14,0,266
17518,2020,Libya,France,1298,627,0,1925
17519,2020,Saint Lucia,France,5,0,0,5
17520,2020,Lebanon,France,167,191,0,358
17521,2020,Sri Lanka,France,23764,2398,0,26162
17522,2020,Lithuania,France,6,0,0,6
17523,2020,Latvia,France,32,0,0,32
17524,2020,Madagascar,France,234,271,0,505
17525,2020,Mauritania,France,5891,1773,0,7664
17526,2020,North Macedonia,France,396,198,0,594
17527,2020,Rep. of Moldova,France,325,1214,0,1539
17528,2020,Maldives,France,5,0,0,5
17529,2020,Mexico,France,27,0,0,27
17530,2020,Mali,France,5576,2636,0,8212
17531,2020,Malaysia,France,16,0,0,16
17532,2020,Mongolia,France,503,223,0,726
17533,2020,Morocco,France,920,561,0,1481
17534,2020,Mozambique,France,12,0,0,12
17535,2020,Montenegro,France,97,0,0,97
17536,2020,Mauritius,France,31,0,0,31
17537,2020,Myanmar,France,324,5,0,329
17538,2020,Nepal,France,161,60,0,221
17539,2020,Niger,France,126,181,0,307
17540,2020,Nicaragua,France,33,5,0,38
17541,2020,Nigeria,France,3661,6714,0,10375
17542,2020,Pakistan,France,2017,3458,0,5475
17543,2020,Paraguay,France,6,0,0,6
17544,2020,Peru,France,339,148,0,487
17545,2020,Philippines,France,5,0,0,5
17546,2020,Poland,France,132,0,0,132
17547,2020,Romania,France,143,0,0,143
17548,2020,South Africa,France,62,6,0,68
17549,2020,Russian Federation,France,16775,3358,0,20133
17550,2020,Rwanda,France,3076,498,0,3574
17551,2020,El Salvador,France,75,7,0,82
17552,2020,Saudi Arabia,France,34,5,0,39
17553,2020,Serbia and Kosovo: S/RES/1244 (1999),France,14268,1646,0,15914
17554,2020,Senegal,France,2011,1863,0,3874
17555,2020,Sierra Leone,France,735,439,0,1174
17556,2020,Somalia,France,5774,4879,0,10653
17557,2020,Viet Nam,France,7671,17,0,7688
17558,2020,Sao Tome and Principe,France,5,0,0,5
17559,2020,Sudan,France,20236,1973,0,22209
17560,2020,Suriname,France,5,7,0,12
17561,2020,South Sudan,France,123,10,0,133
17562,2020,Slovakia,France,102,0,0,102
17563,2020,Syrian Arab Rep.,France,21849,2587,0,24436
17564,2020,United Rep. of Tanzania,France,10,8,0,18
17565,2020,Thailand,France,12,0,0,12
17566,2020,Tajikistan,France,62,133,0,195
17567,2020,Turkmenistan,France,24,0,0,24
17568,2020,Togo,France,794,269,0,1063
17569,2020,Tunisia,France,397,294,0,691
17570,2020,Türkiye,France,12459,5087,0,17546
17571,2020,United Arab Emirates,France,5,0,0,5
17572,2020,Uganda,France,172,9,0,181
17573,2020,Ukraine,France,1921,1940,0,3861
17574,2020,United States of America,France,0,5,0,5
17575,2020,Uzbekistan,France,206,5,0,211
17576,2020,Venezuela (Bolivarian Republic of),France,778,748,0,1526
17577,2020,Western Sahara,France,744,406,0,1150
17578,2020,Yemen,France,566,239,0,805
17579,2020,Zimbabwe,France,51,0,0,51
17580,2020,Stateless,France,48,414,0,462
17581,2020,Unknown ,France,100900,1044,0,101944
17582,2020,Burundi,Gabon,7,0,0,7
17583,2020,Central African Rep.,Gabon,19,22,0,41
17584,2020,Chad,Gabon,254,20,0,274
17585,2020,Cameroon,Gabon,5,5,0,10
17586,2020,Congo,Gabon,67,0,0,67
17587,2020,Dem. Rep. of the Congo,Gabon,74,33,0,107
17588,2020,Mauritania,Gabon,7,0,0,7
17589,2020,Sao Tome and Principe,Gabon,23,0,0,23
17590,2020,South Sudan,Gabon,5,0,0,5
17591,2020,Togo,Gabon,6,0,0,6
17592,2020,Central African Rep.,Gambia,7,8,0,15
17593,2020,Congo,Gambia,6,5,0,11
17594,2020,Dem. Rep. of the Congo,Gambia,52,6,0,58
17595,2020,Guinea-Bissau,Gambia,0,6,0,6
17596,2020,Guinea,Gambia,5,5,0,10
17597,2020,Cote d'Ivoire,Gambia,149,7,0,156
17598,2020,Liberia,Gambia,15,0,0,15
17599,2020,Senegal,Gambia,4019,159,0,4178
17600,2020,Sierra Leone,Gambia,107,11,0,118
17601,2020,Togo,Gambia,18,0,0,18
17602,2020,Afghanistan,United Kingdom of Great Britain and Northern Ireland,9351,3227,0,12578
17603,2020,Albania,United Kingdom of Great Britain and Northern Ireland,3687,8491,0,12178
17604,2020,Algeria,United Kingdom of Great Britain and Northern Ireland,336,403,0,739
17605,2020,Angola,United Kingdom of Great Britain and Northern Ireland,154,147,0,301
17606,2020,Antigua and Barbuda,United Kingdom of Great Britain and Northern Ireland,5,16,0,21
17607,2020,Egypt,United Kingdom of Great Britain and Northern Ireland,938,662,0,1600
17608,2020,Argentina,United Kingdom of Great Britain and Northern Ireland,0,21,0,21
17609,2020,Armenia,United Kingdom of Great Britain and Northern Ireland,62,13,0,75
17610,2020,Australia,United Kingdom of Great Britain and Northern Ireland,5,0,0,5
17611,2020,Azerbaijan,United Kingdom of Great Britain and Northern Ireland,140,48,0,188
17612,2020,Bahrain,United Kingdom of Great Britain and Northern Ireland,181,8,0,189
17613,2020,Barbados,United Kingdom of Great Britain and Northern Ireland,14,9,0,23
17614,2020,Burundi,United Kingdom of Great Britain and Northern Ireland,55,16,0,71
17615,2020,Benin,United Kingdom of Great Britain and Northern Ireland,8,21,0,29
17616,2020,Bangladesh,United Kingdom of Great Britain and Northern Ireland,1667,2605,0,4272
17617,2020,Bhutan,United Kingdom of Great Britain and Northern Ireland,47,0,0,47
17618,2020,Burkina Faso,United Kingdom of Great Britain and Northern Ireland,11,14,0,25
17619,2020,Belarus,United Kingdom of Great Britain and Northern Ireland,121,33,0,154
17620,2020,Bolivia (Plurinational State of),United Kingdom of Great Britain and Northern Ireland,22,24,0,46
17621,2020,Botswana,United Kingdom of Great Britain and Northern Ireland,30,85,0,115
17622,2020,Brazil,United Kingdom of Great Britain and Northern Ireland,29,245,0,274
17623,2020,Bosnia and Herzegovina,United Kingdom of Great Britain and Northern Ireland,10,7,0,17
17624,2020,Belize,United Kingdom of Great Britain and Northern Ireland,0,5,0,5
17625,2020,Canada,United Kingdom of Great Britain and Northern Ireland,11,11,0,22
17626,2020,Central African Rep.,United Kingdom of Great Britain and Northern Ireland,9,12,0,21
17627,2020,Chad,United Kingdom of Great Britain and Northern Ireland,67,172,0,239
17628,2020,China,United Kingdom of Great Britain and Northern Ireland,1286,2040,0,3326
17629,2020,Chile,United Kingdom of Great Britain and Northern Ireland,0,14,0,14
17630,2020,Cameroon,United Kingdom of Great Britain and Northern Ireland,738,374,0,1112
17631,2020,Congo,United Kingdom of Great Britain and Northern Ireland,94,59,0,153
17632,2020,Dem. Rep. of the Congo,United Kingdom of Great Britain and Northern Ireland,1024,206,0,1230
17633,2020,Comoros,United Kingdom of Great Britain and Northern Ireland,5,0,0,5
17634,2020,Colombia,United Kingdom of Great Britain and Northern Ireland,23,52,0,75
17635,2020,Costa Rica,United Kingdom of Great Britain and Northern Ireland,0,5,0,5
17636,2020,Cuba,United Kingdom of Great Britain and Northern Ireland,11,17,0,28
17637,2020,Cabo Verde,United Kingdom of Great Britain and Northern Ireland,5,0,0,5
17638,2020,Cyprus,United Kingdom of Great Britain and Northern Ireland,0,7,0,7
17639,2020,Djibouti,United Kingdom of Great Britain and Northern Ireland,5,5,0,10
17640,2020,Dominica,United Kingdom of Great Britain and Northern Ireland,24,21,0,45
17641,2020,Dominican Rep.,United Kingdom of Great Britain and Northern Ireland,0,5,0,5
17642,2020,Ecuador,United Kingdom of Great Britain and Northern Ireland,9,16,0,25
17643,2020,Equatorial Guinea,United Kingdom of Great Britain and Northern Ireland,0,5,0,5
17644,2020,Eritrea,United Kingdom of Great Britain and Northern Ireland,14016,3111,0,17127
17645,2020,Ethiopia,United Kingdom of Great Britain and Northern Ireland,1824,680,0,2504
17646,2020,Fiji,United Kingdom of Great Britain and Northern Ireland,9,0,0,9
17647,2020,Gabon,United Kingdom of Great Britain and Northern Ireland,5,10,0,15
17648,2020,Gambia,United Kingdom of Great Britain and Northern Ireland,1096,218,0,1314
17649,2020,Palestinian,United Kingdom of Great Britain and Northern Ireland,647,435,0,1082
17650,2020,Georgia,United Kingdom of Great Britain and Northern Ireland,77,334,0,411
17651,2020,Ghana,United Kingdom of Great Britain and Northern Ireland,360,411,0,771
17652,2020,Guinea-Bissau,United Kingdom of Great Britain and Northern Ireland,7,8,0,15
17653,2020,Greece,United Kingdom of Great Britain and Northern Ireland,5,0,0,5
17654,2020,Grenada,United Kingdom of Great Britain and Northern Ireland,26,38,0,64
17655,2020,Guatemala,United Kingdom of Great Britain and Northern Ireland,9,17,0,26
17656,2020,Guinea,United Kingdom of Great Britain and Northern Ireland,224,126,0,350
17657,2020,Guyana,United Kingdom of Great Britain and Northern Ireland,20,9,0,29
17658,2020,Haiti,United Kingdom of Great Britain and Northern Ireland,0,10,0,10
17659,2020,"China, Hong Kong SAR",United Kingdom of Great Britain and Northern Ireland,5,71,0,76
17660,2020,Honduras,United Kingdom of Great Britain and Northern Ireland,74,366,0,440
17661,2020,Cote d'Ivoire,United Kingdom of Great Britain and Northern Ireland,230,100,0,330
17662,2020,India,United Kingdom of Great Britain and Northern Ireland,496,2277,0,2773
17663,2020,Indonesia,United Kingdom of Great Britain and Northern Ireland,34,86,0,120
17664,2020,Iran (Islamic Rep. of),United Kingdom of Great Britain and Northern Ireland,20433,6389,0,26822
17665,2020,Iraq,United Kingdom of Great Britain and Northern Ireland,6399,6090,0,12489
17666,2020,Israel,United Kingdom of Great Britain and Northern Ireland,7,16,0,23
17667,2020,Italy,United Kingdom of Great Britain and Northern Ireland,0,5,0,5
17668,2020,Jamaica,United Kingdom of Great Britain and Northern Ireland,324,212,0,536
17669,2020,Jordan,United Kingdom of Great Britain and Northern Ireland,88,120,0,208
17670,2020,Japan,United Kingdom of Great Britain and Northern Ireland,0,6,0,6
17671,2020,Kazakhstan,United Kingdom of Great Britain and Northern Ireland,27,57,0,84
17672,2020,Kenya,United Kingdom of Great Britain and Northern Ireland,309,355,0,664
17673,2020,Kyrgyzstan,United Kingdom of Great Britain and Northern Ireland,37,27,0,64
17674,2020,Rep. of Korea,United Kingdom of Great Britain and Northern Ireland,7,0,0,7
17675,2020,Dem. People's Rep. of Korea,United Kingdom of Great Britain and Northern Ireland,72,26,0,98
17676,2020,Kuwait,United Kingdom of Great Britain and Northern Ireland,670,454,0,1124
17677,2020,Lao People's Dem. Rep.,United Kingdom of Great Britain and Northern Ireland,5,5,0,10
17678,2020,Liberia,United Kingdom of Great Britain and Northern Ireland,29,30,0,59
17679,2020,Libya,United Kingdom of Great Britain and Northern Ireland,4352,816,0,5168
17680,2020,Saint Lucia,United Kingdom of Great Britain and Northern Ireland,27,37,0,64
17681,2020,Lebanon,United Kingdom of Great Britain and Northern Ireland,179,159,0,338
17682,2020,Sri Lanka,United Kingdom of Great Britain and Northern Ireland,5338,1586,0,6924
17683,2020,Lithuania,United Kingdom of Great Britain and Northern Ireland,0,5,0,5
17684,2020,"China, Macao SAR",United Kingdom of Great Britain and Northern Ireland,0,5,0,5
17685,2020,Mauritania,United Kingdom of Great Britain and Northern Ireland,7,7,0,14
17686,2020,North Macedonia,United Kingdom of Great Britain and Northern Ireland,20,10,0,30
17687,2020,Rep. of Moldova,United Kingdom of Great Britain and Northern Ireland,9,0,0,9
17688,2020,Maldives,United Kingdom of Great Britain and Northern Ireland,42,7,0,49
17689,2020,Mexico,United Kingdom of Great Britain and Northern Ireland,14,0,0,14
17690,2020,Marshall Islands,United Kingdom of Great Britain and Northern Ireland,0,50,0,50
17691,2020,Mali,United Kingdom of Great Britain and Northern Ireland,27,50,0,77
17692,2020,Malaysia,United Kingdom of Great Britain and Northern Ireland,297,381,0,678
17693,2020,Malawi,United Kingdom of Great Britain and Northern Ireland,328,81,0,409
17694,2020,Mongolia,United Kingdom of Great Britain and Northern Ireland,71,60,0,131
17695,2020,Morocco,United Kingdom of Great Britain and Northern Ireland,223,310,0,533
17696,2020,Mozambique,United Kingdom of Great Britain and Northern Ireland,7,6,0,13
17697,2020,Mauritius,United Kingdom of Great Britain and Northern Ireland,66,109,0,175
17698,2020,Myanmar,United Kingdom of Great Britain and Northern Ireland,511,64,0,575
17699,2020,Namibia,United Kingdom of Great Britain and Northern Ireland,128,728,0,856
17700,2020,Nepal,United Kingdom of Great Britain and Northern Ireland,53,336,0,389
17701,2020,Netherlands,United Kingdom of Great Britain and Northern Ireland,5,0,0,5
17702,2020,Niger,United Kingdom of Great Britain and Northern Ireland,190,12,0,202
17703,2020,Nicaragua,United Kingdom of Great Britain and Northern Ireland,36,72,0,108
17704,2020,Nigeria,United Kingdom of Great Britain and Northern Ireland,3059,2423,0,5482
17705,2020,Norway,United Kingdom of Great Britain and Northern Ireland,5,0,0,5
17706,2020,Oman,United Kingdom of Great Britain and Northern Ireland,20,22,0,42
17707,2020,Pakistan,United Kingdom of Great Britain and Northern Ireland,8350,4241,0,12591
17708,2020,Peru,United Kingdom of Great Britain and Northern Ireland,0,6,0,6
17709,2020,Philippines,United Kingdom of Great Britain and Northern Ireland,47,375,0,422
17710,2020,Poland,United Kingdom of Great Britain and Northern Ireland,0,5,0,5
17711,2020,Qatar,United Kingdom of Great Britain and Northern Ireland,8,13,0,21
17712,2020,Romania,United Kingdom of Great Britain and Northern Ireland,5,8,0,13
17713,2020,South Africa,United Kingdom of Great Britain and Northern Ireland,143,143,0,286
17714,2020,Russian Federation,United Kingdom of Great Britain and Northern Ireland,809,594,0,1403
17715,2020,Rwanda,United Kingdom of Great Britain and Northern Ireland,119,40,0,159
17716,2020,El Salvador,United Kingdom of Great Britain and Northern Ireland,551,1598,0,2149
17717,2020,Saudi Arabia,United Kingdom of Great Britain and Northern Ireland,256,148,0,404
17718,2020,Serbia and Kosovo: S/RES/1244 (1999),United Kingdom of Great Britain and Northern Ireland,86,60,0,146
17719,2020,Senegal,United Kingdom of Great Britain and Northern Ireland,107,59,0,166
17720,2020,Seychelles,United Kingdom of Great Britain and Northern Ireland,5,5,0,10
17721,2020,Singapore,United Kingdom of Great Britain and Northern Ireland,5,9,0,14
17722,2020,Sierra Leone,United Kingdom of Great Britain and Northern Ireland,325,299,0,624
17723,2020,Somalia,United Kingdom of Great Britain and Northern Ireland,2855,674,0,3529
17724,2020,Viet Nam,United Kingdom of Great Britain and Northern Ireland,2259,2946,0,5205
17725,2020,Saint Kitts and Nevis,United Kingdom of Great Britain and Northern Ireland,5,13,0,18
17726,2020,Sudan,United Kingdom of Great Britain and Northern Ireland,10994,2280,0,13274
17727,2020,South Sudan,United Kingdom of Great Britain and Northern Ireland,67,50,0,117
17728,2020,Eswatini,United Kingdom of Great Britain and Northern Ireland,56,5,0,61
17729,2020,Sweden,United Kingdom of Great Britain and Northern Ireland,0,5,0,5
17730,2020,Syrian Arab Rep.,United Kingdom of Great Britain and Northern Ireland,10919,2231,0,13150
17731,2020,United Rep. of Tanzania,United Kingdom of Great Britain and Northern Ireland,107,90,0,197
17732,2020,Thailand,United Kingdom of Great Britain and Northern Ireland,35,92,0,127
17733,2020,Tajikistan,United Kingdom of Great Britain and Northern Ireland,14,6,0,20
17734,2020,Turkmenistan,United Kingdom of Great Britain and Northern Ireland,17,26,0,43
17735,2020,Togo,United Kingdom of Great Britain and Northern Ireland,17,34,0,51
17736,2020,Trinidad and Tobago,United Kingdom of Great Britain and Northern Ireland,97,106,0,203
17737,2020,Tunisia,United Kingdom of Great Britain and Northern Ireland,65,75,0,140
17738,2020,Türkiye,United Kingdom of Great Britain and Northern Ireland,2223,1593,0,3816
17739,2020,United Arab Emirates,United Kingdom of Great Britain and Northern Ireland,25,13,0,38
17740,2020,Uganda,United Kingdom of Great Britain and Northern Ireland,1231,297,0,1528
17741,2020,Ukraine,United Kingdom of Great Britain and Northern Ireland,208,228,0,436
17742,2020,United States of America,United Kingdom of Great Britain and Northern Ireland,62,103,0,165
17743,2020,Uzbekistan,United Kingdom of Great Britain and Northern Ireland,82,58,0,140
17744,2020,Saint Vincent and the Grenadines,United Kingdom of Great Britain and Northern Ireland,36,21,0,57
17745,2020,Venezuela (Bolivarian Republic of),United Kingdom of Great Britain and Northern Ireland,61,41,0,102
17746,2020,Samoa,United Kingdom of Great Britain and Northern Ireland,0,5,0,5
17747,2020,Western Sahara,United Kingdom of Great Britain and Northern Ireland,11,0,0,11
17748,2020,Yemen,United Kingdom of Great Britain and Northern Ireland,981,604,0,1585
17749,2020,Zambia,United Kingdom of Great Britain and Northern Ireland,89,49,0,138
17750,2020,Zimbabwe,United Kingdom of Great Britain and Northern Ireland,1594,467,0,2061
17751,2020,Stateless,United Kingdom of Great Britain and Northern Ireland,2936,1517,0,4453
17752,2020,Unknown ,United Kingdom of Great Britain and Northern Ireland,1673,7457,0,9130
17753,2020,Afghanistan,Georgia,11,18,0,29
17754,2020,Egypt,Georgia,64,122,0,186
17755,2020,Azerbaijan,Georgia,5,5,0,10
17756,2020,Bangladesh,Georgia,0,17,0,17
17757,2020,China,Georgia,0,5,0,5
17758,2020,Cameroon,Georgia,0,9,0,9
17759,2020,Dem. Rep. of the Congo,Georgia,5,6,0,11
17760,2020,Eritrea,Georgia,0,14,0,14
17761,2020,Palestinian,Georgia,0,17,0,17
17762,2020,Georgia,Georgia,0,0,288538,0
17763,2020,Ghana,Georgia,0,5,0,5
17764,2020,India,Georgia,0,21,0,21
17765,2020,Iran (Islamic Rep. of),Georgia,37,499,0,536
17766,2020,Iraq,Georgia,406,69,0,475
17767,2020,Jordan,Georgia,0,70,0,70
17768,2020,Kazakhstan,Georgia,0,14,0,14
17769,2020,Lebanon,Georgia,6,22,0,28
17770,2020,Sri Lanka,Georgia,0,5,0,5
17771,2020,Morocco,Georgia,0,6,0,6
17772,2020,Nigeria,Georgia,0,47,0,47
17773,2020,Pakistan,Georgia,11,28,0,39
17774,2020,Philippines,Georgia,0,5,0,5
17775,2020,South Africa,Georgia,0,7,0,7
17776,2020,Russian Federation,Georgia,238,72,0,310
17777,2020,Saudi Arabia,Georgia,0,5,0,5
17778,2020,Somalia,Georgia,0,13,0,13
17779,2020,Sudan,Georgia,6,7,0,13
17780,2020,Syrian Arab Rep.,Georgia,437,20,0,457
17781,2020,Tajikistan,Georgia,5,5,0,10
17782,2020,Türkiye,Georgia,0,88,0,88
17783,2020,Ukraine,Georgia,493,13,0,506
17784,2020,Yemen,Georgia,40,18,0,58
17785,2020,Stateless,Georgia,0,0,0,0
17786,2020,Unknown ,Georgia,16,30,0,46
17787,2020,Afghanistan,Germany,147994,33103,0,181097
17788,2020,Albania,Germany,1272,1460,0,2732
17789,2020,Algeria,Germany,600,1269,0,1869
17790,2020,Angola,Germany,822,511,0,1333
17791,2020,Egypt,Germany,2298,1481,0,3779
17792,2020,Argentina,Germany,15,27,0,42
17793,2020,Armenia,Germany,2681,2902,0,5583
17794,2020,Australia,Germany,5,0,0,5
17795,2020,Austria,Germany,5,0,0,5
17796,2020,Azerbaijan,Germany,3850,3585,0,7435
17797,2020,Bahrain,Germany,80,5,0,85
17798,2020,Burundi,Germany,114,55,0,169
17799,2020,Belgium,Germany,6,5,0,11
17800,2020,Benin,Germany,96,133,0,229
17801,2020,Bangladesh,Germany,796,589,0,1385
17802,2020,Bhutan,Germany,20,0,0,20
17803,2020,Burkina Faso,Germany,104,146,0,250
17804,2020,Belarus,Germany,187,290,0,477
17805,2020,Bolivia (Plurinational State of),Germany,7,0,0,7
17806,2020,Botswana,Germany,5,0,0,5
17807,2020,Brazil,Germany,32,50,0,82
17808,2020,Bosnia and Herzegovina,Germany,1358,358,0,1716
17809,2020,Bulgaria,Germany,74,5,0,79
17810,2020,Cambodia,Germany,34,56,0,90
17811,2020,Canada,Germany,23,0,0,23
17812,2020,Central African Rep.,Germany,48,17,0,65
17813,2020,Chad,Germany,95,267,0,362
17814,2020,China,Germany,1986,544,0,2530
17815,2020,Chile,Germany,160,5,0,165
17816,2020,Cameroon,Germany,824,2427,0,3251
17817,2020,Congo,Germany,278,66,0,344
17818,2020,Dem. Rep. of the Congo,Germany,1539,632,0,2171
17819,2020,Comoros,Germany,0,13,0,13
17820,2020,Colombia,Germany,69,845,0,914
17821,2020,Costa Rica,Germany,0,5,0,5
17822,2020,Cuba,Germany,78,49,0,127
17823,2020,Cabo Verde,Germany,0,5,0,5
17824,2020,Czechia,Germany,706,0,0,706
17825,2020,Djibouti,Germany,33,8,0,41
17826,2020,Dominica,Germany,5,0,0,5
17827,2020,Dominican Rep.,Germany,10,8,0,18
17828,2020,Ecuador,Germany,11,6,0,17
17829,2020,Equatorial Guinea,Germany,23,7,0,30
17830,2020,Eritrea,Germany,61226,3292,0,64518
17831,2020,Estonia,Germany,5,0,0,5
17832,2020,Ethiopia,Germany,5385,3865,0,9250
17833,2020,France,Germany,16,5,0,21
17834,2020,Gabon,Germany,13,47,0,60
17835,2020,Gambia,Germany,1189,2555,0,3744
17836,2020,Palestinian,Germany,2066,497,0,2563
17837,2020,United Kingdom of Great Britain and Northern Ireland,Germany,16,5,0,21
17838,2020,Georgia,Germany,691,3356,0,4047
17839,2020,Ghana,Germany,640,1097,0,1737
17840,2020,Guinea-Bissau,Germany,119,140,0,259
17841,2020,Greece,Germany,47,0,0,47
17842,2020,Guatemala,Germany,5,10,0,15
17843,2020,Guinea,Germany,3488,4527,0,8015
17844,2020,Haiti,Germany,14,20,0,34
17845,2020,Honduras,Germany,71,65,0,136
17846,2020,Croatia,Germany,280,5,0,285
17847,2020,Hungary,Germany,233,10,0,243
17848,2020,Iceland,Germany,5,0,0,5
17849,2020,Cote d'Ivoire,Germany,658,1322,0,1980
17850,2020,India,Germany,415,757,0,1172
17851,2020,Indonesia,Germany,14,13,0,27
17852,2020,Iran (Islamic Rep. of),Germany,44965,18355,0,63320
17853,2020,Iraq,Germany,146009,27400,0,173409
17854,2020,Israel,Germany,40,26,0,66
17855,2020,Italy,Germany,30,6,0,36
17856,2020,Jamaica,Germany,68,40,0,108
17857,2020,Jordan,Germany,485,426,0,911
17858,2020,Japan,Germany,23,5,0,28
17859,2020,Kazakhstan,Germany,117,205,0,322
17860,2020,Kenya,Germany,172,674,0,846
17861,2020,Kyrgyzstan,Germany,238,194,0,432
17862,2020,Rep. of Korea,Germany,26,11,0,37
17863,2020,Dem. People's Rep. of Korea,Germany,85,12,0,97
17864,2020,Kuwait,Germany,39,33,0,72
17865,2020,Lao People's Dem. Rep.,Germany,41,0,0,41
17866,2020,Liberia,Germany,123,347,0,470
17867,2020,Libya,Germany,2545,935,0,3480
17868,2020,Lebanon,Germany,1775,1888,0,3663
17869,2020,Sri Lanka,Germany,3626,801,0,4427
17870,2020,Lithuania,Germany,5,0,0,5
17871,2020,Luxembourg,Germany,5,0,0,5
17872,2020,Latvia,Germany,7,5,0,12
17873,2020,Madagascar,Germany,0,16,0,16
17874,2020,Mauritania,Germany,58,82,0,140
17875,2020,North Macedonia,Germany,655,921,0,1576
17876,2020,Rep. of Moldova,Germany,126,1139,0,1265
17877,2020,Mexico,Germany,23,17,0,40
17878,2020,Mali,Germany,358,476,0,834
17879,2020,Malaysia,Germany,12,10,0,22
17880,2020,Malawi,Germany,7,6,0,13
17881,2020,Mongolia,Germany,213,293,0,506
17882,2020,Morocco,Germany,835,1170,0,2005
17883,2020,Mozambique,Germany,15,35,0,50
17884,2020,Montenegro,Germany,228,149,0,377
17885,2020,Mauritius,Germany,5,0,0,5
17886,2020,Myanmar,Germany,869,443,0,1312
17887,2020,Namibia,Germany,0,40,0,40
17888,2020,Nepal,Germany,60,36,0,96
17889,2020,Netherlands,Germany,31,5,0,36
17890,2020,Niger,Germany,57,126,0,183
17891,2020,Nicaragua,Germany,5,180,0,185
17892,2020,Nigeria,Germany,8813,16486,0,25299
17893,2020,Norway,Germany,0,9,0,9
17894,2020,New Zealand,Germany,8,0,0,8
17895,2020,Oman,Germany,8,10,0,18
17896,2020,Pakistan,Germany,8475,6453,0,14928
17897,2020,Paraguay,Germany,5,8,0,13
17898,2020,Peru,Germany,39,18,0,57
17899,2020,Philippines,Germany,40,29,0,69
17900,2020,Poland,Germany,597,5,0,602
17901,2020,Portugal,Germany,7,0,0,7
17902,2020,Qatar,Germany,5,0,0,5
17903,2020,Romania,Germany,137,5,0,142
17904,2020,South Africa,Germany,21,65,0,86
17905,2020,Russian Federation,Germany,9172,13111,0,22283
17906,2020,Rwanda,Germany,297,259,0,556
17907,2020,El Salvador,Germany,121,43,0,164
17908,2020,Saudi Arabia,Germany,178,12,0,190
17909,2020,Serbia and Kosovo: S/RES/1244 (1999),Germany,7926,2042,0,9968
17910,2020,Senegal,Germany,203,415,0,618
17911,2020,Singapore,Germany,8,0,0,8
17912,2020,Sierra Leone,Germany,788,962,0,1750
17913,2020,Solomon Islands,Germany,6,0,0,6
17914,2020,Somalia,Germany,28061,6579,0,34640
17915,2020,Spain,Germany,22,12,0,34
17916,2020,Viet Nam,Germany,1138,248,0,1386
17917,2020,Sudan,Germany,2774,1224,0,3998
17918,2020,South Sudan,Germany,101,64,0,165
17919,2020,Slovakia,Germany,76,0,0,76
17920,2020,Slovenia,Germany,6,0,0,6
17921,2020,Eswatini,Germany,5,5,0,10
17922,2020,Sweden,Germany,8,0,0,8
17923,2020,Syrian Arab Rep.,Germany,605338,37219,0,642557
17924,2020,United Rep. of Tanzania,Germany,61,324,0,385
17925,2020,Thailand,Germany,25,18,0,43
17926,2020,Tajikistan,Germany,1064,1232,0,2296
17927,2020,Turkmenistan,Germany,95,160,0,255
17928,2020,Togo,Germany,996,704,0,1700
17929,2020,Trinidad and Tobago,Germany,5,10,0,15
17930,2020,Tunisia,Germany,234,606,0,840
17931,2020,Türkiye,Germany,33345,14782,0,48127
17932,2020,United Arab Emirates,Germany,38,0,0,38
17933,2020,Uganda,Germany,228,352,0,580
17934,2020,Ukraine,Germany,895,1519,0,2414
17935,2020,United States of America,Germany,134,25,0,159
17936,2020,Uzbekistan,Germany,139,85,0,224
17937,2020,Saint Vincent and the Grenadines,Germany,5,0,0,5
17938,2020,Venezuela (Bolivarian Republic of),Germany,757,748,0,1505
17939,2020,Yemen,Germany,3039,840,0,3879
17940,2020,Zambia,Germany,5,8,0,13
17941,2020,Zimbabwe,Germany,282,254,0,536
17942,2020,Stateless,Germany,10661,926,0,11587
17943,2020,Unknown ,Germany,35285,6252,0,41537
17944,2020,Egypt,Ghana,0,16,0,16
17945,2020,Burundi,Ghana,14,14,0,28
17946,2020,Benin,Ghana,7,0,0,7
17947,2020,Central African Rep.,Ghana,169,60,0,229
17948,2020,Chad,Ghana,34,17,0,51
17949,2020,Cameroon,Ghana,212,128,0,340
17950,2020,Congo,Ghana,7,0,0,7
17951,2020,Dem. Rep. of the Congo,Ghana,58,20,0,78
17952,2020,Eritrea,Ghana,103,60,0,163
17953,2020,Ethiopia,Ghana,8,5,0,13
17954,2020,Palestinian,Ghana,18,9,0,27
17955,2020,Cote d'Ivoire,Ghana,6417,888,0,7305
17956,2020,Iraq,Ghana,12,0,0,12
17957,2020,Liberia,Ghana,694,0,0,694
17958,2020,Libya,Ghana,7,6,0,13
17959,2020,Lebanon,Ghana,8,0,0,8
17960,2020,Mali,Ghana,0,5,0,5
17961,2020,Nigeria,Ghana,9,7,0,16
17962,2020,Pakistan,Ghana,60,5,0,65
17963,2020,Rwanda,Ghana,37,5,0,42
17964,2020,Sierra Leone,Ghana,90,10,0,100
17965,2020,Somalia,Ghana,68,22,0,90
17966,2020,Sudan,Ghana,588,96,0,684
17967,2020,South Sudan,Ghana,7,5,0,12
17968,2020,Syrian Arab Rep.,Ghana,230,48,0,278
17969,2020,Togo,Ghana,3479,71,0,3550
17970,2020,Türkiye,Ghana,44,6,0,50
17971,2020,Uganda,Ghana,10,0,0,10
17972,2020,Uzbekistan,Ghana,9,0,0,9
17973,2020,Yemen,Ghana,7,8,0,15
17974,2020,Burundi,Guinea-Bissau,5,0,0,5
17975,2020,Cote d'Ivoire,Guinea-Bissau,6,6,0,12
17976,2020,Liberia,Guinea-Bissau,7,0,0,7
17977,2020,Nigeria,Guinea-Bissau,0,6,0,6
17978,2020,Senegal,Guinea-Bissau,1818,8,0,1826
17979,2020,Sierra Leone,Guinea-Bissau,10,5,0,15
17980,2020,Türkiye,Guinea-Bissau,0,5,0,5
17981,2020,Afghanistan,Greece,21456,19706,0,41162
17982,2020,Albania,Greece,174,1681,0,1855
17983,2020,Algeria,Greece,116,310,0,426
17984,2020,Angola,Greece,13,57,0,70
17985,2020,Egypt,Greece,388,1535,0,1923
17986,2020,Armenia,Greece,13,50,0,63
17987,2020,Azerbaijan,Greece,5,0,0,5
17988,2020,Burundi,Greece,63,21,0,84
17989,2020,Benin,Greece,0,5,0,5
17990,2020,Bangladesh,Greece,318,3115,0,3433
17991,2020,Burkina Faso,Greece,27,79,0,106
17992,2020,Belarus,Greece,5,0,0,5
17993,2020,Brazil,Greece,0,12,0,12
17994,2020,Central African Rep.,Greece,18,5,0,23
17995,2020,Chad,Greece,8,5,0,13
17996,2020,China,Greece,113,418,0,531
17997,2020,Cameroon,Greece,706,907,0,1613
17998,2020,Congo,Greece,148,94,0,242
17999,2020,Dem. Rep. of the Congo,Greece,1426,3713,0,5139
18000,2020,Comoros,Greece,6,15,0,21
18001,2020,Colombia,Greece,0,5,0,5
18002,2020,Cuba,Greece,0,42,0,42
18003,2020,Djibouti,Greece,8,5,0,13
18004,2020,Dominican Rep.,Greece,9,12,0,21
18005,2020,Equatorial Guinea,Greece,5,0,0,5
18006,2020,Eritrea,Greece,1239,227,0,1466
18007,2020,Ethiopia,Greece,481,59,0,540
18008,2020,Gabon,Greece,5,15,0,20
18009,2020,Gambia,Greece,60,117,0,177
18010,2020,Palestinian,Greece,4723,524,0,5247
18011,2020,Georgia,Greece,271,1387,0,1658
18012,2020,Ghana,Greece,76,368,0,444
18013,2020,Guinea,Greece,150,197,0,347
18014,2020,Haiti,Greece,23,37,0,60
18015,2020,Cote d'Ivoire,Greece,91,61,0,152
18016,2020,India,Greece,36,399,0,435
18017,2020,Indonesia,Greece,15,50,0,65
18018,2020,Iran (Islamic Rep. of),Greece,2476,2250,0,4726
18019,2020,Iraq,Greece,11840,4229,0,16069
18020,2020,Jordan,Greece,38,11,0,49
18021,2020,Kazakhstan,Greece,5,5,0,10
18022,2020,Kenya,Greece,30,5,0,35
18023,2020,Kuwait,Greece,133,45,0,178
18024,2020,Liberia,Greece,5,0,0,5
18025,2020,Libya,Greece,61,50,0,111
18026,2020,Lebanon,Greece,67,61,0,128
18027,2020,Sri Lanka,Greece,51,132,0,183
18028,2020,Mauritania,Greece,63,14,0,77
18029,2020,North Macedonia,Greece,0,5,0,5
18030,2020,Rep. of Moldova,Greece,13,40,0,53
18031,2020,Mali,Greece,94,95,0,189
18032,2020,Morocco,Greece,202,207,0,409
18033,2020,Myanmar,Greece,101,16,0,117
18034,2020,Nepal,Greece,16,164,0,180
18035,2020,Niger,Greece,12,25,0,37
18036,2020,Nigeria,Greece,331,235,0,566
18037,2020,Pakistan,Greece,1150,5423,0,6573
18038,2020,Peru,Greece,0,5,0,5
18039,2020,Philippines,Greece,7,6,0,13
18040,2020,Russian Federation,Greece,16,47,0,63
18041,2020,Rwanda,Greece,10,0,0,10
18042,2020,El Salvador,Greece,12,0,0,12
18043,2020,Saudi Arabia,Greece,7,5,0,12
18044,2020,Serbia and Kosovo: S/RES/1244 (1999),Greece,23,13,0,36
18045,2020,Senegal,Greece,59,56,0,115
18046,2020,Sierra Leone,Greece,117,150,0,267
18047,2020,Somalia,Greece,3113,1506,0,4619
18048,2020,Viet Nam,Greece,5,12,0,17
18049,2020,Sudan,Greece,519,77,0,596
18050,2020,South Sudan,Greece,45,15,0,60
18051,2020,Syrian Arab Rep.,Greece,36448,5965,0,42413
18052,2020,United Rep. of Tanzania,Greece,13,5,0,18
18053,2020,Tajikistan,Greece,5,5,0,10
18054,2020,Turkmenistan,Greece,6,8,0,14
18055,2020,Togo,Greece,62,151,0,213
18056,2020,Tunisia,Greece,22,35,0,57
18057,2020,Türkiye,Greece,853,4195,0,5048
18058,2020,Uganda,Greece,49,65,0,114
18059,2020,Ukraine,Greece,158,63,0,221
18060,2020,Uzbekistan,Greece,17,5,0,22
18061,2020,Venezuela (Bolivarian Republic of),Greece,13,20,0,33
18062,2020,Western Sahara,Greece,10,6,0,16
18063,2020,Yemen,Greece,853,47,0,900
18064,2020,Zambia,Greece,0,5,0,5
18065,2020,Zimbabwe,Greece,12,5,0,17
18066,2020,Stateless,Greece,701,151,0,852
18067,2020,Unknown ,Greece,11063,5,0,11068
18068,2020,Venezuela (Bolivarian Republic of),Grenada,0,0,0,0
18069,2020,Colombia,Guatemala,10,5,0,15
18070,2020,Cuba,Guatemala,7,50,0,57
18071,2020,Guatemala,Guatemala,0,0,0,0
18072,2020,Honduras,Guatemala,67,298,0,365
18073,2020,Mexico,Guatemala,0,6,0,6
18074,2020,Nicaragua,Guatemala,61,127,0,188
18075,2020,Russian Federation,Guatemala,5,0,0,5
18076,2020,El Salvador,Guatemala,265,222,0,487
18077,2020,Venezuela (Bolivarian Republic of),Guatemala,27,76,0,103
18078,2020,Unknown ,Guatemala,0,0,0,0
18079,2020,Burundi,Guinea,6,0,0,6
18080,2020,Central African Rep.,Guinea,40,0,0,40
18081,2020,Cameroon,Guinea,5,0,0,5
18082,2020,Congo,Guinea,15,0,0,15
18083,2020,Dem. Rep. of the Congo,Guinea,40,11,0,51
18084,2020,Eritrea,Guinea,12,0,0,12
18085,2020,Gambia,Guinea,7,0,0,7
18086,2020,Cote d'Ivoire,Guinea,4201,501,0,4702
18087,2020,Kenya,Guinea,0,6,0,6
18088,2020,Liberia,Guinea,357,35,0,392
18089,2020,Sri Lanka,Guinea,9,0,0,9
18090,2020,Mali,Guinea,10,0,0,10
18091,2020,Nigeria,Guinea,12,0,0,12
18092,2020,Rwanda,Guinea,10,0,0,10
18093,2020,Sierra Leone,Guinea,1272,2978,0,4250
18094,2020,Somalia,Guinea,6,0,0,6
18095,2020,Syrian Arab Rep.,Guinea,17,12,0,29
18096,2020,Togo,Guinea,10,0,0,10
18097,2020,Cameroon,Guyana,0,5,0,5
18098,2020,Cuba,Guyana,18,67,0,85
18099,2020,Pakistan,Guyana,5,0,0,5
18100,2020,Venezuela (Bolivarian Republic of),Guyana,0,0,0,0
18101,2020,Nigeria,Haiti,0,5,0,5
18102,2020,Afghanistan,"China, Hong Kong SAR",10,0,0,10
18103,2020,Egypt,"China, Hong Kong SAR",15,0,0,15
18104,2020,Burundi,"China, Hong Kong SAR",12,0,0,12
18105,2020,Bangladesh,"China, Hong Kong SAR",12,0,0,12
18106,2020,Central African Rep.,"China, Hong Kong SAR",5,0,0,5
18107,2020,Cameroon,"China, Hong Kong SAR",5,0,0,5
18108,2020,Dem. Rep. of the Congo,"China, Hong Kong SAR",10,0,0,10
18109,2020,Ethiopia,"China, Hong Kong SAR",5,0,0,5
18110,2020,Palestinian,"China, Hong Kong SAR",5,0,0,5
18111,2020,Indonesia,"China, Hong Kong SAR",14,0,0,14
18112,2020,Sri Lanka,"China, Hong Kong SAR",21,0,0,21
18113,2020,Nepal,"China, Hong Kong SAR",6,0,0,6
18114,2020,Pakistan,"China, Hong Kong SAR",21,0,0,21
18115,2020,Philippines,"China, Hong Kong SAR",6,0,0,6
18116,2020,Rwanda,"China, Hong Kong SAR",29,0,0,29
18117,2020,Somalia,"China, Hong Kong SAR",35,0,0,35
18118,2020,Sudan,"China, Hong Kong SAR",5,0,0,5
18119,2020,Yemen,"China, Hong Kong SAR",29,0,0,29
18120,2020,Colombia,Honduras,0,5,0,5
18121,2020,Cuba,Honduras,0,5,0,5
18122,2020,Haiti,Honduras,0,0,0,0
18123,2020,Honduras,Honduras,0,0,247090,0
18124,2020,Nicaragua,Honduras,56,92,0,148
18125,2020,El Salvador,Honduras,22,9,0,31
18126,2020,Venezuela (Bolivarian Republic of),Honduras,7,5,0,12
18127,2020,Unknown ,Honduras,0,0,0,0
18128,2020,Afghanistan,Croatia,54,351,0,405
18129,2020,Algeria,Croatia,0,5,0,5
18130,2020,Egypt,Croatia,8,0,0,8
18131,2020,Azerbaijan,Croatia,5,0,0,5
18132,2020,Bangladesh,Croatia,7,6,0,13
18133,2020,Belarus,Croatia,5,0,0,5
18134,2020,Bosnia and Herzegovina,Croatia,5,0,0,5
18135,2020,Cameroon,Croatia,5,0,0,5
18136,2020,Congo,Croatia,5,0,0,5
18137,2020,Dem. Rep. of the Congo,Croatia,6,0,0,6
18138,2020,Eritrea,Croatia,23,11,0,34
18139,2020,Georgia,Croatia,5,0,0,5
18140,2020,Croatia,Croatia,0,0,0,0
18141,2020,Iran (Islamic Rep. of),Croatia,37,32,0,69
18142,2020,Iraq,Croatia,113,49,0,162
18143,2020,Kazakhstan,Croatia,5,0,0,5
18144,2020,Libya,Croatia,5,5,0,10
18145,2020,Mauritania,Croatia,5,0,0,5
18146,2020,Morocco,Croatia,0,8,0,8
18147,2020,Nigeria,Croatia,12,0,0,12
18148,2020,Pakistan,Croatia,7,23,0,30
18149,2020,Russian Federation,Croatia,15,5,0,20
18150,2020,Serbia and Kosovo: S/RES/1244 (1999),Croatia,0,10,0,10
18151,2020,Somalia,Croatia,29,0,0,29
18152,2020,Sudan,Croatia,5,0,0,5
18153,2020,Syrian Arab Rep.,Croatia,539,26,0,565
18154,2020,Türkiye,Croatia,24,36,0,60
18155,2020,Ukraine,Croatia,8,0,0,8
18156,2020,Uzbekistan,Croatia,5,0,0,5
18157,2020,Yemen,Croatia,7,0,0,7
18158,2020,Stateless,Croatia,5,0,0,5
18159,2020,Unknown ,Croatia,7,0,0,7
18160,2020,Afghanistan,Hungary,1503,17,0,1520
18161,2020,Albania,Hungary,5,0,0,5
18162,2020,Algeria,Hungary,14,0,0,14
18163,2020,Angola,Hungary,5,0,0,5
18164,2020,Egypt,Hungary,11,0,0,11
18165,2020,Armenia,Hungary,43,0,0,43
18166,2020,Azerbaijan,Hungary,13,0,0,13
18167,2020,Bangladesh,Hungary,11,0,0,11
18168,2020,China,Hungary,5,0,0,5
18169,2020,Cameroon,Hungary,40,0,0,40
18170,2020,Congo,Hungary,13,0,0,13
18171,2020,Dem. Rep. of the Congo,Hungary,24,0,0,24
18172,2020,Cuba,Hungary,78,0,0,78
18173,2020,Eritrea,Hungary,47,0,0,47
18174,2020,Ethiopia,Hungary,39,0,0,39
18175,2020,Palestinian,Hungary,90,0,0,90
18176,2020,Georgia,Hungary,59,0,0,59
18177,2020,Ghana,Hungary,5,0,0,5
18178,2020,Guinea,Hungary,5,0,0,5
18179,2020,Cote d'Ivoire,Hungary,15,0,0,15
18180,2020,Iran (Islamic Rep. of),Hungary,184,5,0,189
18181,2020,Iraq,Hungary,635,6,0,641
18182,2020,Libya,Hungary,7,0,0,7
18183,2020,Lebanon,Hungary,5,0,0,5
18184,2020,Sri Lanka,Hungary,11,0,0,11
18185,2020,Rep. of Moldova,Hungary,5,0,0,5
18186,2020,Myanmar,Hungary,5,0,0,5
18187,2020,Nepal,Hungary,11,0,0,11
18188,2020,Nigeria,Hungary,52,0,0,52
18189,2020,Pakistan,Hungary,106,5,0,111
18190,2020,Russian Federation,Hungary,36,0,0,36
18191,2020,Serbia and Kosovo: S/RES/1244 (1999),Hungary,48,0,0,48
18192,2020,Sierra Leone,Hungary,5,0,0,5
18193,2020,Somalia,Hungary,614,0,0,614
18194,2020,Sudan,Hungary,67,0,0,67
18195,2020,Syrian Arab Rep.,Hungary,923,0,0,923
18196,2020,Tunisia,Hungary,8,0,0,8
18197,2020,Türkiye,Hungary,33,5,0,38
18198,2020,Uganda,Hungary,7,0,0,7
18199,2020,Ukraine,Hungary,14,0,0,14
18200,2020,Uzbekistan,Hungary,6,0,0,6
18201,2020,Yemen,Hungary,16,0,0,16
18202,2020,Zimbabwe,Hungary,5,0,0,5
18203,2020,Stateless,Hungary,69,0,0,69
18204,2020,Unknown ,Hungary,941,0,0,941
18205,2020,Afghanistan,Iceland,121,5,0,126
18206,2020,Albania,Iceland,5,0,0,5
18207,2020,Egypt,Iceland,10,0,0,10
18208,2020,Azerbaijan,Iceland,5,5,0,10
18209,2020,Bangladesh,Iceland,5,5,0,10
18210,2020,China,Iceland,5,0,0,5
18211,2020,Cameroon,Iceland,5,0,0,5
18212,2020,Dem. Rep. of the Congo,Iceland,5,0,0,5
18213,2020,Eritrea,Iceland,9,0,0,9
18214,2020,Palestinian,Iceland,74,84,0,158
18215,2020,Georgia,Iceland,5,0,0,5
18216,2020,Honduras,Iceland,12,0,0,12
18217,2020,Cote d'Ivoire,Iceland,5,5,0,10
18218,2020,Iran (Islamic Rep. of),Iceland,94,5,0,99
18219,2020,Iraq,Iceland,297,6,0,303
18220,2020,Kazakhstan,Iceland,5,0,0,5
18221,2020,Kenya,Iceland,5,0,0,5
18222,2020,Libya,Iceland,8,0,0,8
18223,2020,Sri Lanka,Iceland,5,0,0,5
18224,2020,North Macedonia,Iceland,5,0,0,5
18225,2020,Mali,Iceland,5,0,0,5
18226,2020,Morocco,Iceland,5,5,0,10
18227,2020,Mozambique,Iceland,5,0,0,5
18228,2020,Nigeria,Iceland,55,15,0,70
18229,2020,Pakistan,Iceland,22,5,0,27
18230,2020,Peru,Iceland,5,0,0,5
18231,2020,Russian Federation,Iceland,14,0,0,14
18232,2020,El Salvador,Iceland,18,0,0,18
18233,2020,Senegal,Iceland,5,5,0,10
18234,2020,Somalia,Iceland,81,16,0,97
18235,2020,Sudan,Iceland,7,0,0,7
18236,2020,South Sudan,Iceland,5,0,0,5
18237,2020,Syrian Arab Rep.,Iceland,167,5,0,172
18238,2020,Tajikistan,Iceland,5,0,0,5
18239,2020,Tunisia,Iceland,5,0,0,5
18240,2020,Türkiye,Iceland,10,0,0,10
18241,2020,Uganda,Iceland,14,0,0,14
18242,2020,Ukraine,Iceland,19,0,0,19
18243,2020,Venezuela (Bolivarian Republic of),Iceland,294,10,0,304
18244,2020,Yemen,Iceland,9,0,0,9
18245,2020,Stateless,Iceland,13,5,0,18
18246,2020,Unknown ,Iceland,12,0,0,12
18247,2020,Burundi,Cote d'Ivoire,35,0,0,35
18248,2020,Benin,Cote d'Ivoire,0,5,0,5
18249,2020,Burkina Faso,Cote d'Ivoire,0,5,0,5
18250,2020,Cambodia,Cote d'Ivoire,10,0,0,10
18251,2020,Central African Rep.,Cote d'Ivoire,525,59,0,584
18252,2020,Chad,Cote d'Ivoire,5,5,0,10
18253,2020,Cameroon,Cote d'Ivoire,0,21,0,21
18254,2020,Congo,Cote d'Ivoire,85,10,0,95
18255,2020,Dem. Rep. of the Congo,Cote d'Ivoire,136,22,0,158
18256,2020,Eritrea,Cote d'Ivoire,8,6,0,14
18257,2020,Ethiopia,Cote d'Ivoire,5,5,0,10
18258,2020,Guinea,Cote d'Ivoire,0,6,0,6
18259,2020,Cote d'Ivoire,Cote d'Ivoire,0,0,5394,0
18260,2020,Iran (Islamic Rep. of),Cote d'Ivoire,6,0,0,6
18261,2020,Iraq,Cote d'Ivoire,5,0,0,5
18262,2020,Liberia,Cote d'Ivoire,973,21,0,994
18263,2020,Sri Lanka,Cote d'Ivoire,5,0,0,5
18264,2020,Mauritania,Cote d'Ivoire,0,5,0,5
18265,2020,Mali,Cote d'Ivoire,12,18,0,30
18266,2020,Nigeria,Cote d'Ivoire,5,5,0,10
18267,2020,Rwanda,Cote d'Ivoire,53,5,0,58
18268,2020,Somalia,Cote d'Ivoire,5,0,0,5
18269,2020,Viet Nam,Cote d'Ivoire,5,0,0,5
18270,2020,Sudan,Cote d'Ivoire,10,0,0,10
18271,2020,South Sudan,Cote d'Ivoire,0,5,0,5
18272,2020,Syrian Arab Rep.,Cote d'Ivoire,142,9,0,151
18273,2020,Togo,Cote d'Ivoire,17,12,0,29
18274,2020,Türkiye,Cote d'Ivoire,34,0,0,34
18275,2020,Yemen,Cote d'Ivoire,5,0,0,5
18276,2020,Stateless,Cote d'Ivoire,0,0,0,0
18277,2020,Afghanistan,India,8275,6857,0,15132
18278,2020,Egypt,India,0,8,0,8
18279,2020,Burundi,India,0,5,0,5
18280,2020,Benin,India,0,5,0,5
18281,2020,Bangladesh,India,8,0,0,8
18282,2020,China,India,73407,0,0,73407
18283,2020,Cameroon,India,0,175,0,175
18284,2020,Congo,India,8,42,0,50
18285,2020,Dem. Rep. of the Congo,India,49,70,0,119
18286,2020,Eritrea,India,9,13,0,22
18287,2020,Ethiopia,India,15,21,0,36
18288,2020,Palestinian,India,58,8,0,66
18289,2020,Ghana,India,0,44,0,44
18290,2020,Guinea,India,0,6,0,6
18291,2020,Cote d'Ivoire,India,5,125,0,130
18292,2020,Iran (Islamic Rep. of),India,49,57,0,106
18293,2020,Iraq,India,153,52,0,205
18294,2020,Kenya,India,0,20,0,20
18295,2020,Liberia,India,0,5,0,5
18296,2020,Libya,India,8,7,0,15
18297,2020,Sri Lanka,India,93259,0,0,93259
18298,2020,Maldives,India,5,0,0,5
18299,2020,Myanmar,India,19398,1974,0,21372
18300,2020,Nigeria,India,0,242,0,242
18301,2020,Russian Federation,India,0,12,0,12
18302,2020,Rwanda,India,5,10,0,15
18303,2020,Saudi Arabia,India,5,0,0,5
18304,2020,Senegal,India,0,18,0,18
18305,2020,Sierra Leone,India,0,5,0,5
18306,2020,Somalia,India,514,288,0,802
18307,2020,Sudan,India,65,121,0,186
18308,2020,South Sudan,India,0,98,0,98
18309,2020,Syrian Arab Rep.,India,63,57,0,120
18310,2020,United Rep. of Tanzania,India,0,6,0,6
18311,2020,Tajikistan,India,0,5,0,5
18312,2020,Turkmenistan,India,0,5,0,5
18313,2020,Türkiye,India,5,0,0,5
18314,2020,Uganda,India,0,7,0,7
18315,2020,Ukraine,India,0,5,0,5
18316,2020,Uzbekistan,India,0,5,0,5
18317,2020,Venezuela (Bolivarian Republic of),India,5,6,0,11
18318,2020,Yemen,India,5,833,0,838
18319,2020,Stateless,India,0,0,0,0
18320,2020,Afghanistan,Indonesia,5863,1739,0,7602
18321,2020,Angola,Indonesia,7,0,0,7
18322,2020,Egypt,Indonesia,18,20,0,38
18323,2020,Bangladesh,Indonesia,0,5,0,5
18324,2020,China,Indonesia,11,5,0,16
18325,2020,Cameroon,Indonesia,0,15,0,15
18326,2020,Dem. Rep. of the Congo,Indonesia,10,0,0,10
18327,2020,Eritrea,Indonesia,100,167,0,267
18328,2020,Ethiopia,Indonesia,135,40,0,175
18329,2020,Palestinian,Indonesia,269,93,0,362
18330,2020,Cote d'Ivoire,Indonesia,0,5,0,5
18331,2020,Indonesia,Indonesia,0,0,0,0
18332,2020,Iran (Islamic Rep. of),Indonesia,310,19,0,329
18333,2020,Iraq,Indonesia,515,216,0,731
18334,2020,Jordan,Indonesia,5,0,0,5
18335,2020,Kuwait,Indonesia,9,0,0,9
18336,2020,Libya,Indonesia,15,11,0,26
18337,2020,Sri Lanka,Indonesia,395,68,0,463
18338,2020,Myanmar,Indonesia,491,418,0,909
18339,2020,Pakistan,Indonesia,284,24,0,308
18340,2020,Russian Federation,Indonesia,5,0,0,5
18341,2020,Somalia,Indonesia,1119,250,0,1369
18342,2020,Viet Nam,Indonesia,20,0,0,20
18343,2020,Sudan,Indonesia,409,95,0,504
18344,2020,Syrian Arab Rep.,Indonesia,23,21,0,44
18345,2020,United Rep. of Tanzania,Indonesia,0,5,0,5
18346,2020,Türkiye,Indonesia,0,18,0,18
18347,2020,Uganda,Indonesia,5,11,0,16
18348,2020,Venezuela (Bolivarian Republic of),Indonesia,0,5,0,5
18349,2020,Yemen,Indonesia,96,347,0,443
18350,2020,Stateless,Indonesia,0,0,0,0
18351,2020,Afghanistan,Ireland,420,159,0,579
18352,2020,Albania,Ireland,190,516,0,706
18353,2020,Algeria,Ireland,64,221,0,285
18354,2020,Angola,Ireland,53,26,0,79
18355,2020,Egypt,Ireland,43,68,0,111
18356,2020,Armenia,Ireland,14,5,0,19
18357,2020,Azerbaijan,Ireland,5,0,0,5
18358,2020,Bahrain,Ireland,6,10,0,16
18359,2020,Burundi,Ireland,22,8,0,30
18360,2020,Benin,Ireland,5,0,0,5
18361,2020,Bangladesh,Ireland,96,204,0,300
18362,2020,Bhutan,Ireland,11,0,0,11
18363,2020,Belarus,Ireland,19,5,0,24
18364,2020,Bolivia (Plurinational State of),Ireland,21,47,0,68
18365,2020,Botswana,Ireland,12,38,0,50
18366,2020,Brazil,Ireland,20,211,0,231
18367,2020,Bosnia and Herzegovina,Ireland,5,0,0,5
18368,2020,Chad,Ireland,5,0,0,5
18369,2020,China,Ireland,68,88,0,156
18370,2020,Chile,Ireland,0,5,0,5
18371,2020,Cameroon,Ireland,94,46,0,140
18372,2020,Congo,Ireland,14,5,0,19
18373,2020,Dem. Rep. of the Congo,Ireland,435,178,0,613
18374,2020,Cuba,Ireland,5,0,0,5
18375,2020,Eritrea,Ireland,84,10,0,94
18376,2020,Ethiopia,Ireland,36,19,0,55
18377,2020,Gambia,Ireland,0,10,0,10
18378,2020,Palestinian,Ireland,138,32,0,170
18379,2020,Georgia,Ireland,132,646,0,778
18380,2020,Ghana,Ireland,31,77,0,108
18381,2020,Guatemala,Ireland,5,15,0,20
18382,2020,Guinea,Ireland,16,9,0,25
18383,2020,Honduras,Ireland,0,5,0,5
18384,2020,Cote d'Ivoire,Ireland,15,8,0,23
18385,2020,India,Ireland,14,105,0,119
18386,2020,Indonesia,Ireland,5,0,0,5
18387,2020,Iran (Islamic Rep. of),Ireland,155,33,0,188
18388,2020,Iraq,Ireland,425,65,0,490
18389,2020,Israel,Ireland,12,0,0,12
18390,2020,Jordan,Ireland,6,15,0,21
18391,2020,Kazakhstan,Ireland,18,0,0,18
18392,2020,Kenya,Ireland,49,27,0,76
18393,2020,Kyrgyzstan,Ireland,5,5,0,10
18394,2020,Dem. People's Rep. of Korea,Ireland,7,5,0,12
18395,2020,Kuwait,Ireland,52,18,0,70
18396,2020,Liberia,Ireland,13,0,0,13
18397,2020,Libya,Ireland,241,22,0,263
18398,2020,Lebanon,Ireland,9,9,0,18
18399,2020,Lesotho,Ireland,0,6,0,6
18400,2020,Sri Lanka,Ireland,21,16,0,37
18401,2020,Rep. of Moldova,Ireland,54,5,0,59
18402,2020,Mexico,Ireland,9,5,0,14
18403,2020,Mali,Ireland,7,0,0,7
18404,2020,Malaysia,Ireland,5,29,0,34
18405,2020,Malawi,Ireland,126,183,0,309
18406,2020,Mongolia,Ireland,5,11,0,16
18407,2020,Morocco,Ireland,12,58,0,70
18408,2020,Mozambique,Ireland,5,0,0,5
18409,2020,Montenegro,Ireland,5,0,0,5
18410,2020,Mauritius,Ireland,19,26,0,45
18411,2020,Myanmar,Ireland,13,5,0,18
18412,2020,Nepal,Ireland,9,23,0,32
18413,2020,Niger,Ireland,5,0,0,5
18414,2020,Nicaragua,Ireland,9,5,0,14
18415,2020,Nigeria,Ireland,339,818,0,1157
18416,2020,Pakistan,Ireland,365,654,0,1019
18417,2020,Philippines,Ireland,0,5,0,5
18418,2020,South Africa,Ireland,116,468,0,584
18419,2020,Russian Federation,Ireland,82,24,0,106
18420,2020,Rwanda,Ireland,39,0,0,39
18421,2020,El Salvador,Ireland,13,28,0,41
18422,2020,Saudi Arabia,Ireland,16,7,0,23
18423,2020,Serbia and Kosovo: S/RES/1244 (1999),Ireland,61,38,0,99
18424,2020,Senegal,Ireland,0,5,0,5
18425,2020,Sierra Leone,Ireland,51,52,0,103
18426,2020,Somalia,Ireland,275,250,0,525
18427,2020,Viet Nam,Ireland,6,39,0,45
18428,2020,Sudan,Ireland,212,31,0,243
18429,2020,Eswatini,Ireland,19,17,0,36
18430,2020,Syrian Arab Rep.,Ireland,3126,67,0,3193
18431,2020,United Rep. of Tanzania,Ireland,0,10,0,10
18432,2020,Turks and Caicos Islands,Ireland,0,5,0,5
18433,2020,Togo,Ireland,21,20,0,41
18434,2020,Trinidad and Tobago,Ireland,0,5,0,5
18435,2020,Tunisia,Ireland,7,6,0,13
18436,2020,Türkiye,Ireland,16,15,0,31
18437,2020,Uganda,Ireland,40,42,0,82
18438,2020,Ukraine,Ireland,85,19,0,104
18439,2020,United States of America,Ireland,0,21,0,21
18440,2020,Uzbekistan,Ireland,17,0,0,17
18441,2020,Venezuela (Bolivarian Republic of),Ireland,101,90,0,191
18442,2020,Yemen,Ireland,20,6,0,26
18443,2020,Zambia,Ireland,5,5,0,10
18444,2020,Zimbabwe,Ireland,597,688,0,1285
18445,2020,Stateless,Ireland,7,0,0,7
18446,2020,Unknown ,Ireland,0,611,0,611
18447,2020,Afghanistan,Iran (Islamic Rep. of),780000,0,0,780000
18448,2020,Iraq,Iran (Islamic Rep. of),20000,0,0,20000
18449,2020,Kuwait,Iran (Islamic Rep. of),8,0,0,8
18450,2020,Myanmar,Iran (Islamic Rep. of),0,34,0,34
18451,2020,Pakistan,Iran (Islamic Rep. of),10,0,0,10
18452,2020,Uzbekistan,Iran (Islamic Rep. of),7,0,0,7
18453,2020,Stateless,Iran (Islamic Rep. of),0,0,0,0
18454,2020,Afghanistan,Iraq,11,64,0,75
18455,2020,Egypt,Iraq,0,23,0,23
18456,2020,Bahrain,Iraq,0,25,0,25
18457,2020,Eritrea,Iraq,5,27,0,32
18458,2020,Ethiopia,Iraq,0,7,0,7
18459,2020,Palestinian,Iraq,7868,95,0,7963
18460,2020,Indonesia,Iraq,0,5,0,5
18461,2020,Iran (Islamic Rep. of),Iraq,5061,5765,0,10826
18462,2020,Iraq,Iraq,0,0,1224108,0
18463,2020,Kazakhstan,Iraq,0,5,0,5
18464,2020,Kyrgyzstan,Iraq,0,15,0,15
18465,2020,Kuwait,Iraq,0,249,0,249
18466,2020,Lebanon,Iraq,0,5,0,5
18467,2020,Pakistan,Iraq,0,27,0,27
18468,2020,Saudi Arabia,Iraq,0,6,0,6
18469,2020,Somalia,Iraq,6,5,0,11
18470,2020,Sudan,Iraq,94,684,0,778
18471,2020,South Sudan,Iraq,0,15,0,15
18472,2020,Syrian Arab Rep.,Iraq,242163,0,0,242163
18473,2020,Tunisia,Iraq,0,6,0,6
18474,2020,Türkiye,Iraq,15169,5477,0,20646
18475,2020,Yemen,Iraq,0,165,0,165
18476,2020,Stateless,Iraq,0,0,0,0
18477,2020,Albania,Israel,0,28,0,28
18478,2020,Argentina,Israel,0,7,0,7
18479,2020,Armenia,Israel,0,53,0,53
18480,2020,Azerbaijan,Israel,0,57,0,57
18481,2020,Benin,Israel,0,5,0,5
18482,2020,Burkina Faso,Israel,0,8,0,8
18483,2020,Belarus,Israel,5,850,0,855
18484,2020,Bolivia (Plurinational State of),Israel,0,5,0,5
18485,2020,Botswana,Israel,0,6,0,6
18486,2020,Brazil,Israel,0,8,0,8
18487,2020,Bulgaria,Israel,0,5,0,5
18488,2020,Central African Rep.,Israel,0,16,0,16
18489,2020,Chad,Israel,5,5,0,10
18490,2020,China,Israel,0,275,0,275
18491,2020,Cameroon,Israel,0,44,0,44
18492,2020,Congo,Israel,0,26,0,26
18493,2020,Dem. Rep. of the Congo,Israel,0,205,0,205
18494,2020,Colombia,Israel,0,295,0,295
18495,2020,Ecuador,Israel,0,38,0,38
18496,2020,Eritrea,Israel,213,12003,0,12216
18497,2020,Ethiopia,Israel,102,811,0,913
18498,2020,Georgia,Israel,5,699,0,704
18499,2020,Ghana,Israel,0,493,0,493
18500,2020,Guinea,Israel,0,5,0,5
18501,2020,Honduras,Israel,0,10,0,10
18502,2020,Cote d'Ivoire,Israel,7,9,0,16
18503,2020,India,Israel,0,1193,0,1193
18504,2020,Iran (Islamic Rep. of),Israel,6,0,0,6
18505,2020,Iraq,Israel,10,0,0,10
18506,2020,Kazakhstan,Israel,0,186,0,186
18507,2020,Kenya,Israel,0,108,0,108
18508,2020,Kyrgyzstan,Israel,0,78,0,78
18509,2020,Dem. People's Rep. of Korea,Israel,5,0,0,5
18510,2020,Lesotho,Israel,0,7,0,7
18511,2020,Sri Lanka,Israel,0,1048,0,1048
18512,2020,North Macedonia,Israel,0,29,0,29
18513,2020,Rep. of Moldova,Israel,0,504,0,504
18514,2020,Mexico,Israel,0,9,0,9
18515,2020,Mali,Israel,0,6,0,6
18516,2020,Malawi,Israel,0,76,0,76
18517,2020,Mongolia,Israel,0,5,0,5
18518,2020,Mozambique,Israel,0,5,0,5
18519,2020,Montenegro,Israel,0,14,0,14
18520,2020,Myanmar,Israel,0,26,0,26
18521,2020,Nepal,Israel,0,36,0,36
18522,2020,Nigeria,Israel,8,995,0,1003
18523,2020,Peru,Israel,0,18,0,18
18524,2020,Philippines,Israel,0,6,0,6
18525,2020,Romania,Israel,0,37,0,37
18526,2020,South Africa,Israel,0,483,0,483
18527,2020,Russian Federation,Israel,5,3967,0,3972
18528,2020,Rwanda,Israel,0,7,0,7
18529,2020,Serbia and Kosovo: S/RES/1244 (1999),Israel,0,120,0,120
18530,2020,Sierra Leone,Israel,5,15,0,20
18531,2020,Somalia,Israel,0,12,0,12
18532,2020,Viet Nam,Israel,0,5,0,5
18533,2020,Sudan,Israel,1157,4500,0,5657
18534,2020,South Sudan,Israel,72,105,0,177
18535,2020,United Rep. of Tanzania,Israel,0,5,0,5
18536,2020,Thailand,Israel,0,5,0,5
18537,2020,Tajikistan,Israel,0,5,0,5
18538,2020,Turkmenistan,Israel,0,6,0,6
18539,2020,Togo,Israel,0,6,0,6
18540,2020,Türkiye,Israel,5,361,0,366
18541,2020,Uganda,Israel,0,174,0,174
18542,2020,Ukraine,Israel,27,1829,0,1856
18543,2020,Uzbekistan,Israel,0,483,0,483
18544,2020,Venezuela (Bolivarian Republic of),Israel,0,5,0,5
18545,2020,Zambia,Israel,0,5,0,5
18546,2020,Zimbabwe,Israel,0,19,0,19
18547,2020,Stateless,Israel,0,0,0,0
18548,2020,Unknown ,Israel,206,49,0,255
18549,2020,Afghanistan,Italy,12096,1339,0,13435
18550,2020,Albania,Italy,620,406,0,1026
18551,2020,Algeria,Italy,0,127,0,127
18552,2020,Angola,Italy,0,15,0,15
18553,2020,Egypt,Italy,786,521,0,1307
18554,2020,Argentina,Italy,0,25,0,25
18555,2020,Armenia,Italy,208,98,0,306
18556,2020,Azerbaijan,Italy,0,46,0,46
18557,2020,Burundi,Italy,0,6,0,6
18558,2020,Benin,Italy,154,34,0,188
18559,2020,Bangladesh,Italy,4360,2949,0,7309
18560,2020,Burkina Faso,Italy,675,127,0,802
18561,2020,Belarus,Italy,0,33,0,33
18562,2020,Bolivia (Plurinational State of),Italy,0,9,0,9
18563,2020,Brazil,Italy,179,231,0,410
18564,2020,Bosnia and Herzegovina,Italy,0,64,0,64
18565,2020,Canada,Italy,0,5,0,5
18566,2020,Central African Rep.,Italy,0,35,0,35
18567,2020,Chad,Italy,0,55,0,55
18568,2020,China,Italy,400,357,0,757
18569,2020,Chile,Italy,0,13,0,13
18570,2020,Cameroon,Italy,1555,470,0,2025
18571,2020,Congo,Italy,329,32,0,361
18572,2020,Dem. Rep. of the Congo,Italy,683,56,0,739
18573,2020,Comoros,Italy,0,5,0,5
18574,2020,Colombia,Italy,664,573,0,1237
18575,2020,Cuba,Italy,0,118,0,118
18576,2020,Cabo Verde,Italy,0,5,0,5
18577,2020,Dominican Rep.,Italy,0,19,0,19
18578,2020,Ecuador,Italy,0,34,0,34
18579,2020,Equatorial Guinea,Italy,0,5,0,5
18580,2020,Eritrea,Italy,3496,13163,0,16659
18581,2020,Ethiopia,Italy,1031,114,0,1145
18582,2020,Gabon,Italy,0,9,0,9
18583,2020,Gambia,Italy,5740,733,0,6473
18584,2020,Palestinian,Italy,677,149,0,826
18585,2020,Georgia,Italy,383,699,0,1082
18586,2020,Germany,Italy,0,6,0,6
18587,2020,Ghana,Italy,2538,638,0,3176
18588,2020,Guinea-Bissau,Italy,438,58,0,496
18589,2020,Guatemala,Italy,0,21,0,21
18590,2020,Guinea,Italy,2358,694,0,3052
18591,2020,Honduras,Italy,290,180,0,470
18592,2020,Croatia,Italy,0,6,0,6
18593,2020,Cote d'Ivoire,Italy,4116,1214,0,5330
18594,2020,India,Italy,209,452,0,661
18595,2020,Iran (Islamic Rep. of),Italy,1313,227,0,1540
18596,2020,Iraq,Italy,4938,1119,0,6057
18597,2020,Jordan,Italy,0,21,0,21
18598,2020,Kazakhstan,Italy,0,6,0,6
18599,2020,Kenya,Italy,0,27,0,27
18600,2020,Kyrgyzstan,Italy,0,27,0,27
18601,2020,Liberia,Italy,317,41,0,358
18602,2020,Libya,Italy,1027,251,0,1278
18603,2020,Lebanon,Italy,0,55,0,55
18604,2020,Liechtenstein,Italy,0,5,0,5
18605,2020,Sri Lanka,Italy,338,234,0,572
18606,2020,Madagascar,Italy,0,5,0,5
18607,2020,Mauritania,Italy,286,6,0,292
18608,2020,North Macedonia,Italy,0,40,0,40
18609,2020,Rep. of Moldova,Italy,0,62,0,62
18610,2020,Mexico,Italy,0,10,0,10
18611,2020,Mali,Italy,10063,997,0,11060
18612,2020,Malaysia,Italy,0,5,0,5
18613,2020,Mongolia,Italy,0,5,0,5
18614,2020,Morocco,Italy,699,787,0,1486
18615,2020,Montenegro,Italy,0,6,0,6
18616,2020,Mauritius,Italy,0,18,0,18
18617,2020,Myanmar,Italy,0,6,0,6
18618,2020,Nepal,Italy,0,49,0,49
18619,2020,Niger,Italy,459,61,0,520
18620,2020,Nicaragua,Italy,0,23,0,23
18621,2020,Nigeria,Italy,18473,5104,0,23577
18622,2020,Pakistan,Italy,14484,9415,0,23899
18623,2020,Paraguay,Italy,0,12,0,12
18624,2020,Peru,Italy,276,931,0,1207
18625,2020,Philippines,Italy,0,67,0,67
18626,2020,Russian Federation,Italy,214,101,0,315
18627,2020,Rwanda,Italy,0,5,0,5
18628,2020,El Salvador,Italy,2826,1298,0,4124
18629,2020,Serbia and Kosovo: S/RES/1244 (1999),Italy,1253,423,0,1676
18630,2020,Senegal,Italy,4324,796,0,5120
18631,2020,Sierra Leone,Italy,434,128,0,562
18632,2020,Somalia,Italy,7704,930,0,8634
18633,2020,Viet Nam,Italy,0,5,0,5
18634,2020,Sudan,Italy,1298,407,0,1705
18635,2020,South Sudan,Italy,0,10,0,10
18636,2020,Syrian Arab Rep.,Italy,3508,1037,0,4545
18637,2020,United Rep. of Tanzania,Italy,0,8,0,8
18638,2020,Togo,Italy,713,91,0,804
18639,2020,Tunisia,Italy,211,447,0,658
18640,2020,Türkiye,Italy,1560,350,0,1910
18641,2020,United Arab Emirates,Italy,0,5,0,5
18642,2020,Uganda,Italy,0,10,0,10
18643,2020,Ukraine,Italy,2920,961,0,3881
18644,2020,Uruguay,Italy,0,6,0,6
18645,2020,United States of America,Italy,0,8,0,8
18646,2020,Venezuela (Bolivarian Republic of),Italy,2119,780,0,2899
18647,2020,Western Sahara,Italy,0,5,0,5
18648,2020,Yemen,Italy,0,56,0,56
18649,2020,Zimbabwe,Italy,0,5,0,5
18650,2020,Stateless,Italy,0,16,0,16
18651,2020,Unknown ,Italy,2291,443,0,2734
18652,2020,Haiti,Jamaica,27,5,0,32
18653,2020,Venezuela (Bolivarian Republic of),Jamaica,0,0,0,0
18654,2020,Afghanistan,Jordan,8,11,0,19
18655,2020,Algeria,Jordan,0,6,0,6
18656,2020,Egypt,Jordan,114,544,0,658
18657,2020,Bangladesh,Jordan,0,7,0,7
18658,2020,Bosnia and Herzegovina,Jordan,9,0,0,9
18659,2020,Bulgaria,Jordan,0,0,0,0
18660,2020,Central African Rep.,Jordan,5,0,0,5
18661,2020,Chad,Jordan,9,14,0,23
18662,2020,Comoros,Jordan,0,5,0,5
18663,2020,Eritrea,Jordan,30,11,0,41
18664,2020,Ethiopia,Jordan,13,27,0,40
18665,2020,Palestinian,Jordan,0,0,0,0
18666,2020,Ghana,Jordan,0,5,0,5
18667,2020,India,Jordan,0,6,0,6
18668,2020,Iran (Islamic Rep. of),Jordan,5,0,0,5
18669,2020,Iraq,Jordan,34318,32474,0,66792
18670,2020,Jordan,Jordan,0,0,0,0
18671,2020,Kenya,Jordan,0,6,0,6
18672,2020,Kuwait,Jordan,0,0,0,0
18673,2020,Libya,Jordan,46,117,0,163
18674,2020,Lebanon,Jordan,6,108,0,114
18675,2020,Sri Lanka,Jordan,7,6,0,13
18676,2020,Morocco,Jordan,0,10,0,10
18677,2020,Niger,Jordan,0,6,0,6
18678,2020,Nigeria,Jordan,0,66,0,66
18679,2020,Pakistan,Jordan,5,25,0,30
18680,2020,Philippines,Jordan,0,5,0,5
18681,2020,South Africa,Jordan,0,5,0,5
18682,2020,Russian Federation,Jordan,24,11,0,35
18683,2020,Saudi Arabia,Jordan,0,8,0,8
18684,2020,Senegal,Jordan,0,5,0,5
18685,2020,Somalia,Jordan,665,62,0,727
18686,2020,Sudan,Jordan,3562,2470,0,6032
18687,2020,South Sudan,Jordan,11,7,0,18
18688,2020,Syrian Arab Rep.,Jordan,662790,0,0,662790
18689,2020,Tajikistan,Jordan,0,15,0,15
18690,2020,Tunisia,Jordan,11,9,0,20
18691,2020,United Arab Emirates,Jordan,0,5,0,5
18692,2020,Uganda,Jordan,5,0,0,5
18693,2020,Ukraine,Jordan,0,10,0,10
18694,2020,United States of America,Jordan,0,0,0,0
18695,2020,Venezuela (Bolivarian Republic of),Jordan,0,5,0,5
18696,2020,Yemen,Jordan,818,13552,0,14370
18697,2020,Stateless,Jordan,0,63,0,63
18698,2020,Afghanistan,Japan,73,0,0,73
18699,2020,Burundi,Japan,9,0,0,9
18700,2020,Bangladesh,Japan,18,0,0,18
18701,2020,China,Japan,55,0,0,55
18702,2020,Cameroon,Japan,17,0,0,17
18703,2020,Dem. Rep. of the Congo,Japan,23,0,0,23
18704,2020,Ethiopia,Japan,27,0,0,27
18705,2020,Guinea,Japan,5,0,0,5
18706,2020,Iran (Islamic Rep. of),Japan,14,0,0,14
18707,2020,Iraq,Japan,15,0,0,15
18708,2020,Sri Lanka,Japan,54,0,0,54
18709,2020,Myanmar,Japan,285,0,0,285
18710,2020,Nigeria,Japan,5,0,0,5
18711,2020,Pakistan,Japan,33,0,0,33
18712,2020,Rwanda,Japan,5,0,0,5
18713,2020,Somalia,Japan,5,0,0,5
18714,2020,Sudan,Japan,16,0,0,16
18715,2020,Syrian Arab Rep.,Japan,73,0,0,73
18716,2020,Türkiye,Japan,46,0,0,46
18717,2020,Uganda,Japan,5,0,0,5
18718,2020,Yemen,Japan,11,0,0,11
18719,2020,Stateless,Japan,11,0,0,11
18720,2020,Unknown ,Japan,327,23765,0,24092
18721,2020,Afghanistan,Kazakhstan,408,198,0,606
18722,2020,China,Kazakhstan,5,7,0,12
18723,2020,Syrian Arab Rep.,Kazakhstan,14,18,0,32
18724,2020,Uzbekistan,Kazakhstan,13,0,0,13
18725,2020,Stateless,Kazakhstan,0,0,0,0
18726,2020,Afghanistan,Kenya,11,8,0,19
18727,2020,Egypt,Kenya,0,21,0,21
18728,2020,Burundi,Kenya,6759,9761,0,16520
18729,2020,Central African Rep.,Kenya,0,10,0,10
18730,2020,Cameroon,Kenya,0,55,0,55
18731,2020,Congo,Kenya,87,85,0,172
18732,2020,Dem. Rep. of the Congo,Kenya,29625,15641,0,45266
18733,2020,Eritrea,Kenya,888,1007,0,1895
18734,2020,Ethiopia,Kenya,20442,8762,0,29204
18735,2020,Cote d'Ivoire,Kenya,5,5,0,10
18736,2020,India,Kenya,0,5,0,5
18737,2020,Iraq,Kenya,5,0,0,5
18738,2020,Kenya,Kenya,0,0,0,0
18739,2020,Sri Lanka,Kenya,9,0,0,9
18740,2020,Mozambique,Kenya,8,0,0,8
18741,2020,Nigeria,Kenya,6,13,0,19
18742,2020,Pakistan,Kenya,9,8,0,17
18743,2020,Rwanda,Kenya,744,1127,0,1871
18744,2020,Somalia,Kenya,265352,7138,0,272490
18745,2020,Sudan,Kenya,3998,6111,0,10109
18746,2020,South Sudan,Kenya,123912,56,0,123968
18747,2020,Syrian Arab Rep.,Kenya,5,5,0,10
18748,2020,United Rep. of Tanzania,Kenya,16,45,0,61
18749,2020,Türkiye,Kenya,108,51,0,159
18750,2020,Uganda,Kenya,837,1789,0,2626
18751,2020,Yemen,Kenya,85,206,0,291
18752,2020,Zimbabwe,Kenya,5,7,0,12
18753,2020,Stateless,Kenya,0,0,0,0
18754,2020,Afghanistan,Kyrgyzstan,219,41,0,260
18755,2020,Iraq,Kyrgyzstan,6,0,0,6
18756,2020,Syrian Arab Rep.,Kyrgyzstan,78,8,0,86
18757,2020,Tajikistan,Kyrgyzstan,5,0,0,5
18758,2020,Turkmenistan,Kyrgyzstan,5,0,0,5
18759,2020,Türkiye,Kyrgyzstan,0,289,0,289
18760,2020,Ukraine,Kyrgyzstan,21,0,0,21
18761,2020,Uzbekistan,Kyrgyzstan,0,5,0,5
18762,2020,Stateless,Kyrgyzstan,0,0,0,0
18763,2020,Afghanistan,Rep. of Korea,42,45,0,87
18764,2020,Algeria,Rep. of Korea,6,207,0,213
18765,2020,Angola,Rep. of Korea,5,42,0,47
18766,2020,Egypt,Rep. of Korea,44,1018,0,1062
18767,2020,Argentina,Rep. of Korea,0,9,0,9
18768,2020,Azerbaijan,Rep. of Korea,0,10,0,10
18769,2020,Burundi,Rep. of Korea,45,12,0,57
18770,2020,Bangladesh,Rep. of Korea,128,1131,0,1259
18771,2020,Burkina Faso,Rep. of Korea,0,10,0,10
18772,2020,Bolivia (Plurinational State of),Rep. of Korea,0,5,0,5
18773,2020,Brazil,Rep. of Korea,0,18,0,18
18774,2020,Cambodia,Rep. of Korea,0,56,0,56
18775,2020,China,Rep. of Korea,46,1754,0,1800
18776,2020,Chile,Rep. of Korea,0,6,0,6
18777,2020,Cameroon,Rep. of Korea,22,210,0,232
18778,2020,Congo,Rep. of Korea,0,11,0,11
18779,2020,Dem. Rep. of the Congo,Rep. of Korea,61,34,0,95
18780,2020,Colombia,Rep. of Korea,0,14,0,14
18781,2020,Eritrea,Rep. of Korea,10,0,0,10
18782,2020,Ethiopia,Rep. of Korea,160,172,0,332
18783,2020,Gabon,Rep. of Korea,0,5,0,5
18784,2020,Gambia,Rep. of Korea,0,61,0,61
18785,2020,Palestinian,Rep. of Korea,8,5,0,13
18786,2020,Ghana,Rep. of Korea,7,238,0,245
18787,2020,Guinea-Bissau,Rep. of Korea,0,11,0,11
18788,2020,Guinea,Rep. of Korea,0,135,0,135
18789,2020,Haiti,Rep. of Korea,0,24,0,24
18790,2020,Cote d'Ivoire,Rep. of Korea,38,29,0,67
18791,2020,India,Rep. of Korea,0,1827,0,1827
18792,2020,Indonesia,Rep. of Korea,0,46,0,46
18793,2020,Iran (Islamic Rep. of),Rep. of Korea,61,60,0,121
18794,2020,Iraq,Rep. of Korea,28,46,0,74
18795,2020,Jordan,Rep. of Korea,7,14,0,21
18796,2020,Kazakhstan,Rep. of Korea,5,1957,0,1962
18797,2020,Kenya,Rep. of Korea,5,55,0,60
18798,2020,Kyrgyzstan,Rep. of Korea,0,117,0,117
18799,2020,Lao People's Dem. Rep.,Rep. of Korea,0,5,0,5
18800,2020,Liberia,Rep. of Korea,12,267,0,279
18801,2020,Libya,Rep. of Korea,9,48,0,57
18802,2020,Sri Lanka,Rep. of Korea,8,300,0,308
18803,2020,Mali,Rep. of Korea,7,94,0,101
18804,2020,Malaysia,Rep. of Korea,0,1848,0,1848
18805,2020,Mongolia,Rep. of Korea,0,370,0,370
18806,2020,Morocco,Rep. of Korea,5,405,0,410
18807,2020,Mozambique,Rep. of Korea,0,6,0,6
18808,2020,Myanmar,Rep. of Korea,390,51,0,441
18809,2020,Nepal,Rep. of Korea,5,487,0,492
18810,2020,Niger,Rep. of Korea,0,5,0,5
18811,2020,Nigeria,Rep. of Korea,12,445,0,457
18812,2020,Pakistan,Rep. of Korea,112,1442,0,1554
18813,2020,Peru,Rep. of Korea,0,12,0,12
18814,2020,Philippines,Rep. of Korea,0,546,0,546
18815,2020,South Africa,Rep. of Korea,0,100,0,100
18816,2020,Russian Federation,Rep. of Korea,13,2421,0,2434
18817,2020,Rwanda,Rep. of Korea,0,28,0,28
18818,2020,Saudi Arabia,Rep. of Korea,0,8,0,8
18819,2020,Senegal,Rep. of Korea,0,92,0,92
18820,2020,Sierra Leone,Rep. of Korea,0,18,0,18
18821,2020,Somalia,Rep. of Korea,5,0,0,5
18822,2020,Viet Nam,Rep. of Korea,0,239,0,239
18823,2020,Sudan,Rep. of Korea,31,62,0,93
18824,2020,South Sudan,Rep. of Korea,0,5,0,5
18825,2020,Syrian Arab Rep.,Rep. of Korea,1236,35,0,1271
18826,2020,United Rep. of Tanzania,Rep. of Korea,5,43,0,48
18827,2020,Thailand,Rep. of Korea,10,354,0,364
18828,2020,Tajikistan,Rep. of Korea,0,11,0,11
18829,2020,Togo,Rep. of Korea,0,17,0,17
18830,2020,Tunisia,Rep. of Korea,0,94,0,94
18831,2020,Türkiye,Rep. of Korea,0,359,0,359
18832,2020,Uganda,Rep. of Korea,37,67,0,104
18833,2020,Ukraine,Rep. of Korea,14,30,0,44
18834,2020,United States of America,Rep. of Korea,0,5,0,5
18835,2020,Uzbekistan,Rep. of Korea,9,306,0,315
18836,2020,Venezuela (Bolivarian Republic of),Rep. of Korea,0,11,0,11
18837,2020,Yemen,Rep. of Korea,795,26,0,821
18838,2020,Zimbabwe,Rep. of Korea,0,11,0,11
18839,2020,Stateless,Rep. of Korea,0,6,0,6
18840,2020,Afghanistan,Kuwait,0,17,0,17
18841,2020,Egypt,Kuwait,5,19,0,24
18842,2020,Djibouti,Kuwait,0,5,0,5
18843,2020,Eritrea,Kuwait,5,28,0,33
18844,2020,Ethiopia,Kuwait,0,11,0,11
18845,2020,Palestinian,Kuwait,0,5,0,5
18846,2020,Iran (Islamic Rep. of),Kuwait,9,83,0,92
18847,2020,Iraq,Kuwait,351,299,0,650
18848,2020,Jordan,Kuwait,0,6,0,6
18849,2020,Lebanon,Kuwait,0,5,0,5
18850,2020,Sri Lanka,Kuwait,0,6,0,6
18851,2020,Pakistan,Kuwait,0,12,0,12
18852,2020,Philippines,Kuwait,0,5,0,5
18853,2020,Somalia,Kuwait,217,444,0,661
18854,2020,Sudan,Kuwait,0,17,0,17
18855,2020,Syrian Arab Rep.,Kuwait,139,77,0,216
18856,2020,Ukraine,Kuwait,0,5,0,5
18857,2020,Yemen,Kuwait,6,10,0,16
18858,2020,Stateless,Kuwait,0,0,0,0
18859,2020,Burkina Faso,Liberia,0,5,0,5
18860,2020,Cameroon,Liberia,5,0,0,5
18861,2020,Dem. Rep. of the Congo,Liberia,21,0,0,21
18862,2020,Cote d'Ivoire,Liberia,8112,10643,0,18755
18863,2020,Mali,Liberia,19,0,0,19
18864,2020,Nigeria,Liberia,0,5,0,5
18865,2020,Pakistan,Liberia,5,0,0,5
18866,2020,Somalia,Liberia,5,0,0,5
18867,2020,Sudan,Liberia,8,0,0,8
18868,2020,South Sudan,Liberia,5,0,0,5
18869,2020,Syrian Arab Rep.,Liberia,12,15,0,27
18870,2020,Togo,Liberia,5,0,0,5
18871,2020,Türkiye,Liberia,16,0,0,16
18872,2020,Afghanistan,Libya,0,5,0,5
18873,2020,Burkina Faso,Libya,0,5,0,5
18874,2020,Chad,Libya,0,15,0,15
18875,2020,Congo,Libya,0,5,0,5
18876,2020,Dem. Rep. of the Congo,Libya,0,5,0,5
18877,2020,Eritrea,Libya,438,4994,0,5432
18878,2020,Ethiopia,Libya,25,1060,0,1085
18879,2020,Palestinian,Libya,1282,2541,0,3823
18880,2020,Cote d'Ivoire,Libya,0,5,0,5
18881,2020,Iraq,Libya,607,329,0,936
18882,2020,Libya,Libya,0,0,278177,0
18883,2020,Mali,Libya,0,26,0,26
18884,2020,Niger,Libya,0,5,0,5
18885,2020,Nigeria,Libya,0,38,0,38
18886,2020,Rwanda,Libya,5,0,0,5
18887,2020,Somalia,Libya,67,2514,0,2581
18888,2020,Sudan,Libya,1002,14297,0,15299
18889,2020,South Sudan,Libya,6,290,0,296
18890,2020,Syrian Arab Rep.,Libya,717,13819,0,14536
18891,2020,Yemen,Libya,0,86,0,86
18892,2020,Afghanistan,Lebanon,13,7,0,20
18893,2020,Algeria,Lebanon,6,7,0,13
18894,2020,Egypt,Lebanon,88,300,0,388
18895,2020,Armenia,Lebanon,0,6,0,6
18896,2020,Bahrain,Lebanon,16,6,0,22
18897,2020,Bangladesh,Lebanon,0,69,0,69
18898,2020,Cameroon,Lebanon,0,34,0,34
18899,2020,Congo,Lebanon,0,5,0,5
18900,2020,Dem. Rep. of the Congo,Lebanon,0,9,0,9
18901,2020,Eritrea,Lebanon,15,24,0,39
18902,2020,Ethiopia,Lebanon,39,696,0,735
18903,2020,Gambia,Lebanon,0,6,0,6
18904,2020,Palestinian,Lebanon,0,0,0,0
18905,2020,Ghana,Lebanon,0,5,0,5
18906,2020,Cote d'Ivoire,Lebanon,0,5,0,5
18907,2020,India,Lebanon,0,5,0,5
18908,2020,Iran (Islamic Rep. of),Lebanon,35,46,0,81
18909,2020,Iraq,Lebanon,4049,7350,0,11399
18910,2020,Jordan,Lebanon,31,88,0,119
18911,2020,Kenya,Lebanon,0,15,0,15
18912,2020,Kuwait,Lebanon,9,0,0,9
18913,2020,Libya,Lebanon,10,17,0,27
18914,2020,Lebanon,Lebanon,0,0,0,0
18915,2020,Sri Lanka,Lebanon,0,13,0,13
18916,2020,Madagascar,Lebanon,0,5,0,5
18917,2020,Morocco,Lebanon,0,7,0,7
18918,2020,Nigeria,Lebanon,0,45,0,45
18919,2020,Pakistan,Lebanon,6,10,0,16
18920,2020,Philippines,Lebanon,0,23,0,23
18921,2020,Saudi Arabia,Lebanon,12,9,0,21
18922,2020,Somalia,Lebanon,11,9,0,20
18923,2020,Sudan,Lebanon,668,1341,0,2009
18924,2020,South Sudan,Lebanon,37,0,0,37
18925,2020,Syrian Arab Rep.,Lebanon,865300,0,0,865300
18926,2020,Tunisia,Lebanon,11,0,0,11
18927,2020,Türkiye,Lebanon,7,7,0,14
18928,2020,Ukraine,Lebanon,0,0,0,0
18929,2020,Venezuela (Bolivarian Republic of),Lebanon,0,5,0,5
18930,2020,Yemen,Lebanon,25,104,0,129
18931,2020,Dem. Rep. of the Congo,Lesotho,192,131,0,323
18932,2020,Eritrea,Lesotho,37,28,0,65
18933,2020,Ethiopia,Lesotho,23,9,0,32
18934,2020,Nigeria,Lesotho,0,5,0,5
18935,2020,Somalia,Lesotho,0,6,0,6
18936,2020,Uganda,Lesotho,9,0,0,9
18937,2020,Zambia,Lesotho,5,0,0,5
18938,2020,Zimbabwe,Lesotho,5,0,0,5
18939,2020,Afghanistan,Liechtenstein,5,0,0,5
18940,2020,China,Liechtenstein,35,0,0,35
18941,2020,Eritrea,Liechtenstein,12,0,0,12
18942,2020,Iran (Islamic Rep. of),Liechtenstein,7,5,0,12
18943,2020,Iraq,Liechtenstein,7,5,0,12
18944,2020,Nigeria,Liechtenstein,0,5,0,5
18945,2020,Serbia and Kosovo: S/RES/1244 (1999),Liechtenstein,0,5,0,5
18946,2020,Somalia,Liechtenstein,26,0,0,26
18947,2020,Syrian Arab Rep.,Liechtenstein,32,0,0,32
18948,2020,Ukraine,Liechtenstein,5,0,0,5
18949,2020,Afghanistan,Sri Lanka,142,25,0,167
18950,2020,Bangladesh,Sri Lanka,0,5,0,5
18951,2020,Palestinian,Sri Lanka,5,5,0,10
18952,2020,Iran (Islamic Rep. of),Sri Lanka,25,7,0,32
18953,2020,Sri Lanka,Sri Lanka,0,0,25013,0
18954,2020,Myanmar,Sri Lanka,34,0,0,34
18955,2020,Nigeria,Sri Lanka,0,5,0,5
18956,2020,Pakistan,Sri Lanka,776,177,0,953
18957,2020,Sudan,Sri Lanka,5,0,0,5
18958,2020,Syrian Arab Rep.,Sri Lanka,5,0,0,5
18959,2020,Yemen,Sri Lanka,16,0,0,16
18960,2020,Stateless,Sri Lanka,0,0,0,0
18961,2020,Afghanistan,Lithuania,230,9,0,239
18962,2020,Azerbaijan,Lithuania,17,0,0,17
18963,2020,Belarus,Lithuania,35,65,0,100
18964,2020,Chile,Lithuania,0,5,0,5
18965,2020,Cameroon,Lithuania,6,0,0,6
18966,2020,Cuba,Lithuania,5,0,0,5
18967,2020,Eritrea,Lithuania,40,0,0,40
18968,2020,Ethiopia,Lithuania,5,0,0,5
18969,2020,Georgia,Lithuania,5,0,0,5
18970,2020,Iran (Islamic Rep. of),Lithuania,13,0,0,13
18971,2020,Iraq,Lithuania,65,15,0,80
18972,2020,Sri Lanka,Lithuania,10,5,0,15
18973,2020,Nigeria,Lithuania,5,0,0,5
18974,2020,Pakistan,Lithuania,5,0,0,5
18975,2020,Russian Federation,Lithuania,688,8,0,696
18976,2020,Somalia,Lithuania,22,0,0,22
18977,2020,Syrian Arab Rep.,Lithuania,463,5,0,468
18978,2020,Tajikistan,Lithuania,85,5,0,90
18979,2020,Türkiye,Lithuania,63,0,0,63
18980,2020,Ukraine,Lithuania,64,5,0,69
18981,2020,Uzbekistan,Lithuania,17,0,0,17
18982,2020,Stateless,Lithuania,37,0,0,37
18983,2020,Afghanistan,Luxembourg,317,146,0,463
18984,2020,Albania,Luxembourg,38,14,0,52
18985,2020,Algeria,Luxembourg,0,15,0,15
18986,2020,Angola,Luxembourg,9,5,0,14
18987,2020,Armenia,Luxembourg,5,0,0,5
18988,2020,Azerbaijan,Luxembourg,13,0,0,13
18989,2020,Burundi,Luxembourg,5,0,0,5
18990,2020,Benin,Luxembourg,0,5,0,5
18991,2020,Bhutan,Luxembourg,5,0,0,5
18992,2020,Belarus,Luxembourg,0,7,0,7
18993,2020,Bosnia and Herzegovina,Luxembourg,5,0,0,5
18994,2020,China,Luxembourg,7,0,0,7
18995,2020,Cameroon,Luxembourg,17,20,0,37
18996,2020,Dem. Rep. of the Congo,Luxembourg,43,6,0,49
18997,2020,Colombia,Luxembourg,0,10,0,10
18998,2020,Eritrea,Luxembourg,1044,317,0,1361
18999,2020,Ethiopia,Luxembourg,58,18,0,76
19000,2020,Gabon,Luxembourg,5,0,0,5
19001,2020,Gambia,Luxembourg,6,5,0,11
19002,2020,Palestinian,Luxembourg,0,27,0,27
19003,2020,Georgia,Luxembourg,0,5,0,5
19004,2020,Guinea,Luxembourg,12,22,0,34
19005,2020,Cote d'Ivoire,Luxembourg,5,10,0,15
19006,2020,Iran (Islamic Rep. of),Luxembourg,196,65,0,261
19007,2020,Iraq,Luxembourg,773,59,0,832
19008,2020,Dem. People's Rep. of Korea,Luxembourg,11,0,0,11
19009,2020,Kuwait,Luxembourg,0,5,0,5
19010,2020,Libya,Luxembourg,5,9,0,14
19011,2020,Lebanon,Luxembourg,5,5,0,10
19012,2020,Sri Lanka,Luxembourg,5,0,0,5
19013,2020,Mali,Luxembourg,0,5,0,5
19014,2020,Morocco,Luxembourg,0,14,0,14
19015,2020,Montenegro,Luxembourg,6,0,0,6
19016,2020,Nigeria,Luxembourg,9,0,0,9
19017,2020,Pakistan,Luxembourg,0,6,0,6
19018,2020,Russian Federation,Luxembourg,17,8,0,25
19019,2020,Rwanda,Luxembourg,13,0,0,13
19020,2020,Serbia and Kosovo: S/RES/1244 (1999),Luxembourg,130,0,0,130
19021,2020,Senegal,Luxembourg,5,5,0,10
19022,2020,Somalia,Luxembourg,47,31,0,78
19023,2020,Sudan,Luxembourg,46,28,0,74
19024,2020,South Sudan,Luxembourg,0,5,0,5
19025,2020,Syrian Arab Rep.,Luxembourg,2069,340,0,2409
19026,2020,Tajikistan,Luxembourg,0,5,0,5
19027,2020,Turkmenistan,Luxembourg,5,0,0,5
19028,2020,Togo,Luxembourg,8,0,0,8
19029,2020,Tunisia,Luxembourg,0,12,0,12
19030,2020,Türkiye,Luxembourg,68,77,0,145
19031,2020,Uganda,Luxembourg,5,0,0,5
19032,2020,Ukraine,Luxembourg,5,5,0,10
19033,2020,Venezuela (Bolivarian Republic of),Luxembourg,5,74,0,79
19034,2020,Yemen,Luxembourg,20,10,0,30
19035,2020,Stateless,Luxembourg,111,0,0,111
19036,2020,Unknown ,Luxembourg,0,0,0,0
19037,2020,Afghanistan,Latvia,63,5,0,68
19038,2020,Egypt,Latvia,5,0,0,5
19039,2020,Azerbaijan,Latvia,11,5,0,16
19040,2020,Bangladesh,Latvia,0,5,0,5
19041,2020,Belarus,Latvia,12,33,0,45
19042,2020,China,Latvia,0,5,0,5
19043,2020,Eritrea,Latvia,35,0,0,35
19044,2020,Palestinian,Latvia,7,0,0,7
19045,2020,Georgia,Latvia,0,5,0,5
19046,2020,Iran (Islamic Rep. of),Latvia,20,0,0,20
19047,2020,Iraq,Latvia,39,0,0,39
19048,2020,Kazakhstan,Latvia,5,0,0,5
19049,2020,Kyrgyzstan,Latvia,5,0,0,5
19050,2020,Lebanon,Latvia,5,0,0,5
19051,2020,Sri Lanka,Latvia,5,0,0,5
19052,2020,Pakistan,Latvia,0,5,0,5
19053,2020,Russian Federation,Latvia,58,5,0,63
19054,2020,Somalia,Latvia,5,0,0,5
19055,2020,Syrian Arab Rep.,Latvia,314,5,0,319
19056,2020,Tajikistan,Latvia,5,0,0,5
19057,2020,Türkiye,Latvia,29,0,0,29
19058,2020,Uzbekistan,Latvia,14,0,0,14
19059,2020,Stateless,Latvia,0,0,0,0
19060,2020,Afghanistan,Madagascar,10,9,0,19
19061,2020,Burundi,Madagascar,5,0,0,5
19062,2020,Congo,Madagascar,0,5,0,5
19063,2020,Dem. Rep. of the Congo,Madagascar,10,0,0,10
19064,2020,Comoros,Madagascar,0,6,0,6
19065,2020,Guinea,Madagascar,0,5,0,5
19066,2020,Pakistan,Madagascar,53,150,0,203
19067,2020,Syrian Arab Rep.,Madagascar,5,0,0,5
19068,2020,Türkiye,Madagascar,9,5,0,14
19069,2020,Yemen,Madagascar,20,9,0,29
19070,2020,Benin,Mauritania,0,5,0,5
19071,2020,Burkina Faso,Mauritania,15,14,0,29
19072,2020,Central African Rep.,Mauritania,644,69,0,713
19073,2020,Chad,Mauritania,5,5,0,10
19074,2020,China,Mauritania,5,0,0,5
19075,2020,Cameroon,Mauritania,14,128,0,142
19076,2020,Congo,Mauritania,9,16,0,25
19077,2020,Dem. Rep. of the Congo,Mauritania,31,36,0,67
19078,2020,Ethiopia,Mauritania,7,0,0,7
19079,2020,Gambia,Mauritania,0,12,0,12
19080,2020,Palestinian,Mauritania,74,30,0,104
19081,2020,Ghana,Mauritania,0,12,0,12
19082,2020,Guinea-Bissau,Mauritania,0,10,0,10
19083,2020,Guinea,Mauritania,7,134,0,141
19084,2020,Cote d'Ivoire,Mauritania,278,138,0,416
19085,2020,Iraq,Mauritania,25,0,0,25
19086,2020,Liberia,Mauritania,7,21,0,28
19087,2020,Libya,Mauritania,0,17,0,17
19088,2020,Mali,Mauritania,65947,763,0,66710
19089,2020,Niger,Mauritania,0,5,0,5
19090,2020,Nigeria,Mauritania,11,86,0,97
19091,2020,Russian Federation,Mauritania,0,9,0,9
19092,2020,Senegal,Mauritania,88,131,0,219
19093,2020,Sierra Leone,Mauritania,0,75,0,75
19094,2020,Sudan,Mauritania,11,12,0,23
19095,2020,Syrian Arab Rep.,Mauritania,364,55,0,419
19096,2020,Togo,Mauritania,24,123,0,147
19097,2020,Türkiye,Mauritania,5,27,0,32
19098,2020,Western Sahara,Mauritania,26000,0,0,26000
19099,2020,Yemen,Mauritania,36,27,0,63
19100,2020,Afghanistan,North Macedonia,6,6,0,12
19101,2020,Congo,North Macedonia,5,0,0,5
19102,2020,Pakistan,North Macedonia,5,0,0,5
19103,2020,Serbia and Kosovo: S/RES/1244 (1999),North Macedonia,270,5,0,275
19104,2020,Syrian Arab Rep.,North Macedonia,17,5,0,22
19105,2020,Türkiye,North Macedonia,0,5,0,5
19106,2020,Stateless,North Macedonia,0,0,0,0
19107,2020,Unknown ,Monaco,22,0,0,22
19108,2020,Afghanistan,Rep. of Moldova,24,0,0,24
19109,2020,Armenia,Rep. of Moldova,15,7,0,22
19110,2020,Azerbaijan,Rep. of Moldova,5,0,0,5
19111,2020,Bangladesh,Rep. of Moldova,0,7,0,7
19112,2020,Palestinian,Rep. of Moldova,5,0,0,5
19113,2020,Iran (Islamic Rep. of),Rep. of Moldova,5,0,0,5
19114,2020,Iraq,Rep. of Moldova,17,0,0,17
19115,2020,Kyrgyzstan,Rep. of Moldova,11,0,0,11
19116,2020,Libya,Rep. of Moldova,5,0,0,5
19117,2020,Russian Federation,Rep. of Moldova,5,0,0,5
19118,2020,Sudan,Rep. of Moldova,8,0,0,8
19119,2020,Syrian Arab Rep.,Rep. of Moldova,190,5,0,195
19120,2020,Tajikistan,Rep. of Moldova,8,5,0,13
19121,2020,Turkmenistan,Rep. of Moldova,5,0,0,5
19122,2020,Türkiye,Rep. of Moldova,53,23,0,76
19123,2020,Ukraine,Rep. of Moldova,33,5,0,38
19124,2020,Uzbekistan,Rep. of Moldova,8,7,0,15
19125,2020,Yemen,Rep. of Moldova,8,0,0,8
19126,2020,Stateless,Rep. of Moldova,0,0,0,0
19127,2020,Afghanistan,Mexico,5,0,0,5
19128,2020,Albania,Mexico,8,0,0,8
19129,2020,Algeria,Mexico,5,0,0,5
19130,2020,Angola,Mexico,9,219,0,228
19131,2020,Egypt,Mexico,5,0,0,5
19132,2020,Argentina,Mexico,5,68,0,73
19133,2020,Benin,Mexico,0,8,0,8
19134,2020,Bangladesh,Mexico,7,26,0,33
19135,2020,Burkina Faso,Mexico,5,18,0,23
19136,2020,Bolivia (Plurinational State of),Mexico,0,16,0,16
19137,2020,Brazil,Mexico,60,757,0,817
19138,2020,Belize,Mexico,10,30,0,40
19139,2020,Cambodia,Mexico,24,45,0,69
19140,2020,Canada,Mexico,0,5,0,5
19141,2020,China,Mexico,5,20,0,25
19142,2020,Chile,Mexico,193,833,0,1026
19143,2020,Cameroon,Mexico,23,378,0,401
19144,2020,Congo,Mexico,21,73,0,94
19145,2020,Dem. Rep. of the Congo,Mexico,67,288,0,355
19146,2020,Colombia,Mexico,448,899,0,1347
19147,2020,Costa Rica,Mexico,5,62,0,67
19148,2020,Cuba,Mexico,1955,8370,0,10325
19149,2020,Dominica,Mexico,0,5,0,5
19150,2020,Dominican Rep.,Mexico,18,55,0,73
19151,2020,Ecuador,Mexico,19,131,0,150
19152,2020,Eritrea,Mexico,7,74,0,81
19153,2020,Ethiopia,Mexico,5,20,0,25
19154,2020,France,Mexico,0,5,0,5
19155,2020,Palestinian,Mexico,5,0,0,5
19156,2020,Ghana,Mexico,21,175,0,196
19157,2020,Guatemala,Mexico,1933,5118,0,7051
19158,2020,Guinea,Mexico,10,76,0,86
19159,2020,Guyana,Mexico,0,5,0,5
19160,2020,Haiti,Mexico,1342,8708,0,10050
19161,2020,Honduras,Mexico,15676,35871,0,51547
19162,2020,Cote d'Ivoire,Mexico,5,19,0,24
19163,2020,India,Mexico,13,66,0,79
19164,2020,Iran (Islamic Rep. of),Mexico,40,6,0,46
19165,2020,Iraq,Mexico,44,5,0,49
19166,2020,Italy,Mexico,0,5,0,5
19167,2020,Jamaica,Mexico,6,5,0,11
19168,2020,Kyrgyzstan,Mexico,5,11,0,16
19169,2020,Rep. of Korea,Mexico,0,5,0,5
19170,2020,Liberia,Mexico,0,5,0,5
19171,2020,Sri Lanka,Mexico,20,42,0,62
19172,2020,Mauritania,Mexico,0,29,0,29
19173,2020,Mali,Mexico,0,10,0,10
19174,2020,Morocco,Mexico,0,6,0,6
19175,2020,Nepal,Mexico,0,16,0,16
19176,2020,Nicaragua,Mexico,901,2461,0,3362
19177,2020,Nigeria,Mexico,44,22,0,66
19178,2020,Pakistan,Mexico,10,17,0,27
19179,2020,Panama,Mexico,20,58,0,78
19180,2020,Peru,Mexico,25,61,0,86
19181,2020,Portugal,Mexico,5,7,0,12
19182,2020,Romania,Mexico,7,5,0,12
19183,2020,South Africa,Mexico,0,11,0,11
19184,2020,Russian Federation,Mexico,41,24,0,65
19185,2020,El Salvador,Mexico,9231,10793,0,20024
19186,2020,Senegal,Mexico,0,14,0,14
19187,2020,Sierra Leone,Mexico,5,14,0,19
19188,2020,Somalia,Mexico,5,18,0,23
19189,2020,Spain,Mexico,0,10,0,10
19190,2020,Sudan,Mexico,0,10,0,10
19191,2020,Syrian Arab Rep.,Mexico,30,14,0,44
19192,2020,Tajikistan,Mexico,0,8,0,8
19193,2020,Togo,Mexico,0,24,0,24
19194,2020,Türkiye,Mexico,8,7,0,15
19195,2020,Uganda,Mexico,0,78,0,78
19196,2020,Ukraine,Mexico,17,5,0,22
19197,2020,Uruguay,Mexico,0,22,0,22
19198,2020,United States of America,Mexico,27,85,0,112
19199,2020,Uzbekistan,Mexico,0,16,0,16
19200,2020,Venezuela (Bolivarian Republic of),Mexico,13014,7362,0,20376
19201,2020,Yemen,Mexico,15,58,0,73
19202,2020,Stateless,Mexico,0,0,0,0
19203,2020,Unknown ,Mexico,0,0,0,0
19204,2020,Burundi,Mali,12,6,0,18
19205,2020,Bangladesh,Mali,0,32,0,32
19206,2020,Burkina Faso,Mali,12890,0,0,12890
19207,2020,Central African Rep.,Mali,945,339,0,1284
19208,2020,Cameroon,Mali,5,7,0,12
19209,2020,Congo,Mali,30,5,0,35
19210,2020,Dem. Rep. of the Congo,Mali,272,60,0,332
19211,2020,Eritrea,Mali,5,0,0,5
19212,2020,Guinea,Mali,0,5,0,5
19213,2020,Cote d'Ivoire,Mali,520,44,0,564
19214,2020,Mauritania,Mali,15697,0,0,15697
19215,2020,Mali,Mali,0,0,332957,0
19216,2020,Niger,Mali,16938,0,0,16938
19217,2020,Nigeria,Mali,0,5,0,5
19218,2020,Pakistan,Mali,10,0,0,10
19219,2020,Rwanda,Mali,7,10,0,17
19220,2020,Syrian Arab Rep.,Mali,20,434,0,454
19221,2020,Togo,Mali,21,6,0,27
19222,2020,Türkiye,Mali,8,16,0,24
19223,2020,Afghanistan,Malaysia,1517,1153,0,2670
19224,2020,Algeria,Malaysia,0,8,0,8
19225,2020,Egypt,Malaysia,14,84,0,98
19226,2020,Australia,Malaysia,5,0,0,5
19227,2020,Bangladesh,Malaysia,38,15,0,53
19228,2020,Cambodia,Malaysia,77,11,0,88
19229,2020,Central African Rep.,Malaysia,5,0,0,5
19230,2020,China,Malaysia,44,5,0,49
19231,2020,Cameroon,Malaysia,5,23,0,28
19232,2020,Congo,Malaysia,0,5,0,5
19233,2020,Dem. Rep. of the Congo,Malaysia,0,7,0,7
19234,2020,Eritrea,Malaysia,9,19,0,28
19235,2020,Ethiopia,Malaysia,12,11,0,23
19236,2020,Palestinian,Malaysia,216,540,0,756
19237,2020,United Kingdom of Great Britain and Northern Ireland,Malaysia,6,0,0,6
19238,2020,Guinea,Malaysia,5,27,0,32
19239,2020,Cote d'Ivoire,Malaysia,5,0,0,5
19240,2020,India,Malaysia,5,12,0,17
19241,2020,Indonesia,Malaysia,985,5,0,990
19242,2020,Iran (Islamic Rep. of),Malaysia,253,188,0,441
19243,2020,Iraq,Malaysia,411,801,0,1212
19244,2020,Jordan,Malaysia,5,5,0,10
19245,2020,Liberia,Malaysia,20,9,0,29
19246,2020,Libya,Malaysia,11,18,0,29
19247,2020,Lebanon,Malaysia,5,6,0,11
19248,2020,Sri Lanka,Malaysia,794,947,0,1741
19249,2020,Mali,Malaysia,5,0,0,5
19250,2020,Morocco,Malaysia,5,0,0,5
19251,2020,Myanmar,Malaysia,119578,34459,0,154037
19252,2020,Nepal,Malaysia,11,0,0,11
19253,2020,Nigeria,Malaysia,5,36,0,41
19254,2020,Pakistan,Malaysia,3166,3453,0,6619
19255,2020,Philippines,Malaysia,20,0,0,20
19256,2020,Russian Federation,Malaysia,6,0,0,6
19257,2020,Sierra Leone,Malaysia,11,37,0,48
19258,2020,Somalia,Malaysia,1786,1445,0,3231
19259,2020,Viet Nam,Malaysia,5,0,0,5
19260,2020,Sudan,Malaysia,163,140,0,303
19261,2020,South Sudan,Malaysia,16,38,0,54
19262,2020,Syrian Arab Rep.,Malaysia,407,2850,0,3257
19263,2020,Thailand,Malaysia,27,23,0,50
19264,2020,Uganda,Malaysia,0,6,0,6
19265,2020,United States of America,Malaysia,7,0,0,7
19266,2020,Uzbekistan,Malaysia,0,8,0,8
19267,2020,Yemen,Malaysia,232,3423,0,3655
19268,2020,Zimbabwe,Malaysia,5,5,0,10
19269,2020,Stateless,Malaysia,0,0,0,0
19270,2020,Burundi,Malawi,2701,8281,0,10982
19271,2020,Dem. Rep. of the Congo,Malawi,9837,20102,0,29939
19272,2020,Ethiopia,Malawi,8,53,0,61
19273,2020,Cote d'Ivoire,Malawi,5,0,0,5
19274,2020,Mozambique,Malawi,0,5,0,5
19275,2020,Rwanda,Malawi,2277,4559,0,6836
19276,2020,Somalia,Malawi,54,56,0,110
19277,2020,South Sudan,Malawi,5,0,0,5
19278,2020,United Rep. of Tanzania,Malawi,0,6,0,6
19279,2020,Türkiye,Malawi,0,47,0,47
19280,2020,Uganda,Malawi,5,13,0,18
19281,2020,Zimbabwe,Malawi,0,7,0,7
19282,2020,Afghanistan,Mongolia,0,5,0,5
19283,2020,China,Mongolia,0,5,0,5
19284,2020,Mongolia,Mongolia,0,0,0,0
19285,2020,Afghanistan,Morocco,5,5,0,10
19286,2020,Algeria,Morocco,9,14,0,23
19287,2020,Angola,Morocco,0,5,0,5
19288,2020,Egypt,Morocco,5,10,0,15
19289,2020,Burundi,Morocco,7,0,0,7
19290,2020,Bangladesh,Morocco,0,132,0,132
19291,2020,Burkina Faso,Morocco,0,35,0,35
19292,2020,Central African Rep.,Morocco,585,198,0,783
19293,2020,Chad,Morocco,5,23,0,28
19294,2020,Cameroon,Morocco,143,1005,0,1148
19295,2020,Congo,Morocco,20,45,0,65
19296,2020,Dem. Rep. of the Congo,Morocco,183,158,0,341
19297,2020,Eritrea,Morocco,19,11,0,30
19298,2020,Ethiopia,Morocco,0,5,0,5
19299,2020,Gambia,Morocco,0,54,0,54
19300,2020,Palestinian,Morocco,82,138,0,220
19301,2020,Ghana,Morocco,0,11,0,11
19302,2020,Guinea-Bissau,Morocco,0,24,0,24
19303,2020,Guinea,Morocco,109,1526,0,1635
19304,2020,Cote d'Ivoire,Morocco,359,713,0,1072
19305,2020,India,Morocco,0,5,0,5
19306,2020,Iraq,Morocco,131,6,0,137
19307,2020,Jordan,Morocco,0,5,0,5
19308,2020,Liberia,Morocco,7,57,0,64
19309,2020,Libya,Morocco,48,14,0,62
19310,2020,Lebanon,Morocco,5,20,0,25
19311,2020,Sri Lanka,Morocco,0,5,0,5
19312,2020,Mauritania,Morocco,6,9,0,15
19313,2020,Mali,Morocco,42,486,0,528
19314,2020,Niger,Morocco,0,9,0,9
19315,2020,Nigeria,Morocco,22,398,0,420
19316,2020,Pakistan,Morocco,16,6,0,22
19317,2020,Senegal,Morocco,86,412,0,498
19318,2020,Sierra Leone,Morocco,0,77,0,77
19319,2020,Somalia,Morocco,19,12,0,31
19320,2020,Sudan,Morocco,20,54,0,74
19321,2020,South Sudan,Morocco,25,321,0,346
19322,2020,Syrian Arab Rep.,Morocco,4528,0,0,4528
19323,2020,Togo,Morocco,0,13,0,13
19324,2020,Tunisia,Morocco,0,5,0,5
19325,2020,Türkiye,Morocco,5,21,0,26
19326,2020,Yemen,Morocco,14,964,0,978
19327,2020,Angola,Mozambique,5,0,0,5
19328,2020,Burundi,Mozambique,905,7875,0,8780
19329,2020,Central African Rep.,Mozambique,0,12,0,12
19330,2020,Congo,Mozambique,15,36,0,51
19331,2020,Dem. Rep. of the Congo,Mozambique,2959,7121,0,10080
19332,2020,Comoros,Mozambique,0,503,0,503
19333,2020,Eritrea,Mozambique,0,27,0,27
19334,2020,Ethiopia,Mozambique,8,15,0,23
19335,2020,Guinea,Mozambique,0,5,0,5
19336,2020,Mozambique,Mozambique,0,0,668038,0
19337,2020,Rwanda,Mozambique,699,3136,0,3835
19338,2020,Somalia,Mozambique,156,3641,0,3797
19339,2020,Sudan,Mozambique,5,30,0,35
19340,2020,South Sudan,Mozambique,0,5,0,5
19341,2020,Uganda,Mozambique,5,36,0,41
19342,2020,Algeria,Malta,0,28,0,28
19343,2020,Egypt,Malta,75,91,0,166
19344,2020,Bangladesh,Malta,12,134,0,146
19345,2020,Burkina Faso,Malta,5,12,0,17
19346,2020,Belarus,Malta,9,0,0,9
19347,2020,Central African Rep.,Malta,0,8,0,8
19348,2020,Chad,Malta,9,61,0,70
19349,2020,China,Malta,17,0,0,17
19350,2020,Cameroon,Malta,10,68,0,78
19351,2020,Dem. Rep. of the Congo,Malta,5,10,0,15
19352,2020,Comoros,Malta,0,5,0,5
19353,2020,Colombia,Malta,0,26,0,26
19354,2020,Eritrea,Malta,808,365,0,1173
19355,2020,Ethiopia,Malta,175,31,0,206
19356,2020,Gambia,Malta,27,12,0,39
19357,2020,Palestinian,Malta,70,15,0,85
19358,2020,Georgia,Malta,5,14,0,19
19359,2020,Ghana,Malta,8,21,0,29
19360,2020,Guinea-Bissau,Malta,0,7,0,7
19361,2020,Guinea,Malta,0,115,0,115
19362,2020,Cote d'Ivoire,Malta,12,169,0,181
19363,2020,India,Malta,0,5,0,5
19364,2020,Iran (Islamic Rep. of),Malta,31,7,0,38
19365,2020,Iraq,Malta,81,0,0,81
19366,2020,Jordan,Malta,5,0,0,5
19367,2020,Liberia,Malta,6,0,0,6
19368,2020,Libya,Malta,2815,264,0,3079
19369,2020,Sri Lanka,Malta,7,0,0,7
19370,2020,Mauritania,Malta,0,5,0,5
19371,2020,North Macedonia,Malta,5,0,0,5
19372,2020,Mali,Malta,19,146,0,165
19373,2020,Morocco,Malta,29,94,0,123
19374,2020,Nepal,Malta,0,19,0,19
19375,2020,Niger,Malta,0,21,0,21
19376,2020,Nigeria,Malta,124,206,0,330
19377,2020,Pakistan,Malta,58,62,0,120
19378,2020,South Africa,Malta,0,5,0,5
19379,2020,Russian Federation,Malta,18,5,0,23
19380,2020,El Salvador,Malta,0,5,0,5
19381,2020,Saudi Arabia,Malta,5,0,0,5
19382,2020,Serbia and Kosovo: S/RES/1244 (1999),Malta,7,5,0,12
19383,2020,Senegal,Malta,5,56,0,61
19384,2020,Sierra Leone,Malta,5,40,0,45
19385,2020,Somalia,Malta,1782,138,0,1920
19386,2020,Sudan,Malta,218,1119,0,1337
19387,2020,South Sudan,Malta,22,106,0,128
19388,2020,Syrian Arab Rep.,Malta,1871,381,0,2252
19389,2020,Togo,Malta,5,9,0,14
19390,2020,Tunisia,Malta,13,19,0,32
19391,2020,Türkiye,Malta,7,10,0,17
19392,2020,Uganda,Malta,0,5,0,5
19393,2020,Ukraine,Malta,141,44,0,185
19394,2020,Uzbekistan,Malta,0,5,0,5
19395,2020,Venezuela (Bolivarian Republic of),Malta,6,68,0,74
19396,2020,Yemen,Malta,5,6,0,11
19397,2020,Zimbabwe,Malta,5,0,0,5
19398,2020,Stateless,Malta,0,0,0,0
19399,2020,Unknown ,Malta,626,0,0,626
19400,2020,Afghanistan,Montenegro,0,6,0,6
19401,2020,Algeria,Montenegro,0,10,0,10
19402,2020,Belarus,Montenegro,5,0,0,5
19403,2020,Bosnia and Herzegovina,Montenegro,5,0,0,5
19404,2020,Cuba,Montenegro,0,18,0,18
19405,2020,Ecuador,Montenegro,0,5,0,5
19406,2020,Palestinian,Montenegro,0,8,0,8
19407,2020,Ghana,Montenegro,5,0,0,5
19408,2020,Croatia,Montenegro,5,0,0,5
19409,2020,Iran (Islamic Rep. of),Montenegro,9,42,0,51
19410,2020,Morocco,Montenegro,0,56,0,56
19411,2020,Pakistan,Montenegro,0,9,0,9
19412,2020,Russian Federation,Montenegro,0,11,0,11
19413,2020,Serbia and Kosovo: S/RES/1244 (1999),Montenegro,130,0,0,130
19414,2020,Syrian Arab Rep.,Montenegro,0,9,0,9
19415,2020,Türkiye,Montenegro,0,14,0,14
19416,2020,Venezuela (Bolivarian Republic of),Montenegro,0,5,0,5
19417,2020,Yemen,Montenegro,7,0,0,7
19418,2020,Stateless,Montenegro,0,0,0,0
19419,2020,Dem. Rep. of the Congo,Mauritius,10,0,0,10
19420,2020,Pakistan,Mauritius,5,0,0,5
19421,2020,South Africa,Mauritius,5,0,0,5
19422,2020,Myanmar,Myanmar,0,0,370320,0
19423,2020,Stateless,Myanmar,0,0,0,0
19424,2020,Burundi,Namibia,296,165,0,461
19425,2020,Central African Rep.,Namibia,5,8,0,13
19426,2020,Cameroon,Namibia,22,21,0,43
19427,2020,Congo,Namibia,5,5,0,10
19428,2020,Dem. Rep. of the Congo,Namibia,3045,1909,0,4954
19429,2020,Kenya,Namibia,5,0,0,5
19430,2020,Nigeria,Namibia,0,6,0,6
19431,2020,Rwanda,Namibia,126,32,0,158
19432,2020,Somalia,Namibia,5,6,0,11
19433,2020,Sudan,Namibia,7,0,0,7
19434,2020,South Sudan,Namibia,0,5,0,5
19435,2020,Uganda,Namibia,5,5,0,10
19436,2020,Zimbabwe,Namibia,57,52,0,109
19437,2020,Afghanistan,Nepal,52,0,0,52
19438,2020,Bangladesh,Nepal,5,0,0,5
19439,2020,Bhutan,Nepal,6365,0,0,6365
19440,2020,India,Nepal,0,0,0,0
19441,2020,Iran (Islamic Rep. of),Nepal,9,0,0,9
19442,2020,Sri Lanka,Nepal,19,6,0,25
19443,2020,Myanmar,Nepal,359,25,0,384
19444,2020,Nepal,Nepal,0,0,0,0
19445,2020,Pakistan,Nepal,184,11,0,195
19446,2020,Somalia,Nepal,22,0,0,22
19447,2020,Stateless,Nepal,0,0,0,0
19448,2020,Tibetan,Nepal,12540,0,0,12540
19449,2020,Afghanistan,Netherlands,5319,497,0,5816
19450,2020,Albania,Netherlands,7,10,0,17
19451,2020,Algeria,Netherlands,16,343,0,359
19452,2020,Angola,Netherlands,24,23,0,47
19453,2020,Egypt,Netherlands,233,197,0,430
19454,2020,Argentina,Netherlands,6,5,0,11
19455,2020,Armenia,Netherlands,207,21,0,228
19456,2020,Azerbaijan,Netherlands,181,66,0,247
19457,2020,Bahrain,Netherlands,10,0,0,10
19458,2020,Burundi,Netherlands,92,13,0,105
19459,2020,Bangladesh,Netherlands,31,30,0,61
19460,2020,Bhutan,Netherlands,97,0,0,97
19461,2020,Burkina Faso,Netherlands,14,5,0,19
19462,2020,Belarus,Netherlands,32,55,0,87
19463,2020,Bosnia and Herzegovina,Netherlands,8,0,0,8
19464,2020,Cambodia,Netherlands,6,0,0,6
19465,2020,Central African Rep.,Netherlands,7,0,0,7
19466,2020,Chad,Netherlands,5,5,0,10
19467,2020,China,Netherlands,879,108,0,987
19468,2020,Cameroon,Netherlands,65,44,0,109
19469,2020,Congo,Netherlands,308,27,0,335
19470,2020,Dem. Rep. of the Congo,Netherlands,114,9,0,123
19471,2020,Comoros,Netherlands,0,5,0,5
19472,2020,Colombia,Netherlands,43,160,0,203
19473,2020,Cuba,Netherlands,29,29,0,58
19474,2020,Ecuador,Netherlands,7,0,0,7
19475,2020,Eritrea,Netherlands,14785,394,0,15179
19476,2020,Ethiopia,Netherlands,433,72,0,505
19477,2020,Gambia,Netherlands,31,148,0,179
19478,2020,Palestinian,Netherlands,160,21,0,181
19479,2020,Georgia,Netherlands,30,23,0,53
19480,2020,Ghana,Netherlands,7,18,0,25
19481,2020,Guinea-Bissau,Netherlands,0,10,0,10
19482,2020,Guinea,Netherlands,464,127,0,591
19483,2020,Honduras,Netherlands,0,10,0,10
19484,2020,Cote d'Ivoire,Netherlands,168,20,0,188
19485,2020,India,Netherlands,6,13,0,19
19486,2020,Indonesia,Netherlands,0,19,0,19
19487,2020,Iran (Islamic Rep. of),Netherlands,4735,2041,0,6776
19488,2020,Iraq,Netherlands,7197,497,0,7694
19489,2020,Jamaica,Netherlands,187,5,0,192
19490,2020,Jordan,Netherlands,32,128,0,160
19491,2020,Kazakhstan,Netherlands,30,22,0,52
19492,2020,Kenya,Netherlands,27,15,0,42
19493,2020,Kyrgyzstan,Netherlands,21,0,0,21
19494,2020,Dem. People's Rep. of Korea,Netherlands,35,0,0,35
19495,2020,Kuwait,Netherlands,5,7,0,12
19496,2020,Lao People's Dem. Rep.,Netherlands,10,0,0,10
19497,2020,Liberia,Netherlands,40,10,0,50
19498,2020,Libya,Netherlands,246,133,0,379
19499,2020,Lebanon,Netherlands,65,124,0,189
19500,2020,Sri Lanka,Netherlands,409,53,0,462
19501,2020,Mauritania,Netherlands,5,5,0,10
19502,2020,North Macedonia,Netherlands,0,5,0,5
19503,2020,Rep. of Moldova,Netherlands,0,18,0,18
19504,2020,Mexico,Netherlands,0,5,0,5
19505,2020,Mali,Netherlands,16,7,0,23
19506,2020,Malaysia,Netherlands,7,0,0,7
19507,2020,Mongolia,Netherlands,33,5,0,38
19508,2020,Morocco,Netherlands,58,267,0,325
19509,2020,Myanmar,Netherlands,333,26,0,359
19510,2020,Nepal,Netherlands,149,5,0,154
19511,2020,Niger,Netherlands,5,17,0,22
19512,2020,Nicaragua,Netherlands,14,33,0,47
19513,2020,Nigeria,Netherlands,288,500,0,788
19514,2020,Pakistan,Netherlands,608,284,0,892
19515,2020,Peru,Netherlands,5,10,0,15
19516,2020,Philippines,Netherlands,6,0,0,6
19517,2020,Russian Federation,Netherlands,356,140,0,496
19518,2020,Rwanda,Netherlands,41,8,0,49
19519,2020,El Salvador,Netherlands,5,48,0,53
19520,2020,Saudi Arabia,Netherlands,25,6,0,31
19521,2020,Serbia and Kosovo: S/RES/1244 (1999),Netherlands,20,22,0,42
19522,2020,Senegal,Netherlands,18,25,0,43
19523,2020,Sierra Leone,Netherlands,339,75,0,414
19524,2020,Somalia,Netherlands,9467,220,0,9687
19525,2020,Viet Nam,Netherlands,11,15,0,26
19526,2020,Sudan,Netherlands,757,115,0,872
19527,2020,Suriname,Netherlands,0,13,0,13
19528,2020,South Sudan,Netherlands,0,9,0,9
19529,2020,Syrian Arab Rep.,Netherlands,35810,2280,0,38090
19530,2020,United Rep. of Tanzania,Netherlands,5,25,0,30
19531,2020,Tajikistan,Netherlands,28,16,0,44
19532,2020,Turkmenistan,Netherlands,7,5,0,12
19533,2020,Timor-Leste,Netherlands,0,6,0,6
19534,2020,Togo,Netherlands,18,0,0,18
19535,2020,Trinidad and Tobago,Netherlands,80,5,0,85
19536,2020,Tunisia,Netherlands,22,120,0,142
19537,2020,Türkiye,Netherlands,3183,707,0,3890
19538,2020,Uganda,Netherlands,452,224,0,676
19539,2020,Ukraine,Netherlands,21,21,0,42
19540,2020,United States of America,Netherlands,29,5,0,34
19541,2020,Uzbekistan,Netherlands,15,11,0,26
19542,2020,Venezuela (Bolivarian Republic of),Netherlands,30,197,0,227
19543,2020,Yemen,Netherlands,1392,229,0,1621
19544,2020,Zambia,Netherlands,8,0,0,8
19545,2020,Zimbabwe,Netherlands,23,27,0,50
19546,2020,Stateless,Netherlands,2401,55,0,2456
19547,2020,Unknown ,Netherlands,2944,504,0,3448
19548,2020,Burkina Faso,Niger,0,0,0,0
19549,2020,Central African Rep.,Niger,159,32,0,191
19550,2020,Chad,Niger,171,1903,0,2074
19551,2020,Cameroon,Niger,19,195,0,214
19552,2020,Congo,Niger,5,6,0,11
19553,2020,Dem. Rep. of the Congo,Niger,81,13,0,94
19554,2020,Eritrea,Niger,272,91,0,363
19555,2020,Ethiopia,Niger,50,20,0,70
19556,2020,Guinea,Niger,0,11,0,11
19557,2020,Cote d'Ivoire,Niger,40,6,0,46
19558,2020,Iraq,Niger,6,0,0,6
19559,2020,Libya,Niger,8,6,0,14
19560,2020,Mali,Niger,60245,99,0,60344
19561,2020,Niger,Niger,0,0,298458,0
19562,2020,Nigeria,Niger,171014,14,0,171028
19563,2020,Pakistan,Niger,0,8,0,8
19564,2020,Rwanda,Niger,18,0,0,18
19565,2020,Somalia,Niger,140,24,0,164
19566,2020,Sudan,Niger,1042,836,0,1878
19567,2020,South Sudan,Niger,8,5,0,13
19568,2020,Syrian Arab Rep.,Niger,5,0,0,5
19569,2020,Togo,Niger,5,11,0,16
19570,2020,Yemen,Niger,5,5,0,10
19571,2020,Colombia,Nicaragua,6,0,0,6
19572,2020,Cuba,Nicaragua,14,0,0,14
19573,2020,Guatemala,Nicaragua,7,0,0,7
19574,2020,Honduras,Nicaragua,74,26,0,100
19575,2020,El Salvador,Nicaragua,210,100,0,310
19576,2020,Unknown ,Nicaragua,0,0,0,0
19577,2020,Afghanistan,Nigeria,5,0,0,5
19578,2020,Egypt,Nigeria,0,5,0,5
19579,2020,Benin,Nigeria,5,0,0,5
19580,2020,Central African Rep.,Nigeria,711,335,0,1046
19581,2020,Chad,Nigeria,86,17,0,103
19582,2020,Cameroon,Nigeria,63634,538,0,64172
19583,2020,Congo,Nigeria,5,0,0,5
19584,2020,Dem. Rep. of the Congo,Nigeria,652,107,0,759
19585,2020,Eritrea,Nigeria,32,13,0,45
19586,2020,Ethiopia,Nigeria,5,0,0,5
19587,2020,Palestinian,Nigeria,14,15,0,29
19588,2020,Ghana,Nigeria,5,5,0,10
19589,2020,Guinea-Bissau,Nigeria,5,0,0,5
19590,2020,Guinea,Nigeria,17,5,0,22
19591,2020,Cote d'Ivoire,Nigeria,136,7,0,143
19592,2020,Liberia,Nigeria,10,5,0,15
19593,2020,Lebanon,Nigeria,0,11,0,11
19594,2020,Sri Lanka,Nigeria,5,0,0,5
19595,2020,Mali,Nigeria,145,15,0,160
19596,2020,Niger,Nigeria,6,1430,0,1436
19597,2020,Nigeria,Nigeria,0,0,2610278,0
19598,2020,Sierra Leone,Nigeria,23,5,0,28
19599,2020,Sudan,Nigeria,47,7,0,54
19600,2020,Syrian Arab Rep.,Nigeria,308,216,0,524
19601,2020,Togo,Nigeria,26,10,0,36
19602,2020,Türkiye,Nigeria,174,36,0,210
19603,2020,Yemen,Nigeria,0,5,0,5
19604,2020,Afghanistan,Norway,4007,65,0,4072
19605,2020,Albania,Norway,19,14,0,33
19606,2020,Algeria,Norway,6,5,0,11
19607,2020,Angola,Norway,11,6,0,17
19608,2020,Egypt,Norway,56,0,0,56
19609,2020,Armenia,Norway,5,0,0,5
19610,2020,Azerbaijan,Norway,20,0,0,20
19611,2020,Burundi,Norway,44,0,0,44
19612,2020,Bangladesh,Norway,6,0,0,6
19613,2020,Belarus,Norway,5,0,0,5
19614,2020,Bulgaria,Norway,5,0,0,5
19615,2020,Central African Rep.,Norway,15,0,0,15
19616,2020,China,Norway,465,5,0,470
19617,2020,Cameroon,Norway,15,10,0,25
19618,2020,Congo,Norway,5,0,0,5
19619,2020,Dem. Rep. of the Congo,Norway,391,5,0,396
19620,2020,Colombia,Norway,12,13,0,25
19621,2020,Djibouti,Norway,5,0,0,5
19622,2020,Eritrea,Norway,12520,92,0,12612
19623,2020,Ethiopia,Norway,1524,53,0,1577
19624,2020,Gambia,Norway,15,0,0,15
19625,2020,United Kingdom of Great Britain and Northern Ireland,Norway,0,5,0,5
19626,2020,Georgia,Norway,5,0,0,5
19627,2020,Ghana,Norway,7,0,0,7
19628,2020,Guinea-Bissau,Norway,5,0,0,5
19629,2020,Guinea,Norway,45,0,0,45
19630,2020,Honduras,Norway,5,0,0,5
19631,2020,Cote d'Ivoire,Norway,13,5,0,18
19632,2020,Iran (Islamic Rep. of),Norway,1647,130,0,1777
19633,2020,Iraq,Norway,1207,57,0,1264
19634,2020,Israel,Norway,8,0,0,8
19635,2020,Jordan,Norway,6,0,0,6
19636,2020,Kazakhstan,Norway,15,0,0,15
19637,2020,Kenya,Norway,8,0,0,8
19638,2020,Kyrgyzstan,Norway,13,0,0,13
19639,2020,Liberia,Norway,5,0,0,5
19640,2020,Libya,Norway,56,5,0,61
19641,2020,Lebanon,Norway,25,0,0,25
19642,2020,Sri Lanka,Norway,69,5,0,74
19643,2020,Mauritania,Norway,5,0,0,5
19644,2020,Rep. of Moldova,Norway,5,0,0,5
19645,2020,Mali,Norway,8,0,0,8
19646,2020,Morocco,Norway,17,0,0,17
19647,2020,Myanmar,Norway,49,5,0,54
19648,2020,Nepal,Norway,5,0,0,5
19649,2020,Nicaragua,Norway,0,8,0,8
19650,2020,Nigeria,Norway,144,11,0,155
19651,2020,Pakistan,Norway,87,11,0,98
19652,2020,Peru,Norway,0,5,0,5
19653,2020,Russian Federation,Norway,432,15,0,447
19654,2020,Rwanda,Norway,23,5,0,28
19655,2020,El Salvador,Norway,10,0,0,10
19656,2020,Saudi Arabia,Norway,8,0,0,8
19657,2020,Serbia and Kosovo: S/RES/1244 (1999),Norway,33,7,0,40
19658,2020,Sierra Leone,Norway,11,0,0,11
19659,2020,Somalia,Norway,5263,25,0,5288
19660,2020,Viet Nam,Norway,38,0,0,38
19661,2020,Sudan,Norway,1848,9,0,1857
19662,2020,South Sudan,Norway,50,0,0,50
19663,2020,Syrian Arab Rep.,Norway,15311,340,0,15651
19664,2020,Tajikistan,Norway,5,0,0,5
19665,2020,Turkmenistan,Norway,5,0,0,5
19666,2020,Tunisia,Norway,5,0,0,5
19667,2020,Türkiye,Norway,1029,62,0,1091
19668,2020,Uganda,Norway,116,5,0,121
19669,2020,Ukraine,Norway,10,9,0,19
19670,2020,Uzbekistan,Norway,182,5,0,187
19671,2020,Venezuela (Bolivarian Republic of),Norway,15,0,0,15
19672,2020,Yemen,Norway,192,12,0,204
19673,2020,Zimbabwe,Norway,11,0,0,11
19674,2020,Stateless,Norway,2418,74,0,2492
19675,2020,Unknown ,Norway,28,0,0,28
19676,2020,Afghanistan,Nauru,29,0,0,29
19677,2020,Bangladesh,Nauru,19,20,0,39
19678,2020,India,Nauru,9,5,0,14
19679,2020,Indonesia,Nauru,5,5,0,10
19680,2020,Iran (Islamic Rep. of),Nauru,561,6,0,567
19681,2020,Iraq,Nauru,48,0,0,48
19682,2020,Kuwait,Nauru,5,0,0,5
19683,2020,Lebanon,Nauru,14,0,0,14
19684,2020,Sri Lanka,Nauru,102,18,0,120
19685,2020,Malaysia,Nauru,5,0,0,5
19686,2020,Myanmar,Nauru,74,0,0,74
19687,2020,Nepal,Nauru,11,6,0,17
19688,2020,Pakistan,Nauru,36,20,0,56
19689,2020,Somalia,Nauru,82,5,0,87
19690,2020,Sudan,Nauru,8,0,0,8
19691,2020,Syrian Arab Rep.,Nauru,0,5,0,5
19692,2020,Stateless,Nauru,66,0,0,66
19693,2020,Afghanistan,New Zealand,57,23,0,80
19694,2020,Egypt,New Zealand,33,0,0,33
19695,2020,Bahrain,New Zealand,26,0,0,26
19696,2020,Burundi,New Zealand,0,5,0,5
19697,2020,Bangladesh,New Zealand,9,14,0,23
19698,2020,Brazil,New Zealand,0,6,0,6
19699,2020,China,New Zealand,238,82,0,320
19700,2020,Chile,New Zealand,5,5,0,10
19701,2020,Cameroon,New Zealand,5,5,0,10
19702,2020,Dem. Rep. of the Congo,New Zealand,5,0,0,5
19703,2020,Colombia,New Zealand,29,16,0,45
19704,2020,Czechia,New Zealand,18,0,0,18
19705,2020,Eritrea,New Zealand,7,0,0,7
19706,2020,Ethiopia,New Zealand,11,5,0,16
19707,2020,Fiji,New Zealand,23,22,0,45
19708,2020,Palestinian,New Zealand,13,5,0,18
19709,2020,"China, Hong Kong SAR",New Zealand,0,5,0,5
19710,2020,Hungary,New Zealand,8,0,0,8
19711,2020,India,New Zealand,12,77,0,89
19712,2020,Indonesia,New Zealand,5,101,0,106
19713,2020,Ireland,New Zealand,0,5,0,5
19714,2020,Iran (Islamic Rep. of),New Zealand,126,19,0,145
19715,2020,Iraq,New Zealand,65,5,0,70
19716,2020,Jordan,New Zealand,8,0,0,8
19717,2020,Kuwait,New Zealand,5,0,0,5
19718,2020,Libya,New Zealand,22,0,0,22
19719,2020,Sri Lanka,New Zealand,45,40,0,85
19720,2020,Maldives,New Zealand,5,0,0,5
19721,2020,Mexico,New Zealand,5,0,0,5
19722,2020,Malaysia,New Zealand,11,43,0,54
19723,2020,Mongolia,New Zealand,6,6,0,12
19724,2020,Myanmar,New Zealand,12,0,0,12
19725,2020,Nepal,New Zealand,5,5,0,10
19726,2020,Pakistan,New Zealand,55,7,0,62
19727,2020,Philippines,New Zealand,7,14,0,21
19728,2020,Papua New Guinea,New Zealand,5,0,0,5
19729,2020,Portugal,New Zealand,0,5,0,5
19730,2020,South Africa,New Zealand,7,6,0,13
19731,2020,Russian Federation,New Zealand,27,16,0,43
19732,2020,El Salvador,New Zealand,5,0,0,5
19733,2020,Saudi Arabia,New Zealand,64,6,0,70
19734,2020,Somalia,New Zealand,11,0,0,11
19735,2020,Viet Nam,New Zealand,7,6,0,13
19736,2020,Sudan,New Zealand,6,5,0,11
19737,2020,Syrian Arab Rep.,New Zealand,72,0,0,72
19738,2020,Türkiye,New Zealand,54,10,0,64
19739,2020,Uganda,New Zealand,5,0,0,5
19740,2020,Uruguay,New Zealand,0,5,0,5
19741,2020,Uzbekistan,New Zealand,5,0,0,5
19742,2020,Samoa,New Zealand,0,5,0,5
19743,2020,Yemen,New Zealand,8,0,0,8
19744,2020,Zimbabwe,New Zealand,16,5,0,21
19745,2020,Unknown ,New Zealand,575,107,0,682
19746,2020,Iran (Islamic Rep. of),Oman,0,5,0,5
19747,2020,Iraq,Oman,295,303,0,598
19748,2020,Pakistan,Oman,5,0,0,5
19749,2020,Syrian Arab Rep.,Oman,8,22,0,30
19750,2020,Afghanistan,Pakistan,1438432,9668,0,1448100
19751,2020,Algeria,Pakistan,22,0,0,22
19752,2020,China,Pakistan,5,15,0,20
19753,2020,Palestinian,Pakistan,21,0,0,21
19754,2020,India,Pakistan,0,5,0,5
19755,2020,Iran (Islamic Rep. of),Pakistan,39,20,0,59
19756,2020,Iraq,Pakistan,22,7,0,29
19757,2020,Myanmar,Pakistan,23,31,0,54
19758,2020,Pakistan,Pakistan,0,0,98898,0
19759,2020,Russian Federation,Pakistan,6,0,0,6
19760,2020,Somalia,Pakistan,177,22,0,199
19761,2020,Syrian Arab Rep.,Pakistan,43,0,0,43
19762,2020,Tajikistan,Pakistan,7,0,0,7
19763,2020,Türkiye,Pakistan,6,0,0,6
19764,2020,Yemen,Pakistan,137,26,0,163
19765,2020,Stateless,Pakistan,0,0,0,0
19766,2020,Afghanistan,Panama,5,6,0,11
19767,2020,Armenia,Panama,0,5,0,5
19768,2020,Bangladesh,Panama,0,15,0,15
19769,2020,Belarus,Panama,7,0,0,7
19770,2020,Bosnia and Herzegovina,Panama,5,0,0,5
19771,2020,Cameroon,Panama,9,5,0,14
19772,2020,Dem. Rep. of the Congo,Panama,5,0,0,5
19773,2020,Colombia,Panama,1698,1114,0,2812
19774,2020,Costa Rica,Panama,0,5,0,5
19775,2020,Cuba,Panama,120,2162,0,2282
19776,2020,Dominican Rep.,Panama,5,0,0,5
19777,2020,Ecuador,Panama,0,17,0,17
19778,2020,Eritrea,Panama,0,38,0,38
19779,2020,Guatemala,Panama,12,9,0,21
19780,2020,Haiti,Panama,19,0,0,19
19781,2020,Honduras,Panama,6,88,0,94
19782,2020,Croatia,Panama,5,0,0,5
19783,2020,Cote d'Ivoire,Panama,0,5,0,5
19784,2020,India,Panama,0,5,0,5
19785,2020,Iran (Islamic Rep. of),Panama,5,0,0,5
19786,2020,Italy,Panama,0,5,0,5
19787,2020,Jamaica,Panama,0,5,0,5
19788,2020,Liberia,Panama,5,0,0,5
19789,2020,Sri Lanka,Panama,0,7,0,7
19790,2020,Mexico,Panama,6,0,0,6
19791,2020,Nepal,Panama,0,14,0,14
19792,2020,Nicaragua,Panama,179,5662,0,5841
19793,2020,Nigeria,Panama,10,34,0,44
19794,2020,Pakistan,Panama,0,17,0,17
19795,2020,Peru,Panama,23,0,0,23
19796,2020,El Salvador,Panama,363,972,0,1335
19797,2020,Sierra Leone,Panama,5,0,0,5
19798,2020,Somalia,Panama,0,101,0,101
19799,2020,Sudan,Panama,5,0,0,5
19800,2020,Ukraine,Panama,0,5,0,5
19801,2020,Venezuela (Bolivarian Republic of),Panama,65,2596,0,2661
19802,2020,Argentina,Paraguay,0,6,0,6
19803,2020,Bolivia (Plurinational State of),Paraguay,16,5,0,21
19804,2020,Brazil,Paraguay,0,5,0,5
19805,2020,Cameroon,Paraguay,0,5,0,5
19806,2020,Colombia,Paraguay,17,40,0,57
19807,2020,Cuba,Paraguay,280,559,0,839
19808,2020,Iraq,Paraguay,6,0,0,6
19809,2020,Lebanon,Paraguay,0,5,0,5
19810,2020,Sri Lanka,Paraguay,5,0,0,5
19811,2020,Nigeria,Paraguay,0,5,0,5
19812,2020,Peru,Paraguay,5,5,0,10
19813,2020,El Salvador,Paraguay,13,5,0,18
19814,2020,Syrian Arab Rep.,Paraguay,88,17,0,105
19815,2020,Türkiye,Paraguay,5,0,0,5
19816,2020,Venezuela (Bolivarian Republic of),Paraguay,1251,795,0,2046
19817,2020,Afghanistan,Peru,0,5,0,5
19818,2020,Angola,Peru,0,10,0,10
19819,2020,Argentina,Peru,0,14,0,14
19820,2020,Bangladesh,Peru,26,0,0,26
19821,2020,Bolivia (Plurinational State of),Peru,20,22,0,42
19822,2020,Brazil,Peru,5,12,0,17
19823,2020,China,Peru,0,13,0,13
19824,2020,Chile,Peru,0,12,0,12
19825,2020,Cameroon,Peru,20,0,0,20
19826,2020,Congo,Peru,0,9,0,9
19827,2020,Dem. Rep. of the Congo,Peru,8,0,0,8
19828,2020,Colombia,Peru,706,1646,0,2352
19829,2020,Costa Rica,Peru,0,5,0,5
19830,2020,Cuba,Peru,494,2775,0,3269
19831,2020,Dominica,Peru,0,5,0,5
19832,2020,Dominican Rep.,Peru,19,56,0,75
19833,2020,Ecuador,Peru,0,264,0,264
19834,2020,Ethiopia,Peru,5,0,0,5
19835,2020,Gambia,Peru,5,0,0,5
19836,2020,Palestinian,Peru,41,8,0,49
19837,2020,Germany,Peru,0,5,0,5
19838,2020,Ghana,Peru,5,0,0,5
19839,2020,Haiti,Peru,80,60,0,140
19840,2020,Honduras,Peru,0,7,0,7
19841,2020,India,Peru,6,5,0,11
19842,2020,Iran (Islamic Rep. of),Peru,6,0,0,6
19843,2020,Iraq,Peru,42,0,0,42
19844,2020,Italy,Peru,0,5,0,5
19845,2020,Jordan,Peru,0,5,0,5
19846,2020,Sri Lanka,Peru,0,7,0,7
19847,2020,Mexico,Peru,0,13,0,13
19848,2020,Morocco,Peru,0,5,0,5
19849,2020,Nepal,Peru,0,5,0,5
19850,2020,Nicaragua,Peru,7,8,0,15
19851,2020,Nigeria,Peru,24,18,0,42
19852,2020,Pakistan,Peru,0,10,0,10
19853,2020,Panama,Peru,0,11,0,11
19854,2020,Paraguay,Peru,0,5,0,5
19855,2020,Peru,Peru,0,0,0,0
19856,2020,Philippines,Peru,0,21,0,21
19857,2020,Poland,Peru,0,5,0,5
19858,2020,Portugal,Peru,0,16,0,16
19859,2020,Russian Federation,Peru,0,5,0,5
19860,2020,El Salvador,Peru,9,5,0,14
19861,2020,Spain,Peru,0,20,0,20
19862,2020,Syrian Arab Rep.,Peru,42,14,0,56
19863,2020,Turkmenistan,Peru,0,8,0,8
19864,2020,Türkiye,Peru,42,47,0,89
19865,2020,Ukraine,Peru,17,0,0,17
19866,2020,Uruguay,Peru,0,5,0,5
19867,2020,United States of America,Peru,0,5,0,5
19868,2020,Venezuela (Bolivarian Republic of),Peru,2628,532303,0,534931
19869,2020,Yemen,Peru,0,63,0,63
19870,2020,Anguilla,Peru,0,5,0,5
19871,2020,Unknown ,Peru,15,5,0,20
19872,2020,Afghanistan,Philippines,9,0,0,9
19873,2020,Egypt,Philippines,0,5,0,5
19874,2020,Burundi,Philippines,13,0,0,13
19875,2020,Cambodia,Philippines,13,0,0,13
19876,2020,Chad,Philippines,0,5,0,5
19877,2020,China,Philippines,5,5,0,10
19878,2020,Cameroon,Philippines,34,40,0,74
19879,2020,Congo,Philippines,5,8,0,13
19880,2020,Dem. Rep. of the Congo,Philippines,5,0,0,5
19881,2020,Eritrea,Philippines,20,14,0,34
19882,2020,Ethiopia,Philippines,5,0,0,5
19883,2020,Palestinian,Philippines,50,11,0,61
19884,2020,Ghana,Philippines,5,0,0,5
19885,2020,Guinea,Philippines,0,5,0,5
19886,2020,Cote d'Ivoire,Philippines,28,21,0,49
19887,2020,Iran (Islamic Rep. of),Philippines,56,14,0,70
19888,2020,Iraq,Philippines,36,10,0,46
19889,2020,Liberia,Philippines,5,5,0,10
19890,2020,Libya,Philippines,0,5,0,5
19891,2020,Lebanon,Philippines,5,8,0,13
19892,2020,Sri Lanka,Philippines,5,0,0,5
19893,2020,Morocco,Philippines,5,0,0,5
19894,2020,Myanmar,Philippines,5,0,0,5
19895,2020,Nigeria,Philippines,5,13,0,18
19896,2020,Pakistan,Philippines,102,25,0,127
19897,2020,Philippines,Philippines,0,0,150368,0
19898,2020,Russian Federation,Philippines,5,0,0,5
19899,2020,Rwanda,Philippines,9,0,0,9
19900,2020,Somalia,Philippines,29,25,0,54
19901,2020,Viet Nam,Philippines,16,5,0,21
19902,2020,Sudan,Philippines,6,32,0,38
19903,2020,Syrian Arab Rep.,Philippines,134,40,0,174
19904,2020,Thailand,Philippines,5,0,0,5
19905,2020,Türkiye,Philippines,54,19,0,73
19906,2020,United Arab Emirates,Philippines,5,7,0,12
19907,2020,United States of America,Philippines,0,5,0,5
19908,2020,Yemen,Philippines,30,65,0,95
19909,2020,Stateless,Philippines,0,0,0,0
19910,2020,Unknown ,Philippines,0,5,0,5
19911,2020,Afghanistan,Papua New Guinea,35,0,0,35
19912,2020,Bangladesh,Papua New Guinea,15,5,0,20
19913,2020,India,Papua New Guinea,0,5,0,5
19914,2020,Indonesia,Papua New Guinea,10501,0,0,10501
19915,2020,Iran (Islamic Rep. of),Papua New Guinea,90,88,0,178
19916,2020,Iraq,Papua New Guinea,32,5,0,37
19917,2020,Sri Lanka,Papua New Guinea,10,0,0,10
19918,2020,Myanmar,Papua New Guinea,5,0,0,5
19919,2020,Pakistan,Papua New Guinea,32,5,0,37
19920,2020,Papua New Guinea,Papua New Guinea,0,0,14000,0
19921,2020,Somalia,Papua New Guinea,14,0,0,14
19922,2020,Sudan,Papua New Guinea,42,0,0,42
19923,2020,Stateless,Papua New Guinea,5,0,0,5
19924,2020,Afghanistan,Poland,92,52,0,144
19925,2020,Algeria,Poland,0,5,0,5
19926,2020,Egypt,Poland,40,5,0,45
19927,2020,Armenia,Poland,5,28,0,33
19928,2020,Azerbaijan,Poland,10,8,0,18
19929,2020,Bangladesh,Poland,6,5,0,11
19930,2020,Belarus,Poland,116,304,0,420
19931,2020,Bosnia and Herzegovina,Poland,7,0,0,7
19932,2020,Central African Rep.,Poland,5,0,0,5
19933,2020,China,Poland,16,0,0,16
19934,2020,Congo,Poland,6,5,0,11
19935,2020,Cuba,Poland,7,5,0,12
19936,2020,Eritrea,Poland,5,5,0,10
19937,2020,Ethiopia,Poland,5,0,0,5
19938,2020,Palestinian,Poland,5,5,0,10
19939,2020,Georgia,Poland,5,65,0,70
19940,2020,Guinea,Poland,5,0,0,5
19941,2020,India,Poland,0,5,0,5
19942,2020,Iran (Islamic Rep. of),Poland,48,13,0,61
19943,2020,Iraq,Poland,111,31,0,142
19944,2020,Jordan,Poland,0,5,0,5
19945,2020,Kazakhstan,Poland,39,19,0,58
19946,2020,Kyrgyzstan,Poland,28,42,0,70
19947,2020,Lao People's Dem. Rep.,Poland,5,0,0,5
19948,2020,Libya,Poland,19,6,0,25
19949,2020,Lebanon,Poland,0,7,0,7
19950,2020,Sri Lanka,Poland,11,8,0,19
19951,2020,Rep. of Moldova,Poland,0,5,0,5
19952,2020,Mongolia,Poland,0,5,0,5
19953,2020,Morocco,Poland,0,5,0,5
19954,2020,Nepal,Poland,7,0,0,7
19955,2020,Nigeria,Poland,6,5,0,11
19956,2020,Pakistan,Poland,27,17,0,44
19957,2020,Russian Federation,Poland,1052,2419,0,3471
19958,2020,Rwanda,Poland,5,0,0,5
19959,2020,Sierra Leone,Poland,7,0,0,7
19960,2020,Somalia,Poland,13,0,0,13
19961,2020,Viet Nam,Poland,5,7,0,12
19962,2020,Syrian Arab Rep.,Poland,237,39,0,276
19963,2020,United Rep. of Tanzania,Poland,0,5,0,5
19964,2020,Tajikistan,Poland,125,88,0,213
19965,2020,Turkmenistan,Poland,33,0,0,33
19966,2020,Türkiye,Poland,162,37,0,199
19967,2020,Ukraine,Poland,416,305,0,721
19968,2020,Uzbekistan,Poland,16,7,0,23
19969,2020,Venezuela (Bolivarian Republic of),Poland,0,5,0,5
19970,2020,Yemen,Poland,13,9,0,22
19971,2020,Stateless,Poland,51,11,0,62
19972,2020,Unknown ,Poland,0,5,0,5
19973,2020,Afghanistan,Portugal,21,30,0,51
19974,2020,Albania,Portugal,0,5,0,5
19975,2020,Algeria,Portugal,0,9,0,9
19976,2020,Angola,Portugal,0,224,0,224
19977,2020,Egypt,Portugal,0,18,0,18
19978,2020,Armenia,Portugal,5,0,0,5
19979,2020,Benin,Portugal,0,5,0,5
19980,2020,Bangladesh,Portugal,5,7,0,12
19981,2020,Belarus,Portugal,16,0,0,16
19982,2020,Brazil,Portugal,0,13,0,13
19983,2020,Bosnia and Herzegovina,Portugal,10,0,0,10
19984,2020,Central African Rep.,Portugal,8,0,0,8
19985,2020,Cameroon,Portugal,13,30,0,43
19986,2020,Congo,Portugal,10,8,0,18
19987,2020,Dem. Rep. of the Congo,Portugal,52,44,0,96
19988,2020,Comoros,Portugal,0,5,0,5
19989,2020,Colombia,Portugal,33,14,0,47
19990,2020,Cuba,Portugal,5,7,0,12
19991,2020,Eritrea,Portugal,191,0,0,191
19992,2020,Ethiopia,Portugal,9,0,0,9
19993,2020,Gambia,Portugal,5,75,0,80
19994,2020,Palestinian,Portugal,5,5,0,10
19995,2020,Georgia,Portugal,0,5,0,5
19996,2020,Ghana,Portugal,0,23,0,23
19997,2020,Guinea-Bissau,Portugal,9,93,0,102
19998,2020,Guinea,Portugal,91,65,0,156
19999,2020,Cote d'Ivoire,Portugal,32,15,0,47
20000,2020,Iran (Islamic Rep. of),Portugal,43,27,0,70
20001,2020,Iraq,Portugal,187,0,0,187
20002,2020,Jordan,Portugal,0,13,0,13
20003,2020,Kenya,Portugal,6,0,0,6
20004,2020,Libya,Portugal,15,0,0,15
20005,2020,Sri Lanka,Portugal,31,5,0,36
20006,2020,Mauritania,Portugal,0,5,0,5
20007,2020,Mali,Portugal,14,31,0,45
20008,2020,Morocco,Portugal,9,52,0,61
20009,2020,Mauritius,Portugal,0,5,0,5
20010,2020,Nigeria,Portugal,23,59,0,82
20011,2020,Pakistan,Portugal,82,9,0,91
20012,2020,Russian Federation,Portugal,23,5,0,28
20013,2020,Senegal,Portugal,5,44,0,49
20014,2020,Sierra Leone,Portugal,25,23,0,48
20015,2020,Somalia,Portugal,34,0,0,34
20016,2020,Sudan,Portugal,52,15,0,67
20017,2020,South Sudan,Portugal,30,0,0,30
20018,2020,Syrian Arab Rep.,Portugal,789,0,0,789
20019,2020,Togo,Portugal,6,13,0,19
20020,2020,Türkiye,Portugal,23,0,0,23
20021,2020,Uganda,Portugal,5,0,0,5
20022,2020,Ukraine,Portugal,443,59,0,502
20023,2020,United States of America,Portugal,0,5,0,5
20024,2020,Venezuela (Bolivarian Republic of),Portugal,0,76,0,76
20025,2020,Yemen,Portugal,9,0,0,9
20026,2020,Stateless,Portugal,31,0,0,31
20027,2020,Unknown ,Portugal,0,8,0,8
20028,2020,Egypt,Qatar,13,21,0,34
20029,2020,Eritrea,Qatar,0,5,0,5
20030,2020,Palestinian,Qatar,0,7,0,7
20031,2020,Iraq,Qatar,141,89,0,230
20032,2020,Martinique,Qatar,0,5,0,5
20033,2020,Somalia,Qatar,8,5,0,13
20034,2020,Sudan,Qatar,0,13,0,13
20035,2020,Syrian Arab Rep.,Qatar,34,89,0,123
20036,2020,Yemen,Qatar,5,9,0,14
20037,2020,Stateless,Qatar,0,0,0,0
20038,2020,Afghanistan,Romania,170,1484,0,1654
20039,2020,Algeria,Romania,0,12,0,12
20040,2020,Angola,Romania,5,0,0,5
20041,2020,Egypt,Romania,17,10,0,27
20042,2020,Burundi,Romania,8,0,0,8
20043,2020,Bangladesh,Romania,7,43,0,50
20044,2020,Central African Rep.,Romania,5,0,0,5
20045,2020,China,Romania,5,0,0,5
20046,2020,Cameroon,Romania,21,21,0,42
20047,2020,Congo,Romania,7,0,0,7
20048,2020,Dem. Rep. of the Congo,Romania,15,0,0,15
20049,2020,Comoros,Romania,5,0,0,5
20050,2020,Cuba,Romania,0,6,0,6
20051,2020,Eritrea,Romania,42,16,0,58
20052,2020,Ethiopia,Romania,6,5,0,11
20053,2020,Gambia,Romania,5,0,0,5
20054,2020,Palestinian,Romania,55,8,0,63
20055,2020,Ghana,Romania,0,5,0,5
20056,2020,Guinea,Romania,11,0,0,11
20057,2020,Haiti,Romania,0,6,0,6
20058,2020,India,Romania,0,5,0,5
20059,2020,Iran (Islamic Rep. of),Romania,121,12,0,133
20060,2020,Iraq,Romania,594,170,0,764
20061,2020,Jordan,Romania,6,0,0,6
20062,2020,Kuwait,Romania,0,5,0,5
20063,2020,Libya,Romania,5,8,0,13
20064,2020,Lebanon,Romania,5,0,0,5
20065,2020,Sri Lanka,Romania,0,10,0,10
20066,2020,Morocco,Romania,0,20,0,20
20067,2020,Myanmar,Romania,24,0,0,24
20068,2020,Nigeria,Romania,8,6,0,14
20069,2020,Pakistan,Romania,37,91,0,128
20070,2020,Rwanda,Romania,7,5,0,12
20071,2020,Sierra Leone,Romania,5,0,0,5
20072,2020,Somalia,Romania,147,23,0,170
20073,2020,Sudan,Romania,16,6,0,22
20074,2020,Syrian Arab Rep.,Romania,2002,215,0,2217
20075,2020,Tunisia,Romania,5,5,0,10
20076,2020,Türkiye,Romania,51,40,0,91
20077,2020,Uganda,Romania,5,0,0,5
20078,2020,Ukraine,Romania,20,5,0,25
20079,2020,Yemen,Romania,41,0,0,41
20080,2020,Zimbabwe,Romania,6,0,0,6
20081,2020,Stateless,Romania,92,0,0,92
20082,2020,Afghanistan,South Africa,5,20,0,25
20083,2020,Algeria,South Africa,5,198,0,203
20084,2020,Angola,South Africa,24,12,0,36
20085,2020,Egypt,South Africa,7,240,0,247
20086,2020,Bahrain,South Africa,0,10,0,10
20087,2020,Burundi,South Africa,2636,6927,0,9563
20088,2020,Benin,South Africa,5,36,0,41
20089,2020,Bangladesh,South Africa,202,25482,0,25684
20090,2020,Bahamas,South Africa,0,14,0,14
20091,2020,Burkina Faso,South Africa,0,43,0,43
20092,2020,Bulgaria,South Africa,5,0,0,5
20093,2020,Central African Rep.,South Africa,9,5,0,14
20094,2020,Chad,South Africa,5,5,0,10
20095,2020,China,South Africa,0,70,0,70
20096,2020,Cameroon,South Africa,326,1814,0,2140
20097,2020,Congo,South Africa,4463,7878,0,12341
20098,2020,Dem. Rep. of the Congo,South Africa,22816,34779,0,57595
20099,2020,Comoros,South Africa,0,14,0,14
20100,2020,Eritrea,South Africa,1469,1058,0,2527
20101,2020,Estonia,South Africa,5,7,0,12
20102,2020,Ethiopia,South Africa,15629,48099,0,63728
20103,2020,Gabon,South Africa,0,12,0,12
20104,2020,Gambia,South Africa,0,10,0,10
20105,2020,Palestinian,South Africa,37,11,0,48
20106,2020,Ghana,South Africa,7,1464,0,1471
20107,2020,Guinea-Bissau,South Africa,0,9,0,9
20108,2020,Guinea,South Africa,0,54,0,54
20109,2020,Cote d'Ivoire,South Africa,27,171,0,198
20110,2020,India,South Africa,5,4112,0,4117
20111,2020,Iraq,South Africa,14,6,0,20
20112,2020,Jordan,South Africa,5,5,0,10
20113,2020,Kenya,South Africa,140,966,0,1106
20114,2020,Liberia,South Africa,47,55,0,102
20115,2020,Lesotho,South Africa,0,20,0,20
20116,2020,Sri Lanka,South Africa,10,18,0,28
20117,2020,Mali,South Africa,5,123,0,128
20118,2020,Malawi,South Africa,8,1611,0,1619
20119,2020,Morocco,South Africa,5,11,0,16
20120,2020,Mozambique,South Africa,0,290,0,290
20121,2020,Nepal,South Africa,0,96,0,96
20122,2020,Niger,South Africa,0,700,0,700
20123,2020,Nigeria,South Africa,11,5519,0,5530
20124,2020,Pakistan,South Africa,10,8858,0,8868
20125,2020,Russian Federation,South Africa,10,0,0,10
20126,2020,Rwanda,South Africa,1016,1056,0,2072
20127,2020,Senegal,South Africa,5,833,0,838
20128,2020,Sierra Leone,South Africa,19,13,0,32
20129,2020,Solomon Islands,South Africa,7,0,0,7
20130,2020,Somalia,South Africa,23054,4736,0,27790
20131,2020,Sudan,South Africa,93,60,0,153
20132,2020,Eswatini,South Africa,7,18,0,25
20133,2020,Syrian Arab Rep.,South Africa,38,20,0,58
20134,2020,United Rep. of Tanzania,South Africa,33,519,0,552
20135,2020,Thailand,South Africa,0,52,0,52
20136,2020,Timor-Leste,South Africa,0,7,0,7
20137,2020,Togo,South Africa,12,30,0,42
20138,2020,Türkiye,South Africa,5,10,0,15
20139,2020,Uganda,South Africa,459,4061,0,4520
20140,2020,Ukraine,South Africa,5,0,0,5
20141,2020,Yemen,South Africa,5,10,0,15
20142,2020,Zambia,South Africa,60,209,0,269
20143,2020,Zimbabwe,South Africa,3954,10995,0,14949
20144,2020,Unknown ,South Africa,5,0,0,5
20145,2020,Afghanistan,Russian Federation,770,174,0,944
20146,2020,Egypt,Russian Federation,5,0,0,5
20147,2020,Armenia,Russian Federation,6,6,0,12
20148,2020,Azerbaijan,Russian Federation,20,7,0,27
20149,2020,Belgium,Russian Federation,0,17,0,17
20150,2020,Bangladesh,Russian Federation,5,0,0,5
20151,2020,China,Russian Federation,19,295,0,314
20152,2020,Cameroon,Russian Federation,5,5,0,10
20153,2020,Congo,Russian Federation,5,0,0,5
20154,2020,Dem. Rep. of the Congo,Russian Federation,7,5,0,12
20155,2020,Cuba,Russian Federation,5,0,0,5
20156,2020,Estonia,Russian Federation,5,0,0,5
20157,2020,Palestinian,Russian Federation,5,0,0,5
20158,2020,Georgia,Russian Federation,142,5,0,147
20159,2020,Germany,Russian Federation,15,0,0,15
20160,2020,Cote d'Ivoire,Russian Federation,5,0,0,5
20161,2020,Iran (Islamic Rep. of),Russian Federation,5,5,0,10
20162,2020,Iraq,Russian Federation,16,0,0,16
20163,2020,Kazakhstan,Russian Federation,12,10,0,22
20164,2020,Kyrgyzstan,Russian Federation,29,5,0,34
20165,2020,Rep. of Korea,Russian Federation,5,0,0,5
20166,2020,Dem. People's Rep. of Korea,Russian Federation,53,5,0,58
20167,2020,Lebanon,Russian Federation,6,0,0,6
20168,2020,Latvia,Russian Federation,7,0,0,7
20169,2020,Rep. of Moldova,Russian Federation,29,5,0,34
20170,2020,Nigeria,Russian Federation,0,5,0,5
20171,2020,Pakistan,Russian Federation,5,0,0,5
20172,2020,Philippines,Russian Federation,5,0,0,5
20173,2020,Sudan,Russian Federation,5,0,0,5
20174,2020,South Sudan,Russian Federation,5,0,0,5
20175,2020,Syrian Arab Rep.,Russian Federation,361,54,0,415
20176,2020,Tajikistan,Russian Federation,42,14,0,56
20177,2020,Turkmenistan,Russian Federation,24,5,0,29
20178,2020,Türkiye,Russian Federation,5,0,0,5
20179,2020,Ukraine,Russian Federation,18428,148,0,18576
20180,2020,United States of America,Russian Federation,5,0,0,5
20181,2020,Uzbekistan,Russian Federation,75,16,0,91
20182,2020,Yemen,Russian Federation,88,11,0,99
20183,2020,Stateless,Russian Federation,31,11,0,42
20184,2020,Unknown ,Russian Federation,0,5,0,5
20185,2020,Angola,Rwanda,9,0,0,9
20186,2020,Burundi,Rwanda,65037,64,0,65101
20187,2020,Chad,Rwanda,5,0,0,5
20188,2020,Cameroon,Rwanda,0,7,0,7
20189,2020,Dem. Rep. of the Congo,Rwanda,74303,188,0,74491
20190,2020,Eritrea,Rwanda,80,97,0,177
20191,2020,Ethiopia,Rwanda,8,0,0,8
20192,2020,Rwanda,Rwanda,0,0,0,0
20193,2020,Somalia,Rwanda,32,15,0,47
20194,2020,Sudan,Rwanda,11,89,0,100
20195,2020,South Sudan,Rwanda,6,5,0,11
20196,2020,Colombia,El Salvador,5,7,0,12
20197,2020,Guatemala,El Salvador,0,5,0,5
20198,2020,Honduras,El Salvador,19,12,0,31
20199,2020,Iraq,El Salvador,5,0,0,5
20200,2020,Mexico,El Salvador,5,0,0,5
20201,2020,Nicaragua,El Salvador,9,13,0,22
20202,2020,El Salvador,El Salvador,0,0,71500,0
20203,2020,Syrian Arab Rep.,El Salvador,5,0,0,5
20204,2020,Venezuela (Bolivarian Republic of),El Salvador,0,16,0,16
20205,2020,Afghanistan,Saudi Arabia,0,61,0,61
20206,2020,Egypt,Saudi Arabia,0,16,0,16
20207,2020,Burkina Faso,Saudi Arabia,0,11,0,11
20208,2020,Chad,Saudi Arabia,9,70,0,79
20209,2020,China,Saudi Arabia,14,23,0,37
20210,2020,Eritrea,Saudi Arabia,36,122,0,158
20211,2020,Palestinian,Saudi Arabia,8,326,0,334
20212,2020,Iraq,Saudi Arabia,32,191,0,223
20213,2020,Jordan,Saudi Arabia,0,8,0,8
20214,2020,Liberia,Saudi Arabia,9,0,0,9
20215,2020,Libya,Saudi Arabia,0,8,0,8
20216,2020,Lebanon,Saudi Arabia,0,13,0,13
20217,2020,Mali,Saudi Arabia,0,5,0,5
20218,2020,Myanmar,Saudi Arabia,0,87,0,87
20219,2020,Nigeria,Saudi Arabia,0,5,0,5
20220,2020,Oman,Saudi Arabia,0,5,0,5
20221,2020,Pakistan,Saudi Arabia,0,21,0,21
20222,2020,Somalia,Saudi Arabia,16,50,0,66
20223,2020,Sudan,Saudi Arabia,0,74,0,74
20224,2020,South Sudan,Saudi Arabia,0,7,0,7
20225,2020,Syrian Arab Rep.,Saudi Arabia,173,7671,0,7844
20226,2020,Tunisia,Saudi Arabia,7,0,0,7
20227,2020,Yemen,Saudi Arabia,26,635,0,661
20228,2020,Stateless,Saudi Arabia,0,0,0,0
20229,2020,Unknown ,Saudi Arabia,0,25,0,25
20230,2020,Afghanistan,Serbia and Kosovo: S/RES/1244 (1999),27,5,0,32
20231,2020,Algeria,Serbia and Kosovo: S/RES/1244 (1999),0,20,0,20
20232,2020,Burundi,Serbia and Kosovo: S/RES/1244 (1999),5,17,0,22
20233,2020,Bangladesh,Serbia and Kosovo: S/RES/1244 (1999),0,0,0,0
20234,2020,Bosnia and Herzegovina,Serbia and Kosovo: S/RES/1244 (1999),8124,0,0,8124
20235,2020,China,Serbia and Kosovo: S/RES/1244 (1999),0,5,0,5
20236,2020,Congo,Serbia and Kosovo: S/RES/1244 (1999),0,6,0,6
20237,2020,Cuba,Serbia and Kosovo: S/RES/1244 (1999),7,0,0,7
20238,2020,Ethiopia,Serbia and Kosovo: S/RES/1244 (1999),5,0,0,5
20239,2020,Palestinian,Serbia and Kosovo: S/RES/1244 (1999),0,20,0,20
20240,2020,Ghana,Serbia and Kosovo: S/RES/1244 (1999),0,7,0,7
20241,2020,Croatia,Serbia and Kosovo: S/RES/1244 (1999),17675,0,0,17675
20242,2020,Iran (Islamic Rep. of),Serbia and Kosovo: S/RES/1244 (1999),18,31,0,49
20243,2020,Iraq,Serbia and Kosovo: S/RES/1244 (1999),13,21,0,34
20244,2020,Jordan,Serbia and Kosovo: S/RES/1244 (1999),0,7,0,7
20245,2020,Libya,Serbia and Kosovo: S/RES/1244 (1999),45,29,0,74
20246,2020,Lebanon,Serbia and Kosovo: S/RES/1244 (1999),0,5,0,5
20247,2020,North Macedonia,Serbia and Kosovo: S/RES/1244 (1999),0,0,0,0
20248,2020,Morocco,Serbia and Kosovo: S/RES/1244 (1999),0,29,0,29
20249,2020,Nigeria,Serbia and Kosovo: S/RES/1244 (1999),0,9,0,9
20250,2020,Pakistan,Serbia and Kosovo: S/RES/1244 (1999),5,0,0,5
20251,2020,Russian Federation,Serbia and Kosovo: S/RES/1244 (1999),5,5,0,10
20252,2020,Serbia and Kosovo: S/RES/1244 (1999),Serbia and Kosovo: S/RES/1244 (1999),0,0,213018,0
20253,2020,Somalia,Serbia and Kosovo: S/RES/1244 (1999),6,18,0,24
20254,2020,Sudan,Serbia and Kosovo: S/RES/1244 (1999),5,0,0,5
20255,2020,Syrian Arab Rep.,Serbia and Kosovo: S/RES/1244 (1999),31,40,0,71
20256,2020,Türkiye,Serbia and Kosovo: S/RES/1244 (1999),99,23,0,122
20257,2020,Ukraine,Serbia and Kosovo: S/RES/1244 (1999),15,0,0,15
20258,2020,Stateless,Serbia and Kosovo: S/RES/1244 (1999),0,0,0,0
20259,2020,Unknown ,Serbia and Kosovo: S/RES/1244 (1999),0,5,0,5
20260,2020,Burundi,Senegal,8,8,0,16
20261,2020,Benin,Senegal,0,5,0,5
20262,2020,Burkina Faso,Senegal,0,5,0,5
20263,2020,Central African Rep.,Senegal,155,468,0,623
20264,2020,Chad,Senegal,5,23,0,28
20265,2020,Cameroon,Senegal,0,27,0,27
20266,2020,Congo,Senegal,0,91,0,91
20267,2020,Dem. Rep. of the Congo,Senegal,11,190,0,201
20268,2020,Eritrea,Senegal,0,14,0,14
20269,2020,Gambia,Senegal,19,354,0,373
20270,2020,Ghana,Senegal,0,5,0,5
20271,2020,Guinea-Bissau,Senegal,0,5,0,5
20272,2020,Guinea,Senegal,0,115,0,115
20273,2020,Haiti,Senegal,0,5,0,5
20274,2020,Cote d'Ivoire,Senegal,25,163,0,188
20275,2020,Liberia,Senegal,0,66,0,66
20276,2020,Sri Lanka,Senegal,0,6,0,6
20277,2020,Mauritania,Senegal,14115,72,0,14187
20278,2020,Mali,Senegal,0,69,0,69
20279,2020,Nigeria,Senegal,0,61,0,61
20280,2020,Pakistan,Senegal,0,12,0,12
20281,2020,Rwanda,Senegal,13,7,0,20
20282,2020,Sierra Leone,Senegal,0,40,0,40
20283,2020,Sudan,Senegal,5,8,0,13
20284,2020,Syrian Arab Rep.,Senegal,0,14,0,14
20285,2020,Togo,Senegal,0,31,0,31
20286,2020,Türkiye,Senegal,5,49,0,54
20287,2020,Stateless,Singapore,0,0,0,0
20288,2020,Cote d'Ivoire,Sierra Leone,10,0,0,10
20289,2020,Liberia,Sierra Leone,332,0,0,332
20290,2020,Bangladesh,Somalia,6,0,0,6
20291,2020,Cameroon,Somalia,5,0,0,5
20292,2020,Djibouti,Somalia,0,6,0,6
20293,2020,Eritrea,Somalia,51,37,0,88
20294,2020,Ethiopia,Somalia,4177,13022,0,17199
20295,2020,Palestinian,Somalia,7,0,0,7
20296,2020,Mozambique,Somalia,0,5,0,5
20297,2020,Somalia,Somalia,0,0,2967500,0
20298,2020,Sudan,Somalia,0,7,0,7
20299,2020,Syrian Arab Rep.,Somalia,603,15,0,618
20300,2020,United Rep. of Tanzania,Somalia,0,118,0,118
20301,2020,Yemen,Somalia,6371,19,0,6390
20302,2020,Afghanistan,Spain,468,185,0,653
20303,2020,Albania,Spain,0,130,0,130
20304,2020,Algeria,Spain,65,1280,0,1345
20305,2020,Angola,Spain,26,60,0,86
20306,2020,Egypt,Spain,71,100,0,171
20307,2020,Argentina,Spain,17,445,0,462
20308,2020,Armenia,Spain,37,305,0,342
20309,2020,Azerbaijan,Spain,50,65,0,115
20310,2020,Burundi,Spain,6,0,0,6
20311,2020,Benin,Spain,5,20,0,25
20312,2020,Bangladesh,Spain,20,205,0,225
20313,2020,Burkina Faso,Spain,0,115,0,115
20314,2020,Belarus,Spain,12,105,0,117
20315,2020,Bolivia (Plurinational State of),Spain,9,170,0,179
20316,2020,Brazil,Spain,39,975,0,1014
20317,2020,Canada,Spain,0,10,0,10
20318,2020,Central African Rep.,Spain,111,40,0,151
20319,2020,Chad,Spain,7,10,0,17
20320,2020,China,Spain,27,980,0,1007
20321,2020,Chile,Spain,13,240,0,253
20322,2020,Cameroon,Spain,110,850,0,960
20323,2020,Congo,Spain,49,45,0,94
20324,2020,Dem. Rep. of the Congo,Spain,77,125,0,202
20325,2020,Colombia,Spain,985,23735,0,24720
20326,2020,Costa Rica,Spain,5,65,0,70
20327,2020,Cuba,Spain,660,2845,0,3505
20328,2020,Djibouti,Spain,0,5,0,5
20329,2020,Dominican Rep.,Spain,11,200,0,211
20330,2020,Ecuador,Spain,6,415,0,421
20331,2020,Equatorial Guinea,Spain,30,80,0,110
20332,2020,Eritrea,Spain,296,60,0,356
20333,2020,Ethiopia,Spain,53,25,0,78
20334,2020,Gabon,Spain,0,10,0,10
20335,2020,Gambia,Spain,45,415,0,460
20336,2020,Palestinian,Spain,1295,540,0,1835
20337,2020,United Kingdom of Great Britain and Northern Ireland,Spain,0,5,0,5
20338,2020,Georgia,Spain,25,2545,0,2570
20339,2020,Ghana,Spain,5,280,0,285
20340,2020,Guinea-Bissau,Spain,5,90,0,95
20341,2020,Guatemala,Spain,77,620,0,697
20342,2020,Guinea,Spain,83,1495,0,1578
20343,2020,Haiti,Spain,10,50,0,60
20344,2020,Honduras,Spain,974,8685,0,9659
20345,2020,Cote d'Ivoire,Spain,357,470,0,827
20346,2020,India,Spain,6,60,0,66
20347,2020,Iran (Islamic Rep. of),Spain,87,205,0,292
20348,2020,Iraq,Spain,295,220,0,515
20349,2020,Israel,Spain,0,15,0,15
20350,2020,Jamaica,Spain,58,5,0,63
20351,2020,Jordan,Spain,30,30,0,60
20352,2020,Kazakhstan,Spain,18,45,0,63
20353,2020,Kenya,Spain,0,20,0,20
20354,2020,Kyrgyzstan,Spain,10,25,0,35
20355,2020,Kuwait,Spain,0,5,0,5
20356,2020,Liberia,Spain,7,40,0,47
20357,2020,Libya,Spain,133,55,0,188
20358,2020,Lebanon,Spain,28,95,0,123
20359,2020,Sri Lanka,Spain,75,20,0,95
20360,2020,Mauritania,Spain,18,75,0,93
20361,2020,North Macedonia,Spain,0,20,0,20
20362,2020,Rep. of Moldova,Spain,0,60,0,60
20363,2020,Mexico,Spain,16,265,0,281
20364,2020,Mali,Spain,334,2755,0,3089
20365,2020,Mongolia,Spain,5,15,0,20
20366,2020,Morocco,Spain,544,2105,0,2649
20367,2020,Myanmar,Spain,9,0,0,9
20368,2020,Nepal,Spain,0,10,0,10
20369,2020,Niger,Spain,0,25,0,25
20370,2020,Nicaragua,Spain,1303,5640,0,6943
20371,2020,Nigeria,Spain,122,1345,0,1467
20372,2020,Oman,Spain,0,5,0,5
20373,2020,Pakistan,Spain,407,1100,0,1507
20374,2020,Panama,Spain,12,95,0,107
20375,2020,Paraguay,Spain,54,545,0,599
20376,2020,Peru,Spain,139,5040,0,5179
20377,2020,Philippines,Spain,0,5,0,5
20378,2020,South Africa,Spain,5,5,0,10
20379,2020,Russian Federation,Spain,356,1855,0,2211
20380,2020,Rwanda,Spain,0,5,0,5
20381,2020,El Salvador,Spain,698,4370,0,5068
20382,2020,Saudi Arabia,Spain,5,5,0,10
20383,2020,Serbia and Kosovo: S/RES/1244 (1999),Spain,5,30,0,35
20384,2020,Senegal,Spain,26,1275,0,1301
20385,2020,Sierra Leone,Spain,11,120,0,131
20386,2020,Somalia,Spain,719,175,0,894
20387,2020,Viet Nam,Spain,0,65,0,65
20388,2020,Sudan,Spain,161,40,0,201
20389,2020,South Sudan,Spain,5,5,0,10
20390,2020,Syrian Arab Rep.,Spain,14660,1545,0,16205
20391,2020,United Rep. of Tanzania,Spain,0,5,0,5
20392,2020,Tajikistan,Spain,5,15,0,20
20393,2020,Togo,Spain,8,45,0,53
20394,2020,Trinidad and Tobago,Spain,5,0,0,5
20395,2020,Tunisia,Spain,29,255,0,284
20396,2020,Türkiye,Spain,109,345,0,454
20397,2020,Uganda,Spain,6,5,0,11
20398,2020,Ukraine,Spain,922,4290,0,5212
20399,2020,Uruguay,Spain,0,230,0,230
20400,2020,United States of America,Spain,11,100,0,111
20401,2020,Uzbekistan,Spain,10,20,0,30
20402,2020,Venezuela (Bolivarian Republic of),Spain,75640,19065,0,94705
20403,2020,Western Sahara,Spain,24,20,0,44
20404,2020,Yemen,Spain,316,410,0,726
20405,2020,Zimbabwe,Spain,0,5,0,5
20406,2020,Stateless,Spain,0,10,0,10
20407,2020,Tibetan,Spain,5,0,0,5
20408,2020,Unknown ,Spain,32,30,0,62
20409,2020,Stateless,Viet Nam,0,0,0,0
20410,2020,Venezuela (Bolivarian Republic of),Saint Kitts and Nevis,0,0,0,0
20411,2020,Afghanistan,Sudan,0,0,0,0
20412,2020,Egypt,Sudan,17,11,0,28
20413,2020,Argentina,Sudan,0,0,0,0
20414,2020,Burundi,Sudan,17,12,0,29
20415,2020,Central African Rep.,Sudan,26928,0,0,26928
20416,2020,Chad,Sudan,3502,5,0,3507
20417,2020,Cameroon,Sudan,7,0,0,7
20418,2020,Congo,Sudan,11,5,0,16
20419,2020,Dem. Rep. of the Congo,Sudan,309,428,0,737
20420,2020,Eritrea,Sudan,114867,7598,0,122465
20421,2020,Ethiopia,Sudan,62498,7353,0,69851
20422,2020,Palestinian,Sudan,0,0,0,0
20423,2020,Iraq,Sudan,9,13,0,22
20424,2020,Jordan,Sudan,0,0,0,0
20425,2020,Kuwait,Sudan,0,0,0,0
20426,2020,Nigeria,Sudan,12,0,0,12
20427,2020,Somalia,Sudan,312,176,0,488
20428,2020,Sudan,Sudan,0,0,2552174,0
20429,2020,South Sudan,Sudan,736685,0,0,736685
20430,2020,Syrian Arab Rep.,Sudan,93498,0,0,93498
20431,2020,Türkiye,Sudan,5,0,0,5
20432,2020,Uganda,Sudan,5,0,0,5
20433,2020,Yemen,Sudan,1551,386,0,1937
20434,2020,Unknown ,Sudan,55,36,0,91
20435,2020,Colombia,Suriname,0,5,0,5
20436,2020,Cuba,Suriname,7,1703,0,1710
20437,2020,Dominican Rep.,Suriname,0,8,0,8
20438,2020,Nigeria,Suriname,0,5,0,5
20439,2020,Venezuela (Bolivarian Republic of),Suriname,12,267,0,279
20440,2020,Burundi,South Sudan,103,847,0,950
20441,2020,Central African Rep.,South Sudan,2135,0,0,2135
20442,2020,Cameroon,South Sudan,0,5,0,5
20443,2020,Dem. Rep. of the Congo,South Sudan,16498,7,0,16505
20444,2020,Eritrea,South Sudan,259,2486,0,2745
20445,2020,Ethiopia,South Sudan,4194,374,0,4568
20446,2020,Somalia,South Sudan,0,30,0,30
20447,2020,Sudan,South Sudan,291249,14,0,291263
20448,2020,South Sudan,South Sudan,0,0,1600254,0
20449,2020,Stateless,South Sudan,0,0,0,0
20450,2020,Afghanistan,Slovakia,298,0,0,298
20451,2020,Algeria,Slovakia,0,6,0,6
20452,2020,Angola,Slovakia,24,0,0,24
20453,2020,Egypt,Slovakia,5,5,0,10
20454,2020,Armenia,Slovakia,34,0,0,34
20455,2020,Burundi,Slovakia,5,0,0,5
20456,2020,Bangladesh,Slovakia,0,5,0,5
20457,2020,Bosnia and Herzegovina,Slovakia,36,0,0,36
20458,2020,Bulgaria,Slovakia,8,0,0,8
20459,2020,Cambodia,Slovakia,5,0,0,5
20460,2020,China,Slovakia,5,0,0,5
20461,2020,Cameroon,Slovakia,9,0,0,9
20462,2020,Dem. Rep. of the Congo,Slovakia,16,0,0,16
20463,2020,Cuba,Slovakia,32,0,0,32
20464,2020,Palestinian,Slovakia,7,0,0,7
20465,2020,Iran (Islamic Rep. of),Slovakia,31,0,0,31
20466,2020,Iraq,Slovakia,214,0,0,214
20467,2020,Liberia,Slovakia,5,0,0,5
20468,2020,Libya,Slovakia,6,0,0,6
20469,2020,Morocco,Slovakia,0,10,0,10
20470,2020,Pakistan,Slovakia,7,0,0,7
20471,2020,Romania,Slovakia,37,0,0,37
20472,2020,Russian Federation,Slovakia,38,0,0,38
20473,2020,Serbia and Kosovo: S/RES/1244 (1999),Slovakia,46,0,0,46
20474,2020,Somalia,Slovakia,32,0,0,32
20475,2020,Viet Nam,Slovakia,16,0,0,16
20476,2020,Syrian Arab Rep.,Slovakia,21,5,0,26
20477,2020,Türkiye,Slovakia,5,13,0,18
20478,2020,Uganda,Slovakia,5,0,0,5
20479,2020,Ukraine,Slovakia,24,0,0,24
20480,2020,Uzbekistan,Slovakia,5,0,0,5
20481,2020,Yemen,Slovakia,21,0,0,21
20482,2020,Stateless,Slovakia,9,0,0,9
20483,2020,Afghanistan,Slovenia,56,155,0,211
20484,2020,Algeria,Slovenia,0,5,0,5
20485,2020,Azerbaijan,Slovenia,0,5,0,5
20486,2020,Bangladesh,Slovenia,0,5,0,5
20487,2020,Bosnia and Herzegovina,Slovenia,6,0,0,6
20488,2020,Cameroon,Slovenia,5,0,0,5
20489,2020,Dem. Rep. of the Congo,Slovenia,6,5,0,11
20490,2020,Eritrea,Slovenia,86,0,0,86
20491,2020,Palestinian,Slovenia,25,5,0,30
20492,2020,Iran (Islamic Rep. of),Slovenia,77,28,0,105
20493,2020,Iraq,Slovenia,53,6,0,59
20494,2020,Kazakhstan,Slovenia,20,0,0,20
20495,2020,Libya,Slovenia,0,5,0,5
20496,2020,Morocco,Slovenia,0,8,0,8
20497,2020,Nigeria,Slovenia,6,0,0,6
20498,2020,Pakistan,Slovenia,5,18,0,23
20499,2020,Russian Federation,Slovenia,21,5,0,26
20500,2020,Serbia and Kosovo: S/RES/1244 (1999),Slovenia,10,6,0,16
20501,2020,Somalia,Slovenia,50,0,0,50
20502,2020,Sudan,Slovenia,6,0,0,6
20503,2020,Syrian Arab Rep.,Slovenia,322,16,0,338
20504,2020,Türkiye,Slovenia,58,5,0,63
20505,2020,Ukraine,Slovenia,5,0,0,5
20506,2020,Yemen,Slovenia,6,0,0,6
20507,2020,Stateless,Slovenia,0,0,0,0
20508,2020,Unknown ,Slovenia,0,0,0,0
20509,2020,Angola,Eswatini,13,0,0,13
20510,2020,Burundi,Eswatini,184,148,0,332
20511,2020,Cameroon,Eswatini,0,8,0,8
20512,2020,Congo,Eswatini,23,108,0,131
20513,2020,Dem. Rep. of the Congo,Eswatini,399,316,0,715
20514,2020,Eritrea,Eswatini,0,5,0,5
20515,2020,Ethiopia,Eswatini,11,82,0,93
20516,2020,Guinea,Eswatini,5,0,0,5
20517,2020,Cote d'Ivoire,Eswatini,0,5,0,5
20518,2020,Kenya,Eswatini,5,0,0,5
20519,2020,Sri Lanka,Eswatini,5,0,0,5
20520,2020,Rwanda,Eswatini,185,104,0,289
20521,2020,Somalia,Eswatini,101,318,0,419
20522,2020,United Rep. of Tanzania,Eswatini,0,5,0,5
20523,2020,Uganda,Eswatini,6,0,0,6
20524,2020,Zimbabwe,Eswatini,8,5,0,13
20525,2020,Afghanistan,Sweden,29927,1358,0,31285
20526,2020,Albania,Sweden,310,206,0,516
20527,2020,Algeria,Sweden,61,62,0,123
20528,2020,Angola,Sweden,23,35,0,58
20529,2020,Egypt,Sweden,409,295,0,704
20530,2020,Armenia,Sweden,340,133,0,473
20531,2020,Azerbaijan,Sweden,624,293,0,917
20532,2020,Bahrain,Sweden,17,5,0,22
20533,2020,Burundi,Sweden,215,71,0,286
20534,2020,Benin,Sweden,10,0,0,10
20535,2020,Bangladesh,Sweden,241,273,0,514
20536,2020,Burkina Faso,Sweden,5,0,0,5
20537,2020,Belarus,Sweden,105,92,0,197
20538,2020,Bolivia (Plurinational State of),Sweden,56,6,0,62
20539,2020,Brazil,Sweden,8,22,0,30
20540,2020,Bosnia and Herzegovina,Sweden,77,86,0,163
20541,2020,Bulgaria,Sweden,16,0,0,16
20542,2020,Central African Rep.,Sweden,71,0,0,71
20543,2020,Chad,Sweden,19,0,0,19
20544,2020,China,Sweden,276,46,0,322
20545,2020,Chile,Sweden,12,28,0,40
20546,2020,Cameroon,Sweden,210,195,0,405
20547,2020,Congo,Sweden,36,20,0,56
20548,2020,Dem. Rep. of the Congo,Sweden,861,99,0,960
20549,2020,Comoros,Sweden,5,0,0,5
20550,2020,Colombia,Sweden,40,101,0,141
20551,2020,Cuba,Sweden,31,22,0,53
20552,2020,Djibouti,Sweden,31,20,0,51
20553,2020,Ecuador,Sweden,5,5,0,10
20554,2020,Equatorial Guinea,Sweden,5,9,0,14
20555,2020,Eritrea,Sweden,27421,461,0,27882
20556,2020,Ethiopia,Sweden,2532,477,0,3009
20557,2020,France,Sweden,5,0,0,5
20558,2020,Gambia,Sweden,180,105,0,285
20559,2020,Palestinian,Sweden,1256,698,0,1954
20560,2020,United Kingdom of Great Britain and Northern Ireland,Sweden,5,0,0,5
20561,2020,Georgia,Sweden,95,266,0,361
20562,2020,Ghana,Sweden,65,70,0,135
20563,2020,Guinea-Bissau,Sweden,8,5,0,13
20564,2020,Greece,Sweden,18,0,0,18
20565,2020,Guatemala,Sweden,10,7,0,17
20566,2020,Guinea,Sweden,71,21,0,92
20567,2020,Honduras,Sweden,27,12,0,39
20568,2020,Croatia,Sweden,0,5,0,5
20569,2020,Hungary,Sweden,5,0,0,5
20570,2020,Cote d'Ivoire,Sweden,45,13,0,58
20571,2020,India,Sweden,19,58,0,77
20572,2020,Indonesia,Sweden,16,0,0,16
20573,2020,Iran (Islamic Rep. of),Sweden,7507,1757,0,9264
20574,2020,Iraq,Sweden,11635,1430,0,13065
20575,2020,Israel,Sweden,24,10,0,34
20576,2020,Jordan,Sweden,279,185,0,464
20577,2020,Kazakhstan,Sweden,231,159,0,390
20578,2020,Kenya,Sweden,94,54,0,148
20579,2020,Kyrgyzstan,Sweden,177,139,0,316
20580,2020,Rep. of Korea,Sweden,7,6,0,13
20581,2020,Kuwait,Sweden,33,15,0,48
20582,2020,Liberia,Sweden,13,7,0,20
20583,2020,Libya,Sweden,384,65,0,449
20584,2020,Lebanon,Sweden,523,267,0,790
20585,2020,Sri Lanka,Sweden,28,45,0,73
20586,2020,Lithuania,Sweden,0,7,0,7
20587,2020,Mauritania,Sweden,13,0,0,13
20588,2020,North Macedonia,Sweden,44,35,0,79
20589,2020,Rep. of Moldova,Sweden,8,10,0,18
20590,2020,Mali,Sweden,43,5,0,48
20591,2020,Malaysia,Sweden,14,10,0,24
20592,2020,Mongolia,Sweden,260,318,0,578
20593,2020,Morocco,Sweden,259,176,0,435
20594,2020,Mozambique,Sweden,0,6,0,6
20595,2020,Montenegro,Sweden,28,13,0,41
20596,2020,Myanmar,Sweden,9,9,0,18
20597,2020,Nepal,Sweden,11,14,0,25
20598,2020,Niger,Sweden,5,0,0,5
20599,2020,Nicaragua,Sweden,63,72,0,135
20600,2020,Nigeria,Sweden,590,439,0,1029
20601,2020,Pakistan,Sweden,622,342,0,964
20602,2020,Peru,Sweden,9,41,0,50
20603,2020,Philippines,Sweden,6,9,0,15
20604,2020,Poland,Sweden,5,0,0,5
20605,2020,Romania,Sweden,45,0,0,45
20606,2020,South Africa,Sweden,0,7,0,7
20607,2020,Russian Federation,Sweden,1427,415,0,1842
20608,2020,Rwanda,Sweden,55,57,0,112
20609,2020,El Salvador,Sweden,146,74,0,220
20610,2020,Saudi Arabia,Sweden,62,5,0,67
20611,2020,Serbia and Kosovo: S/RES/1244 (1999),Sweden,687,311,0,998
20612,2020,Senegal,Sweden,57,25,0,82
20613,2020,Sierra Leone,Sweden,71,17,0,88
20614,2020,Somalia,Sweden,12784,683,0,13467
20615,2020,Viet Nam,Sweden,34,22,0,56
20616,2020,Sudan,Sweden,1132,142,0,1274
20617,2020,South Sudan,Sweden,63,0,0,63
20618,2020,Slovakia,Sweden,5,5,0,10
20619,2020,Eswatini,Sweden,5,5,0,10
20620,2020,Syrian Arab Rep.,Sweden,114609,1544,0,116153
20621,2020,United Rep. of Tanzania,Sweden,62,67,0,129
20622,2020,Thailand,Sweden,0,8,0,8
20623,2020,Tajikistan,Sweden,65,97,0,162
20624,2020,Turkmenistan,Sweden,13,10,0,23
20625,2020,Togo,Sweden,5,5,0,10
20626,2020,Tunisia,Sweden,51,53,0,104
20627,2020,Türkiye,Sweden,2015,619,0,2634
20628,2020,United Arab Emirates,Sweden,5,0,0,5
20629,2020,Uganda,Sweden,768,142,0,910
20630,2020,Ukraine,Sweden,232,390,0,622
20631,2020,United States of America,Sweden,22,14,0,36
20632,2020,Uzbekistan,Sweden,535,1366,0,1901
20633,2020,Venezuela (Bolivarian Republic of),Sweden,28,94,0,122
20634,2020,Yemen,Sweden,1822,83,0,1905
20635,2020,Zambia,Sweden,13,5,0,18
20636,2020,Zimbabwe,Sweden,18,10,0,28
20637,2020,Stateless,Sweden,22218,692,0,22910
20638,2020,Unknown ,Sweden,570,311,0,881
20639,2020,Afghanistan,Switzerland,14523,844,0,15367
20640,2020,Albania,Switzerland,113,49,0,162
20641,2020,Algeria,Switzerland,178,234,0,412
20642,2020,Angola,Switzerland,721,67,0,788
20643,2020,Egypt,Switzerland,120,17,0,137
20644,2020,Armenia,Switzerland,161,33,0,194
20645,2020,Azerbaijan,Switzerland,190,88,0,278
20646,2020,Burundi,Switzerland,173,7,0,180
20647,2020,Benin,Switzerland,22,0,0,22
20648,2020,Bangladesh,Switzerland,49,6,0,55
20649,2020,Burkina Faso,Switzerland,19,6,0,25
20650,2020,Belarus,Switzerland,54,21,0,75
20651,2020,Brazil,Switzerland,12,5,0,17
20652,2020,Bosnia and Herzegovina,Switzerland,1558,5,0,1563
20653,2020,Bulgaria,Switzerland,6,0,0,6
20654,2020,Cambodia,Switzerland,281,0,0,281
20655,2020,Central African Rep.,Switzerland,19,0,0,19
20656,2020,Chad,Switzerland,39,14,0,53
20657,2020,China,Switzerland,2665,86,0,2751
20658,2020,Chile,Switzerland,10,0,0,10
20659,2020,Cameroon,Switzerland,192,55,0,247
20660,2020,Congo,Switzerland,51,5,0,56
20661,2020,Dem. Rep. of the Congo,Switzerland,1255,82,0,1337
20662,2020,Colombia,Switzerland,275,69,0,344
20663,2020,Cuba,Switzerland,35,10,0,45
20664,2020,Czechia,Switzerland,5,0,0,5
20665,2020,Djibouti,Switzerland,17,0,0,17
20666,2020,Ecuador,Switzerland,5,0,0,5
20667,2020,Equatorial Guinea,Switzerland,5,0,0,5
20668,2020,Eritrea,Switzerland,37816,401,0,38217
20669,2020,Ethiopia,Switzerland,1748,125,0,1873
20670,2020,France,Switzerland,7,0,0,7
20671,2020,Gabon,Switzerland,5,0,0,5
20672,2020,Gambia,Switzerland,54,10,0,64
20673,2020,Georgia,Switzerland,217,122,0,339
20674,2020,Germany,Switzerland,5,0,0,5
20675,2020,Ghana,Switzerland,21,12,0,33
20676,2020,Guinea-Bissau,Switzerland,51,5,0,56
20677,2020,Guatemala,Switzerland,7,0,0,7
20678,2020,Guinea,Switzerland,180,35,0,215
20679,2020,Honduras,Switzerland,5,0,0,5
20680,2020,Croatia,Switzerland,16,0,0,16
20681,2020,Hungary,Switzerland,5,0,0,5
20682,2020,Cote d'Ivoire,Switzerland,194,27,0,221
20683,2020,India,Switzerland,34,6,0,40
20684,2020,Iran (Islamic Rep. of),Switzerland,2089,737,0,2826
20685,2020,Iraq,Switzerland,4635,324,0,4959
20686,2020,Israel,Switzerland,6,0,0,6
20687,2020,Italy,Switzerland,5,0,0,5
20688,2020,Jamaica,Switzerland,7,0,0,7
20689,2020,Jordan,Switzerland,57,0,0,57
20690,2020,Kazakhstan,Switzerland,20,13,0,33
20691,2020,Kenya,Switzerland,43,5,0,48
20692,2020,Kyrgyzstan,Switzerland,18,5,0,23
20693,2020,Lao People's Dem. Rep.,Switzerland,114,0,0,114
20694,2020,Liberia,Switzerland,33,0,0,33
20695,2020,Libya,Switzerland,310,42,0,352
20696,2020,Lebanon,Switzerland,44,23,0,67
20697,2020,Sri Lanka,Switzerland,6016,809,0,6825
20698,2020,Madagascar,Switzerland,6,0,0,6
20699,2020,Mauritania,Switzerland,8,0,0,8
20700,2020,North Macedonia,Switzerland,158,13,0,171
20701,2020,Rep. of Moldova,Switzerland,10,0,0,10
20702,2020,Mali,Switzerland,31,5,0,36
20703,2020,Mongolia,Switzerland,164,18,0,182
20704,2020,Morocco,Switzerland,79,93,0,172
20705,2020,Montenegro,Switzerland,53,0,0,53
20706,2020,Myanmar,Switzerland,30,0,0,30
20707,2020,Nepal,Switzerland,17,8,0,25
20708,2020,Niger,Switzerland,7,0,0,7
20709,2020,Nicaragua,Switzerland,5,15,0,20
20710,2020,Nigeria,Switzerland,278,100,0,378
20711,2020,Pakistan,Switzerland,273,87,0,360
20712,2020,Paraguay,Switzerland,5,0,0,5
20713,2020,Peru,Switzerland,5,0,0,5
20714,2020,Philippines,Switzerland,11,5,0,16
20715,2020,Portugal,Switzerland,5,0,0,5
20716,2020,Romania,Switzerland,17,0,0,17
20717,2020,South Africa,Switzerland,10,0,0,10
20718,2020,Russian Federation,Switzerland,753,65,0,818
20719,2020,Rwanda,Switzerland,110,5,0,115
20720,2020,El Salvador,Switzerland,8,5,0,13
20721,2020,Saudi Arabia,Switzerland,17,0,0,17
20722,2020,Serbia and Kosovo: S/RES/1244 (1999),Switzerland,2263,71,0,2334
20723,2020,Senegal,Switzerland,63,12,0,75
20724,2020,Sierra Leone,Switzerland,36,9,0,45
20725,2020,Somalia,Switzerland,4662,107,0,4769
20726,2020,Spain,Switzerland,5,0,0,5
20727,2020,Viet Nam,Switzerland,791,0,0,791
20728,2020,Sudan,Switzerland,324,27,0,351
20729,2020,South Sudan,Switzerland,19,0,0,19
20730,2020,Syrian Arab Rep.,Switzerland,19869,236,0,20105
20731,2020,United Rep. of Tanzania,Switzerland,14,0,0,14
20732,2020,Tajikistan,Switzerland,22,5,0,27
20733,2020,Turkmenistan,Switzerland,5,0,0,5
20734,2020,Togo,Switzerland,556,21,0,577
20735,2020,Tunisia,Switzerland,185,45,0,230
20736,2020,Türkiye,Switzerland,5447,1024,0,6471
20737,2020,Uganda,Switzerland,51,21,0,72
20738,2020,Ukraine,Switzerland,80,25,0,105
20739,2020,Uzbekistan,Switzerland,60,0,0,60
20740,2020,Venezuela (Bolivarian Republic of),Switzerland,39,23,0,62
20741,2020,Western Sahara,Switzerland,9,5,0,14
20742,2020,Yemen,Switzerland,341,5,0,346
20743,2020,Zimbabwe,Switzerland,12,5,0,17
20744,2020,Stateless,Switzerland,646,5,0,651
20745,2020,Unknown ,Switzerland,1724,78,0,1802
20746,2020,Afghanistan,Syrian Arab Rep.,1107,40,0,1147
20747,2020,Algeria,Syrian Arab Rep.,5,0,0,5
20748,2020,Egypt,Syrian Arab Rep.,32,10,0,42
20749,2020,Bahrain,Syrian Arab Rep.,0,5,0,5
20750,2020,Chad,Syrian Arab Rep.,9,6,0,15
20751,2020,Eritrea,Syrian Arab Rep.,19,0,0,19
20752,2020,Ethiopia,Syrian Arab Rep.,15,0,0,15
20753,2020,Guinea,Syrian Arab Rep.,54,5,0,59
20754,2020,Iran (Islamic Rep. of),Syrian Arab Rep.,45,12,0,57
20755,2020,Iraq,Syrian Arab Rep.,12399,8383,0,20782
20756,2020,Jordan,Syrian Arab Rep.,19,0,0,19
20757,2020,Libya,Syrian Arab Rep.,11,10,0,21
20758,2020,Lebanon,Syrian Arab Rep.,22,6,0,28
20759,2020,Sri Lanka,Syrian Arab Rep.,0,5,0,5
20760,2020,Morocco,Syrian Arab Rep.,0,5,0,5
20761,2020,Pakistan,Syrian Arab Rep.,214,10,0,224
20762,2020,Saudi Arabia,Syrian Arab Rep.,6,0,0,6
20763,2020,Sierra Leone,Syrian Arab Rep.,19,0,0,19
20764,2020,Somalia,Syrian Arab Rep.,354,40,0,394
20765,2020,Sudan,Syrian Arab Rep.,719,94,0,813
20766,2020,South Sudan,Syrian Arab Rep.,81,0,0,81
20767,2020,Syrian Arab Rep.,Syrian Arab Rep.,0,0,6701972,0
20768,2020,United Rep. of Tanzania,Syrian Arab Rep.,0,7,0,7
20769,2020,Tunisia,Syrian Arab Rep.,5,5,0,10
20770,2020,Türkiye,Syrian Arab Rep.,6,8,0,14
20771,2020,Yemen,Syrian Arab Rep.,158,118,0,276
20772,2020,Stateless,Syrian Arab Rep.,0,0,0,0
20773,2020,Unknown ,Syrian Arab Rep.,5,0,0,5
20774,2020,Burundi,United Rep. of Tanzania,183515,10539,0,194054
20775,2020,Dem. Rep. of the Congo,United Rep. of Tanzania,50860,18075,0,68935
20776,2020,Iran (Islamic Rep. of),United Rep. of Tanzania,0,5,0,5
20777,2020,Lebanon,United Rep. of Tanzania,0,0,0,0
20778,2020,Rwanda,United Rep. of Tanzania,67,33,0,100
20779,2020,Somalia,United Rep. of Tanzania,160,5,0,165
20780,2020,Sudan,United Rep. of Tanzania,0,8,0,8
20781,2020,South Sudan,United Rep. of Tanzania,10,0,0,10
20782,2020,Syrian Arab Rep.,United Rep. of Tanzania,5,17,0,22
20783,2020,United Rep. of Tanzania,United Rep. of Tanzania,5,0,0,5
20784,2020,Türkiye,United Rep. of Tanzania,0,10,0,10
20785,2020,Uganda,United Rep. of Tanzania,14,5,0,19
20786,2020,Yemen,United Rep. of Tanzania,9,51,0,60
20787,2020,Sri Lanka,Turks and Caicos Islands,8,0,0,8
20788,2020,Afghanistan,Thailand,160,18,0,178
20789,2020,Egypt,Thailand,20,0,0,20
20790,2020,Cambodia,Thailand,260,112,0,372
20791,2020,China,Thailand,177,17,0,194
20792,2020,Cameroon,Thailand,46,10,0,56
20793,2020,Dem. Rep. of the Congo,Thailand,18,5,0,23
20794,2020,Ethiopia,Thailand,18,10,0,28
20795,2020,Palestinian,Thailand,290,5,0,295
20796,2020,Guinea,Thailand,0,5,0,5
20797,2020,Cote d'Ivoire,Thailand,18,0,0,18
20798,2020,Iran (Islamic Rep. of),Thailand,76,38,0,114
20799,2020,Iraq,Thailand,168,5,0,173
20800,2020,Jordan,Thailand,5,0,0,5
20801,2020,Lao People's Dem. Rep.,Thailand,8,0,0,8
20802,2020,Sri Lanka,Thailand,119,16,0,135
20803,2020,Myanmar,Thailand,91805,0,0,91805
20804,2020,Nepal,Thailand,5,0,0,5
20805,2020,Nigeria,Thailand,5,0,0,5
20806,2020,Pakistan,Thailand,1662,104,0,1766
20807,2020,Somalia,Thailand,208,11,0,219
20808,2020,Viet Nam,Thailand,834,485,0,1319
20809,2020,Syrian Arab Rep.,Thailand,226,6,0,232
20810,2020,United Rep. of Tanzania,Thailand,5,0,0,5
20811,2020,Yemen,Thailand,37,5,0,42
20812,2020,Zimbabwe,Thailand,9,0,0,9
20813,2020,Stateless,Thailand,0,0,0,0
20814,2020,Afghanistan,Tajikistan,5573,408,0,5981
20815,2020,Iran (Islamic Rep. of),Tajikistan,5,0,0,5
20816,2020,Stateless,Tajikistan,0,0,0,0
20817,2020,Afghanistan,Turkmenistan,14,0,0,14
20818,2020,Azerbaijan,Turkmenistan,6,0,0,6
20819,2020,Stateless,Turkmenistan,0,0,0,0
20820,2020,Burundi,Togo,5,0,0,5
20821,2020,Benin,Togo,0,11,0,11
20822,2020,Central African Rep.,Togo,242,223,0,465
20823,2020,Chad,Togo,12,12,0,24
20824,2020,Cameroon,Togo,7,14,0,21
20825,2020,Congo,Togo,32,21,0,53
20826,2020,Dem. Rep. of the Congo,Togo,106,89,0,195
20827,2020,Gabon,Togo,0,6,0,6
20828,2020,Ghana,Togo,8513,0,0,8513
20829,2020,Cote d'Ivoire,Togo,1589,202,0,1791
20830,2020,Iraq,Togo,5,0,0,5
20831,2020,Liberia,Togo,0,6,0,6
20832,2020,Lebanon,Togo,5,0,0,5
20833,2020,Sri Lanka,Togo,0,5,0,5
20834,2020,Mali,Togo,78,41,0,119
20835,2020,Nigeria,Togo,9,7,0,16
20836,2020,Rwanda,Togo,116,7,0,123
20837,2020,Syrian Arab Rep.,Togo,16,6,0,22
20838,2020,Türkiye,Togo,63,10,0,73
20839,2020,Bangladesh,Trinidad and Tobago,8,90,0,98
20840,2020,China,Trinidad and Tobago,0,127,0,127
20841,2020,Cameroon,Trinidad and Tobago,0,9,0,9
20842,2020,Colombia,Trinidad and Tobago,12,60,0,72
20843,2020,Cuba,Trinidad and Tobago,171,2348,0,2519
20844,2020,Dominican Rep.,Trinidad and Tobago,0,136,0,136
20845,2020,Ghana,Trinidad and Tobago,0,45,0,45
20846,2020,Grenada,Trinidad and Tobago,0,5,0,5
20847,2020,Guyana,Trinidad and Tobago,19,56,0,75
20848,2020,Haiti,Trinidad and Tobago,0,15,0,15
20849,2020,India,Trinidad and Tobago,0,5,0,5
20850,2020,Jamaica,Trinidad and Tobago,37,124,0,161
20851,2020,Mexico,Trinidad and Tobago,6,0,0,6
20852,2020,Nicaragua,Trinidad and Tobago,0,5,0,5
20853,2020,Nigeria,Trinidad and Tobago,5,158,0,163
20854,2020,Pakistan,Trinidad and Tobago,9,19,0,28
20855,2020,Peru,Trinidad and Tobago,0,5,0,5
20856,2020,Philippines,Trinidad and Tobago,0,5,0,5
20857,2020,Viet Nam,Trinidad and Tobago,0,7,0,7
20858,2020,Syrian Arab Rep.,Trinidad and Tobago,66,38,0,104
20859,2020,Tajikistan,Trinidad and Tobago,0,5,0,5
20860,2020,Trinidad and Tobago,Trinidad and Tobago,0,0,0,0
20861,2020,Saint Vincent and the Grenadines,Trinidad and Tobago,5,0,0,5
20862,2020,Venezuela (Bolivarian Republic of),Trinidad and Tobago,2841,16664,0,19505
20863,2020,Algeria,Tunisia,9,16,0,25
20864,2020,Egypt,Tunisia,0,10,0,10
20865,2020,Burundi,Tunisia,0,7,0,7
20866,2020,Benin,Tunisia,0,6,0,6
20867,2020,Bangladesh,Tunisia,0,17,0,17
20868,2020,Burkina Faso,Tunisia,0,46,0,46
20869,2020,Central African Rep.,Tunisia,10,21,0,31
20870,2020,Chad,Tunisia,0,18,0,18
20871,2020,Cameroon,Tunisia,17,194,0,211
20872,2020,Congo,Tunisia,0,7,0,7
20873,2020,Dem. Rep. of the Congo,Tunisia,0,81,0,81
20874,2020,Comoros,Tunisia,0,5,0,5
20875,2020,Eritrea,Tunisia,197,49,0,246
20876,2020,Ethiopia,Tunisia,0,48,0,48
20877,2020,Gambia,Tunisia,0,5,0,5
20878,2020,Palestinian,Tunisia,35,13,0,48
20879,2020,Ghana,Tunisia,0,5,0,5
20880,2020,Guinea,Tunisia,7,255,0,262
20881,2020,Cote d'Ivoire,Tunisia,33,2210,0,2243
20882,2020,Iran (Islamic Rep. of),Tunisia,8,0,0,8
20883,2020,Iraq,Tunisia,20,10,0,30
20884,2020,Liberia,Tunisia,0,38,0,38
20885,2020,Libya,Tunisia,14,127,0,141
20886,2020,Lebanon,Tunisia,6,20,0,26
20887,2020,Mauritania,Tunisia,0,6,0,6
20888,2020,Mali,Tunisia,6,55,0,61
20889,2020,Morocco,Tunisia,0,0,0,0
20890,2020,Niger,Tunisia,0,6,0,6
20891,2020,Nigeria,Tunisia,5,35,0,40
20892,2020,Rwanda,Tunisia,6,0,0,6
20893,2020,Senegal,Tunisia,0,15,0,15
20894,2020,Sierra Leone,Tunisia,5,36,0,41
20895,2020,Somalia,Tunisia,35,142,0,177
20896,2020,Sudan,Tunisia,144,138,0,282
20897,2020,South Sudan,Tunisia,5,21,0,26
20898,2020,Syrian Arab Rep.,Tunisia,1997,0,0,1997
20899,2020,Togo,Tunisia,0,5,0,5
20900,2020,Türkiye,Tunisia,10,5,0,15
20901,2020,Yemen,Tunisia,11,28,0,39
20902,2020,Afghanistan,Türkiye,4219,125104,0,129323
20903,2020,Iran (Islamic Rep. of),Türkiye,1693,24300,0,25993
20904,2020,Iraq,Türkiye,4565,162760,0,167325
20905,2020,Syrian Arab Rep.,Türkiye,3641370,0,0,3641370
20906,2020,Unknown ,Türkiye,515,10024,0,10539
20907,2020,Afghanistan,United Arab Emirates,5,25,0,30
20908,2020,Algeria,United Arab Emirates,0,0,0,0
20909,2020,Egypt,United Arab Emirates,5,8,0,13
20910,2020,Chad,United Arab Emirates,6,0,0,6
20911,2020,Eritrea,United Arab Emirates,0,7,0,7
20912,2020,Ethiopia,United Arab Emirates,8,5,0,13
20913,2020,Palestinian,United Arab Emirates,15,0,0,15
20914,2020,Iran (Islamic Rep. of),United Arab Emirates,7,7,0,14
20915,2020,Iraq,United Arab Emirates,809,554,0,1363
20916,2020,Jordan,United Arab Emirates,7,0,0,7
20917,2020,Kuwait,United Arab Emirates,5,0,0,5
20918,2020,Libya,United Arab Emirates,0,5,0,5
20919,2020,Lebanon,United Arab Emirates,18,5,0,23
20920,2020,Morocco,United Arab Emirates,0,0,0,0
20921,2020,Pakistan,United Arab Emirates,5,0,0,5
20922,2020,Philippines,United Arab Emirates,0,0,0,0
20923,2020,Russian Federation,United Arab Emirates,0,5,0,5
20924,2020,Saudi Arabia,United Arab Emirates,5,0,0,5
20925,2020,Somalia,United Arab Emirates,18,0,0,18
20926,2020,Sudan,United Arab Emirates,13,7,0,20
20927,2020,Syrian Arab Rep.,United Arab Emirates,383,6551,0,6934
20928,2020,Yemen,United Arab Emirates,6,50,0,56
20929,2020,Stateless,United Arab Emirates,0,0,0,0
20930,2020,Egypt,Uganda,7,5,0,12
20931,2020,Burundi,Uganda,48466,1262,0,49728
20932,2020,Central African Rep.,Uganda,30,0,0,30
20933,2020,Chad,Uganda,7,0,0,7
20934,2020,Cameroon,Uganda,5,0,0,5
20935,2020,Congo,Uganda,22,0,0,22
20936,2020,Dem. Rep. of the Congo,Uganda,417407,4156,0,421563
20937,2020,Eritrea,Uganda,8650,7796,0,16446
20938,2020,Ethiopia,Uganda,2222,1012,0,3234
20939,2020,Palestinian,Uganda,5,0,0,5
20940,2020,Guinea,Uganda,5,0,0,5
20941,2020,Kenya,Uganda,204,19,0,223
20942,2020,Mali,Uganda,0,5,0,5
20943,2020,Pakistan,Uganda,235,17,0,252
20944,2020,Rwanda,Uganda,15978,1905,0,17883
20945,2020,Senegal,Uganda,10,0,0,10
20946,2020,Somalia,Uganda,37536,6943,0,44479
20947,2020,Sudan,Uganda,2790,501,0,3291
20948,2020,South Sudan,Uganda,887452,1602,0,889054
20949,2020,Syrian Arab Rep.,Uganda,16,8,0,24
20950,2020,United Rep. of Tanzania,Uganda,10,0,0,10
20951,2020,Türkiye,Uganda,49,0,0,49
20952,2020,Uganda,Uganda,0,0,0,0
20953,2020,Yemen,Uganda,27,5,0,32
20954,2020,Afghanistan,Ukraine,822,673,0,1495
20955,2020,Algeria,Ukraine,0,9,0,9
20956,2020,Angola,Ukraine,24,0,0,24
20957,2020,Egypt,Ukraine,5,15,0,20
20958,2020,Armenia,Ukraine,46,10,0,56
20959,2020,Azerbaijan,Ukraine,70,25,0,95
20960,2020,Bangladesh,Ukraine,5,147,0,152
20961,2020,Belarus,Ukraine,26,26,0,52
20962,2020,Chad,Ukraine,7,0,0,7
20963,2020,China,Ukraine,0,5,0,5
20964,2020,Cameroon,Ukraine,5,29,0,34
20965,2020,Congo,Ukraine,26,14,0,40
20966,2020,Dem. Rep. of the Congo,Ukraine,25,39,0,64
20967,2020,Eritrea,Ukraine,11,28,0,39
20968,2020,Ethiopia,Ukraine,26,5,0,31
20969,2020,Palestinian,Ukraine,10,40,0,50
20970,2020,Georgia,Ukraine,25,0,0,25
20971,2020,Ghana,Ukraine,0,12,0,12
20972,2020,Guinea,Ukraine,5,22,0,27
20973,2020,Haiti,Ukraine,0,5,0,5
20974,2020,Cote d'Ivoire,Ukraine,0,17,0,17
20975,2020,India,Ukraine,7,26,0,33
20976,2020,Iran (Islamic Rep. of),Ukraine,72,49,0,121
20977,2020,Iraq,Ukraine,79,75,0,154
20978,2020,Jordan,Ukraine,5,5,0,10
20979,2020,Kazakhstan,Ukraine,9,16,0,25
20980,2020,Kyrgyzstan,Ukraine,9,31,0,40
20981,2020,Libya,Ukraine,5,13,0,18
20982,2020,Lebanon,Ukraine,8,14,0,22
20983,2020,Sri Lanka,Ukraine,7,29,0,36
20984,2020,Rep. of Moldova,Ukraine,0,5,0,5
20985,2020,Mali,Ukraine,0,5,0,5
20986,2020,Morocco,Ukraine,0,11,0,11
20987,2020,Myanmar,Ukraine,0,6,0,6
20988,2020,Nigeria,Ukraine,6,38,0,44
20989,2020,Pakistan,Ukraine,7,69,0,76
20990,2020,Russian Federation,Ukraine,165,161,0,326
20991,2020,Rwanda,Ukraine,5,0,0,5
20992,2020,Serbia and Kosovo: S/RES/1244 (1999),Ukraine,5,0,0,5
20993,2020,Senegal,Ukraine,0,5,0,5
20994,2020,Sierra Leone,Ukraine,5,0,0,5
20995,2020,Somalia,Ukraine,81,109,0,190
20996,2020,Viet Nam,Ukraine,0,13,0,13
20997,2020,Sudan,Ukraine,27,25,0,52
20998,2020,Syrian Arab Rep.,Ukraine,491,171,0,662
20999,2020,Tajikistan,Ukraine,22,184,0,206
21000,2020,Turkmenistan,Ukraine,7,0,0,7
21001,2020,Tunisia,Ukraine,0,5,0,5
21002,2020,Türkiye,Ukraine,5,12,0,17
21003,2020,Ukraine,Ukraine,0,0,734000,0
21004,2020,Uzbekistan,Ukraine,32,95,0,127
21005,2020,Yemen,Ukraine,5,46,0,51
21006,2020,Zambia,Ukraine,0,5,0,5
21007,2020,Stateless,Ukraine,47,15,0,62
21008,2020,Afghanistan,Uruguay,0,7,0,7
21009,2020,Angola,Uruguay,14,0,0,14
21010,2020,Egypt,Uruguay,0,5,0,5
21011,2020,Argentina,Uruguay,0,7,0,7
21012,2020,Bangladesh,Uruguay,0,128,0,128
21013,2020,Bolivia (Plurinational State of),Uruguay,5,5,0,10
21014,2020,Brazil,Uruguay,0,15,0,15
21015,2020,Chile,Uruguay,0,5,0,5
21016,2020,Cameroon,Uruguay,12,5,0,17
21017,2020,Congo,Uruguay,5,0,0,5
21018,2020,Colombia,Uruguay,162,51,0,213
21019,2020,Cuba,Uruguay,26,9109,0,9135
21020,2020,Dominican Rep.,Uruguay,0,255,0,255
21021,2020,Ecuador,Uruguay,7,9,0,16
21022,2020,Ghana,Uruguay,0,26,0,26
21023,2020,Guinea-Bissau,Uruguay,0,5,0,5
21024,2020,Guatemala,Uruguay,5,0,0,5
21025,2020,Guinea,Uruguay,0,9,0,9
21026,2020,Haiti,Uruguay,0,15,0,15
21027,2020,Libya,Uruguay,5,0,0,5
21028,2020,Latvia,Uruguay,5,0,0,5
21029,2020,Mexico,Uruguay,5,0,0,5
21030,2020,Morocco,Uruguay,0,10,0,10
21031,2020,Nicaragua,Uruguay,9,0,0,9
21032,2020,Nigeria,Uruguay,22,19,0,41
21033,2020,Pakistan,Uruguay,0,33,0,33
21034,2020,Paraguay,Uruguay,5,0,0,5
21035,2020,Peru,Uruguay,6,5,0,11
21036,2020,Russian Federation,Uruguay,12,5,0,17
21037,2020,El Salvador,Uruguay,42,13,0,55
21038,2020,Senegal,Uruguay,0,238,0,238
21039,2020,Somalia,Uruguay,5,0,0,5
21040,2020,Syrian Arab Rep.,Uruguay,63,6,0,69
21041,2020,Türkiye,Uruguay,13,5,0,18
21042,2020,Ukraine,Uruguay,11,5,0,16
21043,2020,Venezuela (Bolivarian Republic of),Uruguay,225,636,0,861
21044,2020,Afghanistan,United States of America,1592,796,0,2388
21045,2020,Albania,United States of America,1314,2129,0,3443
21046,2020,Algeria,United States of America,155,434,0,589
21047,2020,Angola,United States of America,264,2095,0,2359
21048,2020,Antigua and Barbuda,United States of America,7,13,0,20
21049,2020,Egypt,United States of America,14359,5461,0,19820
21050,2020,Argentina,United States of America,32,313,0,345
21051,2020,Armenia,United States of America,1360,3468,0,4828
21052,2020,Australia,United States of America,5,12,0,17
21053,2020,Austria,United States of America,13,0,0,13
21054,2020,Azerbaijan,United States of America,487,1195,0,1682
21055,2020,Bahrain,United States of America,43,38,0,81
21056,2020,Barbados,United States of America,0,5,0,5
21057,2020,Burundi,United States of America,849,621,0,1470
21058,2020,Belgium,United States of America,17,34,0,51
21059,2020,Benin,United States of America,82,240,0,322
21060,2020,Bangladesh,United States of America,2162,7952,0,10114
21061,2020,Bahamas,United States of America,181,127,0,308
21062,2020,Bhutan,United States of America,34,358,0,392
21063,2020,Burkina Faso,United States of America,1377,3335,0,4712
21064,2020,Belarus,United States of America,1547,2477,0,4024
21065,2020,Bolivia (Plurinational State of),United States of America,96,483,0,579
21066,2020,Botswana,United States of America,0,5,0,5
21067,2020,Brazil,United States of America,989,13245,0,14234
21068,2020,Bosnia and Herzegovina,United States of America,92,200,0,292
21069,2020,Bulgaria,United States of America,200,283,0,483
21070,2020,Belize,United States of America,39,279,0,318
21071,2020,Cambodia,United States of America,128,71,0,199
21072,2020,Canada,United States of America,26,65,0,91
21073,2020,Central African Rep.,United States of America,181,111,0,292
21074,2020,Cayman Islands,United States of America,5,0,0,5
21075,2020,Chad,United States of America,242,241,0,483
21076,2020,China,United States of America,74948,75843,0,150791
21077,2020,Chile,United States of America,21,418,0,439
21078,2020,Cameroon,United States of America,5204,5274,0,10478
21079,2020,Congo,United States of America,1120,2029,0,3149
21080,2020,Dem. Rep. of the Congo,United States of America,1469,1975,0,3444
21081,2020,Comoros,United States of America,5,5,0,10
21082,2020,Colombia,United States of America,2668,16868,0,19536
21083,2020,Costa Rica,United States of America,171,601,0,772
21084,2020,Cuba,United States of America,2591,9751,0,12342
21085,2020,Cabo Verde,United States of America,0,33,0,33
21086,2020,Cyprus,United States of America,0,7,0,7
21087,2020,Czechia,United States of America,8,59,0,67
21088,2020,Denmark,United States of America,0,5,0,5
21089,2020,Djibouti,United States of America,361,469,0,830
21090,2020,Dominica,United States of America,15,25,0,40
21091,2020,Dominican Rep.,United States of America,255,1141,0,1396
21092,2020,Ecuador,United States of America,1453,20863,0,22316
21093,2020,Equatorial Guinea,United States of America,17,71,0,88
21094,2020,Eritrea,United States of America,5765,1019,0,6784
21095,2020,Estonia,United States of America,252,36,0,288
21096,2020,Ethiopia,United States of America,8245,5885,0,14130
21097,2020,French Guiana,United States of America,0,8,0,8
21098,2020,Fiji,United States of America,126,323,0,449
21099,2020,France,United States of America,21,77,0,98
21100,2020,Gabon,United States of America,53,284,0,337
21101,2020,Gambia,United States of America,1449,815,0,2264
21102,2020,Palestinian,United States of America,21,102,0,123
21103,2020,United Kingdom of Great Britain and Northern Ireland,United States of America,30,113,0,143
21104,2020,Georgia,United States of America,456,2005,0,2461
21105,2020,Germany,United States of America,36,132,0,168
21106,2020,Ghana,United States of America,491,963,0,1454
21107,2020,Guinea-Bissau,United States of America,18,37,0,55
21108,2020,Greece,United States of America,14,77,0,91
21109,2020,Grenada,United States of America,20,38,0,58
21110,2020,Guatemala,United States of America,21951,139527,0,161478
21111,2020,Guinea,United States of America,1755,1164,0,2919
21112,2020,Guyana,United States of America,106,437,0,543
21113,2020,Haiti,United States of America,15125,25292,0,40417
21114,2020,"China, Hong Kong SAR",United States of America,5,69,0,74
21115,2020,Honduras,United States of America,15940,101617,0,117557
21116,2020,Croatia,United States of America,27,37,0,64
21117,2020,Hungary,United States of America,12,297,0,309
21118,2020,Cote d'Ivoire,United States of America,1096,1302,0,2398
21119,2020,India,United States of America,8677,37896,0,46573
21120,2020,Indonesia,United States of America,1084,2492,0,3576
21121,2020,Ireland,United States of America,0,28,0,28
21122,2020,Iran (Islamic Rep. of),United States of America,5582,2944,0,8526
21123,2020,Iraq,United States of America,5437,3432,0,8869
21124,2020,Israel,United States of America,115,476,0,591
21125,2020,Italy,United States of America,17,299,0,316
21126,2020,Jamaica,United States of America,896,1164,0,2060
21127,2020,Jordan,United States of America,619,2658,0,3277
21128,2020,Japan,United States of America,6,81,0,87
21129,2020,Kazakhstan,United States of America,1056,2860,0,3916
21130,2020,Kenya,United States of America,1735,5586,0,7321
21131,2020,Kyrgyzstan,United States of America,1612,1876,0,3488
21132,2020,Rep. of Korea,United States of America,27,246,0,273
21133,2020,Dem. People's Rep. of Korea,United States of America,6,26,0,32
21134,2020,Kuwait,United States of America,144,198,0,342
21135,2020,Lao People's Dem. Rep.,United States of America,65,170,0,235
21136,2020,Liberia,United States of America,1239,1154,0,2393
21137,2020,Libya,United States of America,416,1028,0,1444
21138,2020,Saint Lucia,United States of America,6,24,0,30
21139,2020,Lebanon,United States of America,381,1078,0,1459
21140,2020,Lesotho,United States of America,6,0,0,6
21141,2020,Sri Lanka,United States of America,1096,1890,0,2986
21142,2020,Lithuania,United States of America,21,59,0,80
21143,2020,Latvia,United States of America,21,82,0,103
21144,2020,"China, Macao SAR",United States of America,0,11,0,11
21145,2020,Madagascar,United States of America,8,15,0,23
21146,2020,Mauritania,United States of America,956,1077,0,2033
21147,2020,North Macedonia,United States of America,110,220,0,330
21148,2020,Rep. of Moldova,United States of America,1466,2324,0,3790
21149,2020,Maldives,United States of America,5,0,0,5
21150,2020,Mexico,United States of America,12076,104529,0,116605
21151,2020,Marshall Islands,United States of America,7,0,0,7
21152,2020,Mali,United States of America,1015,604,0,1619
21153,2020,Malaysia,United States of America,93,374,0,467
21154,2020,Malawi,United States of America,35,137,0,172
21155,2020,Mongolia,United States of America,726,2234,0,2960
21156,2020,Morocco,United States of America,124,243,0,367
21157,2020,Mozambique,United States of America,24,38,0,62
21158,2020,Malta,United States of America,0,5,0,5
21159,2020,Montenegro,United States of America,95,447,0,542
21160,2020,Mauritius,United States of America,34,36,0,70
21161,2020,Myanmar,United States of America,1272,2190,0,3462
21162,2020,Namibia,United States of America,43,29,0,72
21163,2020,Nepal,United States of America,6742,6953,0,13695
21164,2020,Netherlands,United States of America,7,67,0,74
21165,2020,Niger,United States of America,144,331,0,475
21166,2020,Nicaragua,United States of America,1754,8373,0,10127
21167,2020,Nigeria,United States of America,2523,14651,0,17174
21168,2020,Niue,United States of America,18,7,0,25
21169,2020,Oman,United States of America,14,28,0,42
21170,2020,Pakistan,United States of America,3887,6081,0,9968
21171,2020,Panama,United States of America,12,126,0,138
21172,2020,Paraguay,United States of America,15,102,0,117
21173,2020,Peru,United States of America,498,3422,0,3920
21174,2020,Philippines,United States of America,166,1558,0,1724
21175,2020,Poland,United States of America,9,898,0,907
21176,2020,Portugal,United States of America,5,197,0,202
21177,2020,Qatar,United States of America,20,25,0,45
21178,2020,Romania,United States of America,437,3094,0,3531
21179,2020,South Africa,United States of America,51,769,0,820
21180,2020,Russian Federation,United States of America,6530,12806,0,19336
21181,2020,Rwanda,United States of America,1219,1154,0,2373
21182,2020,El Salvador,United States of America,27434,126248,0,153682
21183,2020,Saudi Arabia,United States of America,594,787,0,1381
21184,2020,Serbia and Kosovo: S/RES/1244 (1999),United States of America,712,1772,0,2484
21185,2020,Senegal,United States of America,398,663,0,1061
21186,2020,Singapore,United States of America,8,39,0,47
21187,2020,Sierra Leone,United States of America,424,376,0,800
21188,2020,Somalia,United States of America,1698,335,0,2033
21189,2020,Spain,United States of America,9,155,0,164
21190,2020,Viet Nam,United States of America,396,1310,0,1706
21191,2020,Saint Kitts and Nevis,United States of America,5,5,0,10
21192,2020,Sudan,United States of America,1412,876,0,2288
21193,2020,Suriname,United States of America,12,44,0,56
21194,2020,South Sudan,United States of America,48,57,0,105
21195,2020,Slovakia,United States of America,5,51,0,56
21196,2020,Slovenia,United States of America,5,5,0,10
21197,2020,Eswatini,United States of America,5,15,0,20
21198,2020,Sweden,United States of America,0,24,0,24
21199,2020,Switzerland,United States of America,5,11,0,16
21200,2020,Syrian Arab Rep.,United States of America,8616,2630,0,11246
21201,2020,United Rep. of Tanzania,United States of America,126,244,0,370
21202,2020,Turks and Caicos Islands,United States of America,14,0,0,14
21203,2020,Thailand,United States of America,35,480,0,515
21204,2020,Tajikistan,United States of America,317,531,0,848
21205,2020,Turkmenistan,United States of America,205,342,0,547
21206,2020,Timor-Leste,United States of America,0,12,0,12
21207,2020,Togo,United States of America,529,648,0,1177
21208,2020,Tonga,United States of America,0,5,0,5
21209,2020,Trinidad and Tobago,United States of America,42,234,0,276
21210,2020,Tunisia,United States of America,94,264,0,358
21211,2020,Türkiye,United States of America,3062,4227,0,7289
21212,2020,United Arab Emirates,United States of America,73,146,0,219
21213,2020,Uganda,United States of America,1783,3311,0,5094
21214,2020,Ukraine,United States of America,2581,8222,0,10803
21215,2020,Uruguay,United States of America,5,131,0,136
21216,2020,Uzbekistan,United States of America,1282,2458,0,3740
21217,2020,Vanuatu,United States of America,0,20,0,20
21218,2020,Saint Vincent and the Grenadines,United States of America,30,17,0,47
21219,2020,Venezuela (Bolivarian Republic of),United States of America,17292,129667,0,146959
21220,2020,Yemen,United States of America,705,830,0,1535
21221,2020,Zambia,United States of America,45,119,0,164
21222,2020,Zimbabwe,United States of America,756,1041,0,1797
21223,2020,Stateless,United States of America,47,0,0,47
21224,2020,Guadeloupe,United States of America,0,86,0,86
21225,2020,Curacao ,United States of America,35,0,0,35
21226,2020,Unknown ,United States of America,6400,3477,0,9877
21227,2020,Afghanistan,Uzbekistan,13,0,0,13
21228,2020,Stateless,Uzbekistan,0,0,0,0
21229,2020,Venezuela (Bolivarian Republic of),Saint Vincent and the Grenadines,0,0,0,0
21230,2020,Afghanistan,Venezuela (Bolivarian Republic of),10,0,0,10
21231,2020,Chile,Venezuela (Bolivarian Republic of),10,0,0,10
21232,2020,Congo,Venezuela (Bolivarian Republic of),5,0,0,5
21233,2020,Colombia,Venezuela (Bolivarian Republic of),67935,284,0,68219
21234,2020,Palestinian,Venezuela (Bolivarian Republic of),7,0,0,7
21235,2020,Haiti,Venezuela (Bolivarian Republic of),7,0,0,7
21236,2020,Iraq,Venezuela (Bolivarian Republic of),18,0,0,18
21237,2020,Liberia,Venezuela (Bolivarian Republic of),9,0,0,9
21238,2020,Libya,Venezuela (Bolivarian Republic of),5,0,0,5
21239,2020,Lebanon,Venezuela (Bolivarian Republic of),12,0,0,12
21240,2020,Nigeria,Venezuela (Bolivarian Republic of),7,0,0,7
21241,2020,Peru,Venezuela (Bolivarian Republic of),5,0,0,5
21242,2020,Rwanda,Venezuela (Bolivarian Republic of),5,0,0,5
21243,2020,Sierra Leone,Venezuela (Bolivarian Republic of),5,0,0,5
21244,2020,Syrian Arab Rep.,Venezuela (Bolivarian Republic of),32,0,0,32
21245,2020,Türkiye,Venezuela (Bolivarian Republic of),6,0,0,6
21246,2020,Venezuela (Bolivarian Republic of),Venezuela (Bolivarian Republic of),0,0,0,0
21247,2020,Western Sahara,Venezuela (Bolivarian Republic of),11,0,0,11
21248,2020,Egypt,Yemen,16,10,0,26
21249,2020,Cameroon,Yemen,0,5,0,5
21250,2020,Djibouti,Yemen,5,6,0,11
21251,2020,Eritrea,Yemen,1370,475,0,1845
21252,2020,Ethiopia,Yemen,6644,8699,0,15343
21253,2020,Palestinian,Yemen,630,307,0,937
21254,2020,Iran (Islamic Rep. of),Yemen,5,0,0,5
21255,2020,Iraq,Yemen,3321,73,0,3394
21256,2020,Jordan,Yemen,17,8,0,25
21257,2020,Mali,Yemen,0,5,0,5
21258,2020,Pakistan,Yemen,0,9,0,9
21259,2020,Somalia,Yemen,151155,155,0,151310
21260,2020,Viet Nam,Yemen,15,0,0,15
21261,2020,Sudan,Yemen,119,522,0,641
21262,2020,Syrian Arab Rep.,Yemen,3609,419,0,4028
21263,2020,United Rep. of Tanzania,Yemen,0,0,0,0
21264,2020,Yemen,Yemen,0,0,4002012,0
21265,2020,Angola,Zambia,0,0,0,0
21266,2020,Burundi,Zambia,6743,939,0,7682
21267,2020,Central African Rep.,Zambia,0,5,0,5
21268,2020,Cameroon,Zambia,5,37,0,42
21269,2020,Congo,Zambia,16,0,0,16
21270,2020,Dem. Rep. of the Congo,Zambia,54715,2779,0,57494
21271,2020,Eritrea,Zambia,31,18,0,49
21272,2020,Ethiopia,Zambia,30,8,0,38
21273,2020,Palestinian,Zambia,14,0,0,14
21274,2020,Liberia,Zambia,8,0,0,8
21275,2020,Nigeria,Zambia,0,5,0,5
21276,2020,South Africa,Zambia,6,0,0,6
21277,2020,Rwanda,Zambia,777,27,0,804
21278,2020,Sierra Leone,Zambia,5,0,0,5
21279,2020,Somalia,Zambia,3414,404,0,3818
21280,2020,Sudan,Zambia,28,0,0,28
21281,2020,South Sudan,Zambia,5,6,0,11
21282,2020,Syrian Arab Rep.,Zambia,20,6,0,26
21283,2020,Türkiye,Zambia,74,5,0,79
21284,2020,Uganda,Zambia,108,54,0,162
21285,2020,Unknown ,Zambia,71,0,0,71
21286,2020,Burundi,Zimbabwe,676,227,0,903
21287,2020,Central African Rep.,Zimbabwe,0,5,0,5
21288,2020,Cameroon,Zimbabwe,0,7,0,7
21289,2020,Congo,Zimbabwe,20,0,0,20
21290,2020,Dem. Rep. of the Congo,Zimbabwe,7757,3260,0,11017
21291,2020,Eritrea,Zimbabwe,20,5,0,25
21292,2020,Ethiopia,Zimbabwe,71,13,0,84
21293,2020,Cote d'Ivoire,Zimbabwe,12,20,0,32
21294,2020,Kenya,Zimbabwe,0,8,0,8
21295,2020,Mali,Zimbabwe,6,89,0,95
21296,2020,Mozambique,Zimbabwe,0,8172,0,8172
21297,2020,South Africa,Zimbabwe,0,0,0,0
21298,2020,Rwanda,Zimbabwe,662,80,0,742
21299,2020,Somalia,Zimbabwe,13,19,0,32
21300,2020,Sudan,Zimbabwe,7,0,0,7
21301,2020,South Sudan,Zimbabwe,8,24,0,32
21302,2020,Uganda,Zimbabwe,9,0,0,9
21303,2020,Zambia,Zimbabwe,0,0,0,0
21304,2020,Zimbabwe,Zimbabwe,0,0,0,0
21305,2020,Venezuela (Bolivarian Republic of),Anguilla,0,0,0,0
21306,2020,Colombia,Aruba,0,0,0,0
21307,2020,Venezuela (Bolivarian Republic of),Aruba,0,0,0,0
21308,2020,Colombia,Curacao ,44,33,0,77
21309,2020,Venezuela (Bolivarian Republic of),Curacao ,24,285,0,309
21310,2020,Venezuela (Bolivarian Republic of),Sint Maarten (Dutch part),0,8,0,8
