,Year,Country of origin,Country of asylum,Refugees under UNHCR's mandate,Asylum-seekers,IDPs of concern to UNHCR,International total
10382,2019,Afghanistan,Afghanistan,0,0,2553390,0
10383,2019,Benin,Afghanistan,0,5,0,5
10384,2019,Iran (Islamic Rep. of),Afghanistan,36,25,0,61
10385,2019,Pakistan,Afghanistan,72191,138,0,72329
10386,2019,Türkiye,Afghanistan,0,79,0,79
10387,2019,Algeria,Albania,0,0,0,0
10388,2019,Egypt,Albania,5,0,0,5
10389,2019,China,Albania,12,0,0,12
10390,2019,Palestinian,Albania,7,5,0,12
10391,2019,Iraq,Albania,8,0,0,8
10392,2019,Morocco,Albania,0,0,0,0
10393,2019,Serbia and Kosovo: S/RES/1244 (1999),Albania,65,0,0,65
10394,2019,Syrian Arab Rep.,Albania,13,0,0,13
10395,2019,Türkiye,Albania,0,0,0,0
10396,2019,Uzbekistan,Albania,5,0,0,5
10397,2019,Venezuela (Bolivarian Republic of),Albania,5,0,0,5
10398,2019,Stateless,Albania,0,0,0,0
10399,2019,Benin,Algeria,0,15,0,15
10400,2019,Burkina Faso,Algeria,0,13,0,13
10401,2019,Central African Rep.,Algeria,67,29,0,96
10402,2019,Chad,Algeria,0,18,0,18
10403,2019,Cameroon,Algeria,72,285,0,357
10404,2019,Congo,Algeria,0,5,0,5
10405,2019,Dem. Rep. of the Congo,Algeria,59,104,0,163
10406,2019,Eritrea,Algeria,0,6,0,6
10407,2019,Palestinian,Algeria,173,0,0,173
10408,2019,Ghana,Algeria,0,5,0,5
10409,2019,Guinea,Algeria,28,227,0,255
10410,2019,Cote d'Ivoire,Algeria,63,162,0,225
10411,2019,Iraq,Algeria,12,5,0,17
10412,2019,Liberia,Algeria,0,36,0,36
10413,2019,Libya,Algeria,19,16,0,35
10414,2019,Mali,Algeria,74,356,0,430
10415,2019,Niger,Algeria,5,92,0,97
10416,2019,Nigeria,Algeria,5,196,0,201
10417,2019,Senegal,Algeria,0,9,0,9
10418,2019,Sierra Leone,Algeria,0,15,0,15
10419,2019,Sudan,Algeria,8,26,0,34
10420,2019,Syrian Arab Rep.,Algeria,7757,0,0,7757
10421,2019,Togo,Algeria,0,14,0,14
10422,2019,Türkiye,Algeria,0,13,0,13
10423,2019,Western Sahara,Algeria,90000,0,0,90000
10424,2019,Yemen,Algeria,257,0,0,257
10425,2019,Angola,Angola,0,0,0,0
10426,2019,Burundi,Angola,18,99,0,117
10427,2019,Central African Rep.,Angola,7,76,0,83
10428,2019,Chad,Angola,190,779,0,969
10429,2019,Congo,Angola,65,58,0,123
10430,2019,Dem. Rep. of the Congo,Angola,22905,500,0,23405
10431,2019,Eritrea,Angola,78,1774,0,1852
10432,2019,Ethiopia,Angola,0,57,0,57
10433,2019,Guinea-Bissau,Angola,7,268,0,275
10434,2019,Guinea,Angola,128,9145,0,9273
10435,2019,Cote d'Ivoire,Angola,417,5940,0,6357
10436,2019,Liberia,Angola,164,478,0,642
10437,2019,Mauritania,Angola,323,5402,0,5725
10438,2019,Rwanda,Angola,507,67,0,574
10439,2019,Sierra Leone,Angola,413,1497,0,1910
10440,2019,Somalia,Angola,270,1731,0,2001
10441,2019,Sudan,Angola,280,1670,0,1950
10442,2019,United Rep. of Tanzania,Angola,5,0,0,5
10443,2019,Türkiye,Angola,0,35,0,35
10444,2019,Uganda,Angola,0,6,0,6
10445,2019,Western Sahara,Angola,16,596,0,612
10446,2019,Afghanistan,Egypt,28,36,0,64
10447,2019,Burundi,Egypt,51,52,0,103
10448,2019,Central African Rep.,Egypt,37,30,0,67
10449,2019,Chad,Egypt,48,35,0,83
10450,2019,China,Egypt,0,71,0,71
10451,2019,Cameroon,Egypt,15,31,0,46
10452,2019,Congo,Egypt,13,20,0,33
10453,2019,Dem. Rep. of the Congo,Egypt,52,26,0,78
10454,2019,Djibouti,Egypt,12,9,0,21
10455,2019,Eritrea,Egypt,8858,9374,0,18232
10456,2019,Ethiopia,Egypt,4599,11657,0,16256
10457,2019,Palestinian,Egypt,70010,0,0,70010
10458,2019,Guinea,Egypt,7,51,0,58
10459,2019,Cote d'Ivoire,Egypt,99,6,0,105
10460,2019,Iraq,Egypt,4426,2345,0,6771
10461,2019,Jordan,Egypt,11,11,0,22
10462,2019,Kenya,Egypt,7,5,0,12
10463,2019,Liberia,Egypt,0,8,0,8
10464,2019,Libya,Egypt,5,0,0,5
10465,2019,Mali,Egypt,0,9,0,9
10466,2019,Nigeria,Egypt,21,135,0,156
10467,2019,Russian Federation,Egypt,8,24,0,32
10468,2019,Rwanda,Egypt,5,0,0,5
10469,2019,Saudi Arabia,Egypt,5,17,0,22
10470,2019,Sierra Leone,Egypt,5,9,0,14
10471,2019,Somalia,Egypt,3973,2729,0,6702
10472,2019,Sudan,Egypt,21861,25902,0,47763
10473,2019,South Sudan,Egypt,14832,4181,0,19013
10474,2019,Syrian Arab Rep.,Egypt,129210,0,0,129210
10475,2019,Tajikistan,Egypt,12,27,0,39
10476,2019,Turkmenistan,Egypt,5,0,0,5
10477,2019,Togo,Egypt,0,7,0,7
10478,2019,Tunisia,Egypt,5,0,0,5
10479,2019,Türkiye,Egypt,0,389,0,389
10480,2019,Uganda,Egypt,13,19,0,32
10481,2019,Uzbekistan,Egypt,0,21,0,21
10482,2019,Yemen,Egypt,126,9032,0,9158
10483,2019,Zimbabwe,Egypt,27,36,0,63
10484,2019,Stateless,Egypt,5,0,0,5
10485,2019,Unknown ,Egypt,0,5,0,5
10486,2019,Afghanistan,Argentina,12,0,0,12
10487,2019,Albania,Argentina,18,0,0,18
10488,2019,Algeria,Argentina,30,22,0,52
10489,2019,Angola,Argentina,14,14,0,28
10490,2019,Egypt,Argentina,5,19,0,24
10491,2019,Armenia,Argentina,77,175,0,252
10492,2019,Burundi,Argentina,5,0,0,5
10493,2019,Bangladesh,Argentina,5,84,0,89
10494,2019,Bolivia (Plurinational State of),Argentina,5,56,0,61
10495,2019,Brazil,Argentina,0,7,0,7
10496,2019,Bosnia and Herzegovina,Argentina,6,0,0,6
10497,2019,China,Argentina,0,121,0,121
10498,2019,Chile,Argentina,34,5,0,39
10499,2019,Cameroon,Argentina,7,42,0,49
10500,2019,Dem. Rep. of the Congo,Argentina,25,27,0,52
10501,2019,Colombia,Argentina,558,191,0,749
10502,2019,Costa Rica,Argentina,5,0,0,5
10503,2019,Cuba,Argentina,257,815,0,1072
10504,2019,Cabo Verde,Argentina,0,5,0,5
10505,2019,Czechia,Argentina,0,5,0,5
10506,2019,Dominican Rep.,Argentina,0,568,0,568
10507,2019,Ecuador,Argentina,16,9,0,25
10508,2019,Ethiopia,Argentina,5,0,0,5
10509,2019,Gambia,Argentina,0,10,0,10
10510,2019,Palestinian,Argentina,18,11,0,29
10511,2019,Georgia,Argentina,5,0,0,5
10512,2019,Ghana,Argentina,38,152,0,190
10513,2019,Guinea-Bissau,Argentina,8,5,0,13
10514,2019,Guatemala,Argentina,6,0,0,6
10515,2019,Guinea,Argentina,10,9,0,19
10516,2019,Haiti,Argentina,72,754,0,826
10517,2019,Honduras,Argentina,5,17,0,22
10518,2019,Hungary,Argentina,0,5,0,5
10519,2019,Cote d'Ivoire,Argentina,20,0,0,20
10520,2019,India,Argentina,23,129,0,152
10521,2019,Iran (Islamic Rep. of),Argentina,24,8,0,32
10522,2019,Iraq,Argentina,22,0,0,22
10523,2019,Jamaica,Argentina,11,5,0,16
10524,2019,Jordan,Argentina,0,5,0,5
10525,2019,Kazakhstan,Argentina,18,10,0,28
10526,2019,Kyrgyzstan,Argentina,5,0,0,5
10527,2019,Liberia,Argentina,42,0,0,42
10528,2019,Libya,Argentina,0,8,0,8
10529,2019,Sri Lanka,Argentina,36,0,0,36
10530,2019,North Macedonia,Argentina,9,0,0,9
10531,2019,Mexico,Argentina,0,6,0,6
10532,2019,Mali,Argentina,9,0,0,9
10533,2019,Morocco,Argentina,0,13,0,13
10534,2019,Nepal,Argentina,0,5,0,5
10535,2019,Nicaragua,Argentina,8,21,0,29
10536,2019,Nigeria,Argentina,41,66,0,107
10537,2019,Pakistan,Argentina,38,19,0,57
10538,2019,Paraguay,Argentina,9,8,0,17
10539,2019,Peru,Argentina,544,39,0,583
10540,2019,Romania,Argentina,51,0,0,51
10541,2019,South Africa,Argentina,0,16,0,16
10542,2019,Russian Federation,Argentina,79,82,0,161
10543,2019,El Salvador,Argentina,32,42,0,74
10544,2019,Senegal,Argentina,41,1419,0,1460
10545,2019,Sierra Leone,Argentina,37,5,0,42
10546,2019,Somalia,Argentina,5,0,0,5
10547,2019,Spain,Argentina,0,7,0,7
10548,2019,Sudan,Argentina,5,0,0,5
10549,2019,Syrian Arab Rep.,Argentina,401,73,0,474
10550,2019,Türkiye,Argentina,7,0,0,7
10551,2019,Ukraine,Argentina,117,91,0,208
10552,2019,United States of America,Argentina,5,10,0,15
10553,2019,Venezuela (Bolivarian Republic of),Argentina,309,2717,0,3026
10554,2019,Yemen,Argentina,19,5,0,24
10555,2019,Unknown ,Argentina,644,44,0,688
10556,2019,Afghanistan,Armenia,5,0,0,5
10557,2019,Egypt,Armenia,5,0,0,5
10558,2019,Azerbaijan,Armenia,1888,5,0,1893
10559,2019,Cuba,Armenia,0,23,0,23
10560,2019,Palestinian,Armenia,7,0,0,7
10561,2019,Georgia,Armenia,8,5,0,13
10562,2019,Cote d'Ivoire,Armenia,6,0,0,6
10563,2019,Iran (Islamic Rep. of),Armenia,68,84,0,152
10564,2019,Iraq,Armenia,1087,0,0,1087
10565,2019,Lebanon,Armenia,24,0,0,24
10566,2019,Nigeria,Armenia,5,0,0,5
10567,2019,Russian Federation,Armenia,0,5,0,5
10568,2019,Syrian Arab Rep.,Armenia,14730,16,0,14746
10569,2019,Türkiye,Armenia,9,15,0,24
10570,2019,Ukraine,Armenia,116,5,0,121
10571,2019,Yemen,Armenia,22,0,0,22
10572,2019,Stateless,Armenia,0,0,0,0
10573,2019,Afghanistan,Australia,11585,1710,0,13295
10574,2019,Albania,Australia,46,89,0,135
10575,2019,Algeria,Australia,7,29,0,36
10576,2019,Egypt,Australia,1531,346,0,1877
10577,2019,Argentina,Australia,0,24,0,24
10578,2019,Australia,Australia,0,32,0,32
10579,2019,Azerbaijan,Australia,9,15,0,24
10580,2019,Bahrain,Australia,92,22,0,114
10581,2019,Burundi,Australia,38,36,0,74
10582,2019,Belgium,Australia,0,9,0,9
10583,2019,Bangladesh,Australia,404,1195,0,1599
10584,2019,Bhutan,Australia,5,14,0,19
10585,2019,Belarus,Australia,7,0,0,7
10586,2019,Botswana,Australia,0,8,0,8
10587,2019,Brazil,Australia,5,119,0,124
10588,2019,Brunei Darussalam,Australia,0,10,0,10
10589,2019,Bosnia and Herzegovina,Australia,0,8,0,8
10590,2019,Cambodia,Australia,50,444,0,494
10591,2019,China,Australia,2016,17668,0,19684
10592,2019,Chile,Australia,0,33,0,33
10593,2019,Cameroon,Australia,27,69,0,96
10594,2019,Congo,Australia,7,55,0,62
10595,2019,Dem. Rep. of the Congo,Australia,63,15,0,78
10596,2019,Colombia,Australia,102,243,0,345
10597,2019,Cyprus,Australia,0,8,0,8
10598,2019,Czechia,Australia,0,5,0,5
10599,2019,Djibouti,Australia,5,0,0,5
10600,2019,Eritrea,Australia,121,18,0,139
10601,2019,Ethiopia,Australia,306,275,0,581
10602,2019,Fiji,Australia,382,2024,0,2406
10603,2019,France,Australia,0,7,0,7
10604,2019,Gambia,Australia,6,13,0,19
10605,2019,Palestinian,Australia,512,93,0,605
10606,2019,United Kingdom of Great Britain and Northern Ireland,Australia,5,91,0,96
10607,2019,Georgia,Australia,15,32,0,47
10608,2019,Germany,Australia,5,9,0,14
10609,2019,Ghana,Australia,26,215,0,241
10610,2019,Greece,Australia,6,31,0,37
10611,2019,Guinea,Australia,9,6,0,15
10612,2019,"China, Hong Kong SAR",Australia,5,172,0,177
10613,2019,Honduras,Australia,5,8,0,13
10614,2019,Hungary,Australia,0,5,0,5
10615,2019,India,Australia,473,5718,0,6191
10616,2019,Indonesia,Australia,233,1766,0,1999
10617,2019,Ireland,Australia,0,20,0,20
10618,2019,Iran (Islamic Rep. of),Australia,11866,4124,0,15990
10619,2019,Iraq,Australia,4946,1183,0,6129
10620,2019,Israel,Australia,10,21,0,31
10621,2019,Italy,Australia,5,21,0,26
10622,2019,Jamaica,Australia,5,0,0,5
10623,2019,Jordan,Australia,133,197,0,330
10624,2019,Japan,Australia,10,5,0,15
10625,2019,Kazakhstan,Australia,7,12,0,19
10626,2019,Kenya,Australia,93,250,0,343
10627,2019,Kyrgyzstan,Australia,13,19,0,32
10628,2019,Rep. of Korea,Australia,37,168,0,205
10629,2019,Dem. People's Rep. of Korea,Australia,18,10,0,28
10630,2019,Kuwait,Australia,51,8,0,59
10631,2019,Lao People's Dem. Rep.,Australia,5,223,0,228
10632,2019,Liberia,Australia,43,25,0,68
10633,2019,Libya,Australia,1160,122,0,1282
10634,2019,Lebanon,Australia,513,872,0,1385
10635,2019,Sri Lanka,Australia,4585,2666,0,7251
10636,2019,North Macedonia,Australia,5,56,0,61
10637,2019,Maldives,Australia,15,6,0,21
10638,2019,Mexico,Australia,14,24,0,38
10639,2019,Malaysia,Australia,494,18180,0,18674
10640,2019,Malawi,Australia,0,10,0,10
10641,2019,Mongolia,Australia,19,244,0,263
10642,2019,Morocco,Australia,12,15,0,27
10643,2019,Mozambique,Australia,5,0,0,5
10644,2019,Mauritius,Australia,7,101,0,108
10645,2019,Myanmar,Australia,506,223,0,729
10646,2019,Nepal,Australia,143,553,0,696
10647,2019,Nigeria,Australia,193,546,0,739
10648,2019,Norway,Australia,0,5,0,5
10649,2019,Nauru,Australia,0,15,0,15
10650,2019,New Zealand,Australia,26,22,0,48
10651,2019,Oman,Australia,5,0,0,5
10652,2019,Pakistan,Australia,5333,2754,0,8087
10653,2019,Peru,Australia,20,57,0,77
10654,2019,Philippines,Australia,48,1279,0,1327
10655,2019,Papua New Guinea,Australia,470,544,0,1014
10656,2019,Poland,Australia,0,23,0,23
10657,2019,Portugal,Australia,0,15,0,15
10658,2019,Romania,Australia,5,9,0,14
10659,2019,South Africa,Australia,31,444,0,475
10660,2019,Russian Federation,Australia,49,66,0,115
10661,2019,Rwanda,Australia,79,66,0,145
10662,2019,El Salvador,Australia,8,26,0,34
10663,2019,Saudi Arabia,Australia,143,126,0,269
10664,2019,Serbia and Kosovo: S/RES/1244 (1999),Australia,5,32,0,37
10665,2019,Singapore,Australia,6,34,0,40
10666,2019,Sierra Leone,Australia,25,154,0,179
10667,2019,Solomon Islands,Australia,21,227,0,248
10668,2019,Somalia,Australia,526,101,0,627
10669,2019,Spain,Australia,0,5,0,5
10670,2019,Viet Nam,Australia,277,2511,0,2788
10671,2019,Sudan,Australia,543,151,0,694
10672,2019,South Sudan,Australia,8,40,0,48
10673,2019,Eswatini,Australia,0,16,0,16
10674,2019,Sweden,Australia,0,6,0,6
10675,2019,Syrian Arab Rep.,Australia,613,79,0,692
10676,2019,United Rep. of Tanzania,Australia,12,30,0,42
10677,2019,Thailand,Australia,14,2435,0,2449
10678,2019,Timor-Leste,Australia,7,11,0,18
10679,2019,Tonga,Australia,32,406,0,438
10680,2019,Tunisia,Australia,5,9,0,14
10681,2019,Türkiye,Australia,765,524,0,1289
10682,2019,United Arab Emirates,Australia,6,0,0,6
10683,2019,Uganda,Australia,54,101,0,155
10684,2019,Ukraine,Australia,24,118,0,142
10685,2019,United States of America,Australia,15,46,0,61
10686,2019,Uzbekistan,Australia,28,32,0,60
10687,2019,Vanuatu,Australia,0,16,0,16
10688,2019,Venezuela (Bolivarian Republic of),Australia,72,274,0,346
10689,2019,Samoa,Australia,0,84,0,84
10690,2019,Yemen,Australia,59,129,0,188
10691,2019,Zambia,Australia,9,28,0,37
10692,2019,Zimbabwe,Australia,584,226,0,810
10693,2019,Stateless,Australia,4702,1246,0,5948
10694,2019,Tibetan,Australia,10,0,0,10
10695,2019,Unknown ,Australia,869,247,0,1116
10696,2019,Afghanistan,Austria,37276,10326,0,47602
10697,2019,Albania,Austria,72,45,0,117
10698,2019,Algeria,Austria,37,117,0,154
10699,2019,Angola,Austria,65,10,0,75
10700,2019,Egypt,Austria,220,151,0,371
10701,2019,Armenia,Austria,442,358,0,800
10702,2019,Azerbaijan,Austria,240,179,0,419
10703,2019,Burundi,Austria,16,0,0,16
10704,2019,Benin,Austria,5,28,0,33
10705,2019,Bangladesh,Austria,325,339,0,664
10706,2019,Bhutan,Austria,5,0,0,5
10707,2019,Burkina Faso,Austria,9,5,0,14
10708,2019,Belarus,Austria,49,20,0,69
10709,2019,Bolivia (Plurinational State of),Austria,11,0,0,11
10710,2019,Bosnia and Herzegovina,Austria,80,10,0,90
10711,2019,Canada,Austria,5,0,0,5
10712,2019,China,Austria,651,157,0,808
10713,2019,Cameroon,Austria,204,47,0,251
10714,2019,Congo,Austria,110,11,0,121
10715,2019,Dem. Rep. of the Congo,Austria,374,87,0,461
10716,2019,Colombia,Austria,0,11,0,11
10717,2019,Cuba,Austria,14,12,0,26
10718,2019,Eritrea,Austria,408,41,0,449
10719,2019,Ethiopia,Austria,228,77,0,305
10720,2019,Gabon,Austria,5,0,0,5
10721,2019,Gambia,Austria,133,114,0,247
10722,2019,Georgia,Austria,392,392,0,784
10723,2019,Ghana,Austria,19,36,0,55
10724,2019,Guinea-Bissau,Austria,5,5,0,10
10725,2019,Guatemala,Austria,6,0,0,6
10726,2019,Guinea,Austria,148,39,0,187
10727,2019,Cote d'Ivoire,Austria,71,21,0,92
10728,2019,India,Austria,44,325,0,369
10729,2019,Iran (Islamic Rep. of),Austria,6393,2024,0,8417
10730,2019,Iraq,Austria,8568,4733,0,13301
10731,2019,Israel,Austria,12,0,0,12
10732,2019,Jordan,Austria,78,26,0,104
10733,2019,Kazakhstan,Austria,113,44,0,157
10734,2019,Kenya,Austria,27,13,0,40
10735,2019,Kyrgyzstan,Austria,171,32,0,203
10736,2019,Kuwait,Austria,9,0,0,9
10737,2019,Liberia,Austria,11,9,0,20
10738,2019,Libya,Austria,124,48,0,172
10739,2019,Lebanon,Austria,107,125,0,232
10740,2019,Sri Lanka,Austria,68,22,0,90
10741,2019,Madagascar,Austria,5,0,0,5
10742,2019,Mauritania,Austria,5,5,0,10
10743,2019,North Macedonia,Austria,24,39,0,63
10744,2019,Rep. of Moldova,Austria,41,26,0,67
10745,2019,Mali,Austria,13,13,0,26
10746,2019,Mongolia,Austria,125,207,0,332
10747,2019,Morocco,Austria,36,111,0,147
10748,2019,Montenegro,Austria,5,5,0,10
10749,2019,Myanmar,Austria,34,7,0,41
10750,2019,Nepal,Austria,26,60,0,86
10751,2019,Nicaragua,Austria,5,0,0,5
10752,2019,Nigeria,Austria,430,607,0,1037
10753,2019,Pakistan,Austria,312,612,0,924
10754,2019,Philippines,Austria,16,13,0,29
10755,2019,Romania,Austria,5,5,0,10
10756,2019,South Africa,Austria,5,0,0,5
10757,2019,Russian Federation,Austria,8664,1194,0,9858
10758,2019,Rwanda,Austria,19,7,0,26
10759,2019,Saudi Arabia,Austria,6,0,0,6
10760,2019,Serbia and Kosovo: S/RES/1244 (1999),Austria,725,217,0,942
10761,2019,Senegal,Austria,14,12,0,26
10762,2019,Sierra Leone,Austria,25,15,0,40
10763,2019,Somalia,Austria,7636,911,0,8547
10764,2019,Viet Nam,Austria,6,10,0,16
10765,2019,Sudan,Austria,344,33,0,377
10766,2019,South Sudan,Austria,6,0,0,6
10767,2019,Syrian Arab Rep.,Austria,51955,1304,0,53259
10768,2019,Tajikistan,Austria,244,35,0,279
10769,2019,Turkmenistan,Austria,7,0,0,7
10770,2019,Togo,Austria,6,5,0,11
10771,2019,Tunisia,Austria,7,40,0,47
10772,2019,Türkiye,Austria,594,415,0,1009
10773,2019,Uganda,Austria,28,12,0,40
10774,2019,Ukraine,Austria,265,313,0,578
10775,2019,United States of America,Austria,5,0,0,5
10776,2019,Uzbekistan,Austria,60,65,0,125
10777,2019,Venezuela (Bolivarian Republic of),Austria,31,29,0,60
10778,2019,Yemen,Austria,311,70,0,381
10779,2019,Zambia,Austria,5,0,0,5
10780,2019,Zimbabwe,Austria,11,0,0,11
10781,2019,Stateless,Austria,2199,0,0,2199
10782,2019,Unknown ,Austria,4341,260,0,4601
10783,2019,Afghanistan,Azerbaijan,627,94,0,721
10784,2019,Egypt,Azerbaijan,0,5,0,5
10785,2019,Azerbaijan,Azerbaijan,0,0,652326,0
10786,2019,Palestinian,Azerbaijan,5,0,0,5
10787,2019,Iran (Islamic Rep. of),Azerbaijan,43,7,0,50
10788,2019,Iraq,Azerbaijan,5,6,0,11
10789,2019,Libya,Azerbaijan,5,0,0,5
10790,2019,Sri Lanka,Azerbaijan,0,5,0,5
10791,2019,Pakistan,Azerbaijan,16,34,0,50
10792,2019,Russian Federation,Azerbaijan,372,30,0,402
10793,2019,Syrian Arab Rep.,Azerbaijan,20,0,0,20
10794,2019,Ukraine,Azerbaijan,5,0,0,5
10795,2019,Yemen,Azerbaijan,11,0,0,11
10796,2019,Stateless,Azerbaijan,0,0,0,0
10797,2019,Egypt,Bahrain,0,5,0,5
10798,2019,Iraq,Bahrain,242,48,0,290
10799,2019,Yemen,Bahrain,9,5,0,14
10800,2019,Trinidad and Tobago,Barbados,0,5,0,5
10801,2019,Venezuela (Bolivarian Republic of),Barbados,0,5,0,5
10802,2019,Angola,Burundi,0,5,0,5
10803,2019,Burundi,Burundi,0,0,33256,0
10804,2019,Benin,Burundi,0,0,0,0
10805,2019,Central African Rep.,Burundi,8,0,0,8
10806,2019,Dem. Rep. of the Congo,Burundi,77807,8204,0,86011
10807,2019,Kenya,Burundi,0,0,0,0
10808,2019,Mali,Burundi,13,0,0,13
10809,2019,Oman,Burundi,0,0,0,0
10810,2019,Rwanda,Burundi,575,776,0,1351
10811,2019,Somalia,Burundi,23,0,0,23
10812,2019,United Rep. of Tanzania,Burundi,5,0,0,5
10813,2019,Türkiye,Burundi,21,5,0,26
10814,2019,Uganda,Burundi,13,5,0,18
10815,2019,United States of America,Burundi,0,0,0,0
10816,2019,Stateless,Burundi,0,0,0,0
10817,2019,Afghanistan,Belgium,5070,1035,0,6105
10818,2019,Albania,Belgium,712,208,0,920
10819,2019,Algeria,Belgium,75,78,0,153
10820,2019,Angola,Belgium,92,82,0,174
10821,2019,Egypt,Belgium,115,27,0,142
10822,2019,Armenia,Belgium,156,80,0,236
10823,2019,Azerbaijan,Belgium,97,37,0,134
10824,2019,Burundi,Belgium,1179,238,0,1417
10825,2019,Benin,Belgium,43,28,0,71
10826,2019,Bangladesh,Belgium,24,5,0,29
10827,2019,Burkina Faso,Belgium,106,62,0,168
10828,2019,Belarus,Belgium,45,6,0,51
10829,2019,Brazil,Belgium,8,7,0,15
10830,2019,Bosnia and Herzegovina,Belgium,61,11,0,72
10831,2019,Bulgaria,Belgium,18,0,0,18
10832,2019,Cambodia,Belgium,10,0,0,10
10833,2019,Central African Rep.,Belgium,60,9,0,69
10834,2019,Chad,Belgium,36,14,0,50
10835,2019,China,Belgium,1283,17,0,1300
10836,2019,Chile,Belgium,42,0,0,42
10837,2019,Cameroon,Belgium,498,319,0,817
10838,2019,Congo,Belgium,27,10,0,37
10839,2019,Dem. Rep. of the Congo,Belgium,1490,292,0,1782
10840,2019,Colombia,Belgium,73,124,0,197
10841,2019,Cuba,Belgium,9,0,0,9
10842,2019,Czechia,Belgium,6,0,0,6
10843,2019,Djibouti,Belgium,369,68,0,437
10844,2019,Ecuador,Belgium,0,5,0,5
10845,2019,Eritrea,Belgium,2254,210,0,2464
10846,2019,Ethiopia,Belgium,170,25,0,195
10847,2019,Gabon,Belgium,26,23,0,49
10848,2019,Gambia,Belgium,27,24,0,51
10849,2019,Palestinian,Belgium,844,877,0,1721
10850,2019,Georgia,Belgium,98,40,0,138
10851,2019,Ghana,Belgium,31,21,0,52
10852,2019,Guinea-Bissau,Belgium,10,5,0,15
10853,2019,Guatemala,Belgium,34,12,0,46
10854,2019,Guinea,Belgium,3561,677,0,4238
10855,2019,Haiti,Belgium,5,0,0,5
10856,2019,Honduras,Belgium,17,0,0,17
10857,2019,Croatia,Belgium,5,0,0,5
10858,2019,Hungary,Belgium,36,0,0,36
10859,2019,Cote d'Ivoire,Belgium,192,112,0,304
10860,2019,India,Belgium,18,15,0,33
10861,2019,Iran (Islamic Rep. of),Belgium,1700,207,0,1907
10862,2019,Iraq,Belgium,5602,879,0,6481
10863,2019,Israel,Belgium,5,0,0,5
10864,2019,Italy,Belgium,0,5,0,5
10865,2019,Jamaica,Belgium,5,0,0,5
10866,2019,Jordan,Belgium,26,31,0,57
10867,2019,Kazakhstan,Belgium,52,7,0,59
10868,2019,Kenya,Belgium,22,5,0,27
10869,2019,Kyrgyzstan,Belgium,66,5,0,71
10870,2019,Dem. People's Rep. of Korea,Belgium,34,0,0,34
10871,2019,Kuwait,Belgium,6,0,0,6
10872,2019,Lao People's Dem. Rep.,Belgium,10,0,0,10
10873,2019,Liberia,Belgium,14,11,0,25
10874,2019,Libya,Belgium,81,55,0,136
10875,2019,Lebanon,Belgium,121,81,0,202
10876,2019,Sri Lanka,Belgium,366,34,0,400
10877,2019,Lithuania,Belgium,5,0,0,5
10878,2019,Madagascar,Belgium,5,0,0,5
10879,2019,Mauritania,Belgium,271,80,0,351
10880,2019,North Macedonia,Belgium,156,45,0,201
10881,2019,Rep. of Moldova,Belgium,5,5,0,10
10882,2019,Mexico,Belgium,0,5,0,5
10883,2019,Mali,Belgium,99,52,0,151
10884,2019,Mongolia,Belgium,0,5,0,5
10885,2019,Morocco,Belgium,145,109,0,254
10886,2019,Montenegro,Belgium,11,0,0,11
10887,2019,Myanmar,Belgium,8,0,0,8
10888,2019,Nepal,Belgium,8,5,0,13
10889,2019,Niger,Belgium,131,68,0,199
10890,2019,Nicaragua,Belgium,9,17,0,26
10891,2019,Nigeria,Belgium,66,62,0,128
10892,2019,Pakistan,Belgium,325,34,0,359
10893,2019,Peru,Belgium,0,7,0,7
10894,2019,Poland,Belgium,117,0,0,117
10895,2019,Romania,Belgium,37,0,0,37
10896,2019,South Africa,Belgium,5,0,0,5
10897,2019,Russian Federation,Belgium,2772,223,0,2995
10898,2019,Rwanda,Belgium,864,255,0,1119
10899,2019,El Salvador,Belgium,389,162,0,551
10900,2019,Saudi Arabia,Belgium,8,0,0,8
10901,2019,Serbia and Kosovo: S/RES/1244 (1999),Belgium,308,104,0,412
10902,2019,Senegal,Belgium,431,174,0,605
10903,2019,Sierra Leone,Belgium,27,32,0,59
10904,2019,Somalia,Belgium,2097,310,0,2407
10905,2019,Viet Nam,Belgium,30,0,0,30
10906,2019,Sudan,Belgium,265,131,0,396
10907,2019,South Sudan,Belgium,5,5,0,10
10908,2019,Syrian Arab Rep.,Belgium,16604,1019,0,17623
10909,2019,United Rep. of Tanzania,Belgium,57,26,0,83
10910,2019,Tajikistan,Belgium,13,0,0,13
10911,2019,Turkmenistan,Belgium,5,0,0,5
10912,2019,Togo,Belgium,191,40,0,231
10913,2019,Tunisia,Belgium,54,24,0,78
10914,2019,Türkiye,Belgium,2007,443,0,2450
10915,2019,United Arab Emirates,Belgium,5,0,0,5
10916,2019,Uganda,Belgium,23,5,0,28
10917,2019,Ukraine,Belgium,254,105,0,359
10918,2019,United States of America,Belgium,0,5,0,5
10919,2019,Uzbekistan,Belgium,40,5,0,45
10920,2019,Venezuela (Bolivarian Republic of),Belgium,273,322,0,595
10921,2019,Yemen,Belgium,51,56,0,107
10922,2019,Stateless,Belgium,261,15,0,276
10923,2019,Unknown ,Belgium,6083,784,0,6867
10924,2019,Burundi,Benin,7,0,0,7
10925,2019,Central African Rep.,Benin,953,154,0,1107
10926,2019,Chad,Benin,8,25,0,33
10927,2019,Cameroon,Benin,16,47,0,63
10928,2019,Congo,Benin,0,7,0,7
10929,2019,Dem. Rep. of the Congo,Benin,11,29,0,40
10930,2019,Eritrea,Benin,5,0,0,5
10931,2019,Guinea,Benin,0,8,0,8
10932,2019,Cote d'Ivoire,Benin,164,19,0,183
10933,2019,Liberia,Benin,0,5,0,5
10934,2019,Sri Lanka,Benin,5,0,0,5
10935,2019,Mali,Benin,25,15,0,40
10936,2019,Niger,Benin,0,5,0,5
10937,2019,Nigeria,Benin,0,23,0,23
10938,2019,Pakistan,Benin,5,0,0,5
10939,2019,Sudan,Benin,6,0,0,6
10940,2019,Syrian Arab Rep.,Benin,12,13,0,25
10941,2019,Togo,Benin,0,23,0,23
10942,2019,Türkiye,Benin,10,0,0,10
10943,2019,Yemen,Benin,11,0,0,11
10944,2019,Myanmar,Bangladesh,854764,0,0,854764
10945,2019,Somalia,Bangladesh,10,14,0,24
10946,2019,Türkiye,Bangladesh,0,20,0,20
10947,2019,Yemen,Bangladesh,5,0,0,5
10948,2019,Stateless,Bangladesh,0,0,0,0
10949,2019,Colombia,Bahamas,5,0,0,5
10950,2019,Cuba,Bahamas,5,5,0,10
10951,2019,South Africa,Bahamas,0,8,0,8
10952,2019,Burundi,Burkina Faso,29,0,0,29
10953,2019,Burkina Faso,Burkina Faso,0,0,560033,0
10954,2019,Central African Rep.,Burkina Faso,194,24,0,218
10955,2019,Chad,Burkina Faso,83,0,0,83
10956,2019,Cameroon,Burkina Faso,7,0,0,7
10957,2019,Congo,Burkina Faso,28,0,0,28
10958,2019,Dem. Rep. of the Congo,Burkina Faso,33,0,0,33
10959,2019,Cote d'Ivoire,Burkina Faso,5,0,0,5
10960,2019,Mali,Burkina Faso,25442,0,0,25442
10961,2019,Rwanda,Burkina Faso,16,0,0,16
10962,2019,South Sudan,Burkina Faso,0,5,0,5
10963,2019,Syrian Arab Rep.,Burkina Faso,5,0,0,5
10964,2019,Togo,Burkina Faso,14,0,0,14
10965,2019,Türkiye,Burkina Faso,13,0,0,13
10966,2019,Afghanistan,Belarus,213,13,0,226
10967,2019,Egypt,Belarus,5,0,0,5
10968,2019,Armenia,Belarus,5,0,0,5
10969,2019,Azerbaijan,Belarus,5,0,0,5
10970,2019,Bangladesh,Belarus,0,5,0,5
10971,2019,Cuba,Belarus,0,5,0,5
10972,2019,Ethiopia,Belarus,5,0,0,5
10973,2019,Palestinian,Belarus,0,5,0,5
10974,2019,Georgia,Belarus,57,0,0,57
10975,2019,Iran (Islamic Rep. of),Belarus,6,0,0,6
10976,2019,Iraq,Belarus,12,0,0,12
10977,2019,Libya,Belarus,8,0,0,8
10978,2019,Syrian Arab Rep.,Belarus,68,0,0,68
10979,2019,Tajikistan,Belarus,12,0,0,12
10980,2019,Türkiye,Belarus,5,0,0,5
10981,2019,Ukraine,Belarus,2300,98,0,2398
10982,2019,Yemen,Belarus,24,5,0,29
10983,2019,Stateless,Belarus,0,0,0,0
10984,2019,Argentina,Bolivia (Plurinational State of),13,0,0,13
10985,2019,Colombia,Bolivia (Plurinational State of),201,7,0,208
10986,2019,Cuba,Bolivia (Plurinational State of),48,0,0,48
10987,2019,Ecuador,Bolivia (Plurinational State of),5,0,0,5
10988,2019,Cote d'Ivoire,Bolivia (Plurinational State of),5,0,0,5
10989,2019,Iraq,Bolivia (Plurinational State of),16,0,0,16
10990,2019,Niger,Bolivia (Plurinational State of),5,0,0,5
10991,2019,Pakistan,Bolivia (Plurinational State of),5,0,0,5
10992,2019,Peru,Bolivia (Plurinational State of),515,0,0,515
10993,2019,Russian Federation,Bolivia (Plurinational State of),14,0,0,14
10994,2019,Syrian Arab Rep.,Bolivia (Plurinational State of),21,0,0,21
10995,2019,Ukraine,Bolivia (Plurinational State of),5,0,0,5
10996,2019,Uruguay,Bolivia (Plurinational State of),10,0,0,10
10997,2019,Venezuela (Bolivarian Republic of),Bolivia (Plurinational State of),0,235,0,235
10998,2019,Angola,Botswana,0,0,0,0
10999,2019,Burundi,Botswana,71,0,0,71
11000,2019,Dem. Rep. of the Congo,Botswana,120,67,0,187
11001,2019,Eritrea,Botswana,5,0,0,5
11002,2019,Ethiopia,Botswana,5,0,0,5
11003,2019,Kenya,Botswana,5,0,0,5
11004,2019,Namibia,Botswana,7,0,0,7
11005,2019,Rwanda,Botswana,14,5,0,19
11006,2019,Somalia,Botswana,299,36,0,335
11007,2019,Sudan,Botswana,5,0,0,5
11008,2019,Uganda,Botswana,18,0,0,18
11009,2019,Zimbabwe,Botswana,564,42,0,606
11010,2019,Afghanistan,Brazil,132,185,0,317
11011,2019,Albania,Brazil,0,6,0,6
11012,2019,Algeria,Brazil,7,27,0,34
11013,2019,Angola,Brazil,1139,5016,0,6155
11014,2019,Egypt,Brazil,48,446,0,494
11015,2019,Argentina,Brazil,6,144,0,150
11016,2019,Armenia,Brazil,5,5,0,10
11017,2019,Burundi,Brazil,46,22,0,68
11018,2019,Belgium,Brazil,0,6,0,6
11019,2019,Benin,Brazil,0,263,0,263
11020,2019,Bangladesh,Brazil,14,5370,0,5384
11021,2019,Bhutan,Brazil,30,36,0,66
11022,2019,Burkina Faso,Brazil,5,296,0,301
11023,2019,Bolivia (Plurinational State of),Brazil,154,426,0,580
11024,2019,Bosnia and Herzegovina,Brazil,5,0,0,5
11025,2019,Bulgaria,Brazil,0,5,0,5
11026,2019,Cambodia,Brazil,0,5,0,5
11027,2019,Canada,Brazil,0,6,0,6
11028,2019,Central African Rep.,Brazil,5,7,0,12
11029,2019,China,Brazil,9,4616,0,4625
11030,2019,Chile,Brazil,21,120,0,141
11031,2019,Cameroon,Brazil,67,586,0,653
11032,2019,Congo,Brazil,20,72,0,92
11033,2019,Dem. Rep. of the Congo,Brazil,1636,2739,0,4375
11034,2019,Colombia,Brazil,1295,1835,0,3130
11035,2019,Costa Rica,Brazil,0,14,0,14
11036,2019,Cuba,Brazil,238,14560,0,14798
11037,2019,Cabo Verde,Brazil,0,197,0,197
11038,2019,Cyprus,Brazil,0,5,0,5
11039,2019,Czechia,Brazil,0,6,0,6
11040,2019,Denmark,Brazil,0,12,0,12
11041,2019,Djibouti,Brazil,0,11,0,11
11042,2019,Dominica,Brazil,0,16,0,16
11043,2019,Dominican Rep.,Brazil,5,1269,0,1274
11044,2019,Ecuador,Brazil,58,88,0,146
11045,2019,Equatorial Guinea,Brazil,0,11,0,11
11046,2019,Eritrea,Brazil,25,116,0,141
11047,2019,Ethiopia,Brazil,27,92,0,119
11048,2019,French Guiana,Brazil,0,19,0,19
11049,2019,Fiji,Brazil,0,20,0,20
11050,2019,France,Brazil,0,40,0,40
11051,2019,Gambia,Brazil,6,360,0,366
11052,2019,Palestinian,Brazil,565,368,0,933
11053,2019,United Kingdom of Great Britain and Northern Ireland,Brazil,0,11,0,11
11054,2019,Georgia,Brazil,10,5,0,15
11055,2019,Germany,Brazil,0,10,0,10
11056,2019,Ghana,Brazil,34,2425,0,2459
11057,2019,Guinea-Bissau,Brazil,21,1671,0,1692
11058,2019,Greece,Brazil,0,6,0,6
11059,2019,Guatemala,Brazil,0,21,0,21
11060,2019,Guinea,Brazil,103,896,0,999
11061,2019,Guyana,Brazil,5,137,0,142
11062,2019,Haiti,Brazil,8,32788,0,32796
11063,2019,Honduras,Brazil,5,17,0,22
11064,2019,Croatia,Brazil,5,0,0,5
11065,2019,Hungary,Brazil,5,5,0,10
11066,2019,Cote d'Ivoire,Brazil,54,185,0,239
11067,2019,India,Brazil,7,1010,0,1017
11068,2019,Indonesia,Brazil,0,8,0,8
11069,2019,Iran (Islamic Rep. of),Brazil,67,180,0,247
11070,2019,Iraq,Brazil,302,412,0,714
11071,2019,Israel,Brazil,0,33,0,33
11072,2019,Italy,Brazil,0,25,0,25
11073,2019,Jamaica,Brazil,0,11,0,11
11074,2019,Jordan,Brazil,10,90,0,100
11075,2019,Japan,Brazil,0,6,0,6
11076,2019,Kazakhstan,Brazil,0,6,0,6
11077,2019,Kenya,Brazil,8,79,0,87
11078,2019,Rep. of Korea,Brazil,0,245,0,245
11079,2019,Kuwait,Brazil,0,6,0,6
11080,2019,Liberia,Brazil,259,32,0,291
11081,2019,Libya,Brazil,5,46,0,51
11082,2019,Lebanon,Brazil,410,1869,0,2279
11083,2019,Lesotho,Brazil,0,5,0,5
11084,2019,Sri Lanka,Brazil,18,59,0,77
11085,2019,Lithuania,Brazil,0,7,0,7
11086,2019,"China, Macao SAR",Brazil,0,28,0,28
11087,2019,Mauritania,Brazil,21,252,0,273
11088,2019,North Macedonia,Brazil,6,5,0,11
11089,2019,Mexico,Brazil,6,42,0,48
11090,2019,Mali,Brazil,91,425,0,516
11091,2019,Malaysia,Brazil,0,5,0,5
11092,2019,Morocco,Brazil,17,675,0,692
11093,2019,Mozambique,Brazil,0,82,0,82
11094,2019,Malta,Brazil,0,5,0,5
11095,2019,Myanmar,Brazil,0,6,0,6
11096,2019,Namibia,Brazil,0,39,0,39
11097,2019,Nepal,Brazil,11,373,0,384
11098,2019,Netherlands,Brazil,0,5,0,5
11099,2019,Niger,Brazil,0,6,0,6
11100,2019,Nicaragua,Brazil,0,37,0,37
11101,2019,Nigeria,Brazil,135,3370,0,3505
11102,2019,Norway,Brazil,0,6,0,6
11103,2019,New Zealand,Brazil,0,5,0,5
11104,2019,Pakistan,Brazil,329,1765,0,2094
11105,2019,Panama,Brazil,0,9,0,9
11106,2019,Paraguay,Brazil,5,140,0,145
11107,2019,Peru,Brazil,46,165,0,211
11108,2019,Philippines,Brazil,0,550,0,550
11109,2019,Poland,Brazil,0,12,0,12
11110,2019,Portugal,Brazil,0,92,0,92
11111,2019,Romania,Brazil,0,15,0,15
11112,2019,South Africa,Brazil,5,424,0,429
11113,2019,Russian Federation,Brazil,13,46,0,59
11114,2019,Rwanda,Brazil,18,5,0,23
11115,2019,El Salvador,Brazil,60,0,0,60
11116,2019,Saudi Arabia,Brazil,0,17,0,17
11117,2019,Serbia and Kosovo: S/RES/1244 (1999),Brazil,92,7,0,99
11118,2019,Senegal,Brazil,14,6253,0,6267
11119,2019,Sierra Leone,Brazil,159,374,0,533
11120,2019,Somalia,Brazil,48,570,0,618
11121,2019,Spain,Brazil,0,43,0,43
11122,2019,Viet Nam,Brazil,5,0,0,5
11123,2019,Sao Tome and Principe,Brazil,0,24,0,24
11124,2019,Sudan,Brazil,73,132,0,205
11125,2019,Suriname,Brazil,0,17,0,17
11126,2019,Sweden,Brazil,0,5,0,5
11127,2019,Switzerland,Brazil,0,5,0,5
11128,2019,Syrian Arab Rep.,Brazil,3761,4242,0,8003
11129,2019,United Rep. of Tanzania,Brazil,7,117,0,124
11130,2019,Thailand,Brazil,0,40,0,40
11131,2019,Togo,Brazil,39,640,0,679
11132,2019,Trinidad and Tobago,Brazil,0,7,0,7
11133,2019,Tunisia,Brazil,5,123,0,128
11134,2019,Türkiye,Brazil,6,255,0,261
11135,2019,Uganda,Brazil,5,33,0,38
11136,2019,Ukraine,Brazil,17,79,0,96
11137,2019,Uruguay,Brazil,0,31,0,31
11138,2019,United States of America,Brazil,0,47,0,47
11139,2019,Uzbekistan,Brazil,0,5,0,5
11140,2019,Vanuatu,Brazil,0,50,0,50
11141,2019,Holy See,Brazil,0,5,0,5
11142,2019,Venezuela (Bolivarian Republic of),Brazil,20941,103657,0,124598
11143,2019,Yemen,Brazil,0,124,0,124
11144,2019,Zambia,Brazil,0,7,0,7
11145,2019,Zimbabwe,Brazil,5,10,0,15
11146,2019,Stateless,Brazil,0,0,0,0
11147,2019,Unknown ,Brazil,0,37,0,37
11148,2019,Stateless,Brunei Darussalam,0,0,0,0
11149,2019,Afghanistan,Bosnia and Herzegovina,0,134,0,134
11150,2019,Algeria,Bosnia and Herzegovina,0,5,0,5
11151,2019,Egypt,Bosnia and Herzegovina,0,5,0,5
11152,2019,Azerbaijan,Bosnia and Herzegovina,0,5,0,5
11153,2019,Bangladesh,Bosnia and Herzegovina,0,0,0,0
11154,2019,Bosnia and Herzegovina,Bosnia and Herzegovina,0,0,96421,0
11155,2019,Eritrea,Bosnia and Herzegovina,0,0,0,0
11156,2019,Palestinian,Bosnia and Herzegovina,0,5,0,5
11157,2019,Croatia,Bosnia and Herzegovina,5116,0,0,5116
11158,2019,India,Bosnia and Herzegovina,0,11,0,11
11159,2019,Iran (Islamic Rep. of),Bosnia and Herzegovina,5,121,0,126
11160,2019,Iraq,Bosnia and Herzegovina,0,205,0,205
11161,2019,Libya,Bosnia and Herzegovina,0,5,0,5
11162,2019,Lebanon,Bosnia and Herzegovina,0,0,0,0
11163,2019,Sri Lanka,Bosnia and Herzegovina,0,0,0,0
11164,2019,North Macedonia,Bosnia and Herzegovina,5,5,0,10
11165,2019,Morocco,Bosnia and Herzegovina,0,0,0,0
11166,2019,Nepal,Bosnia and Herzegovina,0,5,0,5
11167,2019,Pakistan,Bosnia and Herzegovina,0,89,0,89
11168,2019,Serbia and Kosovo: S/RES/1244 (1999),Bosnia and Herzegovina,60,0,0,60
11169,2019,Somalia,Bosnia and Herzegovina,0,7,0,7
11170,2019,Sudan,Bosnia and Herzegovina,0,0,0,0
11171,2019,Syrian Arab Rep.,Bosnia and Herzegovina,21,46,0,67
11172,2019,Tunisia,Bosnia and Herzegovina,0,5,0,5
11173,2019,Türkiye,Bosnia and Herzegovina,34,62,0,96
11174,2019,Western Sahara,Bosnia and Herzegovina,0,0,0,0
11175,2019,Yemen,Bosnia and Herzegovina,0,10,0,10
11176,2019,Stateless,Bosnia and Herzegovina,0,0,0,0
11177,2019,Afghanistan,Bulgaria,243,300,0,543
11178,2019,Algeria,Bulgaria,0,21,0,21
11179,2019,Egypt,Bulgaria,15,6,0,21
11180,2019,Armenia,Bulgaria,15,14,0,29
11181,2019,Bangladesh,Bulgaria,9,13,0,22
11182,2019,China,Bulgaria,0,15,0,15
11183,2019,Congo,Bulgaria,9,0,0,9
11184,2019,Dem. Rep. of the Congo,Bulgaria,5,5,0,10
11185,2019,Eritrea,Bulgaria,13,0,0,13
11186,2019,Ethiopia,Bulgaria,13,0,0,13
11187,2019,Ghana,Bulgaria,0,6,0,6
11188,2019,Guinea,Bulgaria,5,0,0,5
11189,2019,Cote d'Ivoire,Bulgaria,5,6,0,11
11190,2019,India,Bulgaria,5,5,0,10
11191,2019,Iran (Islamic Rep. of),Bulgaria,85,80,0,165
11192,2019,Iraq,Bulgaria,1300,82,0,1382
11193,2019,Jordan,Bulgaria,7,0,0,7
11194,2019,Kyrgyzstan,Bulgaria,0,7,0,7
11195,2019,Lebanon,Bulgaria,28,5,0,33
11196,2019,Mali,Bulgaria,5,5,0,10
11197,2019,Morocco,Bulgaria,5,0,0,5
11198,2019,Nigeria,Bulgaria,0,7,0,7
11199,2019,Pakistan,Bulgaria,24,68,0,92
11200,2019,Russian Federation,Bulgaria,0,28,0,28
11201,2019,Somalia,Bulgaria,50,5,0,55
11202,2019,Sudan,Bulgaria,17,0,0,17
11203,2019,Syrian Arab Rep.,Bulgaria,17551,297,0,17848
11204,2019,Tunisia,Bulgaria,5,0,0,5
11205,2019,Türkiye,Bulgaria,12,7,0,19
11206,2019,Ukraine,Bulgaria,0,40,0,40
11207,2019,Yemen,Bulgaria,13,5,0,18
11208,2019,Stateless,Bulgaria,999,27,0,1026
11209,2019,Cuba,Belize,0,5,0,5
11210,2019,Guatemala,Belize,0,422,0,422
11211,2019,Honduras,Belize,5,448,0,453
11212,2019,Nicaragua,Belize,0,5,0,5
11213,2019,Peru,Belize,0,5,0,5
11214,2019,El Salvador,Belize,24,1259,0,1283
11215,2019,Unknown ,Belize,0,0,0,0
11216,2019,Viet Nam,Cambodia,0,27,0,27
11217,2019,Stateless,Cambodia,0,0,0,0
11218,2019,Afghanistan,Canada,2447,620,0,3067
11219,2019,Albania,Canada,783,289,0,1072
11220,2019,Algeria,Canada,449,909,0,1358
11221,2019,Angola,Canada,226,1223,0,1449
11222,2019,Antigua and Barbuda,Canada,104,44,0,148
11223,2019,Egypt,Canada,2520,1172,0,3692
11224,2019,Argentina,Canada,0,47,0,47
11225,2019,Armenia,Canada,52,22,0,74
11226,2019,Australia,Canada,0,5,0,5
11227,2019,Austria,Canada,0,10,0,10
11228,2019,Azerbaijan,Canada,548,250,0,798
11229,2019,Bahrain,Canada,56,28,0,84
11230,2019,Barbados,Canada,230,106,0,336
11231,2019,Burundi,Canada,2486,654,0,3140
11232,2019,Belgium,Canada,5,30,0,35
11233,2019,Benin,Canada,51,63,0,114
11234,2019,Bangladesh,Canada,1149,1399,0,2548
11235,2019,Bahamas,Canada,310,418,0,728
11236,2019,Bhutan,Canada,0,5,0,5
11237,2019,Burkina Faso,Canada,93,153,0,246
11238,2019,Belarus,Canada,54,23,0,77
11239,2019,Bolivia (Plurinational State of),Canada,31,26,0,57
11240,2019,Botswana,Canada,180,10,0,190
11241,2019,Brazil,Canada,102,515,0,617
11242,2019,Bosnia and Herzegovina,Canada,5,7,0,12
11243,2019,Bulgaria,Canada,127,64,0,191
11244,2019,Belize,Canada,19,10,0,29
11245,2019,Cambodia,Canada,47,31,0,78
11246,2019,Central African Rep.,Canada,51,39,0,90
11247,2019,Chad,Canada,477,534,0,1011
11248,2019,China,Canada,6060,2873,0,8933
11249,2019,Chile,Canada,71,221,0,292
11250,2019,Cameroon,Canada,946,709,0,1655
11251,2019,Congo,Canada,259,199,0,458
11252,2019,Dem. Rep. of the Congo,Canada,1033,2368,0,3401
11253,2019,Comoros,Canada,5,5,0,10
11254,2019,Colombia,Canada,4982,4801,0,9783
11255,2019,Costa Rica,Canada,13,46,0,59
11256,2019,Cuba,Canada,598,246,0,844
11257,2019,Cyprus,Canada,0,11,0,11
11258,2019,Czechia,Canada,370,127,0,497
11259,2019,Denmark,Canada,5,20,0,25
11260,2019,Djibouti,Canada,1130,159,0,1289
11261,2019,Dominica,Canada,8,5,0,13
11262,2019,Dominican Rep.,Canada,113,165,0,278
11263,2019,Ecuador,Canada,44,110,0,154
11264,2019,Equatorial Guinea,Canada,19,7,0,26
11265,2019,Eritrea,Canada,2052,506,0,2558
11266,2019,Estonia,Canada,5,5,0,10
11267,2019,Ethiopia,Canada,1236,902,0,2138
11268,2019,Fiji,Canada,19,7,0,26
11269,2019,Finland,Canada,0,5,0,5
11270,2019,France,Canada,0,65,0,65
11271,2019,Gabon,Canada,33,44,0,77
11272,2019,Gambia,Canada,85,124,0,209
11273,2019,Palestinian,Canada,1470,1083,0,2553
11274,2019,United Kingdom of Great Britain and Northern Ireland,Canada,0,5,0,5
11275,2019,Georgia,Canada,335,312,0,647
11276,2019,Germany,Canada,0,26,0,26
11277,2019,Ghana,Canada,326,326,0,652
11278,2019,Guinea-Bissau,Canada,9,5,0,14
11279,2019,Greece,Canada,0,20,0,20
11280,2019,Grenada,Canada,31,15,0,46
11281,2019,Guatemala,Canada,444,263,0,707
11282,2019,Guinea,Canada,368,382,0,750
11283,2019,Guyana,Canada,126,68,0,194
11284,2019,Haiti,Canada,6563,5365,0,11928
11285,2019,"China, Hong Kong SAR",Canada,0,19,0,19
11286,2019,Honduras,Canada,864,476,0,1340
11287,2019,Croatia,Canada,268,22,0,290
11288,2019,Hungary,Canada,3632,409,0,4041
11289,2019,Iceland,Canada,0,5,0,5
11290,2019,Cote d'Ivoire,Canada,158,253,0,411
11291,2019,India,Canada,1374,9567,0,10941
11292,2019,Indonesia,Canada,111,68,0,179
11293,2019,Ireland,Canada,0,41,0,41
11294,2019,Iran (Islamic Rep. of),Canada,3846,3370,0,7216
11295,2019,Iraq,Canada,5,580,0,585
11296,2019,Israel,Canada,190,70,0,260
11297,2019,Italy,Canada,5,109,0,114
11298,2019,Jamaica,Canada,879,342,0,1221
11299,2019,Jordan,Canada,264,742,0,1006
11300,2019,Japan,Canada,0,7,0,7
11301,2019,Kazakhstan,Canada,153,71,0,224
11302,2019,Kenya,Canada,161,584,0,745
11303,2019,Kyrgyzstan,Canada,68,16,0,84
11304,2019,Rep. of Korea,Canada,58,31,0,89
11305,2019,Dem. People's Rep. of Korea,Canada,412,0,0,412
11306,2019,Kuwait,Canada,0,45,0,45
11307,2019,Lao People's Dem. Rep.,Canada,5,0,0,5
11308,2019,Liberia,Canada,38,159,0,197
11309,2019,Libya,Canada,1552,428,0,1980
11310,2019,Saint Lucia,Canada,805,31,0,836
11311,2019,Lebanon,Canada,683,582,0,1265
11312,2019,Sri Lanka,Canada,2302,1075,0,3377
11313,2019,Lithuania,Canada,21,0,0,21
11314,2019,Latvia,Canada,73,7,0,80
11315,2019,Madagascar,Canada,19,28,0,47
11316,2019,Mauritania,Canada,144,210,0,354
11317,2019,North Macedonia,Canada,19,6,0,25
11318,2019,Rep. of Moldova,Canada,107,10,0,117
11319,2019,Mexico,Canada,3051,6984,0,10035
11320,2019,Mali,Canada,172,177,0,349
11321,2019,Malaysia,Canada,0,18,0,18
11322,2019,Malawi,Canada,10,93,0,103
11323,2019,Mongolia,Canada,151,54,0,205
11324,2019,Morocco,Canada,124,158,0,282
11325,2019,Mozambique,Canada,0,11,0,11
11326,2019,Malta,Canada,5,5,0,10
11327,2019,Mauritius,Canada,11,18,0,29
11328,2019,Myanmar,Canada,0,14,0,14
11329,2019,Namibia,Canada,292,10,0,302
11330,2019,Nepal,Canada,31,257,0,288
11331,2019,Netherlands,Canada,8,36,0,44
11332,2019,Niger,Canada,65,109,0,174
11333,2019,Nicaragua,Canada,203,514,0,717
11334,2019,Nigeria,Canada,6640,12828,0,19468
11335,2019,Oman,Canada,0,5,0,5
11336,2019,Pakistan,Canada,5498,3244,0,8742
11337,2019,Panama,Canada,22,18,0,40
11338,2019,Paraguay,Canada,20,6,0,26
11339,2019,Peru,Canada,173,291,0,464
11340,2019,Philippines,Canada,64,131,0,195
11341,2019,Papua New Guinea,Canada,5,0,0,5
11342,2019,Poland,Canada,76,125,0,201
11343,2019,Portugal,Canada,5,23,0,28
11344,2019,Qatar,Canada,5,0,0,5
11345,2019,Romania,Canada,390,727,0,1117
11346,2019,South Africa,Canada,0,220,0,220
11347,2019,Russian Federation,Canada,735,207,0,942
11348,2019,Rwanda,Canada,800,709,0,1509
11349,2019,El Salvador,Canada,1547,700,0,2247
11350,2019,Saudi Arabia,Canada,344,179,0,523
11351,2019,Serbia and Kosovo: S/RES/1244 (1999),Canada,240,64,0,304
11352,2019,Senegal,Canada,203,337,0,540
11353,2019,Seychelles,Canada,5,0,0,5
11354,2019,Singapore,Canada,12,10,0,22
11355,2019,Sierra Leone,Canada,40,62,0,102
11356,2019,Somalia,Canada,2253,621,0,2874
11357,2019,Spain,Canada,11,54,0,65
11358,2019,Viet Nam,Canada,0,93,0,93
11359,2019,Saint Kitts and Nevis,Canada,44,0,0,44
11360,2019,Sudan,Canada,1399,856,0,2255
11361,2019,Suriname,Canada,0,7,0,7
11362,2019,South Sudan,Canada,6,23,0,29
11363,2019,Slovakia,Canada,1147,214,0,1361
11364,2019,Slovenia,Canada,7,5,0,12
11365,2019,Eswatini,Canada,120,9,0,129
11366,2019,Sweden,Canada,0,6,0,6
11367,2019,Syrian Arab Rep.,Canada,5,303,0,308
11368,2019,United Rep. of Tanzania,Canada,117,198,0,315
11369,2019,Thailand,Canada,0,5,0,5
11370,2019,Tajikistan,Canada,39,27,0,66
11371,2019,Turkmenistan,Canada,23,6,0,29
11372,2019,Timor-Leste,Canada,5,5,0,10
11373,2019,Togo,Canada,87,110,0,197
11374,2019,Trinidad and Tobago,Canada,87,53,0,140
11375,2019,Tunisia,Canada,171,149,0,320
11376,2019,Türkiye,Canada,5876,1390,0,7266
11377,2019,United Arab Emirates,Canada,0,14,0,14
11378,2019,Uganda,Canada,536,756,0,1292
11379,2019,Ukraine,Canada,1199,307,0,1506
11380,2019,Uruguay,Canada,0,12,0,12
11381,2019,United States of America,Canada,0,2445,0,2445
11382,2019,Uzbekistan,Canada,155,19,0,174
11383,2019,Saint Vincent and the Grenadines,Canada,902,36,0,938
11384,2019,Venezuela (Bolivarian Republic of),Canada,3067,1388,0,4455
11385,2019,Yemen,Canada,1711,371,0,2082
11386,2019,Zambia,Canada,6,31,0,37
11387,2019,Zimbabwe,Canada,728,382,0,1110
11388,2019,Stateless,Canada,0,0,0,0
11389,2019,Unknown ,Canada,1533,9109,0,10642
11390,2019,Angola,Central African Rep.,13,0,0,13
11391,2019,Burundi,Central African Rep.,22,0,0,22
11392,2019,Central African Rep.,Central African Rep.,0,0,669906,0
11393,2019,Chad,Central African Rep.,1694,19,0,1713
11394,2019,Cameroon,Central African Rep.,18,23,0,41
11395,2019,Congo,Central African Rep.,15,8,0,23
11396,2019,Dem. Rep. of the Congo,Central African Rep.,2529,242,0,2771
11397,2019,Guinea,Central African Rep.,6,0,0,6
11398,2019,Cote d'Ivoire,Central African Rep.,7,0,0,7
11399,2019,Liberia,Central African Rep.,5,0,0,5
11400,2019,Rwanda,Central African Rep.,209,0,0,209
11401,2019,Sudan,Central African Rep.,405,12,0,417
11402,2019,South Sudan,Central African Rep.,2235,0,0,2235
11403,2019,Türkiye,Central African Rep.,5,0,0,5
11404,2019,Uganda,Central African Rep.,7,5,0,12
11405,2019,Cuba,Cayman Islands,34,14,0,48
11406,2019,Venezuela (Bolivarian Republic of),Cayman Islands,0,0,0,0
11407,2019,Burundi,Chad,5,0,0,5
11408,2019,Central African Rep.,Chad,93711,1563,0,95274
11409,2019,Chad,Chad,0,0,170278,0
11410,2019,Cameroon,Chad,5,11,0,16
11411,2019,Congo,Chad,11,0,0,11
11412,2019,Dem. Rep. of the Congo,Chad,239,18,0,257
11413,2019,Eritrea,Chad,6,9,0,15
11414,2019,Ethiopia,Chad,18,6,0,24
11415,2019,Iran (Islamic Rep. of),Chad,5,0,0,5
11416,2019,Libya,Chad,21,18,0,39
11417,2019,Mali,Chad,7,0,0,7
11418,2019,Niger,Chad,607,0,0,607
11419,2019,Nigeria,Chad,12720,313,0,13033
11420,2019,Rwanda,Chad,13,0,0,13
11421,2019,Somalia,Chad,7,0,0,7
11422,2019,Sudan,Chad,335246,1805,0,337051
11423,2019,South Sudan,Chad,9,0,0,9
11424,2019,Syrian Arab Rep.,Chad,35,8,0,43
11425,2019,Yemen,Chad,5,5,0,10
11426,2019,Afghanistan,China,21,21,0,42
11427,2019,Burundi,China,7,0,0,7
11428,2019,Central African Rep.,China,0,5,0,5
11429,2019,Cameroon,China,5,226,0,231
11430,2019,Dem. Rep. of the Congo,China,10,18,0,28
11431,2019,Eritrea,China,5,5,0,10
11432,2019,Palestinian,China,13,12,0,25
11433,2019,Ghana,China,0,11,0,11
11434,2019,Cote d'Ivoire,China,0,7,0,7
11435,2019,Iran (Islamic Rep. of),China,0,5,0,5
11436,2019,Iraq,China,20,0,0,20
11437,2019,Kenya,China,0,17,0,17
11438,2019,Liberia,China,0,6,0,6
11439,2019,Mozambique,China,0,6,0,6
11440,2019,Nigeria,China,0,19,0,19
11441,2019,Pakistan,China,21,20,0,41
11442,2019,Rwanda,China,0,8,0,8
11443,2019,Sierra Leone,China,0,6,0,6
11444,2019,Somalia,China,106,17,0,123
11445,2019,Viet Nam,China,303095,0,0,303095
11446,2019,Syrian Arab Rep.,China,50,13,0,63
11447,2019,Türkiye,China,0,9,0,9
11448,2019,Uganda,China,5,85,0,90
11449,2019,Yemen,China,16,16,0,32
11450,2019,Zambia,China,0,5,0,5
11451,2019,Zimbabwe,China,5,107,0,112
11452,2019,Afghanistan,Chile,13,13,0,26
11453,2019,Angola,Chile,0,5,0,5
11454,2019,Bangladesh,Chile,0,7,0,7
11455,2019,Bolivia (Plurinational State of),Chile,0,21,0,21
11456,2019,Congo,Chile,8,5,0,13
11457,2019,Dem. Rep. of the Congo,Chile,5,0,0,5
11458,2019,Colombia,Chile,1227,3864,0,5091
11459,2019,Costa Rica,Chile,5,0,0,5
11460,2019,Cuba,Chile,19,1449,0,1468
11461,2019,Dominican Rep.,Chile,0,121,0,121
11462,2019,Ecuador,Chile,23,29,0,52
11463,2019,Palestinian,Chile,15,7,0,22
11464,2019,Ghana,Chile,0,8,0,8
11465,2019,Guatemala,Chile,0,5,0,5
11466,2019,Haiti,Chile,0,26,0,26
11467,2019,Honduras,Chile,5,0,0,5
11468,2019,Iraq,Chile,0,14,0,14
11469,2019,Kenya,Chile,5,0,0,5
11470,2019,Rep. of Korea,Chile,0,5,0,5
11471,2019,Sri Lanka,Chile,5,0,0,5
11472,2019,Nicaragua,Chile,0,5,0,5
11473,2019,Pakistan,Chile,0,7,0,7
11474,2019,Peru,Chile,113,15,0,128
11475,2019,Russian Federation,Chile,5,7,0,12
11476,2019,El Salvador,Chile,9,27,0,36
11477,2019,Senegal,Chile,5,0,0,5
11478,2019,Sierra Leone,Chile,0,5,0,5
11479,2019,Syrian Arab Rep.,Chile,112,33,0,145
11480,2019,Türkiye,Chile,26,5,0,31
11481,2019,United States of America,Chile,0,5,0,5
11482,2019,Venezuela (Bolivarian Republic of),Chile,14,2768,0,2782
11483,2019,Unknown ,Chile,432,65,0,497
11484,2019,Angola,Cameroon,5,0,0,5
11485,2019,Burundi,Cameroon,69,24,0,93
11486,2019,Burkina Faso,Cameroon,0,30,0,30
11487,2019,Cambodia,Cameroon,5,0,0,5
11488,2019,Central African Rep.,Cameroon,292767,7398,0,300165
11489,2019,Chad,Cameroon,1604,624,0,2228
11490,2019,Cameroon,Cameroon,0,0,950263,0
11491,2019,Congo,Cameroon,54,21,0,75
11492,2019,Dem. Rep. of the Congo,Cameroon,521,203,0,724
11493,2019,Ethiopia,Cameroon,0,5,0,5
11494,2019,Gabon,Cameroon,0,6,0,6
11495,2019,Gambia,Cameroon,0,5,0,5
11496,2019,Guinea-Bissau,Cameroon,0,12,0,12
11497,2019,Guinea,Cameroon,12,245,0,257
11498,2019,Cote d'Ivoire,Cameroon,70,97,0,167
11499,2019,Iran (Islamic Rep. of),Cameroon,5,0,0,5
11500,2019,Liberia,Cameroon,9,5,0,14
11501,2019,Mauritania,Cameroon,5,5,0,10
11502,2019,Mali,Cameroon,13,205,0,218
11503,2019,Morocco,Cameroon,7,0,0,7
11504,2019,Niger,Cameroon,0,598,0,598
11505,2019,Nigeria,Cameroon,110627,54,0,110681
11506,2019,Rwanda,Cameroon,334,211,0,545
11507,2019,Senegal,Cameroon,0,30,0,30
11508,2019,Sierra Leone,Cameroon,0,11,0,11
11509,2019,Sudan,Cameroon,98,54,0,152
11510,2019,South Sudan,Cameroon,13,5,0,18
11511,2019,Syrian Arab Rep.,Cameroon,24,5,0,29
11512,2019,Togo,Cameroon,17,15,0,32
11513,2019,Türkiye,Cameroon,0,57,0,57
11514,2019,Yemen,Cameroon,0,5,0,5
11515,2019,Angola,Congo,14,46,0,60
11516,2019,Egypt,Congo,0,0,0,0
11517,2019,Burundi,Congo,66,8,0,74
11518,2019,Burkina Faso,Congo,0,5,0,5
11519,2019,Central African Rep.,Congo,15014,3787,0,18801
11520,2019,Chad,Congo,24,20,0,44
11521,2019,Cameroon,Congo,5,15,0,20
11522,2019,Congo,Congo,0,0,134430,0
11523,2019,Dem. Rep. of the Congo,Congo,9694,10018,0,19712
11524,2019,Guinea,Congo,0,5,0,5
11525,2019,Cote d'Ivoire,Congo,5,5,0,10
11526,2019,Liberia,Congo,0,5,0,5
11527,2019,Mauritania,Congo,5,45,0,50
11528,2019,Mali,Congo,5,0,0,5
11529,2019,Rwanda,Congo,811,406,0,1217
11530,2019,Sudan,Congo,25,39,0,64
11531,2019,Syrian Arab Rep.,Congo,0,13,0,13
11532,2019,Angola,Dem. Rep. of the Congo,490,16,0,506
11533,2019,Burundi,Dem. Rep. of the Congo,47570,2199,0,49769
11534,2019,Central African Rep.,Dem. Rep. of the Congo,171234,632,0,171866
11535,2019,Chad,Dem. Rep. of the Congo,0,15,0,15
11536,2019,Cameroon,Dem. Rep. of the Congo,0,16,0,16
11537,2019,Congo,Dem. Rep. of the Congo,649,19,0,668
11538,2019,Dem. Rep. of the Congo,Dem. Rep. of the Congo,0,0,5014253,0
11539,2019,Eritrea,Dem. Rep. of the Congo,5,0,0,5
11540,2019,Ethiopia,Dem. Rep. of the Congo,0,5,0,5
11541,2019,Palestinian,Dem. Rep. of the Congo,0,7,0,7
11542,2019,Cote d'Ivoire,Dem. Rep. of the Congo,12,15,0,27
11543,2019,Kenya,Dem. Rep. of the Congo,0,5,0,5
11544,2019,Liberia,Dem. Rep. of the Congo,9,12,0,21
11545,2019,Mali,Dem. Rep. of the Congo,0,11,0,11
11546,2019,Niger,Dem. Rep. of the Congo,0,5,0,5
11547,2019,Romania,Dem. Rep. of the Congo,0,5,0,5
11548,2019,Rwanda,Dem. Rep. of the Congo,214989,133,0,215122
11549,2019,Somalia,Dem. Rep. of the Congo,16,51,0,67
11550,2019,Sudan,Dem. Rep. of the Congo,20,12,0,32
11551,2019,South Sudan,Dem. Rep. of the Congo,88717,8,0,88725
11552,2019,Syrian Arab Rep.,Dem. Rep. of the Congo,5,26,0,31
11553,2019,Uganda,Dem. Rep. of the Congo,17,0,0,17
11554,2019,Afghanistan,Colombia,9,0,0,9
11555,2019,Bolivia (Plurinational State of),Colombia,5,0,0,5
11556,2019,Cameroon,Colombia,0,6,0,6
11557,2019,Colombia,Colombia,0,0,7976412,0
11558,2019,Cuba,Colombia,73,85,0,158
11559,2019,Ecuador,Colombia,8,0,0,8
11560,2019,Eritrea,Colombia,5,0,0,5
11561,2019,Ethiopia,Colombia,17,0,0,17
11562,2019,Palestinian,Colombia,0,5,0,5
11563,2019,Ghana,Colombia,0,5,0,5
11564,2019,Honduras,Colombia,5,0,0,5
11565,2019,Hungary,Colombia,5,0,0,5
11566,2019,Iraq,Colombia,9,5,0,14
11567,2019,Nicaragua,Colombia,14,0,0,14
11568,2019,Nigeria,Colombia,0,5,0,5
11569,2019,Romania,Colombia,7,0,0,7
11570,2019,El Salvador,Colombia,11,0,0,11
11571,2019,Serbia and Kosovo: S/RES/1244 (1999),Colombia,7,0,0,7
11572,2019,Sierra Leone,Colombia,5,0,0,5
11573,2019,Somalia,Colombia,11,0,0,11
11574,2019,Syrian Arab Rep.,Colombia,8,8,0,16
11575,2019,Türkiye,Colombia,5,31,0,36
11576,2019,Venezuela (Bolivarian Republic of),Colombia,425,8824,0,9249
11577,2019,Yemen,Colombia,0,7,0,7
11578,2019,Stateless,Colombia,0,0,0,0
11579,2019,Unknown ,Colombia,5,113,0,118
11580,2019,Angola,Costa Rica,0,51,0,51
11581,2019,Argentina,Costa Rica,0,17,0,17
11582,2019,Burundi,Costa Rica,5,0,0,5
11583,2019,Bangladesh,Costa Rica,0,16,0,16
11584,2019,Burkina Faso,Costa Rica,0,5,0,5
11585,2019,Bolivia (Plurinational State of),Costa Rica,0,5,0,5
11586,2019,Brazil,Costa Rica,0,12,0,12
11587,2019,China,Costa Rica,0,152,0,152
11588,2019,Chile,Costa Rica,0,12,0,12
11589,2019,Cameroon,Costa Rica,0,21,0,21
11590,2019,Congo,Costa Rica,0,57,0,57
11591,2019,Dem. Rep. of the Congo,Costa Rica,12,41,0,53
11592,2019,Colombia,Costa Rica,2325,1338,0,3663
11593,2019,Cuba,Costa Rica,380,1933,0,2313
11594,2019,Dominican Rep.,Costa Rica,0,64,0,64
11595,2019,Ecuador,Costa Rica,0,17,0,17
11596,2019,Eritrea,Costa Rica,0,7,0,7
11597,2019,Ethiopia,Costa Rica,5,0,0,5
11598,2019,Gambia,Costa Rica,0,5,0,5
11599,2019,Germany,Costa Rica,0,5,0,5
11600,2019,Ghana,Costa Rica,0,63,0,63
11601,2019,Guatemala,Costa Rica,24,35,0,59
11602,2019,Haiti,Costa Rica,12,111,0,123
11603,2019,Honduras,Costa Rica,189,715,0,904
11604,2019,Cote d'Ivoire,Costa Rica,0,5,0,5
11605,2019,Indonesia,Costa Rica,5,0,0,5
11606,2019,Iran (Islamic Rep. of),Costa Rica,5,0,0,5
11607,2019,Iraq,Costa Rica,5,0,0,5
11608,2019,Israel,Costa Rica,0,5,0,5
11609,2019,Italy,Costa Rica,0,6,0,6
11610,2019,Jamaica,Costa Rica,0,8,0,8
11611,2019,Mexico,Costa Rica,8,23,0,31
11612,2019,Nepal,Costa Rica,0,105,0,105
11613,2019,Niger,Costa Rica,0,5,0,5
11614,2019,Nicaragua,Costa Rica,1402,43481,0,44883
11615,2019,Nigeria,Costa Rica,17,0,0,17
11616,2019,Pakistan,Costa Rica,5,11,0,16
11617,2019,Panama,Costa Rica,5,13,0,18
11618,2019,Peru,Costa Rica,13,0,0,13
11619,2019,Russian Federation,Costa Rica,25,0,0,25
11620,2019,El Salvador,Costa Rica,1155,854,0,2009
11621,2019,Senegal,Costa Rica,0,5,0,5
11622,2019,Somalia,Costa Rica,7,7,0,14
11623,2019,Spain,Costa Rica,0,10,0,10
11624,2019,Syrian Arab Rep.,Costa Rica,5,24,0,29
11625,2019,Türkiye,Costa Rica,0,5,0,5
11626,2019,Ukraine,Costa Rica,13,0,0,13
11627,2019,United States of America,Costa Rica,5,31,0,36
11628,2019,Venezuela (Bolivarian Republic of),Costa Rica,577,6809,0,7386
11629,2019,Zimbabwe,Costa Rica,0,5,0,5
11630,2019,Stateless,Costa Rica,0,0,0,0
11631,2019,Unknown ,Costa Rica,0,31060,0,31060
11632,2019,Afghanistan,Cuba,36,0,0,36
11633,2019,Eritrea,Cuba,14,0,0,14
11634,2019,Ethiopia,Cuba,6,0,0,6
11635,2019,Haiti,Cuba,5,0,0,5
11636,2019,Iran (Islamic Rep. of),Cuba,11,16,0,27
11637,2019,Iraq,Cuba,0,6,0,6
11638,2019,Sudan,Cuba,0,10,0,10
11639,2019,Syrian Arab Rep.,Cuba,40,0,0,40
11640,2019,Western Sahara,Cuba,107,0,0,107
11641,2019,Yemen,Cuba,14,0,0,14
11642,2019,Stateless,Cabo Verde,0,0,0,0
11643,2019,Afghanistan,Cyprus,14,5,0,19
11644,2019,Albania,Cyprus,0,5,0,5
11645,2019,Algeria,Cyprus,8,8,0,16
11646,2019,Egypt,Cyprus,115,1007,0,1122
11647,2019,Armenia,Cyprus,26,21,0,47
11648,2019,Bangladesh,Cyprus,5,1521,0,1526
11649,2019,Burkina Faso,Cyprus,0,6,0,6
11650,2019,Belarus,Cyprus,0,6,0,6
11651,2019,Bosnia and Herzegovina,Cyprus,15,0,0,15
11652,2019,China,Cyprus,5,9,0,14
11653,2019,Cameroon,Cyprus,67,1817,0,1884
11654,2019,Congo,Cyprus,10,60,0,70
11655,2019,Dem. Rep. of the Congo,Cyprus,25,418,0,443
11656,2019,Comoros,Cyprus,0,5,0,5
11657,2019,Cuba,Cyprus,0,5,0,5
11658,2019,Eritrea,Cyprus,53,5,0,58
11659,2019,Ethiopia,Cyprus,10,13,0,23
11660,2019,Gambia,Cyprus,5,68,0,73
11661,2019,Palestinian,Cyprus,2059,330,0,2389
11662,2019,Georgia,Cyprus,85,1553,0,1638
11663,2019,Ghana,Cyprus,0,23,0,23
11664,2019,Guinea,Cyprus,5,116,0,121
11665,2019,Haiti,Cyprus,0,11,0,11
11666,2019,Cote d'Ivoire,Cyprus,5,52,0,57
11667,2019,India,Cyprus,7,1676,0,1683
11668,2019,Iran (Islamic Rep. of),Cyprus,565,587,0,1152
11669,2019,Iraq,Cyprus,919,357,0,1276
11670,2019,Jordan,Cyprus,38,98,0,136
11671,2019,Kazakhstan,Cyprus,5,0,0,5
11672,2019,Kenya,Cyprus,0,5,0,5
11673,2019,Kyrgyzstan,Cyprus,5,0,0,5
11674,2019,Libya,Cyprus,10,5,0,15
11675,2019,Lebanon,Cyprus,52,99,0,151
11676,2019,Sri Lanka,Cyprus,27,616,0,643
11677,2019,Rep. of Moldova,Cyprus,18,7,0,25
11678,2019,Mali,Cyprus,0,10,0,10
11679,2019,Morocco,Cyprus,0,7,0,7
11680,2019,Nepal,Cyprus,0,448,0,448
11681,2019,Nigeria,Cyprus,14,533,0,547
11682,2019,Pakistan,Cyprus,17,1357,0,1374
11683,2019,Philippines,Cyprus,12,256,0,268
11684,2019,Russian Federation,Cyprus,77,81,0,158
11685,2019,Rwanda,Cyprus,5,5,0,10
11686,2019,Serbia and Kosovo: S/RES/1244 (1999),Cyprus,59,8,0,67
11687,2019,Senegal,Cyprus,0,24,0,24
11688,2019,Sierra Leone,Cyprus,24,37,0,61
11689,2019,Somalia,Cyprus,221,369,0,590
11690,2019,Viet Nam,Cyprus,0,668,0,668
11691,2019,Sudan,Cyprus,13,5,0,18
11692,2019,Syrian Arab Rep.,Cyprus,7372,4073,0,11445
11693,2019,Togo,Cyprus,0,5,0,5
11694,2019,Tunisia,Cyprus,0,5,0,5
11695,2019,Türkiye,Cyprus,223,202,0,425
11696,2019,Ukraine,Cyprus,30,135,0,165
11697,2019,Uzbekistan,Cyprus,5,10,0,15
11698,2019,Venezuela (Bolivarian Republic of),Cyprus,0,5,0,5
11699,2019,Yemen,Cyprus,25,10,0,35
11700,2019,Zimbabwe,Cyprus,0,24,0,24
11701,2019,Stateless,Cyprus,56,0,0,56
11702,2019,Unknown ,Cyprus,0,8,0,8
11703,2019,Afghanistan,Czechia,45,14,0,59
11704,2019,Algeria,Czechia,0,5,0,5
11705,2019,Egypt,Czechia,8,5,0,13
11706,2019,Armenia,Czechia,29,24,0,53
11707,2019,Azerbaijan,Czechia,20,25,0,45
11708,2019,Burundi,Czechia,5,0,0,5
11709,2019,Belarus,Czechia,175,14,0,189
11710,2019,Bosnia and Herzegovina,Czechia,5,0,0,5
11711,2019,China,Czechia,30,43,0,73
11712,2019,Cameroon,Czechia,5,5,0,10
11713,2019,Dem. Rep. of the Congo,Czechia,8,5,0,13
11714,2019,Cuba,Czechia,46,25,0,71
11715,2019,Eritrea,Czechia,13,0,0,13
11716,2019,Ethiopia,Czechia,5,0,0,5
11717,2019,Georgia,Czechia,15,43,0,58
11718,2019,Guinea,Czechia,5,0,0,5
11719,2019,India,Czechia,0,7,0,7
11720,2019,Iran (Islamic Rep. of),Czechia,6,9,0,15
11721,2019,Iraq,Czechia,146,6,0,152
11722,2019,Jordan,Czechia,0,5,0,5
11723,2019,Kazakhstan,Czechia,111,54,0,165
11724,2019,Kyrgyzstan,Czechia,22,12,0,34
11725,2019,Libya,Czechia,15,0,0,15
11726,2019,Lebanon,Czechia,5,8,0,13
11727,2019,Sri Lanka,Czechia,7,0,0,7
11728,2019,Rep. of Moldova,Czechia,18,5,0,23
11729,2019,Mongolia,Czechia,7,0,0,7
11730,2019,Morocco,Czechia,5,0,0,5
11731,2019,Myanmar,Czechia,145,0,0,145
11732,2019,Nigeria,Czechia,8,20,0,28
11733,2019,Pakistan,Czechia,14,16,0,30
11734,2019,Russian Federation,Czechia,164,59,0,223
11735,2019,Saudi Arabia,Czechia,6,0,0,6
11736,2019,Serbia and Kosovo: S/RES/1244 (1999),Czechia,9,0,0,9
11737,2019,Sierra Leone,Czechia,5,0,0,5
11738,2019,Somalia,Czechia,14,0,0,14
11739,2019,Viet Nam,Czechia,14,56,0,70
11740,2019,Sudan,Czechia,11,0,0,11
11741,2019,Syrian Arab Rep.,Czechia,408,18,0,426
11742,2019,Turkmenistan,Czechia,7,0,0,7
11743,2019,Togo,Czechia,5,0,0,5
11744,2019,Tunisia,Czechia,0,6,0,6
11745,2019,Türkiye,Czechia,9,15,0,24
11746,2019,Uganda,Czechia,5,0,0,5
11747,2019,Ukraine,Czechia,305,146,0,451
11748,2019,Uzbekistan,Czechia,53,58,0,111
11749,2019,Venezuela (Bolivarian Republic of),Czechia,0,35,0,35
11750,2019,Yemen,Czechia,20,0,0,20
11751,2019,Stateless,Czechia,96,10,0,106
11752,2019,Unknown ,Czechia,0,879,0,879
11753,2019,Afghanistan,Denmark,2620,79,0,2699
11754,2019,Albania,Denmark,0,5,0,5
11755,2019,Algeria,Denmark,5,9,0,14
11756,2019,Egypt,Denmark,16,10,0,26
11757,2019,Armenia,Denmark,75,13,0,88
11758,2019,Azerbaijan,Denmark,41,0,0,41
11759,2019,Burundi,Denmark,5,5,0,10
11760,2019,Bangladesh,Denmark,20,5,0,25
11761,2019,Belarus,Denmark,5,11,0,16
11762,2019,Bosnia and Herzegovina,Denmark,5,5,0,10
11763,2019,China,Denmark,19,5,0,24
11764,2019,Cameroon,Denmark,7,13,0,20
11765,2019,Congo,Denmark,5,0,0,5
11766,2019,Dem. Rep. of the Congo,Denmark,77,9,0,86
11767,2019,Colombia,Denmark,5,30,0,35
11768,2019,Eritrea,Denmark,5320,132,0,5452
11769,2019,Ethiopia,Denmark,94,10,0,104
11770,2019,Gambia,Denmark,5,0,0,5
11771,2019,Palestinian,Denmark,20,0,0,20
11772,2019,Georgia,Denmark,0,64,0,64
11773,2019,Ghana,Denmark,5,0,0,5
11774,2019,Guinea-Bissau,Denmark,5,0,0,5
11775,2019,Guinea,Denmark,5,0,0,5
11776,2019,Cote d'Ivoire,Denmark,14,0,0,14
11777,2019,India,Denmark,5,16,0,21
11778,2019,Iran (Islamic Rep. of),Denmark,3240,141,0,3381
11779,2019,Iraq,Denmark,314,73,0,387
11780,2019,Jordan,Denmark,0,7,0,7
11781,2019,Kenya,Denmark,5,10,0,15
11782,2019,Kyrgyzstan,Denmark,5,0,0,5
11783,2019,Dem. People's Rep. of Korea,Denmark,8,0,0,8
11784,2019,Libya,Denmark,7,5,0,12
11785,2019,Lebanon,Denmark,26,13,0,39
11786,2019,Sri Lanka,Denmark,54,12,0,66
11787,2019,Mauritania,Denmark,0,5,0,5
11788,2019,North Macedonia,Denmark,0,10,0,10
11789,2019,Morocco,Denmark,8,34,0,42
11790,2019,Myanmar,Denmark,28,11,0,39
11791,2019,Nepal,Denmark,5,0,0,5
11792,2019,Nicaragua,Denmark,0,20,0,20
11793,2019,Nigeria,Denmark,9,11,0,20
11794,2019,Pakistan,Denmark,65,20,0,85
11795,2019,Russian Federation,Denmark,855,61,0,916
11796,2019,Rwanda,Denmark,15,0,0,15
11797,2019,El Salvador,Denmark,5,6,0,11
11798,2019,Somalia,Denmark,1308,150,0,1458
11799,2019,Sudan,Denmark,65,11,0,76
11800,2019,Syrian Arab Rep.,Denmark,20046,210,0,20256
11801,2019,United Rep. of Tanzania,Denmark,5,0,0,5
11802,2019,Thailand,Denmark,5,0,0,5
11803,2019,Tajikistan,Denmark,5,0,0,5
11804,2019,Tunisia,Denmark,0,5,0,5
11805,2019,Türkiye,Denmark,11,16,0,27
11806,2019,Uganda,Denmark,74,5,0,79
11807,2019,Ukraine,Denmark,28,29,0,57
11808,2019,Uzbekistan,Denmark,10,0,0,10
11809,2019,Venezuela (Bolivarian Republic of),Denmark,5,14,0,19
11810,2019,Yemen,Denmark,5,0,0,5
11811,2019,Zambia,Denmark,5,0,0,5
11812,2019,Zimbabwe,Denmark,8,0,0,8
11813,2019,Stateless,Denmark,2898,112,0,3010
11814,2019,Unknown ,Denmark,28,10,0,38
11815,2019,Dem. Rep. of the Congo,Djibouti,0,5,0,5
11816,2019,Eritrea,Djibouti,422,469,0,891
11817,2019,Ethiopia,Djibouti,581,10545,0,11126
11818,2019,Iraq,Djibouti,15,5,0,20
11819,2019,Mali,Djibouti,0,5,0,5
11820,2019,Philippines,Djibouti,5,0,0,5
11821,2019,Somalia,Djibouti,13277,119,0,13396
11822,2019,Sudan,Djibouti,7,5,0,12
11823,2019,Syrian Arab Rep.,Djibouti,10,0,0,10
11824,2019,Yemen,Djibouti,5322,0,0,5322
11825,2019,Afghanistan,Dominican Rep.,0,9,0,9
11826,2019,Colombia,Dominican Rep.,0,10,0,10
11827,2019,Cuba,Dominican Rep.,0,32,0,32
11828,2019,Haiti,Dominican Rep.,164,244,0,408
11829,2019,Honduras,Dominican Rep.,0,5,0,5
11830,2019,Sri Lanka,Dominican Rep.,0,5,0,5
11831,2019,Nicaragua,Dominican Rep.,0,5,0,5
11832,2019,United States of America,Dominican Rep.,0,5,0,5
11833,2019,Venezuela (Bolivarian Republic of),Dominican Rep.,0,246,0,246
11834,2019,Afghanistan,Ecuador,150,5,0,155
11835,2019,Albania,Ecuador,6,0,0,6
11836,2019,Angola,Ecuador,5,30,0,35
11837,2019,Egypt,Ecuador,0,16,0,16
11838,2019,Argentina,Ecuador,0,5,0,5
11839,2019,Bangladesh,Ecuador,5,9,0,14
11840,2019,Brazil,Ecuador,5,15,0,20
11841,2019,Canada,Ecuador,0,5,0,5
11842,2019,China,Ecuador,12,0,0,12
11843,2019,Chile,Ecuador,7,6,0,13
11844,2019,Cameroon,Ecuador,16,17,0,33
11845,2019,Congo,Ecuador,5,9,0,14
11846,2019,Dem. Rep. of the Congo,Ecuador,8,14,0,22
11847,2019,Colombia,Ecuador,102928,9918,0,112846
11848,2019,Cuba,Ecuador,214,177,0,391
11849,2019,Dominican Rep.,Ecuador,5,8,0,13
11850,2019,Eritrea,Ecuador,11,5,0,16
11851,2019,Ethiopia,Ecuador,5,0,0,5
11852,2019,Gambia,Ecuador,0,5,0,5
11853,2019,Palestinian,Ecuador,8,14,0,22
11854,2019,Ghana,Ecuador,5,5,0,10
11855,2019,Guinea,Ecuador,9,0,0,9
11856,2019,Haiti,Ecuador,21,11,0,32
11857,2019,Honduras,Ecuador,0,5,0,5
11858,2019,India,Ecuador,5,11,0,16
11859,2019,Iran (Islamic Rep. of),Ecuador,61,20,0,81
11860,2019,Iraq,Ecuador,62,5,0,67
11861,2019,Liberia,Ecuador,5,0,0,5
11862,2019,Libya,Ecuador,6,0,0,6
11863,2019,Lebanon,Ecuador,14,5,0,19
11864,2019,Sri Lanka,Ecuador,18,9,0,27
11865,2019,North Macedonia,Ecuador,14,0,0,14
11866,2019,Mexico,Ecuador,0,5,0,5
11867,2019,Mali,Ecuador,5,0,0,5
11868,2019,Morocco,Ecuador,5,0,0,5
11869,2019,Nepal,Ecuador,5,0,0,5
11870,2019,Nicaragua,Ecuador,5,6,0,11
11871,2019,Nigeria,Ecuador,36,12,0,48
11872,2019,Pakistan,Ecuador,29,12,0,41
11873,2019,Panama,Ecuador,0,5,0,5
11874,2019,Peru,Ecuador,82,90,0,172
11875,2019,Philippines,Ecuador,0,6,0,6
11876,2019,Russian Federation,Ecuador,35,6,0,41
11877,2019,Rwanda,Ecuador,0,5,0,5
11878,2019,El Salvador,Ecuador,33,10,0,43
11879,2019,Saudi Arabia,Ecuador,8,0,0,8
11880,2019,Somalia,Ecuador,8,0,0,8
11881,2019,Spain,Ecuador,5,0,0,5
11882,2019,Viet Nam,Ecuador,5,0,0,5
11883,2019,Sudan,Ecuador,5,0,0,5
11884,2019,Syrian Arab Rep.,Ecuador,146,38,0,184
11885,2019,Türkiye,Ecuador,5,0,0,5
11886,2019,Ukraine,Ecuador,14,0,0,14
11887,2019,United States of America,Ecuador,7,5,0,12
11888,2019,Uzbekistan,Ecuador,5,0,0,5
11889,2019,Venezuela (Bolivarian Republic of),Ecuador,374,14442,0,14816
11890,2019,Western Sahara,Ecuador,5,0,0,5
11891,2019,Yemen,Ecuador,96,17,0,113
11892,2019,Zimbabwe,Ecuador,5,9,0,14
11893,2019,Unknown ,Ecuador,27,5,0,32
11894,2019,Eritrea,Eritrea,0,0,0,0
11895,2019,Ethiopia,Eritrea,15,0,0,15
11896,2019,Somalia,Eritrea,78,0,0,78
11897,2019,Sudan,Eritrea,99,0,0,99
11898,2019,South Sudan,Eritrea,7,0,0,7
11899,2019,Afghanistan,Estonia,9,0,0,9
11900,2019,Albania,Estonia,0,5,0,5
11901,2019,Egypt,Estonia,5,0,0,5
11902,2019,Azerbaijan,Estonia,5,0,0,5
11903,2019,Eritrea,Estonia,5,0,0,5
11904,2019,Georgia,Estonia,5,0,0,5
11905,2019,Iran (Islamic Rep. of),Estonia,5,5,0,10
11906,2019,Iraq,Estonia,22,0,0,22
11907,2019,Sri Lanka,Estonia,5,0,0,5
11908,2019,Pakistan,Estonia,5,0,0,5
11909,2019,Russian Federation,Estonia,30,18,0,48
11910,2019,Serbia and Kosovo: S/RES/1244 (1999),Estonia,6,0,0,6
11911,2019,Sudan,Estonia,16,0,0,16
11912,2019,Syrian Arab Rep.,Estonia,127,0,0,127
11913,2019,Türkiye,Estonia,19,5,0,24
11914,2019,Ukraine,Estonia,62,0,0,62
11915,2019,Yemen,Estonia,5,0,0,5
11916,2019,Stateless,Estonia,0,0,0,0
11917,2019,Egypt,Ethiopia,5,0,0,5
11918,2019,Burundi,Ethiopia,59,71,0,130
11919,2019,Cameroon,Ethiopia,0,5,0,5
11920,2019,Dem. Rep. of the Congo,Ethiopia,731,246,0,977
11921,2019,Cuba,Ethiopia,5,0,0,5
11922,2019,Djibouti,Ethiopia,49,0,0,49
11923,2019,Eritrea,Ethiopia,158596,94,0,158690
11924,2019,Ethiopia,Ethiopia,0,0,1733628,0
11925,2019,Palestinian,Ethiopia,0,5,0,5
11926,2019,Cote d'Ivoire,Ethiopia,5,0,0,5
11927,2019,Iraq,Ethiopia,10,0,0,10
11928,2019,Kenya,Ethiopia,4033,0,0,4033
11929,2019,Nigeria,Ethiopia,0,5,0,5
11930,2019,Rwanda,Ethiopia,11,6,0,17
11931,2019,Somalia,Ethiopia,192181,55,0,192236
11932,2019,Sudan,Ethiopia,41479,480,0,41959
11933,2019,South Sudan,Ethiopia,334014,168,0,334182
11934,2019,Syrian Arab Rep.,Ethiopia,0,410,0,410
11935,2019,Uganda,Ethiopia,19,5,0,24
11936,2019,Yemen,Ethiopia,1926,127,0,2053
11937,2019,Afghanistan,Fiji,5,5,0,10
11938,2019,Bangladesh,Fiji,0,5,0,5
11939,2019,Pakistan,Fiji,7,0,0,7
11940,2019,Afghanistan,Finland,3238,1220,0,4458
11941,2019,Albania,Finland,5,20,0,25
11942,2019,Algeria,Finland,14,13,0,27
11943,2019,Angola,Finland,110,26,0,136
11944,2019,Egypt,Finland,19,28,0,47
11945,2019,Azerbaijan,Finland,58,0,0,58
11946,2019,Burundi,Finland,5,5,0,10
11947,2019,Bangladesh,Finland,24,32,0,56
11948,2019,Burkina Faso,Finland,5,0,0,5
11949,2019,Belarus,Finland,14,17,0,31
11950,2019,Brazil,Finland,5,0,0,5
11951,2019,Cambodia,Finland,5,0,0,5
11952,2019,Central African Rep.,Finland,5,0,0,5
11953,2019,China,Finland,179,21,0,200
11954,2019,Cameroon,Finland,105,91,0,196
11955,2019,Congo,Finland,9,5,0,14
11956,2019,Dem. Rep. of the Congo,Finland,127,36,0,163
11957,2019,Colombia,Finland,0,19,0,19
11958,2019,Cuba,Finland,5,36,0,41
11959,2019,Dominican Rep.,Finland,5,0,0,5
11960,2019,Eritrea,Finland,851,7,0,858
11961,2019,Ethiopia,Finland,147,39,0,186
11962,2019,Finland,Finland,0,5,0,5
11963,2019,Gambia,Finland,30,29,0,59
11964,2019,Georgia,Finland,5,46,0,51
11965,2019,Ghana,Finland,52,18,0,70
11966,2019,Guatemala,Finland,5,0,0,5
11967,2019,Guinea,Finland,23,8,0,31
11968,2019,Honduras,Finland,13,26,0,39
11969,2019,Cote d'Ivoire,Finland,9,6,0,15
11970,2019,India,Finland,5,11,0,16
11971,2019,Indonesia,Finland,0,6,0,6
11972,2019,Iran (Islamic Rep. of),Finland,948,361,0,1309
11973,2019,Iraq,Finland,8862,3509,0,12371
11974,2019,Jordan,Finland,5,11,0,16
11975,2019,Kazakhstan,Finland,13,9,0,22
11976,2019,Kenya,Finland,15,11,0,26
11977,2019,Kyrgyzstan,Finland,19,0,0,19
11978,2019,Liberia,Finland,5,0,0,5
11979,2019,Libya,Finland,27,5,0,32
11980,2019,Lebanon,Finland,12,5,0,17
11981,2019,Sri Lanka,Finland,58,38,0,96
11982,2019,Rep. of Moldova,Finland,6,0,0,6
11983,2019,Mexico,Finland,0,7,0,7
11984,2019,Mali,Finland,6,0,0,6
11985,2019,Malaysia,Finland,0,6,0,6
11986,2019,Mongolia,Finland,0,5,0,5
11987,2019,Morocco,Finland,40,30,0,70
11988,2019,Montenegro,Finland,0,5,0,5
11989,2019,Myanmar,Finland,32,5,0,37
11990,2019,Nepal,Finland,0,5,0,5
11991,2019,Nicaragua,Finland,30,0,0,30
11992,2019,Nigeria,Finland,160,151,0,311
11993,2019,Pakistan,Finland,76,41,0,117
11994,2019,Peru,Finland,0,5,0,5
11995,2019,Philippines,Finland,0,5,0,5
11996,2019,Russian Federation,Finland,833,770,0,1603
11997,2019,Rwanda,Finland,28,29,0,57
11998,2019,El Salvador,Finland,10,5,0,15
11999,2019,Serbia and Kosovo: S/RES/1244 (1999),Finland,66,8,0,74
12000,2019,Senegal,Finland,5,6,0,11
12001,2019,Sierra Leone,Finland,6,14,0,20
12002,2019,Somalia,Finland,2977,728,0,3705
12003,2019,Viet Nam,Finland,5,5,0,10
12004,2019,Sudan,Finland,46,17,0,63
12005,2019,South Sudan,Finland,8,0,0,8
12006,2019,Syrian Arab Rep.,Finland,2585,77,0,2662
12007,2019,United Rep. of Tanzania,Finland,5,0,0,5
12008,2019,Tajikistan,Finland,0,10,0,10
12009,2019,Togo,Finland,5,0,0,5
12010,2019,Tunisia,Finland,5,5,0,10
12011,2019,Türkiye,Finland,581,324,0,905
12012,2019,Uganda,Finland,33,9,0,42
12013,2019,Ukraine,Finland,11,25,0,36
12014,2019,United States of America,Finland,0,7,0,7
12015,2019,Uzbekistan,Finland,9,5,0,14
12016,2019,Venezuela (Bolivarian Republic of),Finland,7,13,0,20
12017,2019,Yemen,Finland,263,57,0,320
12018,2019,Zimbabwe,Finland,6,5,0,11
12019,2019,Stateless,Finland,426,41,0,467
12020,2019,Unknown ,Finland,147,164,0,311
12021,2019,Afghanistan,France,24293,11055,0,35348
12022,2019,Albania,France,5829,3096,0,8925
12023,2019,Algeria,France,1997,1211,0,3208
12024,2019,Angola,France,3678,1165,0,4843
12025,2019,Egypt,France,1091,417,0,1508
12026,2019,Argentina,France,5,0,0,5
12027,2019,Armenia,France,4251,1494,0,5745
12028,2019,Azerbaijan,France,2942,537,0,3479
12029,2019,Bahrain,France,10,0,0,10
12030,2019,Burundi,France,1089,573,0,1662
12031,2019,Benin,France,76,234,0,310
12032,2019,Bangladesh,France,6156,6722,0,12878
12033,2019,Bhutan,France,126,0,0,126
12034,2019,Burkina Faso,France,283,333,0,616
12035,2019,Belarus,France,524,22,0,546
12036,2019,Bolivia (Plurinational State of),France,38,7,0,45
12037,2019,Brazil,France,23,10,0,33
12038,2019,Bosnia and Herzegovina,France,4116,575,0,4691
12039,2019,Bulgaria,France,70,0,0,70
12040,2019,Cambodia,France,11021,21,0,11042
12041,2019,Central African Rep.,France,3419,520,0,3939
12042,2019,Chad,France,1890,1069,0,2959
12043,2019,China,France,6918,1269,0,8187
12044,2019,Chile,France,67,0,0,67
12045,2019,Cameroon,France,1524,1229,0,2753
12046,2019,Congo,France,3678,1118,0,4796
12047,2019,Dem. Rep. of the Congo,France,17512,3580,0,21092
12048,2019,Comoros,France,627,1037,0,1664
12049,2019,Colombia,France,587,454,0,1041
12050,2019,Costa Rica,France,5,0,0,5
12051,2019,Cuba,France,196,23,0,219
12052,2019,Czechia,France,24,0,0,24
12053,2019,Djibouti,France,342,26,0,368
12054,2019,Dominica,France,5,0,0,5
12055,2019,Dominican Rep.,France,76,84,0,160
12056,2019,Ecuador,France,24,0,0,24
12057,2019,Equatorial Guinea,France,35,5,0,40
12058,2019,Eritrea,France,6372,1439,0,7811
12059,2019,Estonia,France,5,0,0,5
12060,2019,Ethiopia,France,1689,878,0,2567
12061,2019,Gabon,France,260,475,0,735
12062,2019,Gambia,France,333,263,0,596
12063,2019,Palestinian,France,1109,230,0,1339
12064,2019,Georgia,France,3550,2617,0,6167
12065,2019,Germany,France,5,0,0,5
12066,2019,Ghana,France,517,27,0,544
12067,2019,Guinea-Bissau,France,907,137,0,1044
12068,2019,Guatemala,France,15,0,0,15
12069,2019,Guinea,France,11038,7136,0,18174
12070,2019,Guyana,France,19,0,0,19
12071,2019,Haiti,France,3815,1535,0,5350
12072,2019,Honduras,France,20,5,0,25
12073,2019,Croatia,France,56,0,0,56
12074,2019,Hungary,France,54,0,0,54
12075,2019,Cote d'Ivoire,France,5652,4921,0,10573
12076,2019,India,France,236,347,0,583
12077,2019,Indonesia,France,8,0,0,8
12078,2019,Iran (Islamic Rep. of),France,2970,674,0,3644
12079,2019,Iraq,France,8829,1330,0,10159
12080,2019,Israel,France,7,0,0,7
12081,2019,Jamaica,France,20,0,0,20
12082,2019,Jordan,France,32,5,0,37
12083,2019,Kazakhstan,France,607,306,0,913
12084,2019,Kenya,France,136,16,0,152
12085,2019,Kyrgyzstan,France,312,9,0,321
12086,2019,Rep. of Korea,France,0,5,0,5
12087,2019,Kuwait,France,164,401,0,565
12088,2019,Lao People's Dem. Rep.,France,6464,0,0,6464
12089,2019,Liberia,France,247,21,0,268
12090,2019,Libya,France,1028,631,0,1659
12091,2019,Saint Lucia,France,5,0,0,5
12092,2019,Lebanon,France,147,38,0,185
12093,2019,Sri Lanka,France,23821,2155,0,25976
12094,2019,Lithuania,France,6,0,0,6
12095,2019,Latvia,France,32,0,0,32
12096,2019,Madagascar,France,224,192,0,416
12097,2019,Mauritania,France,5675,1307,0,6982
12098,2019,North Macedonia,France,383,520,0,903
12099,2019,Rep. of Moldova,France,317,917,0,1234
12100,2019,Maldives,France,5,0,0,5
12101,2019,Mexico,France,27,0,0,27
12102,2019,Mali,France,5169,2295,0,7464
12103,2019,Malaysia,France,9,5,0,14
12104,2019,Mongolia,France,473,178,0,651
12105,2019,Morocco,France,794,518,0,1312
12106,2019,Mozambique,France,12,0,0,12
12107,2019,Montenegro,France,97,7,0,104
12108,2019,Mauritius,France,28,0,0,28
12109,2019,Myanmar,France,329,6,0,335
12110,2019,Nepal,France,150,35,0,185
12111,2019,Niger,France,115,143,0,258
12112,2019,Nicaragua,France,31,0,0,31
12113,2019,Nigeria,France,3216,4506,0,7722
12114,2019,Pakistan,France,1852,2733,0,4585
12115,2019,Paraguay,France,6,0,0,6
12116,2019,Peru,France,326,24,0,350
12117,2019,Philippines,France,5,0,0,5
12118,2019,Poland,France,132,0,0,132
12119,2019,Romania,France,143,0,0,143
12120,2019,South Africa,France,48,8,0,56
12121,2019,Russian Federation,France,16412,2864,0,19276
12122,2019,Rwanda,France,2995,439,0,3434
12123,2019,El Salvador,France,66,6,0,72
12124,2019,Saudi Arabia,France,18,0,0,18
12125,2019,Serbia and Kosovo: S/RES/1244 (1999),France,14141,2004,0,16145
12126,2019,Senegal,France,1687,1695,0,3382
12127,2019,Sierra Leone,France,671,326,0,997
12128,2019,Somalia,France,4535,3895,0,8430
12129,2019,Viet Nam,France,7735,6,0,7741
12130,2019,Sao Tome and Principe,France,5,0,0,5
12131,2019,Sudan,France,18473,2680,0,21153
12132,2019,Suriname,France,5,6,0,11
12133,2019,South Sudan,France,83,14,0,97
12134,2019,Slovakia,France,107,0,0,107
12135,2019,Syrian Arab Rep.,France,18244,3244,0,21488
12136,2019,United Rep. of Tanzania,France,10,7,0,17
12137,2019,Thailand,France,8,0,0,8
12138,2019,Tajikistan,France,56,44,0,100
12139,2019,Turkmenistan,France,23,0,0,23
12140,2019,Togo,France,759,215,0,974
12141,2019,Tunisia,France,368,305,0,673
12142,2019,Türkiye,France,11863,3481,0,15344
12143,2019,Uganda,France,159,6,0,165
12144,2019,Ukraine,France,1839,1020,0,2859
12145,2019,United States of America,France,0,5,0,5
12146,2019,Uzbekistan,France,214,6,0,220
12147,2019,Venezuela (Bolivarian Republic of),France,551,676,0,1227
12148,2019,Western Sahara,France,715,293,0,1008
12149,2019,Yemen,France,454,62,0,516
12150,2019,Zimbabwe,France,51,5,0,56
12151,2019,Stateless,France,0,459,0,459
12152,2019,Unknown ,France,101068,1496,0,102564
12153,2019,Burundi,Gabon,6,0,0,6
12154,2019,Central African Rep.,Gabon,16,20,0,36
12155,2019,Chad,Gabon,242,19,0,261
12156,2019,Cameroon,Gabon,5,6,0,11
12157,2019,Congo,Gabon,67,0,0,67
12158,2019,Dem. Rep. of the Congo,Gabon,72,31,0,103
12159,2019,Mauritania,Gabon,7,0,0,7
12160,2019,Sao Tome and Principe,Gabon,23,0,0,23
12161,2019,South Sudan,Gabon,5,0,0,5
12162,2019,Togo,Gabon,11,0,0,11
12163,2019,Central African Rep.,Gambia,7,8,0,15
12164,2019,Congo,Gambia,6,5,0,11
12165,2019,Dem. Rep. of the Congo,Gambia,52,7,0,59
12166,2019,Guinea-Bissau,Gambia,0,6,0,6
12167,2019,Guinea,Gambia,5,5,0,10
12168,2019,Cote d'Ivoire,Gambia,149,6,0,155
12169,2019,Liberia,Gambia,15,0,0,15
12170,2019,Senegal,Gambia,3943,158,0,4101
12171,2019,Sierra Leone,Gambia,107,11,0,118
12172,2019,Togo,Gambia,18,0,0,18
12173,2019,Afghanistan,United Kingdom of Great Britain and Northern Ireland,9513,2890,0,12403
12174,2019,Albania,United Kingdom of Great Britain and Northern Ireland,3182,6787,0,9969
12175,2019,Algeria,United Kingdom of Great Britain and Northern Ireland,344,353,0,697
12176,2019,Angola,United Kingdom of Great Britain and Northern Ireland,180,143,0,323
12177,2019,Antigua and Barbuda,United Kingdom of Great Britain and Northern Ireland,5,9,0,14
12178,2019,Egypt,United Kingdom of Great Britain and Northern Ireland,860,510,0,1370
12179,2019,Argentina,United Kingdom of Great Britain and Northern Ireland,0,10,0,10
12180,2019,Armenia,United Kingdom of Great Britain and Northern Ireland,63,13,0,76
12181,2019,Australia,United Kingdom of Great Britain and Northern Ireland,5,0,0,5
12182,2019,Azerbaijan,United Kingdom of Great Britain and Northern Ireland,159,57,0,216
12183,2019,Bahrain,United Kingdom of Great Britain and Northern Ireland,177,12,0,189
12184,2019,Barbados,United Kingdom of Great Britain and Northern Ireland,13,5,0,18
12185,2019,Burundi,United Kingdom of Great Britain and Northern Ireland,54,12,0,66
12186,2019,Benin,United Kingdom of Great Britain and Northern Ireland,9,12,0,21
12187,2019,Bangladesh,United Kingdom of Great Britain and Northern Ireland,1601,2329,0,3930
12188,2019,Bahamas,United Kingdom of Great Britain and Northern Ireland,5,0,0,5
12189,2019,Bhutan,United Kingdom of Great Britain and Northern Ireland,64,0,0,64
12190,2019,Burkina Faso,United Kingdom of Great Britain and Northern Ireland,8,14,0,22
12191,2019,Belarus,United Kingdom of Great Britain and Northern Ireland,124,18,0,142
12192,2019,Bolivia (Plurinational State of),United Kingdom of Great Britain and Northern Ireland,18,33,0,51
12193,2019,Botswana,United Kingdom of Great Britain and Northern Ireland,33,63,0,96
12194,2019,Brazil,United Kingdom of Great Britain and Northern Ireland,28,143,0,171
12195,2019,Bosnia and Herzegovina,United Kingdom of Great Britain and Northern Ireland,19,6,0,25
12196,2019,Belize,United Kingdom of Great Britain and Northern Ireland,5,0,0,5
12197,2019,Canada,United Kingdom of Great Britain and Northern Ireland,11,7,0,18
12198,2019,Central African Rep.,United Kingdom of Great Britain and Northern Ireland,11,10,0,21
12199,2019,Chad,United Kingdom of Great Britain and Northern Ireland,55,82,0,137
12200,2019,China,United Kingdom of Great Britain and Northern Ireland,1389,1689,0,3078
12201,2019,Chile,United Kingdom of Great Britain and Northern Ireland,0,8,0,8
12202,2019,Cameroon,United Kingdom of Great Britain and Northern Ireland,698,361,0,1059
12203,2019,Congo,United Kingdom of Great Britain and Northern Ireland,102,42,0,144
12204,2019,Dem. Rep. of the Congo,United Kingdom of Great Britain and Northern Ireland,1067,229,0,1296
12205,2019,Comoros,United Kingdom of Great Britain and Northern Ireland,5,0,0,5
12206,2019,Colombia,United Kingdom of Great Britain and Northern Ireland,24,61,0,85
12207,2019,Costa Rica,United Kingdom of Great Britain and Northern Ireland,0,6,0,6
12208,2019,Cuba,United Kingdom of Great Britain and Northern Ireland,10,11,0,21
12209,2019,Cabo Verde,United Kingdom of Great Britain and Northern Ireland,5,0,0,5
12210,2019,Cyprus,United Kingdom of Great Britain and Northern Ireland,0,6,0,6
12211,2019,Djibouti,United Kingdom of Great Britain and Northern Ireland,5,0,0,5
12212,2019,Dominica,United Kingdom of Great Britain and Northern Ireland,21,39,0,60
12213,2019,Dominican Rep.,United Kingdom of Great Britain and Northern Ireland,0,13,0,13
12214,2019,Ecuador,United Kingdom of Great Britain and Northern Ireland,9,11,0,20
12215,2019,Eritrea,United Kingdom of Great Britain and Northern Ireland,13755,1647,0,15402
12216,2019,Ethiopia,United Kingdom of Great Britain and Northern Ireland,1754,607,0,2361
12217,2019,Fiji,United Kingdom of Great Britain and Northern Ireland,9,5,0,14
12218,2019,Gabon,United Kingdom of Great Britain and Northern Ireland,5,0,0,5
12219,2019,Gambia,United Kingdom of Great Britain and Northern Ireland,1254,157,0,1411
12220,2019,Palestinian,United Kingdom of Great Britain and Northern Ireland,608,345,0,953
12221,2019,Georgia,United Kingdom of Great Britain and Northern Ireland,74,260,0,334
12222,2019,Germany,United Kingdom of Great Britain and Northern Ireland,0,5,0,5
12223,2019,Ghana,United Kingdom of Great Britain and Northern Ireland,340,388,0,728
12224,2019,Guinea-Bissau,United Kingdom of Great Britain and Northern Ireland,8,0,0,8
12225,2019,Greece,United Kingdom of Great Britain and Northern Ireland,5,0,0,5
12226,2019,Grenada,United Kingdom of Great Britain and Northern Ireland,24,29,0,53
12227,2019,Guatemala,United Kingdom of Great Britain and Northern Ireland,9,11,0,20
12228,2019,Guinea,United Kingdom of Great Britain and Northern Ireland,249,100,0,349
12229,2019,Guyana,United Kingdom of Great Britain and Northern Ireland,20,9,0,29
12230,2019,Haiti,United Kingdom of Great Britain and Northern Ireland,0,10,0,10
12231,2019,"China, Hong Kong SAR",United Kingdom of Great Britain and Northern Ireland,0,16,0,16
12232,2019,Honduras,United Kingdom of Great Britain and Northern Ireland,50,203,0,253
12233,2019,Cote d'Ivoire,United Kingdom of Great Britain and Northern Ireland,236,81,0,317
12234,2019,India,United Kingdom of Great Britain and Northern Ireland,463,2248,0,2711
12235,2019,Indonesia,United Kingdom of Great Britain and Northern Ireland,28,49,0,77
12236,2019,Iran (Islamic Rep. of),United Kingdom of Great Britain and Northern Ireland,19744,4845,0,24589
12237,2019,Iraq,United Kingdom of Great Britain and Northern Ireland,5752,5338,0,11090
12238,2019,Israel,United Kingdom of Great Britain and Northern Ireland,7,10,0,17
12239,2019,Italy,United Kingdom of Great Britain and Northern Ireland,0,5,0,5
12240,2019,Jamaica,United Kingdom of Great Britain and Northern Ireland,369,169,0,538
12241,2019,Jordan,United Kingdom of Great Britain and Northern Ireland,73,99,0,172
12242,2019,Japan,United Kingdom of Great Britain and Northern Ireland,0,9,0,9
12243,2019,Kazakhstan,United Kingdom of Great Britain and Northern Ireland,22,66,0,88
12244,2019,Kenya,United Kingdom of Great Britain and Northern Ireland,303,268,0,571
12245,2019,Kyrgyzstan,United Kingdom of Great Britain and Northern Ireland,38,22,0,60
12246,2019,Rep. of Korea,United Kingdom of Great Britain and Northern Ireland,6,0,0,6
12247,2019,Dem. People's Rep. of Korea,United Kingdom of Great Britain and Northern Ireland,78,24,0,102
12248,2019,Kuwait,United Kingdom of Great Britain and Northern Ireland,640,342,0,982
12249,2019,Lao People's Dem. Rep.,United Kingdom of Great Britain and Northern Ireland,5,0,0,5
12250,2019,Liberia,United Kingdom of Great Britain and Northern Ireland,32,17,0,49
12251,2019,Libya,United Kingdom of Great Britain and Northern Ireland,3755,896,0,4651
12252,2019,Saint Lucia,United Kingdom of Great Britain and Northern Ireland,24,22,0,46
12253,2019,Lebanon,United Kingdom of Great Britain and Northern Ireland,180,126,0,306
12254,2019,Lesotho,United Kingdom of Great Britain and Northern Ireland,0,5,0,5
12255,2019,Sri Lanka,United Kingdom of Great Britain and Northern Ireland,5522,1419,0,6941
12256,2019,"China, Macao SAR",United Kingdom of Great Britain and Northern Ireland,0,5,0,5
12257,2019,Mauritania,United Kingdom of Great Britain and Northern Ireland,6,5,0,11
12258,2019,North Macedonia,United Kingdom of Great Britain and Northern Ireland,20,7,0,27
12259,2019,Rep. of Moldova,United Kingdom of Great Britain and Northern Ireland,12,5,0,17
12260,2019,Maldives,United Kingdom of Great Britain and Northern Ireland,40,5,0,45
12261,2019,Mexico,United Kingdom of Great Britain and Northern Ireland,13,23,0,36
12262,2019,Mali,United Kingdom of Great Britain and Northern Ireland,22,26,0,48
12263,2019,Malaysia,United Kingdom of Great Britain and Northern Ireland,248,331,0,579
12264,2019,Malawi,United Kingdom of Great Britain and Northern Ireland,347,85,0,432
12265,2019,Mongolia,United Kingdom of Great Britain and Northern Ireland,75,66,0,141
12266,2019,Morocco,United Kingdom of Great Britain and Northern Ireland,220,206,0,426
12267,2019,Mozambique,United Kingdom of Great Britain and Northern Ireland,6,7,0,13
12268,2019,Mauritius,United Kingdom of Great Britain and Northern Ireland,57,103,0,160
12269,2019,Myanmar,United Kingdom of Great Britain and Northern Ireland,613,54,0,667
12270,2019,Namibia,United Kingdom of Great Britain and Northern Ireland,107,659,0,766
12271,2019,Nepal,United Kingdom of Great Britain and Northern Ireland,47,287,0,334
12272,2019,Netherlands,United Kingdom of Great Britain and Northern Ireland,5,0,0,5
12273,2019,Niger,United Kingdom of Great Britain and Northern Ireland,190,11,0,201
12274,2019,Nicaragua,United Kingdom of Great Britain and Northern Ireland,12,86,0,98
12275,2019,Nigeria,United Kingdom of Great Britain and Northern Ireland,2816,2237,0,5053
12276,2019,Norway,United Kingdom of Great Britain and Northern Ireland,5,0,0,5
12277,2019,Oman,United Kingdom of Great Britain and Northern Ireland,19,17,0,36
12278,2019,Pakistan,United Kingdom of Great Britain and Northern Ireland,8164,3910,0,12074
12279,2019,Philippines,United Kingdom of Great Britain and Northern Ireland,40,179,0,219
12280,2019,Qatar,United Kingdom of Great Britain and Northern Ireland,5,10,0,15
12281,2019,Romania,United Kingdom of Great Britain and Northern Ireland,5,6,0,11
12282,2019,South Africa,United Kingdom of Great Britain and Northern Ireland,156,152,0,308
12283,2019,Russian Federation,United Kingdom of Great Britain and Northern Ireland,722,453,0,1175
12284,2019,Rwanda,United Kingdom of Great Britain and Northern Ireland,118,31,0,149
12285,2019,El Salvador,United Kingdom of Great Britain and Northern Ireland,304,998,0,1302
12286,2019,Saudi Arabia,United Kingdom of Great Britain and Northern Ireland,212,152,0,364
12287,2019,Serbia and Kosovo: S/RES/1244 (1999),United Kingdom of Great Britain and Northern Ireland,86,55,0,141
12288,2019,Senegal,United Kingdom of Great Britain and Northern Ireland,108,45,0,153
12289,2019,Seychelles,United Kingdom of Great Britain and Northern Ireland,5,6,0,11
12290,2019,Singapore,United Kingdom of Great Britain and Northern Ireland,5,5,0,10
12291,2019,Sierra Leone,United Kingdom of Great Britain and Northern Ireland,326,157,0,483
12292,2019,Somalia,United Kingdom of Great Britain and Northern Ireland,3271,508,0,3779
12293,2019,Viet Nam,United Kingdom of Great Britain and Northern Ireland,1928,2494,0,4422
12294,2019,Saint Kitts and Nevis,United Kingdom of Great Britain and Northern Ireland,8,12,0,20
12295,2019,Sudan,United Kingdom of Great Britain and Northern Ireland,10575,1523,0,12098
12296,2019,South Sudan,United Kingdom of Great Britain and Northern Ireland,55,29,0,84
12297,2019,Eswatini,United Kingdom of Great Britain and Northern Ireland,57,0,0,57
12298,2019,Syrian Arab Rep.,United Kingdom of Great Britain and Northern Ireland,10389,1228,0,11617
12299,2019,United Rep. of Tanzania,United Kingdom of Great Britain and Northern Ireland,98,100,0,198
12300,2019,Thailand,United Kingdom of Great Britain and Northern Ireland,41,66,0,107
12301,2019,Tajikistan,United Kingdom of Great Britain and Northern Ireland,10,11,0,21
12302,2019,Turkmenistan,United Kingdom of Great Britain and Northern Ireland,12,22,0,34
12303,2019,Togo,United Kingdom of Great Britain and Northern Ireland,18,15,0,33
12304,2019,Trinidad and Tobago,United Kingdom of Great Britain and Northern Ireland,89,92,0,181
12305,2019,Tunisia,United Kingdom of Great Britain and Northern Ireland,60,60,0,120
12306,2019,Türkiye,United Kingdom of Great Britain and Northern Ireland,1970,1206,0,3176
12307,2019,United Arab Emirates,United Kingdom of Great Britain and Northern Ireland,23,8,0,31
12308,2019,Uganda,United Kingdom of Great Britain and Northern Ireland,1237,248,0,1485
12309,2019,Ukraine,United Kingdom of Great Britain and Northern Ireland,185,233,0,418
12310,2019,United States of America,United Kingdom of Great Britain and Northern Ireland,58,81,0,139
12311,2019,Uzbekistan,United Kingdom of Great Britain and Northern Ireland,76,47,0,123
12312,2019,Saint Vincent and the Grenadines,United Kingdom of Great Britain and Northern Ireland,35,16,0,51
12313,2019,Venezuela (Bolivarian Republic of),United Kingdom of Great Britain and Northern Ireland,51,42,0,93
12314,2019,Western Sahara,United Kingdom of Great Britain and Northern Ireland,12,0,0,12
12315,2019,Yemen,United Kingdom of Great Britain and Northern Ireland,819,290,0,1109
12316,2019,Zambia,United Kingdom of Great Britain and Northern Ireland,89,41,0,130
12317,2019,Zimbabwe,United Kingdom of Great Britain and Northern Ireland,2324,390,0,2714
12318,2019,Stateless,United Kingdom of Great Britain and Northern Ireland,2858,1050,0,3908
12319,2019,Unknown ,United Kingdom of Great Britain and Northern Ireland,6277,5905,0,12182
12320,2019,Afghanistan,Georgia,11,18,0,29
12321,2019,Egypt,Georgia,60,114,0,174
12322,2019,Azerbaijan,Georgia,5,5,0,10
12323,2019,Bangladesh,Georgia,0,25,0,25
12324,2019,China,Georgia,0,5,0,5
12325,2019,Cameroon,Georgia,0,7,0,7
12326,2019,Dem. Rep. of the Congo,Georgia,5,5,0,10
12327,2019,Eritrea,Georgia,0,15,0,15
12328,2019,Palestinian,Georgia,0,14,0,14
12329,2019,Georgia,Georgia,0,0,286216,0
12330,2019,India,Georgia,0,55,0,55
12331,2019,Iran (Islamic Rep. of),Georgia,33,462,0,495
12332,2019,Iraq,Georgia,527,66,0,593
12333,2019,Jordan,Georgia,0,25,0,25
12334,2019,Kazakhstan,Georgia,0,9,0,9
12335,2019,Lebanon,Georgia,6,7,0,13
12336,2019,Morocco,Georgia,0,5,0,5
12337,2019,Nigeria,Georgia,0,34,0,34
12338,2019,Pakistan,Georgia,11,20,0,31
12339,2019,South Africa,Georgia,0,5,0,5
12340,2019,Russian Federation,Georgia,240,50,0,290
12341,2019,Somalia,Georgia,0,33,0,33
12342,2019,Sudan,Georgia,6,6,0,12
12343,2019,Syrian Arab Rep.,Georgia,91,26,0,117
12344,2019,Tajikistan,Georgia,5,0,0,5
12345,2019,Turkmenistan,Georgia,0,5,0,5
12346,2019,Türkiye,Georgia,5,43,0,48
12347,2019,Ukraine,Georgia,306,6,0,312
12348,2019,Uzbekistan,Georgia,0,5,0,5
12349,2019,Yemen,Georgia,32,29,0,61
12350,2019,Stateless,Georgia,0,0,0,0
12351,2019,Unknown ,Georgia,12,12,0,24
12352,2019,Afghanistan,Germany,140366,47343,0,187709
12353,2019,Albania,Germany,1278,2375,0,3653
12354,2019,Algeria,Germany,613,1087,0,1700
12355,2019,Angola,Germany,862,476,0,1338
12356,2019,Egypt,Germany,2310,2187,0,4497
12357,2019,Argentina,Germany,15,24,0,39
12358,2019,Armenia,Germany,2645,4926,0,7571
12359,2019,Australia,Germany,5,0,0,5
12360,2019,Austria,Germany,5,0,0,5
12361,2019,Azerbaijan,Germany,3784,5017,0,8801
12362,2019,Bahrain,Germany,89,5,0,94
12363,2019,Burundi,Germany,118,49,0,167
12364,2019,Belgium,Germany,6,0,0,6
12365,2019,Benin,Germany,92,184,0,276
12366,2019,Bangladesh,Germany,766,850,0,1616
12367,2019,Bhutan,Germany,20,5,0,25
12368,2019,Burkina Faso,Germany,93,176,0,269
12369,2019,Belarus,Germany,193,331,0,524
12370,2019,Bolivia (Plurinational State of),Germany,7,0,0,7
12371,2019,Botswana,Germany,5,5,0,10
12372,2019,Brazil,Germany,33,46,0,79
12373,2019,Bosnia and Herzegovina,Germany,1432,526,0,1958
12374,2019,Bulgaria,Germany,75,5,0,80
12375,2019,Cambodia,Germany,33,51,0,84
12376,2019,Canada,Germany,24,0,0,24
12377,2019,Central African Rep.,Germany,40,24,0,64
12378,2019,Chad,Germany,100,281,0,381
12379,2019,China,Germany,1760,943,0,2703
12380,2019,Chile,Germany,167,5,0,172
12381,2019,Cameroon,Germany,778,2840,0,3618
12382,2019,Congo,Germany,282,73,0,355
12383,2019,Dem. Rep. of the Congo,Germany,1650,655,0,2305
12384,2019,Comoros,Germany,0,13,0,13
12385,2019,Colombia,Germany,69,579,0,648
12386,2019,Cuba,Germany,86,66,0,152
12387,2019,Cabo Verde,Germany,0,5,0,5
12388,2019,Czechia,Germany,726,0,0,726
12389,2019,Djibouti,Germany,33,13,0,46
12390,2019,Dominican Rep.,Germany,9,10,0,19
12391,2019,Ecuador,Germany,13,0,0,13
12392,2019,Equatorial Guinea,Germany,24,11,0,35
12393,2019,Eritrea,Germany,58569,4757,0,63326
12394,2019,Estonia,Germany,5,0,0,5
12395,2019,Ethiopia,Germany,4982,5447,0,10429
12396,2019,France,Germany,15,5,0,20
12397,2019,Gabon,Germany,14,44,0,58
12398,2019,Gambia,Germany,1032,4940,0,5972
12399,2019,United Kingdom of Great Britain and Northern Ireland,Germany,19,0,0,19
12400,2019,Georgia,Germany,649,4445,0,5094
12401,2019,Ghana,Germany,600,1345,0,1945
12402,2019,Guinea-Bissau,Germany,102,193,0,295
12403,2019,Greece,Germany,51,0,0,51
12404,2019,Guatemala,Germany,5,7,0,12
12405,2019,Guinea,Germany,2963,5557,0,8520
12406,2019,Haiti,Germany,15,18,0,33
12407,2019,Honduras,Germany,68,64,0,132
12408,2019,Croatia,Germany,286,5,0,291
12409,2019,Hungary,Germany,241,0,0,241
12410,2019,Iceland,Germany,5,0,0,5
12411,2019,Cote d'Ivoire,Germany,610,1595,0,2205
12412,2019,India,Germany,391,1000,0,1391
12413,2019,Indonesia,Germany,16,20,0,36
12414,2019,Iran (Islamic Rep. of),Germany,43244,22005,0,65249
12415,2019,Iraq,Germany,141650,34890,0,176540
12416,2019,Israel,Germany,39,41,0,80
12417,2019,Italy,Germany,34,10,0,44
12418,2019,Jamaica,Germany,66,62,0,128
12419,2019,Jordan,Germany,435,448,0,883
12420,2019,Japan,Germany,23,5,0,28
12421,2019,Kazakhstan,Germany,114,168,0,282
12422,2019,Kenya,Germany,190,702,0,892
12423,2019,Kyrgyzstan,Germany,198,313,0,511
12424,2019,Rep. of Korea,Germany,30,17,0,47
12425,2019,Dem. People's Rep. of Korea,Germany,85,39,0,124
12426,2019,Kuwait,Germany,30,31,0,61
12427,2019,Lao People's Dem. Rep.,Germany,41,0,0,41
12428,2019,Liberia,Germany,102,372,0,474
12429,2019,Libya,Germany,1987,1179,0,3166
12430,2019,Lebanon,Germany,1656,2245,0,3901
12431,2019,Sri Lanka,Germany,3699,1375,0,5074
12432,2019,Lithuania,Germany,5,0,0,5
12433,2019,Luxembourg,Germany,5,0,0,5
12434,2019,Latvia,Germany,8,5,0,13
12435,2019,Madagascar,Germany,0,18,0,18
12436,2019,Mauritania,Germany,41,97,0,138
12437,2019,North Macedonia,Germany,722,1422,0,2144
12438,2019,Rep. of Moldova,Germany,128,1363,0,1491
12439,2019,Mexico,Germany,24,6,0,30
12440,2019,Mali,Germany,320,717,0,1037
12441,2019,Malaysia,Germany,14,8,0,22
12442,2019,Malawi,Germany,7,5,0,12
12443,2019,Mongolia,Germany,199,418,0,617
12444,2019,Morocco,Germany,800,1147,0,1947
12445,2019,Mozambique,Germany,15,26,0,41
12446,2019,Montenegro,Germany,253,229,0,482
12447,2019,Mauritius,Germany,5,5,0,10
12448,2019,Myanmar,Germany,851,294,0,1145
12449,2019,Namibia,Germany,0,28,0,28
12450,2019,Nepal,Germany,61,81,0,142
12451,2019,Netherlands,Germany,31,5,0,36
12452,2019,Niger,Germany,56,143,0,199
12453,2019,Nicaragua,Germany,5,127,0,132
12454,2019,Nigeria,Germany,7828,21814,0,29642
12455,2019,New Zealand,Germany,8,0,0,8
12456,2019,Oman,Germany,9,11,0,20
12457,2019,Pakistan,Germany,8125,10081,0,18206
12458,2019,Paraguay,Germany,0,6,0,6
12459,2019,Peru,Germany,40,5,0,45
12460,2019,Philippines,Germany,40,36,0,76
12461,2019,Poland,Germany,619,0,0,619
12462,2019,Portugal,Germany,5,5,0,10
12463,2019,Qatar,Germany,5,0,0,5
12464,2019,Romania,Germany,146,13,0,159
12465,2019,South Africa,Germany,19,73,0,92
12466,2019,Russian Federation,Germany,8722,15409,0,24131
12467,2019,Rwanda,Germany,270,193,0,463
12468,2019,El Salvador,Germany,85,41,0,126
12469,2019,Saudi Arabia,Germany,145,39,0,184
12470,2019,Serbia and Kosovo: S/RES/1244 (1999),Germany,8639,3138,0,11777
12471,2019,Senegal,Germany,183,487,0,670
12472,2019,Singapore,Germany,8,0,0,8
12473,2019,Sierra Leone,Germany,769,1208,0,1977
12474,2019,Solomon Islands,Germany,6,0,0,6
12475,2019,Somalia,Germany,26015,8438,0,34453
12476,2019,Spain,Germany,20,24,0,44
12477,2019,Viet Nam,Germany,1191,265,0,1456
12478,2019,Sudan,Germany,2606,1823,0,4429
12479,2019,South Sudan,Germany,86,92,0,178
12480,2019,Slovakia,Germany,78,0,0,78
12481,2019,Slovenia,Germany,6,0,0,6
12482,2019,Eswatini,Germany,5,5,0,10
12483,2019,Sweden,Germany,8,0,0,8
12484,2019,Syrian Arab Rep.,Germany,572818,41280,0,614098
12485,2019,United Rep. of Tanzania,Germany,64,360,0,424
12486,2019,Thailand,Germany,23,10,0,33
12487,2019,Tajikistan,Germany,871,1296,0,2167
12488,2019,Turkmenistan,Germany,83,206,0,289
12489,2019,Togo,Germany,1060,1048,0,2108
12490,2019,Trinidad and Tobago,Germany,5,5,0,10
12491,2019,Tunisia,Germany,218,574,0,792
12492,2019,Türkiye,Germany,28470,16830,0,45300
12493,2019,United Arab Emirates,Germany,39,0,0,39
12494,2019,Uganda,Germany,217,363,0,580
12495,2019,Ukraine,Germany,847,2312,0,3159
12496,2019,United States of America,Germany,133,23,0,156
12497,2019,Uzbekistan,Germany,123,129,0,252
12498,2019,Saint Vincent and the Grenadines,Germany,5,0,0,5
12499,2019,Venezuela (Bolivarian Republic of),Germany,320,923,0,1243
12500,2019,Yemen,Germany,2629,890,0,3519
12501,2019,Zambia,Germany,6,16,0,22
12502,2019,Zimbabwe,Germany,238,298,0,536
12503,2019,Stateless,Germany,10013,1409,0,11422
12504,2019,Unknown ,Germany,34397,7379,0,41776
12505,2019,Egypt,Ghana,0,16,0,16
12506,2019,Burundi,Ghana,12,16,0,28
12507,2019,Benin,Ghana,5,5,0,10
12508,2019,Central African Rep.,Ghana,119,107,0,226
12509,2019,Chad,Ghana,32,14,0,46
12510,2019,Cameroon,Ghana,6,320,0,326
12511,2019,Congo,Ghana,7,7,0,14
12512,2019,Dem. Rep. of the Congo,Ghana,46,26,0,72
12513,2019,Eritrea,Ghana,64,98,0,162
12514,2019,Ethiopia,Ghana,8,5,0,13
12515,2019,Palestinian,Ghana,16,9,0,25
12516,2019,Cote d'Ivoire,Ghana,6524,339,0,6863
12517,2019,Iraq,Ghana,11,0,0,11
12518,2019,Liberia,Ghana,734,0,0,734
12519,2019,Libya,Ghana,0,14,0,14
12520,2019,Lebanon,Ghana,8,0,0,8
12521,2019,Mali,Ghana,0,5,0,5
12522,2019,Nigeria,Ghana,9,9,0,18
12523,2019,Pakistan,Ghana,26,41,0,67
12524,2019,Rwanda,Ghana,36,5,0,41
12525,2019,Sierra Leone,Ghana,89,7,0,96
12526,2019,Somalia,Ghana,63,21,0,84
12527,2019,Sudan,Ghana,485,190,0,675
12528,2019,South Sudan,Ghana,6,5,0,11
12529,2019,Syrian Arab Rep.,Ghana,167,113,0,280
12530,2019,Togo,Ghana,3459,75,0,3534
12531,2019,Türkiye,Ghana,0,47,0,47
12532,2019,Uganda,Ghana,5,6,0,11
12533,2019,Uzbekistan,Ghana,9,0,0,9
12534,2019,Yemen,Ghana,0,9,0,9
12535,2019,Burundi,Guinea-Bissau,5,0,0,5
12536,2019,Cote d'Ivoire,Guinea-Bissau,6,6,0,12
12537,2019,Liberia,Guinea-Bissau,7,0,0,7
12538,2019,Nigeria,Guinea-Bissau,0,6,0,6
12539,2019,Senegal,Guinea-Bissau,1818,8,0,1826
12540,2019,Sierra Leone,Guinea-Bissau,10,5,0,15
12541,2019,Türkiye,Guinea-Bissau,0,5,0,5
12542,2019,Afghanistan,Greece,17685,27608,0,45293
12543,2019,Albania,Greece,165,2092,0,2257
12544,2019,Algeria,Greece,98,478,0,576
12545,2019,Angola,Greece,6,46,0,52
12546,2019,Egypt,Greece,343,1502,0,1845
12547,2019,Armenia,Greece,11,86,0,97
12548,2019,Azerbaijan,Greece,5,5,0,10
12549,2019,Burundi,Greece,35,40,0,75
12550,2019,Benin,Greece,0,6,0,6
12551,2019,Bangladesh,Greece,295,2556,0,2851
12552,2019,Burkina Faso,Greece,17,86,0,103
12553,2019,Belarus,Greece,5,0,0,5
12554,2019,Brazil,Greece,0,14,0,14
12555,2019,Bosnia and Herzegovina,Greece,0,5,0,5
12556,2019,Central African Rep.,Greece,13,9,0,22
12557,2019,Chad,Greece,5,10,0,15
12558,2019,China,Greece,85,529,0,614
12559,2019,Chile,Greece,0,5,0,5
12560,2019,Cameroon,Greece,443,1102,0,1545
12561,2019,Congo,Greece,128,103,0,231
12562,2019,Dem. Rep. of the Congo,Greece,731,4041,0,4772
12563,2019,Comoros,Greece,6,11,0,17
12564,2019,Colombia,Greece,0,5,0,5
12565,2019,Cuba,Greece,0,24,0,24
12566,2019,Djibouti,Greece,5,12,0,17
12567,2019,Dominican Rep.,Greece,9,16,0,25
12568,2019,Equatorial Guinea,Greece,5,0,0,5
12569,2019,Eritrea,Greece,1065,268,0,1333
12570,2019,Ethiopia,Greece,416,97,0,513
12571,2019,Gabon,Greece,0,10,0,10
12572,2019,Gambia,Greece,33,143,0,176
12573,2019,Palestinian,Greece,2756,1530,0,4286
12574,2019,Georgia,Greece,267,1435,0,1702
12575,2019,Ghana,Greece,57,374,0,431
12576,2019,Guinea,Greece,101,223,0,324
12577,2019,Haiti,Greece,8,36,0,44
12578,2019,Cote d'Ivoire,Greece,79,50,0,129
12579,2019,India,Greece,29,439,0,468
12580,2019,Indonesia,Greece,15,41,0,56
12581,2019,Iran (Islamic Rep. of),Greece,1916,2768,0,4684
12582,2019,Iraq,Greece,9614,7283,0,16897
12583,2019,Jordan,Greece,24,27,0,51
12584,2019,Kazakhstan,Greece,5,9,0,14
12585,2019,Kenya,Greece,29,12,0,41
12586,2019,Kyrgyzstan,Greece,0,5,0,5
12587,2019,Kuwait,Greece,104,97,0,201
12588,2019,Libya,Greece,40,38,0,78
12589,2019,Lebanon,Greece,55,55,0,110
12590,2019,Sri Lanka,Greece,45,99,0,144
12591,2019,Mauritania,Greece,55,18,0,73
12592,2019,North Macedonia,Greece,0,5,0,5
12593,2019,Rep. of Moldova,Greece,13,42,0,55
12594,2019,Mexico,Greece,0,8,0,8
12595,2019,Mali,Greece,57,97,0,154
12596,2019,Morocco,Greece,175,265,0,440
12597,2019,Myanmar,Greece,74,24,0,98
12598,2019,Nepal,Greece,12,175,0,187
12599,2019,Niger,Greece,7,18,0,25
12600,2019,Nigeria,Greece,297,200,0,497
12601,2019,Pakistan,Greece,1019,6018,0,7037
12602,2019,Peru,Greece,0,5,0,5
12603,2019,Philippines,Greece,7,7,0,14
12604,2019,Russian Federation,Greece,18,64,0,82
12605,2019,Rwanda,Greece,10,5,0,15
12606,2019,El Salvador,Greece,12,0,0,12
12607,2019,Saudi Arabia,Greece,7,0,0,7
12608,2019,Serbia and Kosovo: S/RES/1244 (1999),Greece,22,19,0,41
12609,2019,Senegal,Greece,52,68,0,120
12610,2019,Sierra Leone,Greece,45,181,0,226
12611,2019,Somalia,Greece,1499,2289,0,3788
12612,2019,Viet Nam,Greece,5,10,0,15
12613,2019,Sudan,Greece,465,114,0,579
12614,2019,South Sudan,Greece,21,30,0,51
12615,2019,Syrian Arab Rep.,Greece,26696,16165,0,42861
12616,2019,United Rep. of Tanzania,Greece,13,9,0,22
12617,2019,Tajikistan,Greece,5,9,0,14
12618,2019,Turkmenistan,Greece,6,8,0,14
12619,2019,Togo,Greece,32,179,0,211
12620,2019,Tunisia,Greece,21,42,0,63
12621,2019,Türkiye,Greece,640,5185,0,5825
12622,2019,Uganda,Greece,29,64,0,93
12623,2019,Ukraine,Greece,151,97,0,248
12624,2019,United States of America,Greece,0,5,0,5
12625,2019,Uzbekistan,Greece,18,9,0,27
12626,2019,Venezuela (Bolivarian Republic of),Greece,6,34,0,40
12627,2019,Western Sahara,Greece,9,11,0,20
12628,2019,Yemen,Greece,574,213,0,787
12629,2019,Zimbabwe,Greece,8,5,0,13
12630,2019,Stateless,Greece,558,315,0,873
12631,2019,Unknown ,Greece,11063,18242,0,29305
12632,2019,Colombia,Guatemala,8,8,0,16
12633,2019,Cuba,Guatemala,0,39,0,39
12634,2019,Honduras,Guatemala,42,147,0,189
12635,2019,Mexico,Guatemala,0,5,0,5
12636,2019,Nicaragua,Guatemala,100,203,0,303
12637,2019,Russian Federation,Guatemala,5,0,0,5
12638,2019,El Salvador,Guatemala,230,175,0,405
12639,2019,United States of America,Guatemala,0,5,0,5
12640,2019,Venezuela (Bolivarian Republic of),Guatemala,23,49,0,72
12641,2019,Unknown ,Guatemala,0,0,0,0
12642,2019,Burundi,Guinea,5,0,0,5
12643,2019,Central African Rep.,Guinea,37,0,0,37
12644,2019,Cameroon,Guinea,5,0,0,5
12645,2019,Congo,Guinea,14,0,0,14
12646,2019,Dem. Rep. of the Congo,Guinea,39,7,0,46
12647,2019,Eritrea,Guinea,9,0,0,9
12648,2019,Gambia,Guinea,7,0,0,7
12649,2019,Cote d'Ivoire,Guinea,3935,6,0,3941
12650,2019,Liberia,Guinea,312,0,0,312
12651,2019,Sri Lanka,Guinea,8,0,0,8
12652,2019,Mali,Guinea,17,5,0,22
12653,2019,Nigeria,Guinea,7,0,0,7
12654,2019,Rwanda,Guinea,10,0,0,10
12655,2019,Sierra Leone,Guinea,530,1962,0,2492
12656,2019,Somalia,Guinea,6,0,0,6
12657,2019,Syrian Arab Rep.,Guinea,14,0,0,14
12658,2019,Togo,Guinea,9,0,0,9
12659,2019,Cuba,Guyana,9,57,0,66
12660,2019,Pakistan,Guyana,5,0,0,5
12661,2019,Venezuela (Bolivarian Republic of),Guyana,0,0,0,0
12662,2019,Nigeria,Haiti,0,5,0,5
12663,2019,Afghanistan,"China, Hong Kong SAR",5,0,0,5
12664,2019,Egypt,"China, Hong Kong SAR",5,0,0,5
12665,2019,Burundi,"China, Hong Kong SAR",12,0,0,12
12666,2019,Bangladesh,"China, Hong Kong SAR",5,0,0,5
12667,2019,Central African Rep.,"China, Hong Kong SAR",5,0,0,5
12668,2019,Congo,"China, Hong Kong SAR",5,0,0,5
12669,2019,Indonesia,"China, Hong Kong SAR",5,0,0,5
12670,2019,Sri Lanka,"China, Hong Kong SAR",17,0,0,17
12671,2019,Pakistan,"China, Hong Kong SAR",6,0,0,6
12672,2019,Philippines,"China, Hong Kong SAR",5,0,0,5
12673,2019,Rwanda,"China, Hong Kong SAR",20,0,0,20
12674,2019,Somalia,"China, Hong Kong SAR",22,0,0,22
12675,2019,Sudan,"China, Hong Kong SAR",5,0,0,5
12676,2019,Yemen,"China, Hong Kong SAR",11,0,0,11
12677,2019,Cuba,Honduras,0,5,0,5
12678,2019,Honduras,Honduras,0,0,247090,0
12679,2019,Nicaragua,Honduras,46,99,0,145
12680,2019,El Salvador,Honduras,22,5,0,27
12681,2019,Venezuela (Bolivarian Republic of),Honduras,7,0,0,7
12682,2019,Afghanistan,Croatia,53,108,0,161
12683,2019,Algeria,Croatia,0,23,0,23
12684,2019,Egypt,Croatia,7,0,0,7
12685,2019,Azerbaijan,Croatia,5,0,0,5
12686,2019,Bangladesh,Croatia,6,5,0,11
12687,2019,Belarus,Croatia,5,0,0,5
12688,2019,Bosnia and Herzegovina,Croatia,8,0,0,8
12689,2019,Congo,Croatia,5,0,0,5
12690,2019,Dem. Rep. of the Congo,Croatia,5,0,0,5
12691,2019,Eritrea,Croatia,23,0,0,23
12692,2019,Palestinian,Croatia,6,7,0,13
12693,2019,Georgia,Croatia,5,0,0,5
12694,2019,Croatia,Croatia,0,0,0,0
12695,2019,India,Croatia,0,14,0,14
12696,2019,Iran (Islamic Rep. of),Croatia,29,71,0,100
12697,2019,Iraq,Croatia,106,130,0,236
12698,2019,Kazakhstan,Croatia,5,7,0,12
12699,2019,Libya,Croatia,5,0,0,5
12700,2019,Mauritania,Croatia,5,0,0,5
12701,2019,Morocco,Croatia,0,12,0,12
12702,2019,Nepal,Croatia,0,5,0,5
12703,2019,Nigeria,Croatia,12,0,0,12
12704,2019,Pakistan,Croatia,7,12,0,19
12705,2019,Russian Federation,Croatia,15,0,0,15
12706,2019,Sierra Leone,Croatia,0,5,0,5
12707,2019,Somalia,Croatia,28,0,0,28
12708,2019,Viet Nam,Croatia,0,5,0,5
12709,2019,Sudan,Croatia,5,0,0,5
12710,2019,Syrian Arab Rep.,Croatia,527,10,0,537
12711,2019,Tunisia,Croatia,0,9,0,9
12712,2019,Türkiye,Croatia,19,26,0,45
12713,2019,Ukraine,Croatia,8,0,0,8
12714,2019,Uzbekistan,Croatia,5,0,0,5
12715,2019,Yemen,Croatia,7,0,0,7
12716,2019,Stateless,Croatia,5,5,0,10
12717,2019,Afghanistan,Hungary,1487,92,0,1579
12718,2019,Algeria,Hungary,15,0,0,15
12719,2019,Angola,Hungary,5,0,0,5
12720,2019,Egypt,Hungary,11,0,0,11
12721,2019,Armenia,Hungary,43,0,0,43
12722,2019,Azerbaijan,Hungary,13,0,0,13
12723,2019,Burundi,Hungary,0,5,0,5
12724,2019,Bangladesh,Hungary,8,0,0,8
12725,2019,China,Hungary,5,0,0,5
12726,2019,Cameroon,Hungary,40,0,0,40
12727,2019,Congo,Hungary,13,0,0,13
12728,2019,Dem. Rep. of the Congo,Hungary,24,0,0,24
12729,2019,Cuba,Hungary,79,0,0,79
12730,2019,Eritrea,Hungary,45,0,0,45
12731,2019,Ethiopia,Hungary,39,0,0,39
12732,2019,Palestinian,Hungary,90,6,0,96
12733,2019,Georgia,Hungary,61,0,0,61
12734,2019,Ghana,Hungary,5,0,0,5
12735,2019,Guinea,Hungary,5,0,0,5
12736,2019,Cote d'Ivoire,Hungary,15,0,0,15
12737,2019,Iran (Islamic Rep. of),Hungary,178,7,0,185
12738,2019,Iraq,Hungary,621,68,0,689
12739,2019,Libya,Hungary,7,0,0,7
12740,2019,Lebanon,Hungary,5,0,0,5
12741,2019,Sri Lanka,Hungary,12,0,0,12
12742,2019,Rep. of Moldova,Hungary,5,0,0,5
12743,2019,Myanmar,Hungary,5,0,0,5
12744,2019,Nepal,Hungary,11,0,0,11
12745,2019,Nigeria,Hungary,56,0,0,56
12746,2019,Pakistan,Hungary,58,27,0,85
12747,2019,Russian Federation,Hungary,36,0,0,36
12748,2019,Serbia and Kosovo: S/RES/1244 (1999),Hungary,52,0,0,52
12749,2019,Sierra Leone,Hungary,5,0,0,5
12750,2019,Somalia,Hungary,615,0,0,615
12751,2019,Sudan,Hungary,67,0,0,67
12752,2019,Syrian Arab Rep.,Hungary,934,7,0,941
12753,2019,Tunisia,Hungary,8,5,0,13
12754,2019,Türkiye,Hungary,33,5,0,38
12755,2019,Uganda,Hungary,7,0,0,7
12756,2019,Ukraine,Hungary,15,0,0,15
12757,2019,Uzbekistan,Hungary,6,0,0,6
12758,2019,Yemen,Hungary,18,0,0,18
12759,2019,Zimbabwe,Hungary,5,0,0,5
12760,2019,Stateless,Hungary,71,0,0,71
12761,2019,Unknown ,Hungary,917,0,0,917
12762,2019,Afghanistan,Iceland,86,19,0,105
12763,2019,Albania,Iceland,5,16,0,21
12764,2019,Egypt,Iceland,6,0,0,6
12765,2019,Belarus,Iceland,0,5,0,5
12766,2019,Chile,Iceland,0,5,0,5
12767,2019,Cameroon,Iceland,5,0,0,5
12768,2019,Colombia,Iceland,0,5,0,5
12769,2019,Eritrea,Iceland,9,0,0,9
12770,2019,Palestinian,Iceland,37,11,0,48
12771,2019,Georgia,Iceland,5,0,0,5
12772,2019,Ghana,Iceland,0,10,0,10
12773,2019,Honduras,Iceland,0,5,0,5
12774,2019,Iran (Islamic Rep. of),Iceland,65,17,0,82
12775,2019,Iraq,Iceland,196,86,0,282
12776,2019,Kazakhstan,Iceland,5,0,0,5
12777,2019,Kenya,Iceland,5,0,0,5
12778,2019,Libya,Iceland,8,0,0,8
12779,2019,North Macedonia,Iceland,5,0,0,5
12780,2019,Rep. of Moldova,Iceland,0,6,0,6
12781,2019,Morocco,Iceland,5,13,0,18
12782,2019,Nigeria,Iceland,10,45,0,55
12783,2019,Pakistan,Iceland,18,12,0,30
12784,2019,Peru,Iceland,5,0,0,5
12785,2019,Russian Federation,Iceland,11,5,0,16
12786,2019,El Salvador,Iceland,16,0,0,16
12787,2019,Senegal,Iceland,5,0,0,5
12788,2019,Somalia,Iceland,38,33,0,71
12789,2019,Sudan,Iceland,6,0,0,6
12790,2019,South Sudan,Iceland,5,0,0,5
12791,2019,Syrian Arab Rep.,Iceland,109,19,0,128
12792,2019,Tunisia,Iceland,0,5,0,5
12793,2019,Türkiye,Iceland,8,6,0,14
12794,2019,Uganda,Iceland,12,0,0,12
12795,2019,Ukraine,Iceland,18,5,0,23
12796,2019,Venezuela (Bolivarian Republic of),Iceland,164,32,0,196
12797,2019,Yemen,Iceland,5,5,0,10
12798,2019,Stateless,Iceland,10,0,0,10
12799,2019,Unknown ,Iceland,12,0,0,12
12800,2019,Burundi,Cote d'Ivoire,36,0,0,36
12801,2019,Benin,Cote d'Ivoire,0,5,0,5
12802,2019,Cambodia,Cote d'Ivoire,10,0,0,10
12803,2019,Central African Rep.,Cote d'Ivoire,525,27,0,552
12804,2019,Chad,Cote d'Ivoire,5,0,0,5
12805,2019,Cameroon,Cote d'Ivoire,0,15,0,15
12806,2019,Congo,Cote d'Ivoire,78,0,0,78
12807,2019,Dem. Rep. of the Congo,Cote d'Ivoire,134,17,0,151
12808,2019,Eritrea,Cote d'Ivoire,6,5,0,11
12809,2019,Ethiopia,Cote d'Ivoire,5,5,0,10
12810,2019,Guinea,Cote d'Ivoire,0,7,0,7
12811,2019,Cote d'Ivoire,Cote d'Ivoire,0,0,0,0
12812,2019,Iran (Islamic Rep. of),Cote d'Ivoire,6,0,0,6
12813,2019,Iraq,Cote d'Ivoire,5,0,0,5
12814,2019,Liberia,Cote d'Ivoire,932,21,0,953
12815,2019,Sri Lanka,Cote d'Ivoire,5,0,0,5
12816,2019,Mauritania,Cote d'Ivoire,0,5,0,5
12817,2019,Mali,Cote d'Ivoire,12,17,0,29
12818,2019,Nigeria,Cote d'Ivoire,5,0,0,5
12819,2019,Rwanda,Cote d'Ivoire,53,5,0,58
12820,2019,Somalia,Cote d'Ivoire,5,0,0,5
12821,2019,Viet Nam,Cote d'Ivoire,5,0,0,5
12822,2019,Sudan,Cote d'Ivoire,10,0,0,10
12823,2019,Syrian Arab Rep.,Cote d'Ivoire,132,11,0,143
12824,2019,Togo,Cote d'Ivoire,17,11,0,28
12825,2019,Türkiye,Cote d'Ivoire,34,0,0,34
12826,2019,Stateless,Cote d'Ivoire,0,0,0,0
12827,2019,Afghanistan,India,7470,8219,0,15689
12828,2019,Egypt,India,0,8,0,8
12829,2019,Benin,India,0,5,0,5
12830,2019,China,India,108008,0,0,108008
12831,2019,Cameroon,India,0,178,0,178
12832,2019,Congo,India,5,34,0,39
12833,2019,Dem. Rep. of the Congo,India,42,48,0,90
12834,2019,Eritrea,India,7,13,0,20
12835,2019,Ethiopia,India,18,24,0,42
12836,2019,Palestinian,India,72,7,0,79
12837,2019,Ghana,India,0,20,0,20
12838,2019,Guinea-Bissau,India,0,5,0,5
12839,2019,Cote d'Ivoire,India,5,86,0,91
12840,2019,Iran (Islamic Rep. of),India,49,56,0,105
12841,2019,Iraq,India,172,51,0,223
12842,2019,Kenya,India,0,6,0,6
12843,2019,Libya,India,8,0,0,8
12844,2019,Sri Lanka,India,59428,0,0,59428
12845,2019,Maldives,India,5,0,0,5
12846,2019,Myanmar,India,2574,676,0,3250
12847,2019,Nigeria,India,0,100,0,100
12848,2019,Russian Federation,India,0,14,0,14
12849,2019,Rwanda,India,5,5,0,10
12850,2019,Saudi Arabia,India,5,0,0,5
12851,2019,Senegal,India,0,7,0,7
12852,2019,Somalia,India,533,319,0,852
12853,2019,Sudan,India,69,116,0,185
12854,2019,South Sudan,India,0,95,0,95
12855,2019,Syrian Arab Rep.,India,70,29,0,99
12856,2019,United Rep. of Tanzania,India,0,5,0,5
12857,2019,Tajikistan,India,0,5,0,5
12858,2019,Turkmenistan,India,0,5,0,5
12859,2019,Türkiye,India,29,0,0,29
12860,2019,Uganda,India,0,5,0,5
12861,2019,Ukraine,India,0,9,0,9
12862,2019,Uzbekistan,India,0,7,0,7
12863,2019,Venezuela (Bolivarian Republic of),India,0,9,0,9
12864,2019,Yemen,India,5,830,0,835
12865,2019,Stateless,India,16524,1206,0,17730
12866,2019,Afghanistan,Indonesia,5866,1826,0,7692
12867,2019,Angola,Indonesia,6,0,0,6
12868,2019,Egypt,Indonesia,18,12,0,30
12869,2019,China,Indonesia,12,5,0,17
12870,2019,Cameroon,Indonesia,0,10,0,10
12871,2019,Dem. Rep. of the Congo,Indonesia,10,0,0,10
12872,2019,Eritrea,Indonesia,52,209,0,261
12873,2019,Ethiopia,Indonesia,132,38,0,170
12874,2019,Palestinian,Indonesia,321,86,0,407
12875,2019,Cote d'Ivoire,Indonesia,0,5,0,5
12876,2019,Iran (Islamic Rep. of),Indonesia,323,24,0,347
12877,2019,Iraq,Indonesia,553,225,0,778
12878,2019,Jordan,Indonesia,5,0,0,5
12879,2019,Kuwait,Indonesia,9,0,0,9
12880,2019,Libya,Indonesia,14,14,0,28
12881,2019,Sri Lanka,Indonesia,397,36,0,433
12882,2019,Mali,Indonesia,0,5,0,5
12883,2019,Myanmar,Indonesia,595,33,0,628
12884,2019,Pakistan,Indonesia,316,25,0,341
12885,2019,Russian Federation,Indonesia,5,0,0,5
12886,2019,Somalia,Indonesia,1120,302,0,1422
12887,2019,Viet Nam,Indonesia,20,0,0,20
12888,2019,Sudan,Indonesia,400,97,0,497
12889,2019,Syrian Arab Rep.,Indonesia,23,19,0,42
12890,2019,Türkiye,Indonesia,0,13,0,13
12891,2019,Uganda,Indonesia,5,5,0,10
12892,2019,Yemen,Indonesia,85,354,0,439
12893,2019,Stateless,Indonesia,0,0,0,0
12894,2019,Afghanistan,Ireland,366,127,0,493
12895,2019,Albania,Ireland,145,783,0,928
12896,2019,Algeria,Ireland,54,202,0,256
12897,2019,Angola,Ireland,50,32,0,82
12898,2019,Egypt,Ireland,30,68,0,98
12899,2019,Armenia,Ireland,14,5,0,19
12900,2019,Azerbaijan,Ireland,5,0,0,5
12901,2019,Bahrain,Ireland,5,5,0,10
12902,2019,Burundi,Ireland,21,7,0,28
12903,2019,Benin,Ireland,5,0,0,5
12904,2019,Bangladesh,Ireland,57,216,0,273
12905,2019,Bhutan,Ireland,10,0,0,10
12906,2019,Belarus,Ireland,22,0,0,22
12907,2019,Bolivia (Plurinational State of),Ireland,12,41,0,53
12908,2019,Botswana,Ireland,10,35,0,45
12909,2019,Brazil,Ireland,5,178,0,183
12910,2019,Bosnia and Herzegovina,Ireland,5,0,0,5
12911,2019,Belize,Ireland,0,5,0,5
12912,2019,Chad,Ireland,5,0,0,5
12913,2019,China,Ireland,63,91,0,154
12914,2019,Chile,Ireland,0,5,0,5
12915,2019,Cameroon,Ireland,72,61,0,133
12916,2019,Congo,Ireland,14,5,0,19
12917,2019,Dem. Rep. of the Congo,Ireland,376,222,0,598
12918,2019,Cuba,Ireland,5,0,0,5
12919,2019,Dominican Rep.,Ireland,0,5,0,5
12920,2019,Eritrea,Ireland,69,13,0,82
12921,2019,Ethiopia,Ireland,34,16,0,50
12922,2019,Gambia,Ireland,0,5,0,5
12923,2019,Palestinian,Ireland,117,52,0,169
12924,2019,United Kingdom of Great Britain and Northern Ireland,Ireland,0,5,0,5
12925,2019,Georgia,Ireland,92,828,0,920
12926,2019,Ghana,Ireland,24,74,0,98
12927,2019,Guatemala,Ireland,0,11,0,11
12928,2019,Guinea,Ireland,16,0,0,16
12929,2019,Guyana,Ireland,0,5,0,5
12930,2019,Cote d'Ivoire,Ireland,14,14,0,28
12931,2019,India,Ireland,10,116,0,126
12932,2019,Iran (Islamic Rep. of),Ireland,141,46,0,187
12933,2019,Iraq,Ireland,398,81,0,479
12934,2019,Israel,Ireland,5,0,0,5
12935,2019,Jordan,Ireland,6,10,0,16
12936,2019,Kazakhstan,Ireland,19,0,0,19
12937,2019,Kenya,Ireland,51,29,0,80
12938,2019,Kyrgyzstan,Ireland,5,5,0,10
12939,2019,Dem. People's Rep. of Korea,Ireland,7,6,0,13
12940,2019,Kuwait,Ireland,50,24,0,74
12941,2019,Liberia,Ireland,13,0,0,13
12942,2019,Libya,Ireland,220,16,0,236
12943,2019,Lebanon,Ireland,5,10,0,15
12944,2019,Lesotho,Ireland,0,5,0,5
12945,2019,Sri Lanka,Ireland,21,12,0,33
12946,2019,Rep. of Moldova,Ireland,54,8,0,62
12947,2019,Mexico,Ireland,5,7,0,12
12948,2019,Mali,Ireland,8,0,0,8
12949,2019,Malaysia,Ireland,5,31,0,36
12950,2019,Malawi,Ireland,95,180,0,275
12951,2019,Mongolia,Ireland,5,14,0,19
12952,2019,Morocco,Ireland,10,46,0,56
12953,2019,Mozambique,Ireland,5,5,0,10
12954,2019,Montenegro,Ireland,5,0,0,5
12955,2019,Mauritius,Ireland,13,32,0,45
12956,2019,Myanmar,Ireland,13,5,0,18
12957,2019,Nepal,Ireland,6,26,0,32
12958,2019,Niger,Ireland,5,0,0,5
12959,2019,Nicaragua,Ireland,0,7,0,7
12960,2019,Nigeria,Ireland,293,703,0,996
12961,2019,Pakistan,Ireland,297,786,0,1083
12962,2019,South Africa,Ireland,77,519,0,596
12963,2019,Russian Federation,Ireland,74,31,0,105
12964,2019,Rwanda,Ireland,36,0,0,36
12965,2019,El Salvador,Ireland,5,18,0,23
12966,2019,Saudi Arabia,Ireland,13,8,0,21
12967,2019,Serbia and Kosovo: S/RES/1244 (1999),Ireland,60,32,0,92
12968,2019,Senegal,Ireland,0,5,0,5
12969,2019,Sierra Leone,Ireland,34,52,0,86
12970,2019,Somalia,Ireland,231,136,0,367
12971,2019,Viet Nam,Ireland,5,36,0,41
12972,2019,Sudan,Ireland,202,34,0,236
12973,2019,Eswatini,Ireland,15,26,0,41
12974,2019,Syrian Arab Rep.,Ireland,2882,54,0,2936
12975,2019,United Rep. of Tanzania,Ireland,0,9,0,9
12976,2019,Togo,Ireland,19,9,0,28
12977,2019,Trinidad and Tobago,Ireland,0,5,0,5
12978,2019,Tunisia,Ireland,5,10,0,15
12979,2019,Türkiye,Ireland,8,12,0,20
12980,2019,Uganda,Ireland,37,38,0,75
12981,2019,Ukraine,Ireland,81,33,0,114
12982,2019,United States of America,Ireland,0,17,0,17
12983,2019,Uzbekistan,Ireland,17,0,0,17
12984,2019,Venezuela (Bolivarian Republic of),Ireland,46,104,0,150
12985,2019,Yemen,Ireland,16,7,0,23
12986,2019,Zambia,Ireland,0,8,0,8
12987,2019,Zimbabwe,Ireland,438,790,0,1228
12988,2019,Stateless,Ireland,7,0,0,7
12989,2019,Unknown ,Ireland,0,534,0,534
12990,2019,Afghanistan,Iran (Islamic Rep. of),951142,0,0,951142
12991,2019,Iraq,Iran (Islamic Rep. of),28268,0,0,28268
12992,2019,Kuwait,Iran (Islamic Rep. of),8,0,0,8
12993,2019,Myanmar,Iran (Islamic Rep. of),0,33,0,33
12994,2019,Pakistan,Iran (Islamic Rep. of),10,0,0,10
12995,2019,Uzbekistan,Iran (Islamic Rep. of),7,0,0,7
12996,2019,Afghanistan,Iraq,11,56,0,67
12997,2019,Egypt,Iraq,0,22,0,22
12998,2019,Bahrain,Iraq,0,23,0,23
12999,2019,Eritrea,Iraq,5,30,0,35
13000,2019,Palestinian,Iraq,7858,107,0,7965
13001,2019,Indonesia,Iraq,0,5,0,5
13002,2019,Iran (Islamic Rep. of),Iraq,5041,6051,0,11092
13003,2019,Iraq,Iraq,0,0,1414632,0
13004,2019,Kazakhstan,Iraq,0,5,0,5
13005,2019,Kyrgyzstan,Iraq,0,15,0,15
13006,2019,Kuwait,Iraq,0,209,0,209
13007,2019,Lebanon,Iraq,0,5,0,5
13008,2019,Pakistan,Iraq,0,25,0,25
13009,2019,Saudi Arabia,Iraq,0,5,0,5
13010,2019,Somalia,Iraq,6,5,0,11
13011,2019,Sudan,Iraq,88,692,0,780
13012,2019,South Sudan,Iraq,0,15,0,15
13013,2019,Syrian Arab Rep.,Iraq,245810,0,0,245810
13014,2019,Tunisia,Iraq,0,6,0,6
13015,2019,Türkiye,Iraq,15167,5510,0,20677
13016,2019,Uzbekistan,Iraq,0,5,0,5
13017,2019,Yemen,Iraq,0,147,0,147
13018,2019,Stateless,Iraq,0,0,0,0
13019,2019,Egypt,Israel,0,12,0,12
13020,2019,Argentina,Israel,0,5,0,5
13021,2019,Armenia,Israel,0,58,0,58
13022,2019,Azerbaijan,Israel,0,69,0,69
13023,2019,Benin,Israel,0,5,0,5
13024,2019,Burkina Faso,Israel,0,10,0,10
13025,2019,Belarus,Israel,0,952,0,952
13026,2019,Botswana,Israel,0,7,0,7
13027,2019,Brazil,Israel,0,7,0,7
13028,2019,Central African Rep.,Israel,0,17,0,17
13029,2019,Chad,Israel,5,5,0,10
13030,2019,China,Israel,0,235,0,235
13031,2019,Cameroon,Israel,0,49,0,49
13032,2019,Congo,Israel,0,30,0,30
13033,2019,Dem. Rep. of the Congo,Israel,210,209,0,419
13034,2019,Colombia,Israel,0,284,0,284
13035,2019,Ecuador,Israel,0,24,0,24
13036,2019,Eritrea,Israel,12181,11395,0,23576
13037,2019,Ethiopia,Israel,97,818,0,915
13038,2019,Georgia,Israel,5,1730,0,1735
13039,2019,Ghana,Israel,0,533,0,533
13040,2019,Guinea,Israel,0,7,0,7
13041,2019,Cote d'Ivoire,Israel,5,10,0,15
13042,2019,India,Israel,0,1270,0,1270
13043,2019,Iran (Islamic Rep. of),Israel,6,5,0,11
13044,2019,Iraq,Israel,10,0,0,10
13045,2019,Kazakhstan,Israel,0,214,0,214
13046,2019,Kenya,Israel,0,107,0,107
13047,2019,Kyrgyzstan,Israel,0,90,0,90
13048,2019,Dem. People's Rep. of Korea,Israel,5,0,0,5
13049,2019,Lesotho,Israel,0,7,0,7
13050,2019,Sri Lanka,Israel,0,1115,0,1115
13051,2019,Latvia,Israel,0,5,0,5
13052,2019,Rep. of Moldova,Israel,0,656,0,656
13053,2019,Mali,Israel,0,5,0,5
13054,2019,Malawi,Israel,0,67,0,67
13055,2019,Mongolia,Israel,0,7,0,7
13056,2019,Myanmar,Israel,0,23,0,23
13057,2019,Nepal,Israel,0,28,0,28
13058,2019,Nigeria,Israel,6,996,0,1002
13059,2019,Philippines,Israel,0,7,0,7
13060,2019,Romania,Israel,0,50,0,50
13061,2019,South Africa,Israel,0,502,0,502
13062,2019,Russian Federation,Israel,0,5932,0,5932
13063,2019,Rwanda,Israel,0,7,0,7
13064,2019,Sierra Leone,Israel,5,10,0,15
13065,2019,Somalia,Israel,0,11,0,11
13066,2019,Viet Nam,Israel,0,5,0,5
13067,2019,Sudan,Israel,3248,4461,0,7709
13068,2019,South Sudan,Israel,109,124,0,233
13069,2019,Thailand,Israel,0,6,0,6
13070,2019,Tajikistan,Israel,0,6,0,6
13071,2019,Turkmenistan,Israel,0,6,0,6
13072,2019,Togo,Israel,0,6,0,6
13073,2019,Türkiye,Israel,5,432,0,437
13074,2019,Uganda,Israel,0,148,0,148
13075,2019,Ukraine,Israel,5,5056,0,5061
13076,2019,Uzbekistan,Israel,0,546,0,546
13077,2019,Venezuela (Bolivarian Republic of),Israel,0,5,0,5
13078,2019,Zimbabwe,Israel,0,20,0,20
13079,2019,Stateless,Israel,0,0,0,0
13080,2019,Unknown ,Israel,205,73,0,278
13081,2019,Afghanistan,Italy,17849,840,0,18689
13082,2019,Albania,Italy,809,589,0,1398
13083,2019,Algeria,Italy,228,130,0,358
13084,2019,Angola,Italy,34,9,0,43
13085,2019,Egypt,Italy,2379,638,0,3017
13086,2019,Argentina,Italy,9,16,0,25
13087,2019,Armenia,Italy,376,78,0,454
13088,2019,Azerbaijan,Italy,97,35,0,132
13089,2019,Bahrain,Italy,5,0,0,5
13090,2019,Burundi,Italy,29,5,0,34
13091,2019,Belgium,Italy,0,5,0,5
13092,2019,Benin,Italy,297,36,0,333
13093,2019,Bangladesh,Italy,8974,1934,0,10908
13094,2019,Bahamas,Italy,5,0,0,5
13095,2019,Burkina Faso,Italy,1212,126,0,1338
13096,2019,Belarus,Italy,40,22,0,62
13097,2019,Bolivia (Plurinational State of),Italy,16,6,0,22
13098,2019,Brazil,Italy,220,154,0,374
13099,2019,Bosnia and Herzegovina,Italy,667,35,0,702
13100,2019,Cambodia,Italy,5,0,0,5
13101,2019,Central African Rep.,Italy,110,22,0,132
13102,2019,Chad,Italy,473,34,0,507
13103,2019,China,Italy,241,499,0,740
13104,2019,Chile,Italy,10,7,0,17
13105,2019,Cameroon,Italy,2217,399,0,2616
13106,2019,Congo,Italy,421,0,0,421
13107,2019,Dem. Rep. of the Congo,Italy,645,41,0,686
13108,2019,Comoros,Italy,0,6,0,6
13109,2019,Colombia,Italy,690,466,0,1156
13110,2019,Costa Rica,Italy,6,0,0,6
13111,2019,Cuba,Italy,238,105,0,343
13112,2019,Cabo Verde,Italy,5,5,0,10
13113,2019,Dominican Rep.,Italy,29,20,0,49
13114,2019,Ecuador,Italy,35,25,0,60
13115,2019,Equatorial Guinea,Italy,15,5,0,20
13116,2019,Eritrea,Italy,7118,9257,0,16375
13117,2019,Ethiopia,Italy,1319,232,0,1551
13118,2019,Gabon,Italy,38,10,0,48
13119,2019,Gambia,Italy,12968,701,0,13669
13120,2019,Palestinian,Italy,1086,90,0,1176
13121,2019,Georgia,Italy,732,714,0,1446
13122,2019,Germany,Italy,0,11,0,11
13123,2019,Ghana,Italy,5953,589,0,6542
13124,2019,Guinea-Bissau,Italy,909,94,0,1003
13125,2019,Guatemala,Italy,17,17,0,34
13126,2019,Guinea,Italy,4868,884,0,5752
13127,2019,Haiti,Italy,9,0,0,9
13128,2019,Honduras,Italy,286,172,0,458
13129,2019,Croatia,Italy,18,0,0,18
13130,2019,Cote d'Ivoire,Italy,7659,1250,0,8909
13131,2019,India,Italy,396,746,0,1142
13132,2019,Indonesia,Italy,5,0,0,5
13133,2019,Iran (Islamic Rep. of),Italy,2094,186,0,2280
13134,2019,Iraq,Italy,6994,934,0,7928
13135,2019,Israel,Italy,9,0,0,9
13136,2019,Jamaica,Italy,5,0,0,5
13137,2019,Jordan,Italy,41,10,0,51
13138,2019,Kazakhstan,Italy,29,8,0,37
13139,2019,Kenya,Italy,124,23,0,147
13140,2019,Kyrgyzstan,Italy,101,45,0,146
13141,2019,Rep. of Korea,Italy,5,0,0,5
13142,2019,Kuwait,Italy,13,5,0,18
13143,2019,Liberia,Italy,389,35,0,424
13144,2019,Libya,Italy,1436,192,0,1628
13145,2019,Lebanon,Italy,372,97,0,469
13146,2019,Liechtenstein,Italy,0,14,0,14
13147,2019,Sri Lanka,Italy,588,346,0,934
13148,2019,Madagascar,Italy,23,5,0,28
13149,2019,Mauritania,Italy,355,8,0,363
13150,2019,North Macedonia,Italy,77,44,0,121
13151,2019,Rep. of Moldova,Italy,115,39,0,154
13152,2019,Mexico,Italy,13,8,0,21
13153,2019,Mali,Italy,15842,871,0,16713
13154,2019,Malaysia,Italy,5,0,0,5
13155,2019,Malawi,Italy,5,0,0,5
13156,2019,Mongolia,Italy,0,5,0,5
13157,2019,Morocco,Italy,1284,1102,0,2386
13158,2019,Mozambique,Italy,5,0,0,5
13159,2019,Montenegro,Italy,84,5,0,89
13160,2019,Mauritius,Italy,19,6,0,25
13161,2019,Myanmar,Italy,49,5,0,54
13162,2019,Namibia,Italy,5,0,0,5
13163,2019,Nepal,Italy,130,50,0,180
13164,2019,Niger,Italy,676,53,0,729
13165,2019,Nicaragua,Italy,47,25,0,72
13166,2019,Nigeria,Italy,25241,5380,0,30621
13167,2019,Pakistan,Italy,20063,7800,0,27863
13168,2019,Paraguay,Italy,7,22,0,29
13169,2019,Peru,Italy,246,1046,0,1292
13170,2019,Philippines,Italy,90,94,0,184
13171,2019,South Africa,Italy,13,0,0,13
13172,2019,Russian Federation,Italy,357,108,0,465
13173,2019,Rwanda,Italy,16,5,0,21
13174,2019,El Salvador,Italy,3291,1136,0,4427
13175,2019,Saudi Arabia,Italy,25,20,0,45
13176,2019,Serbia and Kosovo: S/RES/1244 (1999),Italy,1202,97,0,1299
13177,2019,Senegal,Italy,7991,1134,0,9125
13178,2019,Sierra Leone,Italy,795,120,0,915
13179,2019,Somalia,Italy,14029,444,0,14473
13180,2019,Viet Nam,Italy,9,5,0,14
13181,2019,Sudan,Italy,1718,513,0,2231
13182,2019,South Sudan,Italy,140,13,0,153
13183,2019,Eswatini,Italy,10,0,0,10
13184,2019,Switzerland,Italy,0,5,0,5
13185,2019,Syrian Arab Rep.,Italy,4781,917,0,5698
13186,2019,United Rep. of Tanzania,Italy,31,6,0,37
13187,2019,Tajikistan,Italy,11,0,0,11
13188,2019,Turkmenistan,Italy,5,0,0,5
13189,2019,Timor-Leste,Italy,5,0,0,5
13190,2019,Togo,Italy,982,75,0,1057
13191,2019,Tunisia,Italy,713,315,0,1028
13192,2019,Türkiye,Italy,2845,381,0,3226
13193,2019,United Arab Emirates,Italy,5,0,0,5
13194,2019,Uganda,Italy,80,10,0,90
13195,2019,Ukraine,Italy,6353,1189,0,7542
13196,2019,Uruguay,Italy,0,5,0,5
13197,2019,United States of America,Italy,5,0,0,5
13198,2019,Uzbekistan,Italy,21,0,0,21
13199,2019,Venezuela (Bolivarian Republic of),Italy,1988,580,0,2568
13200,2019,Western Sahara,Italy,5,0,0,5
13201,2019,Yemen,Italy,151,40,0,191
13202,2019,Zimbabwe,Italy,30,5,0,35
13203,2019,Stateless,Italy,17,0,0,17
13204,2019,Unknown ,Italy,1630,385,0,2015
13205,2019,Haiti,Jamaica,0,5,0,5
13206,2019,Venezuela (Bolivarian Republic of),Jamaica,0,0,0,0
13207,2019,Afghanistan,Jordan,8,11,0,19
13208,2019,Algeria,Jordan,0,7,0,7
13209,2019,Egypt,Jordan,100,587,0,687
13210,2019,Bangladesh,Jordan,0,6,0,6
13211,2019,Burkina Faso,Jordan,0,5,0,5
13212,2019,Bosnia and Herzegovina,Jordan,9,0,0,9
13213,2019,Bulgaria,Jordan,0,0,0,0
13214,2019,Central African Rep.,Jordan,5,0,0,5
13215,2019,Chad,Jordan,8,12,0,20
13216,2019,Comoros,Jordan,0,5,0,5
13217,2019,Eritrea,Jordan,30,11,0,41
13218,2019,Ethiopia,Jordan,12,29,0,41
13219,2019,Palestinian,Jordan,0,0,0,0
13220,2019,Ghana,Jordan,0,6,0,6
13221,2019,India,Jordan,0,6,0,6
13222,2019,Iran (Islamic Rep. of),Jordan,5,0,0,5
13223,2019,Iraq,Jordan,34336,32843,0,67179
13224,2019,Jordan,Jordan,0,0,0,0
13225,2019,Kenya,Jordan,0,9,0,9
13226,2019,Kuwait,Jordan,0,0,0,0
13227,2019,Libya,Jordan,30,165,0,195
13228,2019,Lebanon,Jordan,6,103,0,109
13229,2019,Sri Lanka,Jordan,8,9,0,17
13230,2019,Morocco,Jordan,0,10,0,10
13231,2019,Niger,Jordan,0,11,0,11
13232,2019,Nigeria,Jordan,0,95,0,95
13233,2019,Pakistan,Jordan,5,25,0,30
13234,2019,Philippines,Jordan,0,5,0,5
13235,2019,Russian Federation,Jordan,24,11,0,35
13236,2019,Saudi Arabia,Jordan,0,15,0,15
13237,2019,Serbia and Kosovo: S/RES/1244 (1999),Jordan,0,5,0,5
13238,2019,Senegal,Jordan,0,5,0,5
13239,2019,Somalia,Jordan,660,84,0,744
13240,2019,Sudan,Jordan,2996,3014,0,6010
13241,2019,South Sudan,Jordan,11,8,0,19
13242,2019,Syrian Arab Rep.,Jordan,654692,0,0,654692
13243,2019,Tajikistan,Jordan,0,14,0,14
13244,2019,Tunisia,Jordan,8,13,0,21
13245,2019,United Arab Emirates,Jordan,0,5,0,5
13246,2019,Ukraine,Jordan,0,19,0,19
13247,2019,United States of America,Jordan,0,0,0,0
13248,2019,Venezuela (Bolivarian Republic of),Jordan,0,5,0,5
13249,2019,Yemen,Jordan,715,14059,0,14774
13250,2019,Stateless,Jordan,0,66,0,66
13251,2019,Afghanistan,Japan,68,0,0,68
13252,2019,Burundi,Japan,9,0,0,9
13253,2019,Bangladesh,Japan,24,0,0,24
13254,2019,China,Japan,56,0,0,56
13255,2019,Cameroon,Japan,17,0,0,17
13256,2019,Dem. Rep. of the Congo,Japan,20,0,0,20
13257,2019,Ethiopia,Japan,31,0,0,31
13258,2019,Iran (Islamic Rep. of),Japan,17,0,0,17
13259,2019,Iraq,Japan,13,0,0,13
13260,2019,Sri Lanka,Japan,58,0,0,58
13261,2019,Myanmar,Japan,668,0,0,668
13262,2019,Nigeria,Japan,5,0,0,5
13263,2019,Pakistan,Japan,35,0,0,35
13264,2019,Somalia,Japan,5,0,0,5
13265,2019,Sudan,Japan,15,0,0,15
13266,2019,Syrian Arab Rep.,Japan,69,0,0,69
13267,2019,Türkiye,Japan,51,0,0,51
13268,2019,Stateless,Japan,10,0,0,10
13269,2019,Unknown ,Japan,292,29123,0,29415
13270,2019,Afghanistan,Kazakhstan,491,181,0,672
13271,2019,China,Kazakhstan,0,12,0,12
13272,2019,Syrian Arab Rep.,Kazakhstan,14,19,0,33
13273,2019,Uzbekistan,Kazakhstan,13,0,0,13
13274,2019,Stateless,Kazakhstan,0,0,0,0
13275,2019,Afghanistan,Kenya,10,9,0,19
13276,2019,Egypt,Kenya,0,21,0,21
13277,2019,Burundi,Kenya,5775,9323,0,15098
13278,2019,Central African Rep.,Kenya,0,10,0,10
13279,2019,Cameroon,Kenya,0,52,0,52
13280,2019,Congo,Kenya,79,88,0,167
13281,2019,Dem. Rep. of the Congo,Kenya,28085,15492,0,43577
13282,2019,Eritrea,Kenya,869,963,0,1832
13283,2019,Ethiopia,Kenya,19552,8864,0,28416
13284,2019,Cote d'Ivoire,Kenya,5,5,0,10
13285,2019,India,Kenya,0,5,0,5
13286,2019,Iraq,Kenya,5,0,0,5
13287,2019,Sri Lanka,Kenya,9,0,0,9
13288,2019,Mozambique,Kenya,8,0,0,8
13289,2019,Nigeria,Kenya,5,16,0,21
13290,2019,Pakistan,Kenya,9,7,0,16
13291,2019,Rwanda,Kenya,732,1056,0,1788
13292,2019,Somalia,Kenya,257766,6499,0,264265
13293,2019,Sudan,Kenya,3568,6358,0,9926
13294,2019,South Sudan,Kenya,121410,143,0,121553
13295,2019,Syrian Arab Rep.,Kenya,5,5,0,10
13296,2019,United Rep. of Tanzania,Kenya,11,40,0,51
13297,2019,Türkiye,Kenya,41,40,0,81
13298,2019,Uganda,Kenya,890,1609,0,2499
13299,2019,Yemen,Kenya,60,217,0,277
13300,2019,Zimbabwe,Kenya,5,7,0,12
13301,2019,Stateless,Kenya,0,0,0,0
13302,2019,Afghanistan,Kyrgyzstan,227,104,0,331
13303,2019,Palestinian,Kyrgyzstan,0,5,0,5
13304,2019,Iraq,Kyrgyzstan,6,5,0,11
13305,2019,Syrian Arab Rep.,Kyrgyzstan,86,5,0,91
13306,2019,Tajikistan,Kyrgyzstan,5,0,0,5
13307,2019,Türkiye,Kyrgyzstan,0,36,0,36
13308,2019,Ukraine,Kyrgyzstan,23,0,0,23
13309,2019,Uzbekistan,Kyrgyzstan,0,9,0,9
13310,2019,Stateless,Kyrgyzstan,0,0,0,0
13311,2019,Afghanistan,Rep. of Korea,41,49,0,90
13312,2019,Algeria,Rep. of Korea,6,239,0,245
13313,2019,Angola,Rep. of Korea,5,50,0,55
13314,2019,Egypt,Rep. of Korea,34,787,0,821
13315,2019,Argentina,Rep. of Korea,0,11,0,11
13316,2019,Azerbaijan,Rep. of Korea,0,7,0,7
13317,2019,Burundi,Rep. of Korea,39,16,0,55
13318,2019,Benin,Rep. of Korea,0,5,0,5
13319,2019,Bangladesh,Rep. of Korea,114,1087,0,1201
13320,2019,Burkina Faso,Rep. of Korea,0,11,0,11
13321,2019,Bolivia (Plurinational State of),Rep. of Korea,0,5,0,5
13322,2019,Brazil,Rep. of Korea,0,8,0,8
13323,2019,Cambodia,Rep. of Korea,0,80,0,80
13324,2019,China,Rep. of Korea,44,2606,0,2650
13325,2019,Cameroon,Rep. of Korea,20,269,0,289
13326,2019,Congo,Rep. of Korea,0,11,0,11
13327,2019,Dem. Rep. of the Congo,Rep. of Korea,61,38,0,99
13328,2019,Colombia,Rep. of Korea,0,10,0,10
13329,2019,Eritrea,Rep. of Korea,9,0,0,9
13330,2019,Ethiopia,Rep. of Korea,154,146,0,300
13331,2019,Gambia,Rep. of Korea,0,76,0,76
13332,2019,Palestinian,Rep. of Korea,7,5,0,12
13333,2019,Ghana,Rep. of Korea,7,301,0,308
13334,2019,Guinea-Bissau,Rep. of Korea,0,11,0,11
13335,2019,Guinea,Rep. of Korea,0,158,0,158
13336,2019,Haiti,Rep. of Korea,0,20,0,20
13337,2019,Cote d'Ivoire,Rep. of Korea,34,30,0,64
13338,2019,India,Rep. of Korea,0,2065,0,2065
13339,2019,Indonesia,Rep. of Korea,0,55,0,55
13340,2019,Iran (Islamic Rep. of),Rep. of Korea,61,75,0,136
13341,2019,Iraq,Rep. of Korea,27,38,0,65
13342,2019,Jordan,Rep. of Korea,7,14,0,21
13343,2019,Kazakhstan,Rep. of Korea,5,3417,0,3422
13344,2019,Kenya,Rep. of Korea,5,44,0,49
13345,2019,Kyrgyzstan,Rep. of Korea,0,166,0,166
13346,2019,Lao People's Dem. Rep.,Rep. of Korea,0,6,0,6
13347,2019,Liberia,Rep. of Korea,12,334,0,346
13348,2019,Libya,Rep. of Korea,7,21,0,28
13349,2019,Sri Lanka,Rep. of Korea,8,393,0,401
13350,2019,Mali,Rep. of Korea,7,91,0,98
13351,2019,Malaysia,Rep. of Korea,0,2287,0,2287
13352,2019,Mongolia,Rep. of Korea,0,506,0,506
13353,2019,Morocco,Rep. of Korea,5,514,0,519
13354,2019,Mozambique,Rep. of Korea,0,11,0,11
13355,2019,Myanmar,Rep. of Korea,363,72,0,435
13356,2019,Nepal,Rep. of Korea,5,431,0,436
13357,2019,Nigeria,Rep. of Korea,10,542,0,552
13358,2019,Pakistan,Rep. of Korea,105,1769,0,1874
13359,2019,Peru,Rep. of Korea,0,9,0,9
13360,2019,Philippines,Rep. of Korea,0,562,0,562
13361,2019,South Africa,Rep. of Korea,0,134,0,134
13362,2019,Russian Federation,Rep. of Korea,13,3628,0,3641
13363,2019,Rwanda,Rep. of Korea,0,26,0,26
13364,2019,Saudi Arabia,Rep. of Korea,0,10,0,10
13365,2019,Senegal,Rep. of Korea,0,112,0,112
13366,2019,Sierra Leone,Rep. of Korea,0,18,0,18
13367,2019,Somalia,Rep. of Korea,6,0,0,6
13368,2019,Viet Nam,Rep. of Korea,0,396,0,396
13369,2019,Sudan,Rep. of Korea,21,47,0,68
13370,2019,South Sudan,Rep. of Korea,0,5,0,5
13371,2019,Eswatini,Rep. of Korea,0,5,0,5
13372,2019,Syrian Arab Rep.,Rep. of Korea,1199,60,0,1259
13373,2019,United Rep. of Tanzania,Rep. of Korea,5,55,0,60
13374,2019,Thailand,Rep. of Korea,9,435,0,444
13375,2019,Tajikistan,Rep. of Korea,0,17,0,17
13376,2019,Togo,Rep. of Korea,0,18,0,18
13377,2019,Tunisia,Rep. of Korea,0,116,0,116
13378,2019,Türkiye,Rep. of Korea,0,405,0,405
13379,2019,Uganda,Rep. of Korea,36,78,0,114
13380,2019,Ukraine,Rep. of Korea,14,64,0,78
13381,2019,United States of America,Rep. of Korea,0,5,0,5
13382,2019,Uzbekistan,Rep. of Korea,9,319,0,328
13383,2019,Venezuela (Bolivarian Republic of),Rep. of Korea,0,14,0,14
13384,2019,Yemen,Rep. of Korea,682,124,0,806
13385,2019,Zimbabwe,Rep. of Korea,0,8,0,8
13386,2019,Stateless,Rep. of Korea,0,5,0,5
13387,2019,Afghanistan,Kuwait,0,17,0,17
13388,2019,Egypt,Kuwait,5,19,0,24
13389,2019,Djibouti,Kuwait,0,5,0,5
13390,2019,Eritrea,Kuwait,0,29,0,29
13391,2019,Ethiopia,Kuwait,0,11,0,11
13392,2019,Palestinian,Kuwait,0,5,0,5
13393,2019,Iran (Islamic Rep. of),Kuwait,9,83,0,92
13394,2019,Iraq,Kuwait,343,295,0,638
13395,2019,Jordan,Kuwait,0,6,0,6
13396,2019,Lebanon,Kuwait,0,5,0,5
13397,2019,Sri Lanka,Kuwait,0,6,0,6
13398,2019,Pakistan,Kuwait,0,12,0,12
13399,2019,Philippines,Kuwait,0,5,0,5
13400,2019,Somalia,Kuwait,218,442,0,660
13401,2019,Sudan,Kuwait,0,20,0,20
13402,2019,South Sudan,Kuwait,0,5,0,5
13403,2019,Syrian Arab Rep.,Kuwait,106,100,0,206
13404,2019,Ukraine,Kuwait,0,5,0,5
13405,2019,Yemen,Kuwait,5,9,0,14
13406,2019,Stateless,Kuwait,0,0,0,0
13407,2019,Cameroon,Liberia,5,0,0,5
13408,2019,Dem. Rep. of the Congo,Liberia,20,6,0,26
13409,2019,Cote d'Ivoire,Liberia,8152,0,0,8152
13410,2019,Mali,Liberia,19,0,0,19
13411,2019,Nigeria,Liberia,0,5,0,5
13412,2019,Somalia,Liberia,5,0,0,5
13413,2019,Sudan,Liberia,8,0,0,8
13414,2019,Syrian Arab Rep.,Liberia,11,0,0,11
13415,2019,Togo,Liberia,5,0,0,5
13416,2019,Afghanistan,Libya,0,11,0,11
13417,2019,Chad,Libya,6,24,0,30
13418,2019,Congo,Libya,0,5,0,5
13419,2019,Dem. Rep. of the Congo,Libya,0,5,0,5
13420,2019,Eritrea,Libya,375,5126,0,5501
13421,2019,Ethiopia,Libya,14,1040,0,1054
13422,2019,Palestinian,Libya,2015,2853,0,4868
13423,2019,Cote d'Ivoire,Libya,0,5,0,5
13424,2019,Iraq,Libya,810,346,0,1156
13425,2019,Libya,Libya,0,0,355672,0
13426,2019,Rwanda,Libya,5,0,0,5
13427,2019,Somalia,Libya,91,2331,0,2422
13428,2019,Sudan,Libya,797,11963,0,12760
13429,2019,South Sudan,Libya,5,224,0,229
13430,2019,Syrian Arab Rep.,Libya,612,16738,0,17350
13431,2019,Yemen,Libya,0,47,0,47
13432,2019,Afghanistan,Lebanon,18,6,0,24
13433,2019,Algeria,Lebanon,0,6,0,6
13434,2019,Egypt,Lebanon,88,293,0,381
13435,2019,Armenia,Lebanon,0,6,0,6
13436,2019,Bahrain,Lebanon,19,7,0,26
13437,2019,Bangladesh,Lebanon,0,71,0,71
13438,2019,Cameroon,Lebanon,0,33,0,33
13439,2019,Congo,Lebanon,0,8,0,8
13440,2019,Dem. Rep. of the Congo,Lebanon,0,5,0,5
13441,2019,Eritrea,Lebanon,16,29,0,45
13442,2019,Ethiopia,Lebanon,31,691,0,722
13443,2019,Gambia,Lebanon,0,9,0,9
13444,2019,Palestinian,Lebanon,0,5,0,5
13445,2019,Ghana,Lebanon,0,5,0,5
13446,2019,Hungary,Lebanon,0,0,0,0
13447,2019,Cote d'Ivoire,Lebanon,0,10,0,10
13448,2019,India,Lebanon,0,6,0,6
13449,2019,Iran (Islamic Rep. of),Lebanon,35,43,0,78
13450,2019,Iraq,Lebanon,4551,8911,0,13462
13451,2019,Jordan,Lebanon,31,93,0,124
13452,2019,Kenya,Lebanon,0,14,0,14
13453,2019,Kuwait,Lebanon,9,0,0,9
13454,2019,Libya,Lebanon,10,11,0,21
13455,2019,Lebanon,Lebanon,0,0,0,0
13456,2019,Sri Lanka,Lebanon,0,11,0,11
13457,2019,Madagascar,Lebanon,0,7,0,7
13458,2019,Mali,Lebanon,0,5,0,5
13459,2019,Morocco,Lebanon,0,5,0,5
13460,2019,Nigeria,Lebanon,0,63,0,63
13461,2019,Pakistan,Lebanon,6,5,0,11
13462,2019,Philippines,Lebanon,0,23,0,23
13463,2019,Saudi Arabia,Lebanon,13,9,0,22
13464,2019,Somalia,Lebanon,14,8,0,22
13465,2019,Sudan,Lebanon,641,1560,0,2201
13466,2019,South Sudan,Lebanon,32,0,0,32
13467,2019,Syrian Arab Rep.,Lebanon,910586,0,0,910586
13468,2019,Tunisia,Lebanon,11,0,0,11
13469,2019,Türkiye,Lebanon,7,7,0,14
13470,2019,Ukraine,Lebanon,0,0,0,0
13471,2019,Yemen,Lebanon,23,124,0,147
13472,2019,Unknown ,Lebanon,0,6,0,6
13473,2019,Dem. Rep. of the Congo,Lesotho,92,61,0,153
13474,2019,Eritrea,Lesotho,24,12,0,36
13475,2019,Ethiopia,Lesotho,13,0,0,13
13476,2019,Niger,Lesotho,0,5,0,5
13477,2019,Uganda,Lesotho,9,0,0,9
13478,2019,Zimbabwe,Lesotho,5,0,0,5
13479,2019,Afghanistan,Liechtenstein,5,0,0,5
13480,2019,China,Liechtenstein,27,9,0,36
13481,2019,Dem. Rep. of the Congo,Liechtenstein,6,0,0,6
13482,2019,Eritrea,Liechtenstein,11,0,0,11
13483,2019,Iran (Islamic Rep. of),Liechtenstein,7,5,0,12
13484,2019,Iraq,Liechtenstein,7,0,0,7
13485,2019,Nigeria,Liechtenstein,0,5,0,5
13486,2019,Serbia and Kosovo: S/RES/1244 (1999),Liechtenstein,0,5,0,5
13487,2019,Somalia,Liechtenstein,25,5,0,30
13488,2019,Syrian Arab Rep.,Liechtenstein,32,0,0,32
13489,2019,Ukraine,Liechtenstein,5,0,0,5
13490,2019,Afghanistan,Sri Lanka,160,45,0,205
13491,2019,Bangladesh,Sri Lanka,0,5,0,5
13492,2019,Palestinian,Sri Lanka,5,5,0,10
13493,2019,Iran (Islamic Rep. of),Sri Lanka,23,12,0,35
13494,2019,Sri Lanka,Sri Lanka,0,0,25110,0
13495,2019,Myanmar,Sri Lanka,34,0,0,34
13496,2019,Nigeria,Sri Lanka,0,5,0,5
13497,2019,Pakistan,Sri Lanka,800,284,0,1084
13498,2019,Sudan,Sri Lanka,0,5,0,5
13499,2019,Syrian Arab Rep.,Sri Lanka,5,0,0,5
13500,2019,Yemen,Sri Lanka,14,0,0,14
13501,2019,Afghanistan,Lithuania,236,5,0,241
13502,2019,Armenia,Lithuania,5,5,0,10
13503,2019,Azerbaijan,Lithuania,16,0,0,16
13504,2019,Belarus,Lithuania,35,12,0,47
13505,2019,Cameroon,Lithuania,5,0,0,5
13506,2019,Cuba,Lithuania,5,0,0,5
13507,2019,Eritrea,Lithuania,40,0,0,40
13508,2019,Ethiopia,Lithuania,5,0,0,5
13509,2019,Georgia,Lithuania,5,0,0,5
13510,2019,India,Lithuania,0,6,0,6
13511,2019,Iran (Islamic Rep. of),Lithuania,9,5,0,14
13512,2019,Iraq,Lithuania,65,9,0,74
13513,2019,Sri Lanka,Lithuania,10,0,0,10
13514,2019,Rep. of Moldova,Lithuania,0,5,0,5
13515,2019,Nigeria,Lithuania,5,0,0,5
13516,2019,Pakistan,Lithuania,5,0,0,5
13517,2019,Russian Federation,Lithuania,668,202,0,870
13518,2019,Somalia,Lithuania,22,0,0,22
13519,2019,Syrian Arab Rep.,Lithuania,453,6,0,459
13520,2019,Tajikistan,Lithuania,73,140,0,213
13521,2019,Türkiye,Lithuania,44,8,0,52
13522,2019,Ukraine,Lithuania,64,5,0,69
13523,2019,Uzbekistan,Lithuania,16,0,0,16
13524,2019,Stateless,Lithuania,36,0,0,36
13525,2019,Afghanistan,Luxembourg,97,170,0,267
13526,2019,Albania,Luxembourg,70,15,0,85
13527,2019,Algeria,Luxembourg,0,40,0,40
13528,2019,Angola,Luxembourg,13,5,0,18
13529,2019,Egypt,Luxembourg,5,5,0,10
13530,2019,Armenia,Luxembourg,6,0,0,6
13531,2019,Azerbaijan,Luxembourg,15,0,0,15
13532,2019,Benin,Luxembourg,0,10,0,10
13533,2019,Bhutan,Luxembourg,5,0,0,5
13534,2019,Burkina Faso,Luxembourg,0,5,0,5
13535,2019,Belarus,Luxembourg,7,20,0,27
13536,2019,Bosnia and Herzegovina,Luxembourg,7,5,0,12
13537,2019,Chad,Luxembourg,0,5,0,5
13538,2019,China,Luxembourg,5,0,0,5
13539,2019,Cameroon,Luxembourg,10,35,0,45
13540,2019,Congo,Luxembourg,5,0,0,5
13541,2019,Dem. Rep. of the Congo,Luxembourg,38,10,0,48
13542,2019,Colombia,Luxembourg,0,10,0,10
13543,2019,Eritrea,Luxembourg,257,505,0,762
13544,2019,Ethiopia,Luxembourg,47,25,0,72
13545,2019,Gabon,Luxembourg,5,0,0,5
13546,2019,Gambia,Luxembourg,6,5,0,11
13547,2019,Georgia,Luxembourg,0,15,0,15
13548,2019,Guinea,Luxembourg,9,35,0,44
13549,2019,Cote d'Ivoire,Luxembourg,6,15,0,21
13550,2019,Iran (Islamic Rep. of),Luxembourg,163,60,0,223
13551,2019,Iraq,Luxembourg,310,90,0,400
13552,2019,Dem. People's Rep. of Korea,Luxembourg,11,0,0,11
13553,2019,Kuwait,Luxembourg,0,5,0,5
13554,2019,Liberia,Luxembourg,0,5,0,5
13555,2019,Libya,Luxembourg,5,30,0,35
13556,2019,Lebanon,Luxembourg,0,5,0,5
13557,2019,Sri Lanka,Luxembourg,5,0,0,5
13558,2019,Mauritania,Luxembourg,0,5,0,5
13559,2019,Rep. of Moldova,Luxembourg,0,5,0,5
13560,2019,Mexico,Luxembourg,5,0,0,5
13561,2019,Mali,Luxembourg,0,5,0,5
13562,2019,Morocco,Luxembourg,0,30,0,30
13563,2019,Montenegro,Luxembourg,18,5,0,23
13564,2019,Nigeria,Luxembourg,9,20,0,29
13565,2019,Pakistan,Luxembourg,0,5,0,5
13566,2019,Peru,Luxembourg,5,0,0,5
13567,2019,Russian Federation,Luxembourg,20,10,0,30
13568,2019,Rwanda,Luxembourg,19,5,0,24
13569,2019,Serbia and Kosovo: S/RES/1244 (1999),Luxembourg,227,20,0,247
13570,2019,Senegal,Luxembourg,0,10,0,10
13571,2019,Somalia,Luxembourg,41,35,0,76
13572,2019,Sudan,Luxembourg,7,65,0,72
13573,2019,South Sudan,Luxembourg,0,5,0,5
13574,2019,Syrian Arab Rep.,Luxembourg,951,200,0,1151
13575,2019,Tajikistan,Luxembourg,0,5,0,5
13576,2019,Turkmenistan,Luxembourg,5,0,0,5
13577,2019,Togo,Luxembourg,5,10,0,15
13578,2019,Tunisia,Luxembourg,0,25,0,25
13579,2019,Türkiye,Luxembourg,33,80,0,113
13580,2019,Ukraine,Luxembourg,6,25,0,31
13581,2019,Venezuela (Bolivarian Republic of),Luxembourg,15,55,0,70
13582,2019,Yemen,Luxembourg,10,5,0,15
13583,2019,Zambia,Luxembourg,0,5,0,5
13584,2019,Stateless,Luxembourg,50,0,0,50
13585,2019,Unknown ,Luxembourg,15,20,0,35
13586,2019,Afghanistan,Latvia,66,0,0,66
13587,2019,Egypt,Latvia,5,5,0,10
13588,2019,Azerbaijan,Latvia,11,15,0,26
13589,2019,Bangladesh,Latvia,0,5,0,5
13590,2019,Eritrea,Latvia,35,0,0,35
13591,2019,Palestinian,Latvia,6,0,0,6
13592,2019,Iran (Islamic Rep. of),Latvia,23,5,0,28
13593,2019,Iraq,Latvia,36,0,0,36
13594,2019,Kazakhstan,Latvia,5,0,0,5
13595,2019,Kyrgyzstan,Latvia,5,0,0,5
13596,2019,Lebanon,Latvia,5,0,0,5
13597,2019,Sri Lanka,Latvia,5,0,0,5
13598,2019,Nigeria,Latvia,5,0,0,5
13599,2019,Russian Federation,Latvia,56,6,0,62
13600,2019,Somalia,Latvia,5,0,0,5
13601,2019,Syrian Arab Rep.,Latvia,354,0,0,354
13602,2019,Tajikistan,Latvia,5,5,0,10
13603,2019,Türkiye,Latvia,24,0,0,24
13604,2019,Uzbekistan,Latvia,14,0,0,14
13605,2019,Stateless,Latvia,0,0,0,0
13606,2019,Afghanistan,Madagascar,10,10,0,20
13607,2019,Burundi,Madagascar,5,0,0,5
13608,2019,Dem. Rep. of the Congo,Madagascar,13,0,0,13
13609,2019,Costa Rica,Madagascar,0,5,0,5
13610,2019,Guinea,Madagascar,0,5,0,5
13611,2019,Pakistan,Madagascar,53,90,0,143
13612,2019,Syrian Arab Rep.,Madagascar,5,0,0,5
13613,2019,Türkiye,Madagascar,5,9,0,14
13614,2019,Yemen,Madagascar,22,9,0,31
13615,2019,Benin,Mauritania,0,6,0,6
13616,2019,Burkina Faso,Mauritania,0,25,0,25
13617,2019,Central African Rep.,Mauritania,622,74,0,696
13618,2019,Chad,Mauritania,5,0,0,5
13619,2019,China,Mauritania,5,5,0,10
13620,2019,Cameroon,Mauritania,0,129,0,129
13621,2019,Congo,Mauritania,9,18,0,27
13622,2019,Dem. Rep. of the Congo,Mauritania,32,28,0,60
13623,2019,Ethiopia,Mauritania,6,0,0,6
13624,2019,Gambia,Mauritania,0,14,0,14
13625,2019,Palestinian,Mauritania,60,27,0,87
13626,2019,Ghana,Mauritania,0,15,0,15
13627,2019,Guinea-Bissau,Mauritania,0,19,0,19
13628,2019,Guinea,Mauritania,10,184,0,194
13629,2019,Cote d'Ivoire,Mauritania,264,136,0,400
13630,2019,Iraq,Mauritania,24,0,0,24
13631,2019,Liberia,Mauritania,7,31,0,38
13632,2019,Lebanon,Mauritania,5,0,0,5
13633,2019,Mali,Mauritania,57392,167,0,57559
13634,2019,Morocco,Mauritania,0,7,0,7
13635,2019,Nigeria,Mauritania,11,106,0,117
13636,2019,Russian Federation,Mauritania,0,7,0,7
13637,2019,Senegal,Mauritania,45,124,0,169
13638,2019,Sierra Leone,Mauritania,0,213,0,213
13639,2019,Somalia,Mauritania,0,5,0,5
13640,2019,Sudan,Mauritania,10,20,0,30
13641,2019,Syrian Arab Rep.,Mauritania,355,36,0,391
13642,2019,Togo,Mauritania,23,83,0,106
13643,2019,Türkiye,Mauritania,0,24,0,24
13644,2019,Ukraine,Mauritania,5,0,0,5
13645,2019,Western Sahara,Mauritania,26000,0,0,26000
13646,2019,Yemen,Mauritania,10,37,0,47
13647,2019,Afghanistan,North Macedonia,5,15,0,20
13648,2019,Algeria,North Macedonia,0,7,0,7
13649,2019,Congo,North Macedonia,5,0,0,5
13650,2019,Cuba,North Macedonia,0,5,0,5
13651,2019,Iraq,North Macedonia,0,8,0,8
13652,2019,Morocco,North Macedonia,0,13,0,13
13653,2019,Pakistan,North Macedonia,5,8,0,13
13654,2019,Russian Federation,North Macedonia,0,5,0,5
13655,2019,Serbia and Kosovo: S/RES/1244 (1999),North Macedonia,322,0,0,322
13656,2019,Syrian Arab Rep.,North Macedonia,17,14,0,31
13657,2019,Stateless,North Macedonia,0,0,0,0
13658,2019,Unknown ,Monaco,22,0,0,22
13659,2019,Afghanistan,Rep. of Moldova,24,0,0,24
13660,2019,Armenia,Rep. of Moldova,16,7,0,23
13661,2019,Azerbaijan,Rep. of Moldova,5,7,0,12
13662,2019,Bangladesh,Rep. of Moldova,0,21,0,21
13663,2019,Palestinian,Rep. of Moldova,5,0,0,5
13664,2019,Iran (Islamic Rep. of),Rep. of Moldova,5,0,0,5
13665,2019,Iraq,Rep. of Moldova,21,5,0,26
13666,2019,Kyrgyzstan,Rep. of Moldova,11,0,0,11
13667,2019,Libya,Rep. of Moldova,0,5,0,5
13668,2019,Russian Federation,Rep. of Moldova,5,5,0,10
13669,2019,Sudan,Rep. of Moldova,9,0,0,9
13670,2019,Syrian Arab Rep.,Rep. of Moldova,210,5,0,215
13671,2019,Tajikistan,Rep. of Moldova,8,0,0,8
13672,2019,Turkmenistan,Rep. of Moldova,5,0,0,5
13673,2019,Türkiye,Rep. of Moldova,26,29,0,55
13674,2019,Ukraine,Rep. of Moldova,53,5,0,58
13675,2019,Uzbekistan,Rep. of Moldova,6,5,0,11
13676,2019,Yemen,Rep. of Moldova,8,0,0,8
13677,2019,Stateless,Rep. of Moldova,0,0,0,0
13678,2019,Albania,Mexico,8,0,0,8
13679,2019,Algeria,Mexico,5,0,0,5
13680,2019,Angola,Mexico,5,179,0,184
13681,2019,Egypt,Mexico,5,0,0,5
13682,2019,Argentina,Mexico,5,29,0,34
13683,2019,Benin,Mexico,0,9,0,9
13684,2019,Bangladesh,Mexico,6,5,0,11
13685,2019,Burkina Faso,Mexico,0,14,0,14
13686,2019,Bolivia (Plurinational State of),Mexico,0,6,0,6
13687,2019,Brazil,Mexico,0,543,0,543
13688,2019,Belize,Mexico,6,24,0,30
13689,2019,Cambodia,Mexico,24,44,0,68
13690,2019,China,Mexico,5,5,0,10
13691,2019,Chile,Mexico,5,399,0,404
13692,2019,Cameroon,Mexico,0,480,0,480
13693,2019,Congo,Mexico,21,31,0,52
13694,2019,Dem. Rep. of the Congo,Mexico,62,222,0,284
13695,2019,Colombia,Mexico,351,628,0,979
13696,2019,Costa Rica,Mexico,0,43,0,43
13697,2019,Cuba,Mexico,325,6746,0,7071
13698,2019,Dominican Rep.,Mexico,12,39,0,51
13699,2019,Ecuador,Mexico,6,79,0,85
13700,2019,Eritrea,Mexico,7,61,0,68
13701,2019,Ethiopia,Mexico,5,13,0,18
13702,2019,France,Mexico,0,5,0,5
13703,2019,Gambia,Mexico,0,5,0,5
13704,2019,Palestinian,Mexico,5,0,0,5
13705,2019,Ghana,Mexico,13,105,0,118
13706,2019,Guatemala,Mexico,1250,3631,0,4881
13707,2019,Guinea,Mexico,5,50,0,55
13708,2019,Guyana,Mexico,0,5,0,5
13709,2019,Haiti,Mexico,221,5566,0,5787
13710,2019,Honduras,Mexico,9257,29507,0,38764
13711,2019,Cote d'Ivoire,Mexico,5,5,0,10
13712,2019,India,Mexico,12,54,0,66
13713,2019,Iran (Islamic Rep. of),Mexico,39,6,0,45
13714,2019,Iraq,Mexico,43,5,0,48
13715,2019,Italy,Mexico,0,5,0,5
13716,2019,Jamaica,Mexico,6,5,0,11
13717,2019,Kyrgyzstan,Mexico,0,11,0,11
13718,2019,Rep. of Korea,Mexico,0,5,0,5
13719,2019,Sri Lanka,Mexico,20,45,0,65
13720,2019,Mauritania,Mexico,0,7,0,7
13721,2019,Mali,Mexico,0,5,0,5
13722,2019,Nepal,Mexico,0,9,0,9
13723,2019,Nicaragua,Mexico,545,2306,0,2851
13724,2019,Nigeria,Mexico,36,23,0,59
13725,2019,Pakistan,Mexico,10,11,0,21
13726,2019,Panama,Mexico,5,11,0,16
13727,2019,Peru,Mexico,16,24,0,40
13728,2019,Portugal,Mexico,5,5,0,10
13729,2019,Romania,Mexico,7,0,0,7
13730,2019,South Africa,Mexico,0,11,0,11
13731,2019,Russian Federation,Mexico,39,24,0,63
13732,2019,El Salvador,Mexico,7244,9563,0,16807
13733,2019,Sierra Leone,Mexico,5,10,0,15
13734,2019,Somalia,Mexico,0,6,0,6
13735,2019,Spain,Mexico,0,10,0,10
13736,2019,Sudan,Mexico,0,5,0,5
13737,2019,Syrian Arab Rep.,Mexico,29,8,0,37
13738,2019,Togo,Mexico,0,9,0,9
13739,2019,Türkiye,Mexico,8,0,0,8
13740,2019,Uganda,Mexico,0,66,0,66
13741,2019,Ukraine,Mexico,17,5,0,22
13742,2019,Uruguay,Mexico,0,15,0,15
13743,2019,United States of America,Mexico,18,60,0,78
13744,2019,Venezuela (Bolivarian Republic of),Mexico,8781,8614,0,17395
13745,2019,Yemen,Mexico,13,30,0,43
13746,2019,Stateless,Mexico,0,0,0,0
13747,2019,Burundi,Mali,12,6,0,18
13748,2019,Bangladesh,Mali,0,32,0,32
13749,2019,Burkina Faso,Mali,8457,72,0,8529
13750,2019,Central African Rep.,Mali,971,328,0,1299
13751,2019,Cameroon,Mali,5,7,0,12
13752,2019,Congo,Mali,30,5,0,35
13753,2019,Dem. Rep. of the Congo,Mali,271,60,0,331
13754,2019,Eritrea,Mali,5,0,0,5
13755,2019,Guinea,Mali,0,5,0,5
13756,2019,Cote d'Ivoire,Mali,515,43,0,558
13757,2019,Mauritania,Mali,15316,0,0,15316
13758,2019,Mali,Mali,0,0,207751,0
13759,2019,Niger,Mali,1024,0,0,1024
13760,2019,Nigeria,Mali,0,5,0,5
13761,2019,Pakistan,Mali,10,0,0,10
13762,2019,Rwanda,Mali,7,10,0,17
13763,2019,Syrian Arab Rep.,Mali,20,413,0,433
13764,2019,Togo,Mali,21,5,0,26
13765,2019,Türkiye,Mali,8,13,0,21
13766,2019,Afghanistan,Malaysia,1352,1126,0,2478
13767,2019,Algeria,Malaysia,0,7,0,7
13768,2019,Egypt,Malaysia,15,79,0,94
13769,2019,Australia,Malaysia,5,0,0,5
13770,2019,Bangladesh,Malaysia,39,17,0,56
13771,2019,Cambodia,Malaysia,80,9,0,89
13772,2019,Central African Rep.,Malaysia,5,0,0,5
13773,2019,China,Malaysia,44,7,0,51
13774,2019,Cameroon,Malaysia,5,21,0,26
13775,2019,Congo,Malaysia,0,5,0,5
13776,2019,Dem. Rep. of the Congo,Malaysia,0,7,0,7
13777,2019,Eritrea,Malaysia,7,20,0,27
13778,2019,Ethiopia,Malaysia,11,11,0,22
13779,2019,Palestinian,Malaysia,226,582,0,808
13780,2019,United Kingdom of Great Britain and Northern Ireland,Malaysia,6,0,0,6
13781,2019,Guinea,Malaysia,5,27,0,32
13782,2019,Cote d'Ivoire,Malaysia,5,0,0,5
13783,2019,India,Malaysia,5,11,0,16
13784,2019,Indonesia,Malaysia,996,8,0,1004
13785,2019,Iran (Islamic Rep. of),Malaysia,246,198,0,444
13786,2019,Iraq,Malaysia,435,876,0,1311
13787,2019,Jordan,Malaysia,0,6,0,6
13788,2019,Lao People's Dem. Rep.,Malaysia,0,5,0,5
13789,2019,Liberia,Malaysia,19,9,0,28
13790,2019,Libya,Malaysia,10,21,0,31
13791,2019,Lebanon,Malaysia,5,7,0,12
13792,2019,Sri Lanka,Malaysia,857,1046,0,1903
13793,2019,Mali,Malaysia,5,0,0,5
13794,2019,Morocco,Malaysia,5,0,0,5
13795,2019,Myanmar,Malaysia,119231,34546,0,153777
13796,2019,Nepal,Malaysia,11,0,0,11
13797,2019,Nigeria,Malaysia,5,32,0,37
13798,2019,Pakistan,Malaysia,3033,3574,0,6607
13799,2019,Philippines,Malaysia,24,0,0,24
13800,2019,Russian Federation,Malaysia,6,0,0,6
13801,2019,Sierra Leone,Malaysia,11,43,0,54
13802,2019,Somalia,Malaysia,1540,1754,0,3294
13803,2019,Viet Nam,Malaysia,5,0,0,5
13804,2019,Sudan,Malaysia,158,156,0,314
13805,2019,South Sudan,Malaysia,13,43,0,56
13806,2019,Syrian Arab Rep.,Malaysia,425,2861,0,3286
13807,2019,Thailand,Malaysia,29,22,0,51
13808,2019,Uganda,Malaysia,5,8,0,13
13809,2019,United States of America,Malaysia,7,0,0,7
13810,2019,Uzbekistan,Malaysia,0,8,0,8
13811,2019,Yemen,Malaysia,206,3462,0,3668
13812,2019,Zimbabwe,Malaysia,5,5,0,10
13813,2019,Stateless,Malaysia,0,0,0,0
13814,2019,Burundi,Malawi,2592,7487,0,10079
13815,2019,Dem. Rep. of the Congo,Malawi,9264,18509,0,27773
13816,2019,Ethiopia,Malawi,8,49,0,57
13817,2019,Cote d'Ivoire,Malawi,5,0,0,5
13818,2019,Mozambique,Malawi,0,5,0,5
13819,2019,Rwanda,Malawi,2163,4117,0,6280
13820,2019,Somalia,Malawi,50,52,0,102
13821,2019,South Sudan,Malawi,5,0,0,5
13822,2019,United Rep. of Tanzania,Malawi,0,6,0,6
13823,2019,Türkiye,Malawi,0,47,0,47
13824,2019,Uganda,Malawi,0,14,0,14
13825,2019,Zimbabwe,Malawi,0,7,0,7
13826,2019,China,Mongolia,0,5,0,5
13827,2019,Mongolia,Mongolia,0,0,0,0
13828,2019,Stateless,Mongolia,0,0,0,0
13829,2019,Afghanistan,Morocco,5,6,0,11
13830,2019,Algeria,Morocco,9,5,0,14
13831,2019,Egypt,Morocco,0,5,0,5
13832,2019,Burundi,Morocco,0,5,0,5
13833,2019,Benin,Morocco,0,5,0,5
13834,2019,Bangladesh,Morocco,0,132,0,132
13835,2019,Burkina Faso,Morocco,0,25,0,25
13836,2019,Central African Rep.,Morocco,560,29,0,589
13837,2019,Chad,Morocco,5,14,0,19
13838,2019,Cameroon,Morocco,110,687,0,797
13839,2019,Congo,Morocco,18,45,0,63
13840,2019,Dem. Rep. of the Congo,Morocco,172,112,0,284
13841,2019,Eritrea,Morocco,15,7,0,22
13842,2019,Gambia,Morocco,0,18,0,18
13843,2019,Palestinian,Morocco,183,0,0,183
13844,2019,Ghana,Morocco,0,11,0,11
13845,2019,Guinea-Bissau,Morocco,0,5,0,5
13846,2019,Guinea,Morocco,66,732,0,798
13847,2019,Cote d'Ivoire,Morocco,335,457,0,792
13848,2019,India,Morocco,0,5,0,5
13849,2019,Iraq,Morocco,137,6,0,143
13850,2019,Liberia,Morocco,6,36,0,42
13851,2019,Libya,Morocco,32,28,0,60
13852,2019,Lebanon,Morocco,6,8,0,14
13853,2019,Mauritania,Morocco,6,5,0,11
13854,2019,Mali,Morocco,31,133,0,164
13855,2019,Niger,Morocco,0,5,0,5
13856,2019,Nigeria,Morocco,17,277,0,294
13857,2019,Pakistan,Morocco,10,9,0,19
13858,2019,Senegal,Morocco,82,164,0,246
13859,2019,Sierra Leone,Morocco,0,44,0,44
13860,2019,Somalia,Morocco,8,10,0,18
13861,2019,Sudan,Morocco,18,24,0,42
13862,2019,South Sudan,Morocco,292,0,0,292
13863,2019,Syrian Arab Rep.,Morocco,3676,0,0,3676
13864,2019,Togo,Morocco,0,7,0,7
13865,2019,Tunisia,Morocco,0,5,0,5
13866,2019,Türkiye,Morocco,0,13,0,13
13867,2019,Yemen,Morocco,843,0,0,843
13868,2019,Angola,Mozambique,5,0,0,5
13869,2019,Burundi,Mozambique,906,7482,0,8388
13870,2019,Central African Rep.,Mozambique,0,5,0,5
13871,2019,Congo,Mozambique,15,34,0,49
13872,2019,Dem. Rep. of the Congo,Mozambique,2934,6786,0,9720
13873,2019,Comoros,Mozambique,0,347,0,347
13874,2019,Eritrea,Mozambique,0,25,0,25
13875,2019,Ethiopia,Mozambique,8,15,0,23
13876,2019,Guinea,Mozambique,0,5,0,5
13877,2019,Mozambique,Mozambique,0,0,180516,0
13878,2019,Rwanda,Mozambique,687,2972,0,3659
13879,2019,Somalia,Mozambique,148,3239,0,3387
13880,2019,Sudan,Mozambique,5,30,0,35
13881,2019,Uganda,Mozambique,5,35,0,40
13882,2019,Afghanistan,Malta,0,5,0,5
13883,2019,Algeria,Malta,0,15,0,15
13884,2019,Egypt,Malta,74,60,0,134
13885,2019,Armenia,Malta,0,5,0,5
13886,2019,Bangladesh,Malta,12,74,0,86
13887,2019,Burkina Faso,Malta,5,11,0,16
13888,2019,Belarus,Malta,9,0,0,9
13889,2019,Central African Rep.,Malta,0,5,0,5
13890,2019,Chad,Malta,8,48,0,56
13891,2019,China,Malta,17,0,0,17
13892,2019,Cameroon,Malta,10,12,0,22
13893,2019,Dem. Rep. of the Congo,Malta,5,0,0,5
13894,2019,Colombia,Malta,0,12,0,12
13895,2019,Eritrea,Malta,805,187,0,992
13896,2019,Ethiopia,Malta,175,37,0,212
13897,2019,Gambia,Malta,28,189,0,217
13898,2019,Palestinian,Malta,70,24,0,94
13899,2019,Georgia,Malta,5,19,0,24
13900,2019,Ghana,Malta,8,43,0,51
13901,2019,Guinea-Bissau,Malta,0,6,0,6
13902,2019,Guinea,Malta,0,73,0,73
13903,2019,Cote d'Ivoire,Malta,12,118,0,130
13904,2019,Iran (Islamic Rep. of),Malta,31,7,0,38
13905,2019,Iraq,Malta,84,5,0,89
13906,2019,Jordan,Malta,5,0,0,5
13907,2019,Liberia,Malta,6,5,0,11
13908,2019,Libya,Malta,2748,357,0,3105
13909,2019,Lebanon,Malta,0,5,0,5
13910,2019,Sri Lanka,Malta,7,10,0,17
13911,2019,North Macedonia,Malta,5,5,0,10
13912,2019,Mali,Malta,18,74,0,92
13913,2019,Morocco,Malta,31,59,0,90
13914,2019,Nepal,Malta,0,19,0,19
13915,2019,Niger,Malta,0,28,0,28
13916,2019,Nigeria,Malta,124,102,0,226
13917,2019,Pakistan,Malta,58,90,0,148
13918,2019,Peru,Malta,0,5,0,5
13919,2019,Russian Federation,Malta,18,5,0,23
13920,2019,El Salvador,Malta,0,5,0,5
13921,2019,Saudi Arabia,Malta,5,0,0,5
13922,2019,Serbia and Kosovo: S/RES/1244 (1999),Malta,7,5,0,12
13923,2019,Senegal,Malta,5,84,0,89
13924,2019,Sierra Leone,Malta,5,20,0,25
13925,2019,Somalia,Malta,1780,145,0,1925
13926,2019,Sudan,Malta,199,967,0,1166
13927,2019,South Sudan,Malta,22,62,0,84
13928,2019,Syrian Arab Rep.,Malta,1706,482,0,2188
13929,2019,Togo,Malta,5,10,0,15
13930,2019,Tunisia,Malta,13,26,0,39
13931,2019,Türkiye,Malta,5,16,0,21
13932,2019,Uganda,Malta,0,5,0,5
13933,2019,Ukraine,Malta,142,59,0,201
13934,2019,Uzbekistan,Malta,0,5,0,5
13935,2019,Venezuela (Bolivarian Republic of),Malta,5,65,0,70
13936,2019,Yemen,Malta,0,6,0,6
13937,2019,Zimbabwe,Malta,5,0,0,5
13938,2019,Stateless,Malta,0,0,0,0
13939,2019,Unknown ,Malta,626,0,0,626
13940,2019,Afghanistan,Montenegro,0,50,0,50
13941,2019,Algeria,Montenegro,0,48,0,48
13942,2019,Egypt,Montenegro,0,5,0,5
13943,2019,Belarus,Montenegro,5,0,0,5
13944,2019,Bosnia and Herzegovina,Montenegro,16,0,0,16
13945,2019,Cuba,Montenegro,0,5,0,5
13946,2019,Palestinian,Montenegro,0,5,0,5
13947,2019,Ghana,Montenegro,5,0,0,5
13948,2019,Croatia,Montenegro,10,0,0,10
13949,2019,Iran (Islamic Rep. of),Montenegro,0,48,0,48
13950,2019,Iraq,Montenegro,0,5,0,5
13951,2019,Libya,Montenegro,0,6,0,6
13952,2019,Morocco,Montenegro,0,261,0,261
13953,2019,Pakistan,Montenegro,0,9,0,9
13954,2019,Russian Federation,Montenegro,0,12,0,12
13955,2019,Serbia and Kosovo: S/RES/1244 (1999),Montenegro,610,5,0,615
13956,2019,Syrian Arab Rep.,Montenegro,0,14,0,14
13957,2019,Türkiye,Montenegro,0,11,0,11
13958,2019,Yemen,Montenegro,7,0,0,7
13959,2019,Stateless,Montenegro,0,0,0,0
13960,2019,Unknown ,Montenegro,0,0,0,0
13961,2019,Dem. Rep. of the Congo,Mauritius,10,0,0,10
13962,2019,Pakistan,Mauritius,5,0,0,5
13963,2019,Philippines,Mauritius,0,5,0,5
13964,2019,South Africa,Mauritius,5,0,0,5
13965,2019,Myanmar,Myanmar,0,0,312018,0
13966,2019,Stateless,Myanmar,0,0,0,0
13967,2019,Burundi,Namibia,273,119,0,392
13968,2019,Central African Rep.,Namibia,5,15,0,20
13969,2019,Cameroon,Namibia,20,14,0,34
13970,2019,Congo,Namibia,5,5,0,10
13971,2019,Dem. Rep. of the Congo,Namibia,2685,1649,0,4334
13972,2019,Niger,Namibia,0,5,0,5
13973,2019,Rwanda,Namibia,121,32,0,153
13974,2019,Somalia,Namibia,5,6,0,11
13975,2019,Sudan,Namibia,6,0,0,6
13976,2019,South Sudan,Namibia,0,5,0,5
13977,2019,Uganda,Namibia,5,5,0,10
13978,2019,Zimbabwe,Namibia,57,51,0,108
13979,2019,Afghanistan,Nepal,51,0,0,51
13980,2019,Bangladesh,Nepal,5,0,0,5
13981,2019,Bhutan,Nepal,6396,0,0,6396
13982,2019,India,Nepal,0,0,0,0
13983,2019,Iran (Islamic Rep. of),Nepal,5,5,0,10
13984,2019,Sri Lanka,Nepal,20,6,0,26
13985,2019,Myanmar,Nepal,351,11,0,362
13986,2019,Nepal,Nepal,0,0,0,0
13987,2019,Pakistan,Nepal,176,30,0,206
13988,2019,Somalia,Nepal,26,0,0,26
13989,2019,Yemen,Nepal,0,5,0,5
13990,2019,Tibetan,Nepal,12540,0,0,12540
13991,2019,Afghanistan,Netherlands,5815,543,0,6358
13992,2019,Albania,Netherlands,5,12,0,17
13993,2019,Algeria,Netherlands,15,293,0,308
13994,2019,Angola,Netherlands,41,30,0,71
13995,2019,Egypt,Netherlands,205,189,0,394
13996,2019,Argentina,Netherlands,5,5,0,10
13997,2019,Armenia,Netherlands,366,48,0,414
13998,2019,Azerbaijan,Netherlands,229,126,0,355
13999,2019,Bahrain,Netherlands,9,0,0,9
14000,2019,Burundi,Netherlands,128,13,0,141
14001,2019,Benin,Netherlands,5,5,0,10
14002,2019,Bangladesh,Netherlands,34,15,0,49
14003,2019,Bhutan,Netherlands,144,0,0,144
14004,2019,Burkina Faso,Netherlands,14,5,0,19
14005,2019,Belarus,Netherlands,45,65,0,110
14006,2019,Bosnia and Herzegovina,Netherlands,0,9,0,9
14007,2019,Cambodia,Netherlands,17,0,0,17
14008,2019,Central African Rep.,Netherlands,7,0,0,7
14009,2019,Chad,Netherlands,5,7,0,12
14010,2019,China,Netherlands,1004,153,0,1157
14011,2019,Cameroon,Netherlands,66,34,0,100
14012,2019,Congo,Netherlands,375,31,0,406
14013,2019,Dem. Rep. of the Congo,Netherlands,147,10,0,157
14014,2019,Colombia,Netherlands,19,146,0,165
14015,2019,Cuba,Netherlands,28,28,0,56
14016,2019,Dominican Rep.,Netherlands,0,6,0,6
14017,2019,Ecuador,Netherlands,8,0,0,8
14018,2019,Eritrea,Netherlands,14809,511,0,15320
14019,2019,Ethiopia,Netherlands,456,90,0,546
14020,2019,Gambia,Netherlands,32,229,0,261
14021,2019,Palestinian,Netherlands,160,42,0,202
14022,2019,Georgia,Netherlands,32,37,0,69
14023,2019,Ghana,Netherlands,7,20,0,27
14024,2019,Guinea-Bissau,Netherlands,0,9,0,9
14025,2019,Guinea,Netherlands,567,162,0,729
14026,2019,Guyana,Netherlands,0,5,0,5
14027,2019,Honduras,Netherlands,7,10,0,17
14028,2019,Cote d'Ivoire,Netherlands,237,30,0,267
14029,2019,India,Netherlands,6,19,0,25
14030,2019,Indonesia,Netherlands,0,11,0,11
14031,2019,Iran (Islamic Rep. of),Netherlands,4783,2490,0,7273
14032,2019,Iraq,Netherlands,8423,675,0,9098
14033,2019,Jamaica,Netherlands,190,10,0,200
14034,2019,Jordan,Netherlands,5,122,0,127
14035,2019,Kazakhstan,Netherlands,39,30,0,69
14036,2019,Kenya,Netherlands,37,13,0,50
14037,2019,Kyrgyzstan,Netherlands,20,5,0,25
14038,2019,Dem. People's Rep. of Korea,Netherlands,39,0,0,39
14039,2019,Kuwait,Netherlands,5,0,0,5
14040,2019,Lao People's Dem. Rep.,Netherlands,27,0,0,27
14041,2019,Liberia,Netherlands,54,20,0,74
14042,2019,Libya,Netherlands,278,164,0,442
14043,2019,Lebanon,Netherlands,50,107,0,157
14044,2019,Sri Lanka,Netherlands,543,47,0,590
14045,2019,Mauritania,Netherlands,5,5,0,10
14046,2019,North Macedonia,Netherlands,0,30,0,30
14047,2019,Rep. of Moldova,Netherlands,0,233,0,233
14048,2019,Mexico,Netherlands,0,5,0,5
14049,2019,Mali,Netherlands,17,12,0,29
14050,2019,Malaysia,Netherlands,7,0,0,7
14051,2019,Malawi,Netherlands,5,0,0,5
14052,2019,Mongolia,Netherlands,37,6,0,43
14053,2019,Morocco,Netherlands,49,259,0,308
14054,2019,Myanmar,Netherlands,495,40,0,535
14055,2019,Namibia,Netherlands,5,0,0,5
14056,2019,Nepal,Netherlands,192,7,0,199
14057,2019,Niger,Netherlands,6,31,0,37
14058,2019,Nicaragua,Netherlands,0,49,0,49
14059,2019,Nigeria,Netherlands,289,735,0,1024
14060,2019,Pakistan,Netherlands,456,375,0,831
14061,2019,Peru,Netherlands,9,9,0,18
14062,2019,South Africa,Netherlands,0,6,0,6
14063,2019,Russian Federation,Netherlands,300,185,0,485
14064,2019,Rwanda,Netherlands,51,15,0,66
14065,2019,El Salvador,Netherlands,0,34,0,34
14066,2019,Saudi Arabia,Netherlands,21,10,0,31
14067,2019,Serbia and Kosovo: S/RES/1244 (1999),Netherlands,23,28,0,51
14068,2019,Senegal,Netherlands,26,41,0,67
14069,2019,Sierra Leone,Netherlands,405,91,0,496
14070,2019,Somalia,Netherlands,13007,196,0,13203
14071,2019,Viet Nam,Netherlands,5,12,0,17
14072,2019,Sudan,Netherlands,792,131,0,923
14073,2019,Suriname,Netherlands,0,5,0,5
14074,2019,South Sudan,Netherlands,0,5,0,5
14075,2019,Syrian Arab Rep.,Netherlands,31694,3092,0,34786
14076,2019,United Rep. of Tanzania,Netherlands,5,17,0,22
14077,2019,Tajikistan,Netherlands,30,45,0,75
14078,2019,Turkmenistan,Netherlands,5,9,0,14
14079,2019,Timor-Leste,Netherlands,0,8,0,8
14080,2019,Togo,Netherlands,24,5,0,29
14081,2019,Trinidad and Tobago,Netherlands,77,12,0,89
14082,2019,Tunisia,Netherlands,19,80,0,99
14083,2019,Türkiye,Netherlands,1736,1308,0,3044
14084,2019,Uganda,Netherlands,488,251,0,739
14085,2019,Ukraine,Netherlands,20,59,0,79
14086,2019,United States of America,Netherlands,17,13,0,30
14087,2019,Uzbekistan,Netherlands,31,16,0,47
14088,2019,Venezuela (Bolivarian Republic of),Netherlands,13,207,0,220
14089,2019,Yemen,Netherlands,791,546,0,1337
14090,2019,Zambia,Netherlands,8,0,0,8
14091,2019,Zimbabwe,Netherlands,26,24,0,50
14092,2019,Stateless,Netherlands,842,49,0,891
14093,2019,Unknown ,Netherlands,2847,672,0,3519
14094,2019,Burkina Faso,Niger,0,0,0,0
14095,2019,Central African Rep.,Niger,145,23,0,168
14096,2019,Chad,Niger,166,1291,0,1457
14097,2019,Cameroon,Niger,5,153,0,158
14098,2019,Congo,Niger,5,0,0,5
14099,2019,Dem. Rep. of the Congo,Niger,80,19,0,99
14100,2019,Eritrea,Niger,284,149,0,433
14101,2019,Ethiopia,Niger,38,14,0,52
14102,2019,Guinea,Niger,0,12,0,12
14103,2019,Cote d'Ivoire,Niger,38,5,0,43
14104,2019,Iraq,Niger,6,0,0,6
14105,2019,Libya,Niger,7,6,0,13
14106,2019,Mali,Niger,58000,74,0,58074
14107,2019,Niger,Niger,0,0,191902,0
14108,2019,Nigeria,Niger,120621,34699,0,155320
14109,2019,Pakistan,Niger,0,8,0,8
14110,2019,Rwanda,Niger,18,0,0,18
14111,2019,Somalia,Niger,163,64,0,227
14112,2019,Sudan,Niger,409,1362,0,1771
14113,2019,South Sudan,Niger,0,7,0,7
14114,2019,Syrian Arab Rep.,Niger,7,0,0,7
14115,2019,Togo,Niger,5,5,0,10
14116,2019,Yemen,Niger,0,5,0,5
14117,2019,Colombia,Nicaragua,6,0,0,6
14118,2019,Cuba,Nicaragua,15,0,0,15
14119,2019,Guatemala,Nicaragua,8,0,0,8
14120,2019,Honduras,Nicaragua,74,26,0,100
14121,2019,El Salvador,Nicaragua,219,100,0,319
14122,2019,Afghanistan,Nigeria,5,0,0,5
14123,2019,Benin,Nigeria,5,0,0,5
14124,2019,Central African Rep.,Nigeria,460,212,0,672
14125,2019,Chad,Nigeria,88,22,0,110
14126,2019,Cameroon,Nigeria,52066,424,0,52490
14127,2019,Congo,Nigeria,5,5,0,10
14128,2019,Dem. Rep. of the Congo,Nigeria,635,114,0,749
14129,2019,Eritrea,Nigeria,30,5,0,35
14130,2019,Ethiopia,Nigeria,6,0,0,6
14131,2019,Palestinian,Nigeria,11,5,0,16
14132,2019,Ghana,Nigeria,5,5,0,10
14133,2019,Guinea-Bissau,Nigeria,5,0,0,5
14134,2019,Guinea,Nigeria,17,5,0,22
14135,2019,Cote d'Ivoire,Nigeria,128,6,0,134
14136,2019,Liberia,Nigeria,9,5,0,14
14137,2019,Lebanon,Nigeria,0,7,0,7
14138,2019,Sri Lanka,Nigeria,5,0,0,5
14139,2019,Mali,Nigeria,144,18,0,162
14140,2019,Niger,Nigeria,6,0,0,6
14141,2019,Nigeria,Nigeria,0,0,2195779,0
14142,2019,Sierra Leone,Nigeria,23,5,0,28
14143,2019,Sudan,Nigeria,47,5,0,52
14144,2019,Syrian Arab Rep.,Nigeria,263,132,0,395
14145,2019,Togo,Nigeria,20,20,0,40
14146,2019,Türkiye,Nigeria,174,37,0,211
14147,2019,Afghanistan,Norway,5108,81,0,5189
14148,2019,Albania,Norway,20,26,0,46
14149,2019,Algeria,Norway,6,0,0,6
14150,2019,Angola,Norway,14,7,0,21
14151,2019,Egypt,Norway,59,10,0,69
14152,2019,Armenia,Norway,5,0,0,5
14153,2019,Azerbaijan,Norway,27,5,0,32
14154,2019,Burundi,Norway,51,0,0,51
14155,2019,Bangladesh,Norway,8,0,0,8
14156,2019,Belarus,Norway,5,0,0,5
14157,2019,Bulgaria,Norway,7,0,0,7
14158,2019,Central African Rep.,Norway,6,0,0,6
14159,2019,Chad,Norway,5,0,0,5
14160,2019,China,Norway,565,5,0,570
14161,2019,Cameroon,Norway,24,10,0,34
14162,2019,Congo,Norway,5,0,0,5
14163,2019,Dem. Rep. of the Congo,Norway,154,0,0,154
14164,2019,Colombia,Norway,12,26,0,38
14165,2019,Djibouti,Norway,5,0,0,5
14166,2019,Eritrea,Norway,14038,80,0,14118
14167,2019,Ethiopia,Norway,1732,24,0,1756
14168,2019,Gambia,Norway,16,0,0,16
14169,2019,Georgia,Norway,5,10,0,15
14170,2019,Ghana,Norway,7,0,0,7
14171,2019,Guinea-Bissau,Norway,5,0,0,5
14172,2019,Greece,Norway,0,5,0,5
14173,2019,Guatemala,Norway,7,0,0,7
14174,2019,Guinea,Norway,48,0,0,48
14175,2019,Honduras,Norway,5,0,0,5
14176,2019,Cote d'Ivoire,Norway,13,5,0,18
14177,2019,Iran (Islamic Rep. of),Norway,1810,171,0,1981
14178,2019,Iraq,Norway,1634,82,0,1716
14179,2019,Israel,Norway,8,0,0,8
14180,2019,Jordan,Norway,7,0,0,7
14181,2019,Kazakhstan,Norway,15,0,0,15
14182,2019,Kenya,Norway,9,0,0,9
14183,2019,Kyrgyzstan,Norway,13,5,0,18
14184,2019,Liberia,Norway,13,0,0,13
14185,2019,Libya,Norway,61,7,0,68
14186,2019,Lebanon,Norway,25,0,0,25
14187,2019,Sri Lanka,Norway,109,5,0,114
14188,2019,Mauritania,Norway,5,0,0,5
14189,2019,Rep. of Moldova,Norway,5,0,0,5
14190,2019,Mali,Norway,8,0,0,8
14191,2019,Malaysia,Norway,5,5,0,10
14192,2019,Mongolia,Norway,5,0,0,5
14193,2019,Morocco,Norway,27,10,0,37
14194,2019,Montenegro,Norway,5,0,0,5
14195,2019,Myanmar,Norway,109,0,0,109
14196,2019,Nepal,Norway,5,0,0,5
14197,2019,Nicaragua,Norway,0,19,0,19
14198,2019,Nigeria,Norway,163,5,0,168
14199,2019,Pakistan,Norway,96,21,0,117
14200,2019,Peru,Norway,0,10,0,10
14201,2019,Philippines,Norway,6,0,0,6
14202,2019,Russian Federation,Norway,587,50,0,637
14203,2019,Rwanda,Norway,36,6,0,42
14204,2019,El Salvador,Norway,10,0,0,10
14205,2019,Saudi Arabia,Norway,8,0,0,8
14206,2019,Serbia and Kosovo: S/RES/1244 (1999),Norway,51,11,0,62
14207,2019,Sierra Leone,Norway,12,0,0,12
14208,2019,Somalia,Norway,6518,40,0,6558
14209,2019,Viet Nam,Norway,42,5,0,47
14210,2019,Sudan,Norway,1906,15,0,1921
14211,2019,South Sudan,Norway,17,0,0,17
14212,2019,Syrian Arab Rep.,Norway,14359,252,0,14611
14213,2019,Tajikistan,Norway,5,0,0,5
14214,2019,Turkmenistan,Norway,5,0,0,5
14215,2019,Tunisia,Norway,5,5,0,10
14216,2019,Türkiye,Norway,1021,300,0,1321
14217,2019,Uganda,Norway,120,7,0,127
14218,2019,Ukraine,Norway,10,15,0,25
14219,2019,Uzbekistan,Norway,191,0,0,191
14220,2019,Venezuela (Bolivarian Republic of),Norway,15,24,0,39
14221,2019,Yemen,Norway,219,19,0,238
14222,2019,Zambia,Norway,5,0,0,5
14223,2019,Zimbabwe,Norway,12,0,0,12
14224,2019,Stateless,Norway,2623,124,0,2747
14225,2019,Afghanistan,Nauru,25,5,0,30
14226,2019,Bangladesh,Nauru,14,27,0,41
14227,2019,India,Nauru,0,11,0,11
14228,2019,Indonesia,Nauru,0,5,0,5
14229,2019,Iran (Islamic Rep. of),Nauru,345,209,0,554
14230,2019,Iraq,Nauru,39,13,0,52
14231,2019,Kuwait,Nauru,5,0,0,5
14232,2019,Lebanon,Nauru,14,0,0,14
14233,2019,Sri Lanka,Nauru,73,51,0,124
14234,2019,Malaysia,Nauru,0,5,0,5
14235,2019,Myanmar,Nauru,66,13,0,79
14236,2019,Nepal,Nauru,0,15,0,15
14237,2019,Pakistan,Nauru,42,26,0,68
14238,2019,Somalia,Nauru,78,10,0,88
14239,2019,Sudan,Nauru,11,0,0,11
14240,2019,Syrian Arab Rep.,Nauru,0,5,0,5
14241,2019,Stateless,Nauru,43,20,0,63
14242,2019,Afghanistan,New Zealand,46,31,0,77
14243,2019,Algeria,New Zealand,5,0,0,5
14244,2019,Egypt,New Zealand,35,5,0,40
14245,2019,Bahrain,New Zealand,26,0,0,26
14246,2019,Bangladesh,New Zealand,7,21,0,28
14247,2019,Brazil,New Zealand,0,7,0,7
14248,2019,China,New Zealand,228,74,0,302
14249,2019,Chile,New Zealand,5,7,0,12
14250,2019,Cameroon,New Zealand,5,0,0,5
14251,2019,Dem. Rep. of the Congo,New Zealand,5,0,0,5
14252,2019,Colombia,New Zealand,30,10,0,40
14253,2019,Czechia,New Zealand,22,5,0,27
14254,2019,Eritrea,New Zealand,7,0,0,7
14255,2019,Ethiopia,New Zealand,7,9,0,16
14256,2019,Fiji,New Zealand,27,9,0,36
14257,2019,Palestinian,New Zealand,17,0,0,17
14258,2019,Hungary,New Zealand,8,0,0,8
14259,2019,India,New Zealand,11,59,0,70
14260,2019,Indonesia,New Zealand,5,5,0,10
14261,2019,Iran (Islamic Rep. of),New Zealand,129,34,0,163
14262,2019,Iraq,New Zealand,77,5,0,82
14263,2019,Jordan,New Zealand,8,0,0,8
14264,2019,Kuwait,New Zealand,7,0,0,7
14265,2019,Libya,New Zealand,22,0,0,22
14266,2019,Sri Lanka,New Zealand,50,53,0,103
14267,2019,Madagascar,New Zealand,5,0,0,5
14268,2019,Maldives,New Zealand,5,0,0,5
14269,2019,Mexico,New Zealand,5,5,0,10
14270,2019,Malaysia,New Zealand,9,24,0,33
14271,2019,Mongolia,New Zealand,0,11,0,11
14272,2019,Myanmar,New Zealand,12,0,0,12
14273,2019,Nepal,New Zealand,5,5,0,10
14274,2019,Pakistan,New Zealand,63,11,0,74
14275,2019,Philippines,New Zealand,7,6,0,13
14276,2019,Papua New Guinea,New Zealand,0,5,0,5
14277,2019,South Africa,New Zealand,8,10,0,18
14278,2019,Russian Federation,New Zealand,26,7,0,33
14279,2019,El Salvador,New Zealand,5,0,0,5
14280,2019,Saudi Arabia,New Zealand,68,5,0,73
14281,2019,Somalia,New Zealand,13,0,0,13
14282,2019,Viet Nam,New Zealand,9,5,0,14
14283,2019,Sudan,New Zealand,8,0,0,8
14284,2019,Syrian Arab Rep.,New Zealand,69,5,0,74
14285,2019,Tonga,New Zealand,0,5,0,5
14286,2019,Türkiye,New Zealand,55,13,0,68
14287,2019,Uganda,New Zealand,5,0,0,5
14288,2019,Yemen,New Zealand,8,0,0,8
14289,2019,Zimbabwe,New Zealand,20,0,0,20
14290,2019,Stateless,New Zealand,0,0,0,0
14291,2019,Unknown ,New Zealand,515,107,0,622
14292,2019,Iraq,Oman,295,254,0,549
14293,2019,Pakistan,Oman,5,0,0,5
14294,2019,Syrian Arab Rep.,Oman,8,0,0,8
14295,2019,Afghanistan,Pakistan,1419084,8406,0,1427490
14296,2019,Algeria,Pakistan,22,0,0,22
14297,2019,China,Pakistan,5,15,0,20
14298,2019,Palestinian,Pakistan,21,0,0,21
14299,2019,India,Pakistan,0,5,0,5
14300,2019,Iran (Islamic Rep. of),Pakistan,40,21,0,61
14301,2019,Iraq,Pakistan,22,7,0,29
14302,2019,Myanmar,Pakistan,23,31,0,54
14303,2019,Pakistan,Pakistan,0,0,100680,0
14304,2019,Russian Federation,Pakistan,6,0,0,6
14305,2019,Somalia,Pakistan,181,21,0,202
14306,2019,Syrian Arab Rep.,Pakistan,43,0,0,43
14307,2019,Tajikistan,Pakistan,6,0,0,6
14308,2019,Türkiye,Pakistan,6,0,0,6
14309,2019,Yemen,Pakistan,137,22,0,159
14310,2019,Afghanistan,Panama,5,6,0,11
14311,2019,Armenia,Panama,0,5,0,5
14312,2019,Bangladesh,Panama,0,18,0,18
14313,2019,Belarus,Panama,7,5,0,12
14314,2019,Brazil,Panama,0,6,0,6
14315,2019,Bosnia and Herzegovina,Panama,5,0,0,5
14316,2019,Cameroon,Panama,9,5,0,14
14317,2019,Dem. Rep. of the Congo,Panama,5,0,0,5
14318,2019,Colombia,Panama,1702,1897,0,3599
14319,2019,Costa Rica,Panama,0,5,0,5
14320,2019,Cuba,Panama,120,2662,0,2782
14321,2019,Dominican Rep.,Panama,5,5,0,10
14322,2019,Ecuador,Panama,0,25,0,25
14323,2019,Eritrea,Panama,0,39,0,39
14324,2019,Guatemala,Panama,12,14,0,26
14325,2019,Haiti,Panama,19,0,0,19
14326,2019,Honduras,Panama,0,114,0,114
14327,2019,Croatia,Panama,5,0,0,5
14328,2019,Cote d'Ivoire,Panama,0,5,0,5
14329,2019,India,Panama,0,5,0,5
14330,2019,Iran (Islamic Rep. of),Panama,5,0,0,5
14331,2019,Italy,Panama,0,5,0,5
14332,2019,Jamaica,Panama,0,8,0,8
14333,2019,Kenya,Panama,0,5,0,5
14334,2019,Liberia,Panama,5,0,0,5
14335,2019,Sri Lanka,Panama,0,7,0,7
14336,2019,Mexico,Panama,6,0,0,6
14337,2019,Nepal,Panama,0,12,0,12
14338,2019,Nicaragua,Panama,178,7550,0,7728
14339,2019,Nigeria,Panama,10,35,0,45
14340,2019,Pakistan,Panama,0,29,0,29
14341,2019,Peru,Panama,23,5,0,28
14342,2019,El Salvador,Panama,344,1357,0,1701
14343,2019,Sierra Leone,Panama,5,0,0,5
14344,2019,Somalia,Panama,0,103,0,103
14345,2019,Sudan,Panama,5,0,0,5
14346,2019,Syrian Arab Rep.,Panama,0,12,0,12
14347,2019,Ukraine,Panama,0,5,0,5
14348,2019,Venezuela (Bolivarian Republic of),Panama,61,3724,0,3785
14349,2019,Argentina,Paraguay,0,6,0,6
14350,2019,Bolivia (Plurinational State of),Paraguay,16,0,0,16
14351,2019,Brazil,Paraguay,0,5,0,5
14352,2019,Cameroon,Paraguay,0,5,0,5
14353,2019,Colombia,Paraguay,17,18,0,35
14354,2019,Cuba,Paraguay,109,617,0,726
14355,2019,Iraq,Paraguay,6,0,0,6
14356,2019,Lebanon,Paraguay,0,5,0,5
14357,2019,Sri Lanka,Paraguay,5,0,0,5
14358,2019,Nigeria,Paraguay,0,5,0,5
14359,2019,Peru,Paraguay,5,0,0,5
14360,2019,El Salvador,Paraguay,13,0,0,13
14361,2019,Syrian Arab Rep.,Paraguay,88,11,0,99
14362,2019,Türkiye,Paraguay,5,0,0,5
14363,2019,Venezuela (Bolivarian Republic of),Paraguay,750,8,0,758
14364,2019,Angola,Peru,0,7,0,7
14365,2019,Argentina,Peru,0,12,0,12
14366,2019,Bangladesh,Peru,26,0,0,26
14367,2019,Bolivia (Plurinational State of),Peru,20,18,0,38
14368,2019,Brazil,Peru,5,10,0,15
14369,2019,China,Peru,0,12,0,12
14370,2019,Chile,Peru,0,8,0,8
14371,2019,Cameroon,Peru,20,0,0,20
14372,2019,Congo,Peru,0,9,0,9
14373,2019,Dem. Rep. of the Congo,Peru,8,0,0,8
14374,2019,Colombia,Peru,705,1230,0,1935
14375,2019,Costa Rica,Peru,0,5,0,5
14376,2019,Cuba,Peru,477,2693,0,3170
14377,2019,Dominican Rep.,Peru,19,41,0,60
14378,2019,Ecuador,Peru,0,98,0,98
14379,2019,Ethiopia,Peru,5,0,0,5
14380,2019,Gambia,Peru,5,0,0,5
14381,2019,Palestinian,Peru,41,8,0,49
14382,2019,Ghana,Peru,5,0,0,5
14383,2019,Haiti,Peru,78,63,0,141
14384,2019,Honduras,Peru,0,5,0,5
14385,2019,India,Peru,6,0,0,6
14386,2019,Iran (Islamic Rep. of),Peru,6,5,0,11
14387,2019,Iraq,Peru,42,0,0,42
14388,2019,Sri Lanka,Peru,0,6,0,6
14389,2019,Mexico,Peru,0,6,0,6
14390,2019,Morocco,Peru,0,5,0,5
14391,2019,Nepal,Peru,0,5,0,5
14392,2019,Nicaragua,Peru,7,6,0,13
14393,2019,Nigeria,Peru,24,8,0,32
14394,2019,Pakistan,Peru,0,10,0,10
14395,2019,Panama,Peru,0,9,0,9
14396,2019,Paraguay,Peru,0,5,0,5
14397,2019,Philippines,Peru,0,19,0,19
14398,2019,Poland,Peru,0,5,0,5
14399,2019,Portugal,Peru,0,14,0,14
14400,2019,Russian Federation,Peru,0,5,0,5
14401,2019,El Salvador,Peru,6,8,0,14
14402,2019,Spain,Peru,0,15,0,15
14403,2019,Syrian Arab Rep.,Peru,42,12,0,54
14404,2019,Turkmenistan,Peru,0,8,0,8
14405,2019,Türkiye,Peru,41,44,0,85
14406,2019,Ukraine,Peru,17,0,0,17
14407,2019,Uruguay,Peru,0,5,0,5
14408,2019,United States of America,Peru,0,5,0,5
14409,2019,Venezuela (Bolivarian Republic of),Peru,1230,482571,0,483801
14410,2019,Yemen,Peru,0,54,0,54
14411,2019,Unknown ,Peru,15,0,0,15
14412,2019,Afghanistan,Philippines,14,6,0,20
14413,2019,Burundi,Philippines,13,0,0,13
14414,2019,Cambodia,Philippines,13,5,0,18
14415,2019,China,Philippines,5,5,0,10
14416,2019,Cameroon,Philippines,24,37,0,61
14417,2019,Dem. Rep. of the Congo,Philippines,9,5,0,14
14418,2019,Eritrea,Philippines,19,5,0,24
14419,2019,Ethiopia,Philippines,5,0,0,5
14420,2019,Palestinian,Philippines,54,12,0,66
14421,2019,Ghana,Philippines,5,0,0,5
14422,2019,Guinea,Philippines,0,5,0,5
14423,2019,Cote d'Ivoire,Philippines,27,25,0,52
14424,2019,Iran (Islamic Rep. of),Philippines,68,14,0,82
14425,2019,Iraq,Philippines,43,12,0,55
14426,2019,Liberia,Philippines,5,5,0,10
14427,2019,Lebanon,Philippines,5,0,0,5
14428,2019,Sri Lanka,Philippines,20,0,0,20
14429,2019,Morocco,Philippines,5,0,0,5
14430,2019,Myanmar,Philippines,7,0,0,7
14431,2019,Nigeria,Philippines,6,12,0,18
14432,2019,Pakistan,Philippines,88,17,0,105
14433,2019,Philippines,Philippines,0,0,178897,0
14434,2019,Russian Federation,Philippines,5,0,0,5
14435,2019,Saudi Arabia,Philippines,8,5,0,13
14436,2019,Somalia,Philippines,31,14,0,45
14437,2019,Viet Nam,Philippines,11,0,0,11
14438,2019,Sudan,Philippines,6,25,0,31
14439,2019,Syrian Arab Rep.,Philippines,115,41,0,156
14440,2019,Türkiye,Philippines,49,17,0,66
14441,2019,United States of America,Philippines,0,5,0,5
14442,2019,Yemen,Philippines,15,40,0,55
14443,2019,Stateless,Philippines,5,0,0,5
14444,2019,Unknown ,Philippines,0,7,0,7
14445,2019,Afghanistan,Papua New Guinea,43,5,0,48
14446,2019,Bangladesh,Papua New Guinea,14,0,0,14
14447,2019,India,Papua New Guinea,0,5,0,5
14448,2019,Indonesia,Papua New Guinea,9368,0,0,9368
14449,2019,Iran (Islamic Rep. of),Papua New Guinea,100,112,0,212
14450,2019,Iraq,Papua New Guinea,35,5,0,40
14451,2019,Sri Lanka,Papua New Guinea,10,0,0,10
14452,2019,Myanmar,Papua New Guinea,5,0,0,5
14453,2019,Pakistan,Papua New Guinea,40,5,0,45
14454,2019,Somalia,Papua New Guinea,19,0,0,19
14455,2019,Sudan,Papua New Guinea,55,0,0,55
14456,2019,Stateless,Papua New Guinea,9,0,0,9
14457,2019,Afghanistan,Poland,121,16,0,137
14458,2019,Algeria,Poland,5,10,0,15
14459,2019,Angola,Poland,0,5,0,5
14460,2019,Egypt,Poland,71,16,0,87
14461,2019,Armenia,Poland,78,49,0,127
14462,2019,Azerbaijan,Poland,8,19,0,27
14463,2019,Bangladesh,Poland,8,16,0,24
14464,2019,Burkina Faso,Poland,0,5,0,5
14465,2019,Belarus,Poland,201,63,0,264
14466,2019,Central African Rep.,Poland,5,0,0,5
14467,2019,China,Poland,21,6,0,27
14468,2019,Cameroon,Poland,11,0,0,11
14469,2019,Congo,Poland,8,0,0,8
14470,2019,Dem. Rep. of the Congo,Poland,6,0,0,6
14471,2019,Cuba,Poland,17,11,0,28
14472,2019,Eritrea,Poland,32,0,0,32
14473,2019,Ethiopia,Poland,5,5,0,10
14474,2019,Gambia,Poland,0,5,0,5
14475,2019,Palestinian,Poland,17,8,0,25
14476,2019,Georgia,Poland,71,96,0,167
14477,2019,Guinea,Poland,0,6,0,6
14478,2019,India,Poland,5,20,0,25
14479,2019,Iran (Islamic Rep. of),Poland,54,31,0,85
14480,2019,Iraq,Poland,272,24,0,296
14481,2019,Jordan,Poland,0,5,0,5
14482,2019,Kazakhstan,Poland,64,48,0,112
14483,2019,Kenya,Poland,5,0,0,5
14484,2019,Kyrgyzstan,Poland,59,79,0,138
14485,2019,Libya,Poland,31,7,0,38
14486,2019,Lebanon,Poland,0,22,0,22
14487,2019,Sri Lanka,Poland,49,0,0,49
14488,2019,Rep. of Moldova,Poland,5,6,0,11
14489,2019,Mongolia,Poland,19,0,0,19
14490,2019,Nepal,Poland,8,0,0,8
14491,2019,Nigeria,Poland,11,10,0,21
14492,2019,Pakistan,Poland,32,22,0,54
14493,2019,Russian Federation,Poland,9870,3320,0,13190
14494,2019,Rwanda,Poland,5,0,0,5
14495,2019,Serbia and Kosovo: S/RES/1244 (1999),Poland,5,0,0,5
14496,2019,Senegal,Poland,5,5,0,10
14497,2019,Sierra Leone,Poland,0,5,0,5
14498,2019,Somalia,Poland,50,0,0,50
14499,2019,Viet Nam,Poland,16,13,0,29
14500,2019,Sudan,Poland,5,0,0,5
14501,2019,Syrian Arab Rep.,Poland,542,23,0,565
14502,2019,Tajikistan,Poland,102,179,0,281
14503,2019,Turkmenistan,Poland,44,6,0,50
14504,2019,Tunisia,Poland,0,5,0,5
14505,2019,Türkiye,Poland,92,76,0,168
14506,2019,Uganda,Poland,6,5,0,11
14507,2019,Ukraine,Poland,485,515,0,1000
14508,2019,Uzbekistan,Poland,24,6,0,30
14509,2019,Venezuela (Bolivarian Republic of),Poland,0,5,0,5
14510,2019,Yemen,Poland,9,0,0,9
14511,2019,Stateless,Poland,99,10,0,109
14512,2019,Afghanistan,Portugal,20,5,0,25
14513,2019,Albania,Portugal,0,5,0,5
14514,2019,Algeria,Portugal,0,5,0,5
14515,2019,Angola,Portugal,0,216,0,216
14516,2019,Egypt,Portugal,0,9,0,9
14517,2019,Armenia,Portugal,5,0,0,5
14518,2019,Benin,Portugal,0,5,0,5
14519,2019,Bangladesh,Portugal,5,5,0,10
14520,2019,Belarus,Portugal,16,0,0,16
14521,2019,Brazil,Portugal,0,18,0,18
14522,2019,Bosnia and Herzegovina,Portugal,10,0,0,10
14523,2019,Central African Rep.,Portugal,8,0,0,8
14524,2019,China,Portugal,0,7,0,7
14525,2019,Cameroon,Portugal,15,21,0,36
14526,2019,Congo,Portugal,9,5,0,14
14527,2019,Dem. Rep. of the Congo,Portugal,55,36,0,91
14528,2019,Colombia,Portugal,45,17,0,62
14529,2019,Cuba,Portugal,5,12,0,17
14530,2019,Eritrea,Portugal,195,12,0,207
14531,2019,Ethiopia,Portugal,6,0,0,6
14532,2019,Gambia,Portugal,5,75,0,80
14533,2019,Palestinian,Portugal,5,0,0,5
14534,2019,Georgia,Portugal,0,5,0,5
14535,2019,Ghana,Portugal,0,16,0,16
14536,2019,Guinea-Bissau,Portugal,9,79,0,88
14537,2019,Guinea,Portugal,103,57,0,160
14538,2019,Cote d'Ivoire,Portugal,32,12,0,44
14539,2019,Iran (Islamic Rep. of),Portugal,41,23,0,64
14540,2019,Iraq,Portugal,181,5,0,186
14541,2019,Jordan,Portugal,0,5,0,5
14542,2019,Kenya,Portugal,6,7,0,13
14543,2019,Libya,Portugal,15,10,0,25
14544,2019,Sri Lanka,Portugal,34,5,0,39
14545,2019,Mauritania,Portugal,5,0,0,5
14546,2019,Mali,Portugal,13,16,0,29
14547,2019,Morocco,Portugal,9,28,0,37
14548,2019,Nigeria,Portugal,25,48,0,73
14549,2019,Pakistan,Portugal,69,12,0,81
14550,2019,Russian Federation,Portugal,16,9,0,25
14551,2019,Rwanda,Portugal,5,0,0,5
14552,2019,Senegal,Portugal,6,27,0,33
14553,2019,Sierra Leone,Portugal,26,25,0,51
14554,2019,Somalia,Portugal,33,5,0,38
14555,2019,Sao Tome and Principe,Portugal,0,5,0,5
14556,2019,Sudan,Portugal,49,12,0,61
14557,2019,South Sudan,Portugal,30,0,0,30
14558,2019,Syrian Arab Rep.,Portugal,768,5,0,773
14559,2019,Togo,Portugal,7,13,0,20
14560,2019,Türkiye,Portugal,8,10,0,18
14561,2019,Uganda,Portugal,5,0,0,5
14562,2019,Ukraine,Portugal,436,93,0,529
14563,2019,Venezuela (Bolivarian Republic of),Portugal,0,67,0,67
14564,2019,Yemen,Portugal,9,0,0,9
14565,2019,Stateless,Portugal,31,5,0,36
14566,2019,Egypt,Qatar,13,8,0,21
14567,2019,Eritrea,Qatar,0,5,0,5
14568,2019,Iraq,Qatar,141,73,0,214
14569,2019,Somalia,Qatar,9,0,0,9
14570,2019,Sudan,Qatar,0,13,0,13
14571,2019,Syrian Arab Rep.,Qatar,34,0,0,34
14572,2019,Yemen,Qatar,5,0,0,5
14573,2019,Stateless,Qatar,0,0,0,0
14574,2019,Afghanistan,Romania,148,67,0,215
14575,2019,Algeria,Romania,0,55,0,55
14576,2019,Angola,Romania,5,0,0,5
14577,2019,Egypt,Romania,19,25,0,44
14578,2019,Burundi,Romania,7,0,0,7
14579,2019,Bangladesh,Romania,6,14,0,20
14580,2019,Central African Rep.,Romania,7,0,0,7
14581,2019,Cameroon,Romania,23,11,0,34
14582,2019,Congo,Romania,6,0,0,6
14583,2019,Dem. Rep. of the Congo,Romania,21,5,0,26
14584,2019,Comoros,Romania,5,0,0,5
14585,2019,Cuba,Romania,0,5,0,5
14586,2019,Eritrea,Romania,45,5,0,50
14587,2019,Ethiopia,Romania,7,5,0,12
14588,2019,Gambia,Romania,5,0,0,5
14589,2019,Palestinian,Romania,58,15,0,73
14590,2019,Guinea,Romania,5,0,0,5
14591,2019,India,Romania,0,15,0,15
14592,2019,Iran (Islamic Rep. of),Romania,116,60,0,176
14593,2019,Iraq,Romania,881,278,0,1159
14594,2019,Jordan,Romania,6,5,0,11
14595,2019,Liberia,Romania,5,0,0,5
14596,2019,Libya,Romania,0,30,0,30
14597,2019,Lebanon,Romania,5,0,0,5
14598,2019,Sri Lanka,Romania,0,5,0,5
14599,2019,Rep. of Moldova,Romania,0,5,0,5
14600,2019,Morocco,Romania,0,46,0,46
14601,2019,Myanmar,Romania,26,0,0,26
14602,2019,Nigeria,Romania,5,5,0,10
14603,2019,Pakistan,Romania,42,7,0,49
14604,2019,South Africa,Romania,0,5,0,5
14605,2019,Rwanda,Romania,7,5,0,12
14606,2019,Sierra Leone,Romania,5,0,0,5
14607,2019,Somalia,Romania,99,27,0,126
14608,2019,Sudan,Romania,16,0,0,16
14609,2019,Syrian Arab Rep.,Romania,2090,146,0,2236
14610,2019,Tunisia,Romania,0,21,0,21
14611,2019,Türkiye,Romania,39,35,0,74
14612,2019,Uganda,Romania,5,0,0,5
14613,2019,Ukraine,Romania,22,5,0,27
14614,2019,Yemen,Romania,29,0,0,29
14615,2019,Zimbabwe,Romania,6,0,0,6
14616,2019,Stateless,Romania,89,9,0,98
14617,2019,Afghanistan,South Africa,0,24,0,24
14618,2019,Algeria,South Africa,5,230,0,235
14619,2019,Angola,South Africa,23,12,0,35
14620,2019,Egypt,South Africa,7,265,0,272
14621,2019,Bahrain,South Africa,0,10,0,10
14622,2019,Burundi,South Africa,2699,7171,0,9870
14623,2019,Benin,South Africa,5,47,0,52
14624,2019,Bangladesh,South Africa,205,28347,0,28552
14625,2019,Bahamas,South Africa,0,14,0,14
14626,2019,Burkina Faso,South Africa,0,44,0,44
14627,2019,Botswana,South Africa,0,5,0,5
14628,2019,Bulgaria,South Africa,5,0,0,5
14629,2019,Central African Rep.,South Africa,9,6,0,15
14630,2019,Chad,South Africa,5,5,0,10
14631,2019,China,South Africa,0,87,0,87
14632,2019,Cameroon,South Africa,328,1983,0,2311
14633,2019,Congo,South Africa,4552,8115,0,12667
14634,2019,Dem. Rep. of the Congo,South Africa,23160,36120,0,59280
14635,2019,Comoros,South Africa,0,20,0,20
14636,2019,Eritrea,South Africa,1574,1098,0,2672
14637,2019,Estonia,South Africa,5,12,0,17
14638,2019,Ethiopia,South Africa,15990,51288,0,67278
14639,2019,Gabon,South Africa,0,12,0,12
14640,2019,Gambia,South Africa,0,5,0,5
14641,2019,Palestinian,South Africa,39,13,0,52
14642,2019,Ghana,South Africa,7,1854,0,1861
14643,2019,Guinea-Bissau,South Africa,0,9,0,9
14644,2019,Guinea,South Africa,0,59,0,59
14645,2019,Cote d'Ivoire,South Africa,28,177,0,205
14646,2019,India,South Africa,5,4665,0,4670
14647,2019,Iraq,South Africa,14,6,0,20
14648,2019,Jordan,South Africa,5,11,0,16
14649,2019,Kenya,South Africa,143,1034,0,1177
14650,2019,Liberia,South Africa,50,69,0,119
14651,2019,Libya,South Africa,0,5,0,5
14652,2019,Lesotho,South Africa,0,27,0,27
14653,2019,Sri Lanka,South Africa,10,18,0,28
14654,2019,Mali,South Africa,5,133,0,138
14655,2019,Malawi,South Africa,8,2015,0,2023
14656,2019,Morocco,South Africa,5,11,0,16
14657,2019,Mozambique,South Africa,0,412,0,412
14658,2019,Nepal,South Africa,0,146,0,146
14659,2019,Niger,South Africa,0,736,0,736
14660,2019,Nigeria,South Africa,9,6372,0,6381
14661,2019,Pakistan,South Africa,12,10281,0,10293
14662,2019,Russian Federation,South Africa,10,0,0,10
14663,2019,Rwanda,South Africa,1067,1083,0,2150
14664,2019,Senegal,South Africa,5,913,0,918
14665,2019,Sierra Leone,South Africa,20,13,0,33
14666,2019,Solomon Islands,South Africa,7,0,0,7
14667,2019,Somalia,South Africa,23635,5054,0,28689
14668,2019,Sudan,South Africa,95,62,0,157
14669,2019,Eswatini,South Africa,7,19,0,26
14670,2019,Syrian Arab Rep.,South Africa,40,20,0,60
14671,2019,United Rep. of Tanzania,South Africa,33,568,0,601
14672,2019,Thailand,South Africa,0,46,0,46
14673,2019,Timor-Leste,South Africa,0,7,0,7
14674,2019,Togo,South Africa,12,31,0,43
14675,2019,Türkiye,South Africa,5,5,0,10
14676,2019,Uganda,South Africa,472,4374,0,4846
14677,2019,Ukraine,South Africa,5,0,0,5
14678,2019,Yemen,South Africa,5,15,0,20
14679,2019,Zambia,South Africa,62,227,0,289
14680,2019,Zimbabwe,South Africa,4003,12825,0,16828
14681,2019,Afghanistan,Russian Federation,795,268,0,1063
14682,2019,Egypt,Russian Federation,0,5,0,5
14683,2019,Armenia,Russian Federation,0,5,0,5
14684,2019,Azerbaijan,Russian Federation,18,11,0,29
14685,2019,Belgium,Russian Federation,0,23,0,23
14686,2019,Bangladesh,Russian Federation,5,0,0,5
14687,2019,Cameroon,Russian Federation,5,0,0,5
14688,2019,Congo,Russian Federation,5,0,0,5
14689,2019,Dem. Rep. of the Congo,Russian Federation,5,5,0,10
14690,2019,Palestinian,Russian Federation,10,0,0,10
14691,2019,Georgia,Russian Federation,147,5,0,152
14692,2019,Germany,Russian Federation,11,5,0,16
14693,2019,Cote d'Ivoire,Russian Federation,5,0,0,5
14694,2019,Iran (Islamic Rep. of),Russian Federation,5,0,0,5
14695,2019,Iraq,Russian Federation,17,5,0,22
14696,2019,Kazakhstan,Russian Federation,12,13,0,25
14697,2019,Kyrgyzstan,Russian Federation,32,14,0,46
14698,2019,Rep. of Korea,Russian Federation,5,0,0,5
14699,2019,Dem. People's Rep. of Korea,Russian Federation,50,7,0,57
14700,2019,Lebanon,Russian Federation,6,0,0,6
14701,2019,Latvia,Russian Federation,5,0,0,5
14702,2019,Rep. of Moldova,Russian Federation,30,8,0,38
14703,2019,Nigeria,Russian Federation,0,5,0,5
14704,2019,Pakistan,Russian Federation,5,0,0,5
14705,2019,Sudan,Russian Federation,6,0,0,6
14706,2019,Syrian Arab Rep.,Russian Federation,593,110,0,703
14707,2019,Tajikistan,Russian Federation,40,22,0,62
14708,2019,Turkmenistan,Russian Federation,12,5,0,17
14709,2019,Türkiye,Russian Federation,5,0,0,5
14710,2019,Ukraine,Russian Federation,40393,858,0,41251
14711,2019,Uzbekistan,Russian Federation,61,33,0,94
14712,2019,Yemen,Russian Federation,97,20,0,117
14713,2019,Stateless,Russian Federation,28,13,0,41
14714,2019,Unknown ,Russian Federation,5,5,0,10
14715,2019,Angola,Rwanda,8,0,0,8
14716,2019,Burundi,Rwanda,71488,77,0,71565
14717,2019,Chad,Rwanda,5,0,0,5
14718,2019,Cameroon,Rwanda,0,5,0,5
14719,2019,Dem. Rep. of the Congo,Rwanda,73408,228,0,73636
14720,2019,Eritrea,Rwanda,104,143,0,247
14721,2019,Ethiopia,Rwanda,5,6,0,11
14722,2019,Rwanda,Rwanda,0,0,0,0
14723,2019,Somalia,Rwanda,18,24,0,42
14724,2019,Sudan,Rwanda,13,5,0,18
14725,2019,South Sudan,Rwanda,5,5,0,10
14726,2019,Colombia,El Salvador,5,6,0,11
14727,2019,Cuba,El Salvador,0,5,0,5
14728,2019,Honduras,El Salvador,19,8,0,27
14729,2019,Iraq,El Salvador,5,0,0,5
14730,2019,Mexico,El Salvador,5,0,0,5
14731,2019,Nicaragua,El Salvador,9,10,0,19
14732,2019,El Salvador,El Salvador,0,0,71500,0
14733,2019,Syrian Arab Rep.,El Salvador,5,0,0,5
14734,2019,Chad,Saudi Arabia,9,0,0,9
14735,2019,China,Saudi Arabia,14,14,0,28
14736,2019,Eritrea,Saudi Arabia,42,0,0,42
14737,2019,Palestinian,Saudi Arabia,8,14,0,22
14738,2019,Iraq,Saudi Arabia,31,30,0,61
14739,2019,Liberia,Saudi Arabia,9,0,0,9
14740,2019,Somalia,Saudi Arabia,16,0,0,16
14741,2019,Sudan,Saudi Arabia,0,5,0,5
14742,2019,Syrian Arab Rep.,Saudi Arabia,152,2220,0,2372
14743,2019,Tunisia,Saudi Arabia,7,0,0,7
14744,2019,Yemen,Saudi Arabia,27,44,0,71
14745,2019,Stateless,Saudi Arabia,0,0,0,0
14746,2019,Afghanistan,Serbia and Kosovo: S/RES/1244 (1999),19,10,0,29
14747,2019,Algeria,Serbia and Kosovo: S/RES/1244 (1999),0,5,0,5
14748,2019,Burundi,Serbia and Kosovo: S/RES/1244 (1999),0,26,0,26
14749,2019,Bangladesh,Serbia and Kosovo: S/RES/1244 (1999),0,6,0,6
14750,2019,Bosnia and Herzegovina,Serbia and Kosovo: S/RES/1244 (1999),8198,0,0,8198
14751,2019,Congo,Serbia and Kosovo: S/RES/1244 (1999),0,7,0,7
14752,2019,Dem. Rep. of the Congo,Serbia and Kosovo: S/RES/1244 (1999),0,5,0,5
14753,2019,Cuba,Serbia and Kosovo: S/RES/1244 (1999),7,0,0,7
14754,2019,Ethiopia,Serbia and Kosovo: S/RES/1244 (1999),5,0,0,5
14755,2019,Palestinian,Serbia and Kosovo: S/RES/1244 (1999),0,7,0,7
14756,2019,Guinea,Serbia and Kosovo: S/RES/1244 (1999),0,6,0,6
14757,2019,Croatia,Serbia and Kosovo: S/RES/1244 (1999),17972,0,0,17972
14758,2019,Iran (Islamic Rep. of),Serbia and Kosovo: S/RES/1244 (1999),12,59,0,71
14759,2019,Iraq,Serbia and Kosovo: S/RES/1244 (1999),13,9,0,22
14760,2019,Libya,Serbia and Kosovo: S/RES/1244 (1999),45,0,0,45
14761,2019,Morocco,Serbia and Kosovo: S/RES/1244 (1999),0,20,0,20
14762,2019,Nigeria,Serbia and Kosovo: S/RES/1244 (1999),0,10,0,10
14763,2019,Pakistan,Serbia and Kosovo: S/RES/1244 (1999),5,0,0,5
14764,2019,Russian Federation,Serbia and Kosovo: S/RES/1244 (1999),5,7,0,12
14765,2019,Serbia and Kosovo: S/RES/1244 (1999),Serbia and Kosovo: S/RES/1244 (1999),0,0,214696,0
14766,2019,Somalia,Serbia and Kosovo: S/RES/1244 (1999),5,20,0,25
14767,2019,Sudan,Serbia and Kosovo: S/RES/1244 (1999),5,0,0,5
14768,2019,Syrian Arab Rep.,Serbia and Kosovo: S/RES/1244 (1999),25,25,0,50
14769,2019,Tunisia,Serbia and Kosovo: S/RES/1244 (1999),0,5,0,5
14770,2019,Türkiye,Serbia and Kosovo: S/RES/1244 (1999),96,32,0,128
14771,2019,Ukraine,Serbia and Kosovo: S/RES/1244 (1999),15,0,0,15
14772,2019,Yemen,Serbia and Kosovo: S/RES/1244 (1999),0,10,0,10
14773,2019,Stateless,Serbia and Kosovo: S/RES/1244 (1999),0,0,0,0
14774,2019,Unknown ,Serbia and Kosovo: S/RES/1244 (1999),0,5,0,5
14775,2019,Afghanistan,Senegal,0,5,0,5
14776,2019,Burundi,Senegal,8,8,0,16
14777,2019,Benin,Senegal,0,5,0,5
14778,2019,Burkina Faso,Senegal,0,5,0,5
14779,2019,Central African Rep.,Senegal,228,406,0,634
14780,2019,Chad,Senegal,8,22,0,30
14781,2019,Cameroon,Senegal,0,27,0,27
14782,2019,Congo,Senegal,0,86,0,86
14783,2019,Dem. Rep. of the Congo,Senegal,11,185,0,196
14784,2019,Eritrea,Senegal,0,13,0,13
14785,2019,Gambia,Senegal,10,336,0,346
14786,2019,Ghana,Senegal,0,5,0,5
14787,2019,Guinea-Bissau,Senegal,0,5,0,5
14788,2019,Guinea,Senegal,0,110,0,110
14789,2019,Haiti,Senegal,0,5,0,5
14790,2019,Cote d'Ivoire,Senegal,22,165,0,187
14791,2019,Liberia,Senegal,0,62,0,62
14792,2019,Sri Lanka,Senegal,0,6,0,6
14793,2019,Mauritania,Senegal,14150,68,0,14218
14794,2019,Mali,Senegal,0,64,0,64
14795,2019,Nigeria,Senegal,0,57,0,57
14796,2019,Rwanda,Senegal,13,7,0,20
14797,2019,Sierra Leone,Senegal,0,39,0,39
14798,2019,Sudan,Senegal,5,8,0,13
14799,2019,Syrian Arab Rep.,Senegal,0,14,0,14
14800,2019,Togo,Senegal,0,29,0,29
14801,2019,Türkiye,Senegal,12,49,0,61
14802,2019,Stateless,Singapore,0,0,0,0
14803,2019,Cote d'Ivoire,Sierra Leone,16,0,0,16
14804,2019,Liberia,Sierra Leone,425,0,0,425
14805,2019,Egypt,Somalia,0,26,0,26
14806,2019,Bangladesh,Somalia,6,0,0,6
14807,2019,Cameroon,Somalia,5,0,0,5
14808,2019,Djibouti,Somalia,0,14,0,14
14809,2019,Eritrea,Somalia,57,50,0,107
14810,2019,Ethiopia,Somalia,4287,17477,0,21764
14811,2019,Palestinian,Somalia,21,0,0,21
14812,2019,Iraq,Somalia,21,0,0,21
14813,2019,Mozambique,Somalia,0,5,0,5
14814,2019,Nigeria,Somalia,0,5,0,5
14815,2019,Pakistan,Somalia,0,5,0,5
14816,2019,Somalia,Somalia,0,0,2648000,0
14817,2019,Sudan,Somalia,5,15,0,20
14818,2019,Syrian Arab Rep.,Somalia,245,21,0,266
14819,2019,United Rep. of Tanzania,Somalia,0,121,0,121
14820,2019,Yemen,Somalia,13235,50,0,13285
14821,2019,Afghanistan,Spain,395,270,0,665
14822,2019,Albania,Spain,0,185,0,185
14823,2019,Algeria,Spain,61,1345,0,1406
14824,2019,Angola,Spain,6,70,0,76
14825,2019,Egypt,Spain,39,125,0,164
14826,2019,Argentina,Spain,0,300,0,300
14827,2019,Armenia,Spain,36,380,0,416
14828,2019,Azerbaijan,Spain,49,65,0,114
14829,2019,Burundi,Spain,6,0,0,6
14830,2019,Benin,Spain,5,15,0,20
14831,2019,Bangladesh,Spain,18,295,0,313
14832,2019,Burkina Faso,Spain,0,130,0,130
14833,2019,Belarus,Spain,10,95,0,105
14834,2019,Bolivia (Plurinational State of),Spain,9,115,0,124
14835,2019,Brazil,Spain,14,960,0,974
14836,2019,Canada,Spain,0,5,0,5
14837,2019,Central African Rep.,Spain,90,60,0,150
14838,2019,Chad,Spain,6,10,0,16
14839,2019,China,Spain,20,1010,0,1030
14840,2019,Chile,Spain,0,145,0,145
14841,2019,Cameroon,Spain,95,935,0,1030
14842,2019,Congo,Spain,42,80,0,122
14843,2019,Dem. Rep. of the Congo,Spain,50,280,0,330
14844,2019,Colombia,Spain,242,34110,0,34352
14845,2019,Costa Rica,Spain,0,65,0,65
14846,2019,Cuba,Spain,856,1645,0,2501
14847,2019,Djibouti,Spain,0,5,0,5
14848,2019,Dominican Rep.,Spain,8,220,0,228
14849,2019,Ecuador,Spain,0,240,0,240
14850,2019,Equatorial Guinea,Spain,30,70,0,100
14851,2019,Eritrea,Spain,291,65,0,356
14852,2019,Ethiopia,Spain,55,25,0,80
14853,2019,France,Spain,0,5,0,5
14854,2019,Gabon,Spain,0,10,0,10
14855,2019,Gambia,Spain,35,255,0,290
14856,2019,Palestinian,Spain,1184,1385,0,2569
14857,2019,United Kingdom of Great Britain and Northern Ireland,Spain,0,5,0,5
14858,2019,Georgia,Spain,18,2595,0,2613
14859,2019,Germany,Spain,0,5,0,5
14860,2019,Ghana,Spain,0,390,0,390
14861,2019,Guinea-Bissau,Spain,5,75,0,80
14862,2019,Guatemala,Spain,23,655,0,678
14863,2019,Guinea,Spain,24,1695,0,1719
14864,2019,Haiti,Spain,14,25,0,39
14865,2019,Honduras,Spain,281,9085,0,9366
14866,2019,Cote d'Ivoire,Spain,206,1100,0,1306
14867,2019,India,Spain,8,110,0,118
14868,2019,Iran (Islamic Rep. of),Spain,87,230,0,317
14869,2019,Iraq,Spain,292,250,0,542
14870,2019,Israel,Spain,0,10,0,10
14871,2019,Jamaica,Spain,32,25,0,57
14872,2019,Jordan,Spain,30,30,0,60
14873,2019,Kazakhstan,Spain,15,30,0,45
14874,2019,Kenya,Spain,0,20,0,20
14875,2019,Kyrgyzstan,Spain,9,15,0,24
14876,2019,Kuwait,Spain,0,5,0,5
14877,2019,Liberia,Spain,5,55,0,60
14878,2019,Libya,Spain,51,140,0,191
14879,2019,Lebanon,Spain,25,175,0,200
14880,2019,Sri Lanka,Spain,87,40,0,127
14881,2019,Mauritania,Spain,5,120,0,125
14882,2019,North Macedonia,Spain,0,15,0,15
14883,2019,Rep. of Moldova,Spain,0,40,0,40
14884,2019,Mexico,Spain,18,205,0,223
14885,2019,Mali,Spain,98,1755,0,1853
14886,2019,Mongolia,Spain,5,10,0,15
14887,2019,Morocco,Spain,366,1980,0,2346
14888,2019,Myanmar,Spain,8,0,0,8
14889,2019,Nepal,Spain,0,5,0,5
14890,2019,Niger,Spain,0,35,0,35
14891,2019,Nicaragua,Spain,182,6145,0,6327
14892,2019,Nigeria,Spain,87,1465,0,1552
14893,2019,Oman,Spain,0,5,0,5
14894,2019,Pakistan,Spain,407,1210,0,1617
14895,2019,Panama,Spain,0,70,0,70
14896,2019,Paraguay,Spain,5,355,0,360
14897,2019,Peru,Spain,26,3575,0,3601
14898,2019,Philippines,Spain,0,10,0,10
14899,2019,Portugal,Spain,0,5,0,5
14900,2019,South Africa,Spain,0,5,0,5
14901,2019,Russian Federation,Spain,211,1705,0,1916
14902,2019,Rwanda,Spain,5,5,0,10
14903,2019,El Salvador,Spain,274,6095,0,6369
14904,2019,Saudi Arabia,Spain,5,5,0,10
14905,2019,Serbia and Kosovo: S/RES/1244 (1999),Spain,6,25,0,31
14906,2019,Senegal,Spain,7,935,0,942
14907,2019,Sierra Leone,Spain,11,115,0,126
14908,2019,Somalia,Spain,747,140,0,887
14909,2019,Viet Nam,Spain,0,60,0,60
14910,2019,Sudan,Spain,63,145,0,208
14911,2019,South Sudan,Spain,5,5,0,10
14912,2019,Syrian Arab Rep.,Spain,14133,2805,0,16938
14913,2019,Tajikistan,Spain,5,15,0,20
14914,2019,Togo,Spain,13,45,0,58
14915,2019,Trinidad and Tobago,Spain,0,5,0,5
14916,2019,Tunisia,Spain,7,305,0,312
14917,2019,Türkiye,Spain,31,460,0,491
14918,2019,Uganda,Spain,5,5,0,10
14919,2019,Ukraine,Spain,631,6460,0,7091
14920,2019,Uruguay,Spain,0,120,0,120
14921,2019,United States of America,Spain,0,85,0,85
14922,2019,Uzbekistan,Spain,15,15,0,30
14923,2019,Venezuela (Bolivarian Republic of),Spain,35243,33960,0,69203
14924,2019,Western Sahara,Spain,19,50,0,69
14925,2019,Yemen,Spain,206,675,0,881
14926,2019,Zimbabwe,Spain,0,5,0,5
14927,2019,Stateless,Spain,0,5,0,5
14928,2019,Tibetan,Spain,5,0,0,5
14929,2019,Unknown ,Spain,33,30,0,63
14930,2019,Stateless,Viet Nam,0,0,0,0
14931,2019,Cuba,Saint Kitts and Nevis,5,0,0,5
14932,2019,Afghanistan,Sudan,0,0,0,0
14933,2019,Argentina,Sudan,0,0,0,0
14934,2019,Central African Rep.,Sudan,25961,0,0,25961
14935,2019,Chad,Sudan,3487,5,0,3492
14936,2019,Eritrea,Sudan,112904,7425,0,120329
14937,2019,Ethiopia,Sudan,6704,6913,0,13617
14938,2019,Palestinian,Sudan,0,0,0,0
14939,2019,Jordan,Sudan,0,0,0,0
14940,2019,Kuwait,Sudan,0,0,0,0
14941,2019,Somalia,Sudan,438,171,0,609
14942,2019,Sudan,Sudan,0,0,1885782,0
14943,2019,South Sudan,Sudan,810917,0,0,810917
14944,2019,Syrian Arab Rep.,Sudan,93495,0,0,93495
14945,2019,Yemen,Sudan,1227,452,0,1679
14946,2019,Unknown ,Sudan,356,575,0,931
14947,2019,Colombia,Suriname,0,5,0,5
14948,2019,Cuba,Suriname,36,1187,0,1223
14949,2019,Dominican Rep.,Suriname,0,14,0,14
14950,2019,Nigeria,Suriname,0,5,0,5
14951,2019,Venezuela (Bolivarian Republic of),Suriname,8,215,0,223
14952,2019,Burundi,South Sudan,55,844,0,899
14953,2019,Central African Rep.,South Sudan,2081,0,0,2081
14954,2019,Cameroon,South Sudan,0,5,0,5
14955,2019,Dem. Rep. of the Congo,South Sudan,16343,7,0,16350
14956,2019,Eritrea,South Sudan,202,2415,0,2617
14957,2019,Ethiopia,South Sudan,4065,362,0,4427
14958,2019,Somalia,South Sudan,0,31,0,31
14959,2019,Sudan,South Sudan,275563,13,0,275576
14960,2019,South Sudan,South Sudan,0,0,1665815,0
14961,2019,Afghanistan,Slovakia,276,0,0,276
14962,2019,Angola,Slovakia,24,0,0,24
14963,2019,Egypt,Slovakia,5,0,0,5
14964,2019,Armenia,Slovakia,34,0,0,34
14965,2019,Burundi,Slovakia,5,0,0,5
14966,2019,Bosnia and Herzegovina,Slovakia,36,0,0,36
14967,2019,Bulgaria,Slovakia,8,0,0,8
14968,2019,Cambodia,Slovakia,5,0,0,5
14969,2019,China,Slovakia,5,0,0,5
14970,2019,Cameroon,Slovakia,9,0,0,9
14971,2019,Dem. Rep. of the Congo,Slovakia,16,0,0,16
14972,2019,Cuba,Slovakia,32,0,0,32
14973,2019,Palestinian,Slovakia,7,0,0,7
14974,2019,Iran (Islamic Rep. of),Slovakia,31,0,0,31
14975,2019,Iraq,Slovakia,214,0,0,214
14976,2019,Liberia,Slovakia,5,0,0,5
14977,2019,Pakistan,Slovakia,7,0,0,7
14978,2019,Romania,Slovakia,37,0,0,37
14979,2019,Russian Federation,Slovakia,37,0,0,37
14980,2019,Serbia and Kosovo: S/RES/1244 (1999),Slovakia,46,0,0,46
14981,2019,Somalia,Slovakia,32,0,0,32
14982,2019,Viet Nam,Slovakia,16,0,0,16
14983,2019,Syrian Arab Rep.,Slovakia,14,5,0,19
14984,2019,Uganda,Slovakia,5,0,0,5
14985,2019,Ukraine,Slovakia,24,0,0,24
14986,2019,Uzbekistan,Slovakia,5,0,0,5
14987,2019,Yemen,Slovakia,21,0,0,21
14988,2019,Stateless,Slovakia,9,0,0,9
14989,2019,Afghanistan,Slovenia,51,23,0,74
14990,2019,Algeria,Slovenia,0,41,0,41
14991,2019,Azerbaijan,Slovenia,0,5,0,5
14992,2019,Bosnia and Herzegovina,Slovenia,6,5,0,11
14993,2019,Cameroon,Slovenia,5,0,0,5
14994,2019,Dem. Rep. of the Congo,Slovenia,6,0,0,6
14995,2019,Eritrea,Slovenia,82,19,0,101
14996,2019,Palestinian,Slovenia,14,16,0,30
14997,2019,Iran (Islamic Rep. of),Slovenia,66,33,0,99
14998,2019,Iraq,Slovenia,43,19,0,62
14999,2019,Kazakhstan,Slovenia,20,0,0,20
15000,2019,Sri Lanka,Slovenia,0,9,0,9
15001,2019,Morocco,Slovenia,0,60,0,60
15002,2019,Nigeria,Slovenia,5,5,0,10
15003,2019,Pakistan,Slovenia,0,21,0,21
15004,2019,Russian Federation,Slovenia,19,5,0,24
15005,2019,Serbia and Kosovo: S/RES/1244 (1999),Slovenia,10,7,0,17
15006,2019,Somalia,Slovenia,50,0,0,50
15007,2019,Sudan,Slovenia,5,0,0,5
15008,2019,Syrian Arab Rep.,Slovenia,307,15,0,322
15009,2019,Tunisia,Slovenia,0,11,0,11
15010,2019,Türkiye,Slovenia,41,14,0,55
15011,2019,Ukraine,Slovenia,5,0,0,5
15012,2019,Yemen,Slovenia,6,0,0,6
15013,2019,Stateless,Slovenia,0,0,0,0
15014,2019,Angola,Eswatini,13,0,0,13
15015,2019,Burundi,Eswatini,183,135,0,318
15016,2019,Cameroon,Eswatini,0,5,0,5
15017,2019,Congo,Eswatini,23,96,0,119
15018,2019,Dem. Rep. of the Congo,Eswatini,401,284,0,685
15019,2019,Eritrea,Eswatini,0,5,0,5
15020,2019,Ethiopia,Eswatini,9,73,0,82
15021,2019,Guinea,Eswatini,5,0,0,5
15022,2019,Kenya,Eswatini,5,0,0,5
15023,2019,Sri Lanka,Eswatini,5,0,0,5
15024,2019,Rwanda,Eswatini,184,104,0,288
15025,2019,Somalia,Eswatini,99,256,0,355
15026,2019,United Rep. of Tanzania,Eswatini,0,5,0,5
15027,2019,Uganda,Eswatini,6,0,0,6
15028,2019,Zimbabwe,Eswatini,7,0,0,7
15029,2019,Afghanistan,Sweden,30546,3015,0,33561
15030,2019,Albania,Sweden,327,376,0,703
15031,2019,Algeria,Sweden,60,70,0,130
15032,2019,Angola,Sweden,23,30,0,53
15033,2019,Egypt,Sweden,391,506,0,897
15034,2019,Argentina,Sweden,0,8,0,8
15035,2019,Armenia,Sweden,378,212,0,590
15036,2019,Azerbaijan,Sweden,651,453,0,1104
15037,2019,Bahrain,Sweden,17,5,0,22
15038,2019,Burundi,Sweden,217,113,0,330
15039,2019,Benin,Sweden,10,0,0,10
15040,2019,Bangladesh,Sweden,253,361,0,614
15041,2019,Burkina Faso,Sweden,5,5,0,10
15042,2019,Belarus,Sweden,116,85,0,201
15043,2019,Bolivia (Plurinational State of),Sweden,56,20,0,76
15044,2019,Brazil,Sweden,8,14,0,22
15045,2019,Bosnia and Herzegovina,Sweden,95,84,0,179
15046,2019,Bulgaria,Sweden,16,5,0,21
15047,2019,Central African Rep.,Sweden,70,0,0,70
15048,2019,Chad,Sweden,19,0,0,19
15049,2019,China,Sweden,285,78,0,363
15050,2019,Chile,Sweden,13,35,0,48
15051,2019,Cameroon,Sweden,187,206,0,393
15052,2019,Congo,Sweden,38,34,0,72
15053,2019,Dem. Rep. of the Congo,Sweden,875,113,0,988
15054,2019,Comoros,Sweden,5,0,0,5
15055,2019,Colombia,Sweden,39,322,0,361
15056,2019,Cuba,Sweden,36,26,0,62
15057,2019,Djibouti,Sweden,23,33,0,56
15058,2019,Ecuador,Sweden,5,18,0,23
15059,2019,Equatorial Guinea,Sweden,6,5,0,11
15060,2019,Eritrea,Sweden,27933,578,0,28511
15061,2019,Ethiopia,Sweden,2561,614,0,3175
15062,2019,France,Sweden,5,0,0,5
15063,2019,Gambia,Sweden,184,131,0,315
15064,2019,Palestinian,Sweden,1167,714,0,1881
15065,2019,United Kingdom of Great Britain and Northern Ireland,Sweden,7,0,0,7
15066,2019,Georgia,Sweden,107,353,0,460
15067,2019,Ghana,Sweden,62,87,0,149
15068,2019,Guinea-Bissau,Sweden,9,5,0,14
15069,2019,Greece,Sweden,18,0,0,18
15070,2019,Guatemala,Sweden,10,13,0,23
15071,2019,Guinea,Sweden,72,46,0,118
15072,2019,Honduras,Sweden,19,31,0,50
15073,2019,Croatia,Sweden,0,5,0,5
15074,2019,Hungary,Sweden,5,0,0,5
15075,2019,Cote d'Ivoire,Sweden,51,17,0,68
15076,2019,India,Sweden,23,105,0,128
15077,2019,Indonesia,Sweden,16,0,0,16
15078,2019,Iran (Islamic Rep. of),Sweden,7408,2441,0,9849
15079,2019,Iraq,Sweden,12460,2879,0,15339
15080,2019,Israel,Sweden,25,20,0,45
15081,2019,Italy,Sweden,5,0,0,5
15082,2019,Jamaica,Sweden,0,5,0,5
15083,2019,Jordan,Sweden,284,273,0,557
15084,2019,Kazakhstan,Sweden,251,219,0,470
15085,2019,Kenya,Sweden,99,67,0,166
15086,2019,Kyrgyzstan,Sweden,175,138,0,313
15087,2019,Rep. of Korea,Sweden,7,5,0,12
15088,2019,Dem. People's Rep. of Korea,Sweden,5,0,0,5
15089,2019,Kuwait,Sweden,32,26,0,58
15090,2019,Liberia,Sweden,13,11,0,24
15091,2019,Libya,Sweden,393,90,0,483
15092,2019,Lebanon,Sweden,542,455,0,997
15093,2019,Sri Lanka,Sweden,28,58,0,86
15094,2019,Lithuania,Sweden,0,7,0,7
15095,2019,Mauritania,Sweden,13,5,0,18
15096,2019,North Macedonia,Sweden,51,107,0,158
15097,2019,Rep. of Moldova,Sweden,8,5,0,13
15098,2019,Mexico,Sweden,0,5,0,5
15099,2019,Mali,Sweden,42,10,0,52
15100,2019,Malaysia,Sweden,13,6,0,19
15101,2019,Mongolia,Sweden,287,241,0,528
15102,2019,Morocco,Sweden,250,238,0,488
15103,2019,Mozambique,Sweden,0,9,0,9
15104,2019,Montenegro,Sweden,34,14,0,48
15105,2019,Myanmar,Sweden,10,12,0,22
15106,2019,Nepal,Sweden,14,20,0,34
15107,2019,Niger,Sweden,5,0,0,5
15108,2019,Nicaragua,Sweden,38,238,0,276
15109,2019,Nigeria,Sweden,588,539,0,1127
15110,2019,Pakistan,Sweden,595,515,0,1110
15111,2019,Peru,Sweden,10,108,0,118
15112,2019,Philippines,Sweden,7,19,0,26
15113,2019,Poland,Sweden,5,0,0,5
15114,2019,Romania,Sweden,56,0,0,56
15115,2019,South Africa,Sweden,0,6,0,6
15116,2019,Russian Federation,Sweden,1506,662,0,2168
15117,2019,Rwanda,Sweden,42,88,0,130
15118,2019,El Salvador,Sweden,127,215,0,342
15119,2019,Saudi Arabia,Sweden,55,11,0,66
15120,2019,Serbia and Kosovo: S/RES/1244 (1999),Sweden,861,351,0,1212
15121,2019,Senegal,Sweden,56,27,0,83
15122,2019,Sierra Leone,Sweden,70,19,0,89
15123,2019,Somalia,Sweden,17593,1084,0,18677
15124,2019,Viet Nam,Sweden,42,40,0,82
15125,2019,Sudan,Sweden,1128,185,0,1313
15126,2019,South Sudan,Sweden,63,0,0,63
15127,2019,Slovakia,Sweden,5,5,0,10
15128,2019,Eswatini,Sweden,5,0,0,5
15129,2019,Syrian Arab Rep.,Sweden,113418,2226,0,115644
15130,2019,United Rep. of Tanzania,Sweden,52,79,0,131
15131,2019,Thailand,Sweden,5,7,0,12
15132,2019,Tajikistan,Sweden,60,108,0,168
15133,2019,Turkmenistan,Sweden,9,5,0,14
15134,2019,Togo,Sweden,5,0,0,5
15135,2019,Tunisia,Sweden,52,71,0,123
15136,2019,Türkiye,Sweden,1638,940,0,2578
15137,2019,United Arab Emirates,Sweden,5,0,0,5
15138,2019,Uganda,Sweden,726,158,0,884
15139,2019,Ukraine,Sweden,223,471,0,694
15140,2019,United States of America,Sweden,22,25,0,47
15141,2019,Uzbekistan,Sweden,565,1371,0,1936
15142,2019,Venezuela (Bolivarian Republic of),Sweden,13,220,0,233
15143,2019,Yemen,Sweden,1659,193,0,1852
15144,2019,Zambia,Sweden,13,5,0,18
15145,2019,Zimbabwe,Sweden,19,5,0,24
15146,2019,Stateless,Sweden,22392,1032,0,23424
15147,2019,Unknown ,Sweden,586,681,0,1267
15148,2019,Afghanistan,Switzerland,13455,1152,0,14607
15149,2019,Albania,Switzerland,106,76,0,182
15150,2019,Algeria,Switzerland,162,147,0,309
15151,2019,Angola,Switzerland,713,77,0,790
15152,2019,Egypt,Switzerland,115,24,0,139
15153,2019,Armenia,Switzerland,150,73,0,223
15154,2019,Azerbaijan,Switzerland,118,158,0,276
15155,2019,Bahrain,Switzerland,5,0,0,5
15156,2019,Burundi,Switzerland,123,37,0,160
15157,2019,Benin,Switzerland,19,5,0,24
15158,2019,Bangladesh,Switzerland,54,9,0,63
15159,2019,Burkina Faso,Switzerland,18,5,0,23
15160,2019,Belarus,Switzerland,52,20,0,72
15161,2019,Brazil,Switzerland,6,5,0,11
15162,2019,Bosnia and Herzegovina,Switzerland,1647,22,0,1669
15163,2019,Bulgaria,Switzerland,6,0,0,6
15164,2019,Cambodia,Switzerland,291,0,0,291
15165,2019,Canada,Switzerland,0,5,0,5
15166,2019,Central African Rep.,Switzerland,16,5,0,21
15167,2019,Chad,Switzerland,36,14,0,50
15168,2019,China,Switzerland,2825,207,0,3032
15169,2019,Chile,Switzerland,11,5,0,16
15170,2019,Cameroon,Switzerland,181,59,0,240
15171,2019,Congo,Switzerland,51,6,0,57
15172,2019,Dem. Rep. of the Congo,Switzerland,1231,122,0,1353
15173,2019,Colombia,Switzerland,246,90,0,336
15174,2019,Cuba,Switzerland,34,8,0,42
15175,2019,Czechia,Switzerland,5,0,0,5
15176,2019,Djibouti,Switzerland,16,5,0,21
15177,2019,Dominican Rep.,Switzerland,5,0,0,5
15178,2019,Ecuador,Switzerland,5,0,0,5
15179,2019,Equatorial Guinea,Switzerland,5,0,0,5
15180,2019,Eritrea,Switzerland,36698,892,0,37590
15181,2019,Ethiopia,Switzerland,1637,285,0,1922
15182,2019,France,Switzerland,7,0,0,7
15183,2019,Gabon,Switzerland,5,5,0,10
15184,2019,Gambia,Switzerland,52,27,0,79
15185,2019,Georgia,Switzerland,177,221,0,398
15186,2019,Germany,Switzerland,5,0,0,5
15187,2019,Ghana,Switzerland,20,18,0,38
15188,2019,Guinea-Bissau,Switzerland,50,5,0,55
15189,2019,Guatemala,Switzerland,7,0,0,7
15190,2019,Guinea,Switzerland,182,54,0,236
15191,2019,Honduras,Switzerland,0,6,0,6
15192,2019,Croatia,Switzerland,21,0,0,21
15193,2019,Hungary,Switzerland,5,0,0,5
15194,2019,Cote d'Ivoire,Switzerland,180,42,0,222
15195,2019,India,Switzerland,34,13,0,47
15196,2019,Indonesia,Switzerland,0,5,0,5
15197,2019,Iran (Islamic Rep. of),Switzerland,1800,1063,0,2863
15198,2019,Iraq,Switzerland,4545,671,0,5216
15199,2019,Israel,Switzerland,5,0,0,5
15200,2019,Italy,Switzerland,5,0,0,5
15201,2019,Jamaica,Switzerland,0,5,0,5
15202,2019,Jordan,Switzerland,59,0,0,59
15203,2019,Kazakhstan,Switzerland,21,6,0,27
15204,2019,Kenya,Switzerland,41,7,0,48
15205,2019,Kyrgyzstan,Switzerland,20,5,0,25
15206,2019,Kuwait,Switzerland,6,0,0,6
15207,2019,Lao People's Dem. Rep.,Switzerland,115,0,0,115
15208,2019,Liberia,Switzerland,37,0,0,37
15209,2019,Libya,Switzerland,312,50,0,362
15210,2019,Lebanon,Switzerland,43,20,0,63
15211,2019,Sri Lanka,Switzerland,5819,1319,0,7138
15212,2019,Madagascar,Switzerland,5,0,0,5
15213,2019,Mauritania,Switzerland,10,5,0,15
15214,2019,North Macedonia,Switzerland,162,12,0,174
15215,2019,Rep. of Moldova,Switzerland,10,42,0,52
15216,2019,Mali,Switzerland,34,8,0,42
15217,2019,Mongolia,Switzerland,153,13,0,166
15218,2019,Morocco,Switzerland,68,58,0,126
15219,2019,Montenegro,Switzerland,53,5,0,58
15220,2019,Myanmar,Switzerland,34,0,0,34
15221,2019,Nepal,Switzerland,20,8,0,28
15222,2019,Niger,Switzerland,8,0,0,8
15223,2019,Nicaragua,Switzerland,5,14,0,19
15224,2019,Nigeria,Switzerland,246,140,0,386
15225,2019,Pakistan,Switzerland,241,148,0,389
15226,2019,Paraguay,Switzerland,5,0,0,5
15227,2019,Peru,Switzerland,6,0,0,6
15228,2019,Philippines,Switzerland,10,0,0,10
15229,2019,Portugal,Switzerland,5,0,0,5
15230,2019,Romania,Switzerland,19,0,0,19
15231,2019,South Africa,Switzerland,11,0,0,11
15232,2019,Russian Federation,Switzerland,723,138,0,861
15233,2019,Rwanda,Switzerland,126,6,0,132
15234,2019,El Salvador,Switzerland,7,8,0,15
15235,2019,Saudi Arabia,Switzerland,11,9,0,20
15236,2019,Serbia and Kosovo: S/RES/1244 (1999),Switzerland,2389,121,0,2510
15237,2019,Senegal,Switzerland,56,19,0,75
15238,2019,Sierra Leone,Switzerland,30,11,0,41
15239,2019,Somalia,Switzerland,4762,250,0,5012
15240,2019,Spain,Switzerland,5,0,0,5
15241,2019,Viet Nam,Switzerland,848,0,0,848
15242,2019,Sudan,Switzerland,326,37,0,363
15243,2019,South Sudan,Switzerland,13,8,0,21
15244,2019,Syrian Arab Rep.,Switzerland,18755,918,0,19673
15245,2019,United Rep. of Tanzania,Switzerland,16,5,0,21
15246,2019,Tajikistan,Switzerland,21,0,0,21
15247,2019,Turkmenistan,Switzerland,5,0,0,5
15248,2019,Togo,Switzerland,576,24,0,600
15249,2019,Tunisia,Switzerland,205,27,0,232
15250,2019,Türkiye,Switzerland,3925,1774,0,5699
15251,2019,Uganda,Switzerland,42,25,0,67
15252,2019,Ukraine,Switzerland,65,50,0,115
15253,2019,Uzbekistan,Switzerland,54,7,0,61
15254,2019,Venezuela (Bolivarian Republic of),Switzerland,15,49,0,64
15255,2019,Western Sahara,Switzerland,9,5,0,14
15256,2019,Yemen,Switzerland,130,12,0,142
15257,2019,Zimbabwe,Switzerland,13,5,0,18
15258,2019,Stateless,Switzerland,600,10,0,610
15259,2019,Unknown ,Switzerland,1715,174,0,1889
15260,2019,Afghanistan,Syrian Arab Rep.,1110,32,0,1142
15261,2019,Algeria,Syrian Arab Rep.,5,0,0,5
15262,2019,Egypt,Syrian Arab Rep.,33,10,0,43
15263,2019,Bahrain,Syrian Arab Rep.,0,5,0,5
15264,2019,Chad,Syrian Arab Rep.,9,6,0,15
15265,2019,Eritrea,Syrian Arab Rep.,18,0,0,18
15266,2019,Ethiopia,Syrian Arab Rep.,15,0,0,15
15267,2019,Guinea,Syrian Arab Rep.,51,5,0,56
15268,2019,Cote d'Ivoire,Syrian Arab Rep.,5,0,0,5
15269,2019,Iran (Islamic Rep. of),Syrian Arab Rep.,44,5,0,49
15270,2019,Iraq,Syrian Arab Rep.,13311,11720,0,25031
15271,2019,Jordan,Syrian Arab Rep.,19,0,0,19
15272,2019,Libya,Syrian Arab Rep.,11,10,0,21
15273,2019,Lebanon,Syrian Arab Rep.,23,5,0,28
15274,2019,Sri Lanka,Syrian Arab Rep.,0,5,0,5
15275,2019,Morocco,Syrian Arab Rep.,5,0,0,5
15276,2019,Pakistan,Syrian Arab Rep.,207,10,0,217
15277,2019,Saudi Arabia,Syrian Arab Rep.,9,0,0,9
15278,2019,Sierra Leone,Syrian Arab Rep.,19,0,0,19
15279,2019,Somalia,Syrian Arab Rep.,346,31,0,377
15280,2019,Sudan,Syrian Arab Rep.,718,92,0,810
15281,2019,South Sudan,Syrian Arab Rep.,80,0,0,80
15282,2019,Syrian Arab Rep.,Syrian Arab Rep.,0,0,6146994,0
15283,2019,United Rep. of Tanzania,Syrian Arab Rep.,0,7,0,7
15284,2019,Tunisia,Syrian Arab Rep.,5,5,0,10
15285,2019,Türkiye,Syrian Arab Rep.,6,7,0,13
15286,2019,Yemen,Syrian Arab Rep.,159,110,0,269
15287,2019,Stateless,Syrian Arab Rep.,0,0,0,0
15288,2019,Unknown ,Syrian Arab Rep.,5,0,0,5
15289,2019,Burundi,United Rep. of Tanzania,192231,12059,0,204290
15290,2019,Congo,United Rep. of Tanzania,5,0,0,5
15291,2019,Dem. Rep. of the Congo,United Rep. of Tanzania,49672,17375,0,67047
15292,2019,Kenya,United Rep. of Tanzania,5,0,0,5
15293,2019,Lebanon,United Rep. of Tanzania,0,0,0,0
15294,2019,Rwanda,United Rep. of Tanzania,65,30,0,95
15295,2019,Somalia,United Rep. of Tanzania,159,5,0,164
15296,2019,South Sudan,United Rep. of Tanzania,10,9,0,19
15297,2019,Syrian Arab Rep.,United Rep. of Tanzania,5,16,0,21
15298,2019,United Rep. of Tanzania,United Rep. of Tanzania,0,0,0,0
15299,2019,Türkiye,United Rep. of Tanzania,0,10,0,10
15300,2019,Uganda,United Rep. of Tanzania,14,5,0,19
15301,2019,Yemen,United Rep. of Tanzania,5,45,0,50
15302,2019,Cuba,Turks and Caicos Islands,5,0,0,5
15303,2019,Afghanistan,Thailand,134,18,0,152
15304,2019,Egypt,Thailand,16,10,0,26
15305,2019,Cambodia,Thailand,228,93,0,321
15306,2019,China,Thailand,174,14,0,188
15307,2019,Cameroon,Thailand,29,22,0,51
15308,2019,Dem. Rep. of the Congo,Thailand,19,0,0,19
15309,2019,Eritrea,Thailand,5,0,0,5
15310,2019,Ethiopia,Thailand,20,10,0,30
15311,2019,Palestinian,Thailand,310,5,0,315
15312,2019,Guinea,Thailand,0,5,0,5
15313,2019,Cote d'Ivoire,Thailand,17,0,0,17
15314,2019,India,Thailand,0,5,0,5
15315,2019,Iran (Islamic Rep. of),Thailand,69,36,0,105
15316,2019,Iraq,Thailand,177,5,0,182
15317,2019,Jordan,Thailand,5,0,0,5
15318,2019,Lao People's Dem. Rep.,Thailand,6,0,0,6
15319,2019,Sri Lanka,Thailand,131,24,0,155
15320,2019,Myanmar,Thailand,93335,13,0,93348
15321,2019,Nepal,Thailand,6,0,0,6
15322,2019,Pakistan,Thailand,1667,111,0,1778
15323,2019,Somalia,Thailand,200,24,0,224
15324,2019,Viet Nam,Thailand,744,420,0,1164
15325,2019,Sudan,Thailand,5,0,0,5
15326,2019,Syrian Arab Rep.,Thailand,217,8,0,225
15327,2019,United Rep. of Tanzania,Thailand,5,0,0,5
15328,2019,Türkiye,Thailand,0,5,0,5
15329,2019,Yemen,Thailand,37,0,0,37
15330,2019,Zimbabwe,Thailand,0,9,0,9
15331,2019,Stateless,Thailand,0,0,0,0
15332,2019,Afghanistan,Tajikistan,3783,1413,0,5196
15333,2019,Iran (Islamic Rep. of),Tajikistan,5,0,0,5
15334,2019,Stateless,Tajikistan,0,0,0,0
15335,2019,Afghanistan,Turkmenistan,14,0,0,14
15336,2019,Azerbaijan,Turkmenistan,7,0,0,7
15337,2019,Stateless,Turkmenistan,0,0,0,0
15338,2019,Burundi,Togo,5,0,0,5
15339,2019,Benin,Togo,0,5,0,5
15340,2019,Burkina Faso,Togo,0,5,0,5
15341,2019,Central African Rep.,Togo,236,127,0,363
15342,2019,Chad,Togo,12,13,0,25
15343,2019,Cameroon,Togo,7,9,0,16
15344,2019,Congo,Togo,30,20,0,50
15345,2019,Dem. Rep. of the Congo,Togo,101,84,0,185
15346,2019,Ghana,Togo,9768,0,0,9768
15347,2019,Cote d'Ivoire,Togo,1544,333,0,1877
15348,2019,Iraq,Togo,5,0,0,5
15349,2019,Lebanon,Togo,0,17,0,17
15350,2019,Sri Lanka,Togo,0,5,0,5
15351,2019,Mali,Togo,72,35,0,107
15352,2019,Nigeria,Togo,8,14,0,22
15353,2019,Rwanda,Togo,120,0,0,120
15354,2019,Sudan,Togo,0,5,0,5
15355,2019,Syrian Arab Rep.,Togo,6,11,0,17
15356,2019,Türkiye,Togo,50,9,0,59
15357,2019,Egypt,Trinidad and Tobago,0,5,0,5
15358,2019,Bangladesh,Trinidad and Tobago,8,89,0,97
15359,2019,China,Trinidad and Tobago,0,79,0,79
15360,2019,Cameroon,Trinidad and Tobago,0,10,0,10
15361,2019,Colombia,Trinidad and Tobago,12,53,0,65
15362,2019,Cuba,Trinidad and Tobago,155,2257,0,2412
15363,2019,Dominican Rep.,Trinidad and Tobago,0,130,0,130
15364,2019,Ghana,Trinidad and Tobago,0,39,0,39
15365,2019,Grenada,Trinidad and Tobago,0,5,0,5
15366,2019,Guyana,Trinidad and Tobago,0,53,0,53
15367,2019,Haiti,Trinidad and Tobago,0,15,0,15
15368,2019,India,Trinidad and Tobago,0,5,0,5
15369,2019,Jamaica,Trinidad and Tobago,15,94,0,109
15370,2019,Mexico,Trinidad and Tobago,6,0,0,6
15371,2019,Nicaragua,Trinidad and Tobago,0,5,0,5
15372,2019,Nigeria,Trinidad and Tobago,0,148,0,148
15373,2019,Pakistan,Trinidad and Tobago,9,21,0,30
15374,2019,Philippines,Trinidad and Tobago,0,5,0,5
15375,2019,Viet Nam,Trinidad and Tobago,0,7,0,7
15376,2019,Syrian Arab Rep.,Trinidad and Tobago,58,38,0,96
15377,2019,Tajikistan,Trinidad and Tobago,0,5,0,5
15378,2019,Trinidad and Tobago,Trinidad and Tobago,0,0,0,0
15379,2019,Saint Vincent and the Grenadines,Trinidad and Tobago,5,5,0,10
15380,2019,Venezuela (Bolivarian Republic of),Trinidad and Tobago,2040,14296,0,16336
15381,2019,Algeria,Tunisia,9,13,0,22
15382,2019,Egypt,Tunisia,0,5,0,5
15383,2019,Bangladesh,Tunisia,0,10,0,10
15384,2019,Burkina Faso,Tunisia,0,12,0,12
15385,2019,Central African Rep.,Tunisia,9,9,0,18
15386,2019,Chad,Tunisia,0,12,0,12
15387,2019,Cameroon,Tunisia,5,36,0,41
15388,2019,Dem. Rep. of the Congo,Tunisia,0,36,0,36
15389,2019,Eritrea,Tunisia,158,85,0,243
15390,2019,Ethiopia,Tunisia,0,42,0,42
15391,2019,Palestinian,Tunisia,35,9,0,44
15392,2019,Ghana,Tunisia,0,5,0,5
15393,2019,Guinea,Tunisia,0,38,0,38
15394,2019,Cote d'Ivoire,Tunisia,15,637,0,652
15395,2019,Iran (Islamic Rep. of),Tunisia,5,5,0,10
15396,2019,Iraq,Tunisia,20,7,0,27
15397,2019,Liberia,Tunisia,0,9,0,9
15398,2019,Libya,Tunisia,7,31,0,38
15399,2019,Lebanon,Tunisia,6,0,0,6
15400,2019,Mali,Tunisia,0,11,0,11
15401,2019,Niger,Tunisia,0,5,0,5
15402,2019,Nigeria,Tunisia,0,21,0,21
15403,2019,Rwanda,Tunisia,6,0,0,6
15404,2019,Senegal,Tunisia,0,5,0,5
15405,2019,Sierra Leone,Tunisia,5,0,0,5
15406,2019,Somalia,Tunisia,19,170,0,189
15407,2019,Sudan,Tunisia,51,232,0,283
15408,2019,South Sudan,Tunisia,0,26,0,26
15409,2019,Syrian Arab Rep.,Tunisia,1382,0,0,1382
15410,2019,Türkiye,Tunisia,0,15,0,15
15411,2019,Yemen,Tunisia,0,31,0,31
15412,2019,Afghanistan,Türkiye,1192,116403,0,117595
15413,2019,Iran (Islamic Rep. of),Türkiye,548,27029,0,27577
15414,2019,Iraq,Türkiye,1279,173245,0,174524
15415,2019,Syrian Arab Rep.,Türkiye,3576370,0,0,3576370
15416,2019,Unknown ,Türkiye,142,11580,0,11722
15417,2019,Afghanistan,United Arab Emirates,5,25,0,30
15418,2019,Algeria,United Arab Emirates,0,0,0,0
15419,2019,Egypt,United Arab Emirates,8,6,0,14
15420,2019,Chad,United Arab Emirates,6,0,0,6
15421,2019,Eritrea,United Arab Emirates,0,7,0,7
15422,2019,Ethiopia,United Arab Emirates,10,5,0,15
15423,2019,Palestinian,United Arab Emirates,15,0,0,15
15424,2019,Iran (Islamic Rep. of),United Arab Emirates,7,10,0,17
15425,2019,Iraq,United Arab Emirates,783,560,0,1343
15426,2019,Jordan,United Arab Emirates,6,0,0,6
15427,2019,Kuwait,United Arab Emirates,5,0,0,5
15428,2019,Libya,United Arab Emirates,0,5,0,5
15429,2019,Lebanon,United Arab Emirates,16,7,0,23
15430,2019,Morocco,United Arab Emirates,0,0,0,0
15431,2019,Pakistan,United Arab Emirates,5,0,0,5
15432,2019,Philippines,United Arab Emirates,0,0,0,0
15433,2019,Russian Federation,United Arab Emirates,0,5,0,5
15434,2019,Saudi Arabia,United Arab Emirates,5,0,0,5
15435,2019,Somalia,United Arab Emirates,18,0,0,18
15436,2019,Sudan,United Arab Emirates,8,11,0,19
15437,2019,Syrian Arab Rep.,United Arab Emirates,333,6575,0,6908
15438,2019,Yemen,United Arab Emirates,12,50,0,62
15439,2019,Egypt,Uganda,0,8,0,8
15440,2019,Burundi,Uganda,43888,1783,0,45671
15441,2019,Central African Rep.,Uganda,32,0,0,32
15442,2019,Chad,Uganda,6,5,0,11
15443,2019,Cameroon,Uganda,5,0,0,5
15444,2019,Congo,Uganda,19,0,0,19
15445,2019,Dem. Rep. of the Congo,Uganda,394037,3601,0,397638
15446,2019,Eritrea,Uganda,6435,8064,0,14499
15447,2019,Ethiopia,Uganda,2007,954,0,2961
15448,2019,Palestinian,Uganda,5,0,0,5
15449,2019,Guinea,Uganda,5,0,0,5
15450,2019,Kenya,Uganda,200,19,0,219
15451,2019,Mali,Uganda,0,5,0,5
15452,2019,Pakistan,Uganda,220,22,0,242
15453,2019,Rwanda,Uganda,15362,1748,0,17110
15454,2019,Senegal,Uganda,10,0,0,10
15455,2019,Somalia,Uganda,33073,4887,0,37960
15456,2019,Sudan,Uganda,2627,409,0,3036
15457,2019,South Sudan,Uganda,861452,138,0,861590
15458,2019,Syrian Arab Rep.,Uganda,6,10,0,16
15459,2019,United Rep. of Tanzania,Uganda,9,0,0,9
15460,2019,Türkiye,Uganda,33,0,0,33
15461,2019,Uganda,Uganda,0,0,0,0
15462,2019,Yemen,Uganda,27,5,0,32
15463,2019,Afghanistan,Ukraine,820,641,0,1461
15464,2019,Algeria,Ukraine,0,12,0,12
15465,2019,Angola,Ukraine,24,0,0,24
15466,2019,Egypt,Ukraine,5,15,0,20
15467,2019,Armenia,Ukraine,47,5,0,52
15468,2019,Azerbaijan,Ukraine,72,22,0,94
15469,2019,Bangladesh,Ukraine,5,161,0,166
15470,2019,Belarus,Ukraine,24,7,0,31
15471,2019,Chad,Ukraine,7,0,0,7
15472,2019,China,Ukraine,0,6,0,6
15473,2019,Cameroon,Ukraine,5,30,0,35
15474,2019,Congo,Ukraine,26,12,0,38
15475,2019,Dem. Rep. of the Congo,Ukraine,26,37,0,63
15476,2019,Eritrea,Ukraine,11,29,0,40
15477,2019,Ethiopia,Ukraine,26,5,0,31
15478,2019,Palestinian,Ukraine,10,39,0,49
15479,2019,Georgia,Ukraine,26,5,0,31
15480,2019,Ghana,Ukraine,0,13,0,13
15481,2019,Guinea,Ukraine,5,28,0,33
15482,2019,Cote d'Ivoire,Ukraine,0,19,0,19
15483,2019,India,Ukraine,7,28,0,35
15484,2019,Iran (Islamic Rep. of),Ukraine,73,53,0,126
15485,2019,Iraq,Ukraine,80,93,0,173
15486,2019,Jordan,Ukraine,5,8,0,13
15487,2019,Kazakhstan,Ukraine,7,18,0,25
15488,2019,Kyrgyzstan,Ukraine,7,32,0,39
15489,2019,Libya,Ukraine,0,19,0,19
15490,2019,Lebanon,Ukraine,8,16,0,24
15491,2019,Sri Lanka,Ukraine,7,29,0,36
15492,2019,Morocco,Ukraine,0,16,0,16
15493,2019,Myanmar,Ukraine,0,6,0,6
15494,2019,Nigeria,Ukraine,6,41,0,47
15495,2019,Pakistan,Ukraine,8,83,0,91
15496,2019,Russian Federation,Ukraine,122,233,0,355
15497,2019,Rwanda,Ukraine,5,0,0,5
15498,2019,Serbia and Kosovo: S/RES/1244 (1999),Ukraine,5,0,0,5
15499,2019,Senegal,Ukraine,0,5,0,5
15500,2019,Sierra Leone,Ukraine,5,0,0,5
15501,2019,Somalia,Ukraine,85,106,0,191
15502,2019,Viet Nam,Ukraine,0,13,0,13
15503,2019,Sudan,Ukraine,28,28,0,56
15504,2019,Syrian Arab Rep.,Ukraine,462,161,0,623
15505,2019,Tajikistan,Ukraine,13,161,0,174
15506,2019,Turkmenistan,Ukraine,7,0,0,7
15507,2019,Türkiye,Ukraine,7,10,0,17
15508,2019,Ukraine,Ukraine,0,0,734000,0
15509,2019,Uzbekistan,Ukraine,30,78,0,108
15510,2019,Yemen,Ukraine,5,48,0,53
15511,2019,Stateless,Ukraine,45,15,0,60
15512,2019,Afghanistan,Uruguay,0,5,0,5
15513,2019,Angola,Uruguay,14,5,0,19
15514,2019,Egypt,Uruguay,0,5,0,5
15515,2019,Argentina,Uruguay,0,5,0,5
15516,2019,Bangladesh,Uruguay,0,66,0,66
15517,2019,Bolivia (Plurinational State of),Uruguay,5,0,0,5
15518,2019,Brazil,Uruguay,0,14,0,14
15519,2019,Canada,Uruguay,0,5,0,5
15520,2019,Cameroon,Uruguay,10,5,0,15
15521,2019,Congo,Uruguay,5,0,0,5
15522,2019,Colombia,Uruguay,158,29,0,187
15523,2019,Cuba,Uruguay,25,12371,0,12396
15524,2019,Cabo Verde,Uruguay,0,5,0,5
15525,2019,Dominican Rep.,Uruguay,0,194,0,194
15526,2019,Ecuador,Uruguay,7,5,0,12
15527,2019,Ghana,Uruguay,0,22,0,22
15528,2019,Guinea-Bissau,Uruguay,0,5,0,5
15529,2019,Guatemala,Uruguay,5,0,0,5
15530,2019,Guinea,Uruguay,0,11,0,11
15531,2019,Haiti,Uruguay,0,15,0,15
15532,2019,India,Uruguay,0,5,0,5
15533,2019,Libya,Uruguay,5,0,0,5
15534,2019,Latvia,Uruguay,5,0,0,5
15535,2019,Mauritania,Uruguay,0,5,0,5
15536,2019,Mexico,Uruguay,5,0,0,5
15537,2019,Morocco,Uruguay,0,14,0,14
15538,2019,Nicaragua,Uruguay,6,8,0,14
15539,2019,Nigeria,Uruguay,22,12,0,34
15540,2019,Pakistan,Uruguay,0,40,0,40
15541,2019,Paraguay,Uruguay,7,0,0,7
15542,2019,Peru,Uruguay,6,0,0,6
15543,2019,Russian Federation,Uruguay,12,5,0,17
15544,2019,El Salvador,Uruguay,37,18,0,55
15545,2019,Senegal,Uruguay,0,374,0,374
15546,2019,Somalia,Uruguay,5,0,0,5
15547,2019,Syrian Arab Rep.,Uruguay,61,7,0,68
15548,2019,Türkiye,Uruguay,13,5,0,18
15549,2019,Ukraine,Uruguay,11,5,0,16
15550,2019,Venezuela (Bolivarian Republic of),Uruguay,74,472,0,546
15551,2019,Yemen,Uruguay,0,5,0,5
15552,2019,Afghanistan,United States of America,1629,727,0,2356
15553,2019,Albania,United States of America,1436,1902,0,3338
15554,2019,Algeria,United States of America,158,376,0,534
15555,2019,Angola,United States of America,246,1684,0,1930
15556,2019,Antigua and Barbuda,United States of America,8,12,0,20
15557,2019,Egypt,United States of America,14291,4721,0,19012
15558,2019,Argentina,United States of America,41,264,0,305
15559,2019,Armenia,United States of America,1551,2925,0,4476
15560,2019,Australia,United States of America,5,13,0,18
15561,2019,Austria,United States of America,13,0,0,13
15562,2019,Azerbaijan,United States of America,474,1098,0,1572
15563,2019,Bahrain,United States of America,47,34,0,81
15564,2019,Barbados,United States of America,0,5,0,5
15565,2019,Burundi,United States of America,846,612,0,1458
15566,2019,Belgium,United States of America,23,32,0,55
15567,2019,Benin,United States of America,89,198,0,287
15568,2019,Bangladesh,United States of America,2038,7303,0,9341
15569,2019,Bahamas,United States of America,181,96,0,277
15570,2019,Bhutan,United States of America,34,353,0,387
15571,2019,Burkina Faso,United States of America,1403,3292,0,4695
15572,2019,Belarus,United States of America,1631,2193,0,3824
15573,2019,Bolivia (Plurinational State of),United States of America,111,453,0,564
15574,2019,Botswana,United States of America,0,6,0,6
15575,2019,Brazil,United States of America,932,9217,0,10149
15576,2019,Bosnia and Herzegovina,United States of America,98,174,0,272
15577,2019,Bulgaria,United States of America,234,265,0,499
15578,2019,Belize,United States of America,43,239,0,282
15579,2019,Cambodia,United States of America,142,63,0,205
15580,2019,Canada,United States of America,31,55,0,86
15581,2019,Central African Rep.,United States of America,199,99,0,298
15582,2019,Cayman Islands,United States of America,6,0,0,6
15583,2019,Chad,United States of America,276,223,0,499
15584,2019,China,United States of America,78752,68794,0,147546
15585,2019,Chile,United States of America,23,220,0,243
15586,2019,Cameroon,United States of America,5000,5078,0,10078
15587,2019,Congo,United States of America,1186,428,0,1614
15588,2019,Dem. Rep. of the Congo,United States of America,1448,2912,0,4360
15589,2019,Comoros,United States of America,5,10,0,15
15590,2019,Colombia,United States of America,2936,12570,0,15506
15591,2019,Costa Rica,United States of America,172,550,0,722
15592,2019,Cuba,United States of America,1765,5899,0,7664
15593,2019,Cabo Verde,United States of America,0,33,0,33
15594,2019,Cyprus,United States of America,0,5,0,5
15595,2019,Czechia,United States of America,13,33,0,46
15596,2019,Denmark,United States of America,0,5,0,5
15597,2019,Djibouti,United States of America,352,468,0,820
15598,2019,Dominica,United States of America,16,22,0,38
15599,2019,Dominican Rep.,United States of America,246,1046,0,1292
15600,2019,Ecuador,United States of America,1378,18557,0,19935
15601,2019,Equatorial Guinea,United States of America,17,52,0,69
15602,2019,Eritrea,United States of America,5941,1056,0,6997
15603,2019,Estonia,United States of America,254,38,0,292
15604,2019,Ethiopia,United States of America,9079,5556,0,14635
15605,2019,French Guiana,United States of America,0,5,0,5
15606,2019,Fiji,United States of America,154,278,0,432
15607,2019,France,United States of America,23,141,0,164
15608,2019,Gabon,United States of America,49,254,0,303
15609,2019,Gambia,United States of America,1511,816,0,2327
15610,2019,Palestinian,United States of America,14,99,0,113
15611,2019,United Kingdom of Great Britain and Northern Ireland,United States of America,32,110,0,142
15612,2019,Georgia,United States of America,456,1852,0,2308
15613,2019,Germany,United States of America,43,125,0,168
15614,2019,Ghana,United States of America,481,912,0,1393
15615,2019,Guinea-Bissau,United States of America,19,26,0,45
15616,2019,Greece,United States of America,15,71,0,86
15617,2019,Grenada,United States of America,25,40,0,65
15618,2019,Guatemala,United States of America,20883,114404,0,135287
15619,2019,Guinea,United States of America,2001,1098,0,3099
15620,2019,Guyana,United States of America,114,394,0,508
15621,2019,Haiti,United States of America,15698,19061,0,34759
15622,2019,"China, Hong Kong SAR",United States of America,0,15,0,15
15623,2019,Honduras,United States of America,15110,81375,0,96485
15624,2019,Croatia,United States of America,31,33,0,64
15625,2019,Hungary,United States of America,16,247,0,263
15626,2019,Cote d'Ivoire,United States of America,1162,1199,0,2361
15627,2019,India,United States of America,8174,33996,0,42170
15628,2019,Indonesia,United States of America,1228,2271,0,3499
15629,2019,Ireland,United States of America,0,29,0,29
15630,2019,Iran (Islamic Rep. of),United States of America,5824,2816,0,8640
15631,2019,Iraq,United States of America,5632,3339,0,8971
15632,2019,Israel,United States of America,130,480,0,610
15633,2019,Italy,United States of America,22,240,0,262
15634,2019,Jamaica,United States of America,926,1049,0,1975
15635,2019,Jordan,United States of America,621,2289,0,2910
15636,2019,Japan,United States of America,6,79,0,85
15637,2019,Kazakhstan,United States of America,1025,2196,0,3221
15638,2019,Kenya,United States of America,1931,4485,0,6416
15639,2019,Kyrgyzstan,United States of America,1584,1528,0,3112
15640,2019,Rep. of Korea,United States of America,32,162,0,194
15641,2019,Dem. People's Rep. of Korea,United States of America,6,26,0,32
15642,2019,Kuwait,United States of America,147,198,0,345
15643,2019,Lao People's Dem. Rep.,United States of America,79,156,0,235
15644,2019,Liberia,United States of America,1276,1040,0,2316
15645,2019,Libya,United States of America,395,1027,0,1422
15646,2019,Saint Lucia,United States of America,9,21,0,30
15647,2019,Lebanon,United States of America,411,810,0,1221
15648,2019,Lesotho,United States of America,6,0,0,6
15649,2019,Sri Lanka,United States of America,1232,1746,0,2978
15650,2019,Lithuania,United States of America,24,62,0,86
15651,2019,Latvia,United States of America,21,81,0,102
15652,2019,Madagascar,United States of America,12,14,0,26
15653,2019,Mauritania,United States of America,990,911,0,1901
15654,2019,North Macedonia,United States of America,121,193,0,314
15655,2019,Monaco,United States of America,5,0,0,5
15656,2019,Rep. of Moldova,United States of America,1530,2215,0,3745
15657,2019,Maldives,United States of America,5,0,0,5
15658,2019,Mexico,United States of America,11410,94275,0,105685
15659,2019,Marshall Islands,United States of America,7,0,0,7
15660,2019,Mali,United States of America,1129,563,0,1692
15661,2019,Malaysia,United States of America,97,348,0,445
15662,2019,Malawi,United States of America,37,115,0,152
15663,2019,Mongolia,United States of America,804,2067,0,2871
15664,2019,Morocco,United States of America,125,212,0,337
15665,2019,Mozambique,United States of America,21,36,0,57
15666,2019,Malta,United States of America,0,5,0,5
15667,2019,Montenegro,United States of America,94,331,0,425
15668,2019,Mauritius,United States of America,38,39,0,77
15669,2019,Myanmar,United States of America,1429,1294,0,2723
15670,2019,Namibia,United States of America,43,20,0,63
15671,2019,Nepal,United States of America,7122,6755,0,13877
15672,2019,Netherlands,United States of America,11,56,0,67
15673,2019,Niger,United States of America,152,303,0,455
15674,2019,Nicaragua,United States of America,1489,5861,0,7350
15675,2019,Nigeria,United States of America,2291,11682,0,13973
15676,2019,Niue,United States of America,19,6,0,25
15677,2019,Oman,United States of America,9,21,0,30
15678,2019,Pakistan,United States of America,3964,5567,0,9531
15679,2019,Panama,United States of America,13,105,0,118
15680,2019,Paraguay,United States of America,20,90,0,110
15681,2019,Peru,United States of America,531,3170,0,3701
15682,2019,Philippines,United States of America,168,1510,0,1678
15683,2019,Poland,United States of America,12,851,0,863
15684,2019,Portugal,United States of America,5,179,0,184
15685,2019,Qatar,United States of America,21,26,0,47
15686,2019,Romania,United States of America,444,3080,0,3524
15687,2019,South Africa,United States of America,52,291,0,343
15688,2019,Russian Federation,United States of America,6702,10194,0,16896
15689,2019,Rwanda,United States of America,1247,897,0,2144
15690,2019,El Salvador,United States of America,26216,113404,0,139620
15691,2019,Saudi Arabia,United States of America,568,768,0,1336
15692,2019,Serbia and Kosovo: S/RES/1244 (1999),United States of America,845,1095,0,1940
15693,2019,Senegal,United States of America,405,605,0,1010
15694,2019,Seychelles,United States of America,5,0,0,5
15695,2019,Singapore,United States of America,8,39,0,47
15696,2019,Sierra Leone,United States of America,464,316,0,780
15697,2019,Somalia,United States of America,1971,345,0,2316
15698,2019,Spain,United States of America,10,108,0,118
15699,2019,Viet Nam,United States of America,353,928,0,1281
15700,2019,Saint Kitts and Nevis,United States of America,5,5,0,10
15701,2019,Sudan,United States of America,1441,839,0,2280
15702,2019,Suriname,United States of America,12,37,0,49
15703,2019,South Sudan,United States of America,45,37,0,82
15704,2019,Slovakia,United States of America,6,12,0,18
15705,2019,Slovenia,United States of America,6,10,0,16
15706,2019,Eswatini,United States of America,5,17,0,22
15707,2019,Sweden,United States of America,5,18,0,23
15708,2019,Switzerland,United States of America,5,10,0,15
15709,2019,Syrian Arab Rep.,United States of America,8449,2660,0,11109
15710,2019,United Rep. of Tanzania,United States of America,130,193,0,323
15711,2019,Turks and Caicos Islands,United States of America,14,0,0,14
15712,2019,Thailand,United States of America,39,459,0,498
15713,2019,Tajikistan,United States of America,331,475,0,806
15714,2019,Turkmenistan,United States of America,205,285,0,490
15715,2019,Timor-Leste,United States of America,0,10,0,10
15716,2019,Togo,United States of America,565,574,0,1139
15717,2019,Tonga,United States of America,0,8,0,8
15718,2019,Trinidad and Tobago,United States of America,49,224,0,273
15719,2019,Tunisia,United States of America,86,246,0,332
15720,2019,Türkiye,United States of America,2501,3518,0,6019
15721,2019,United Arab Emirates,United States of America,72,154,0,226
15722,2019,Uganda,United States of America,1760,2795,0,4555
15723,2019,Ukraine,United States of America,2580,7817,0,10397
15724,2019,Uruguay,United States of America,5,123,0,128
15725,2019,Uzbekistan,United States of America,1317,2156,0,3473
15726,2019,Vanuatu,United States of America,0,9,0,9
15727,2019,Saint Vincent and the Grenadines,United States of America,32,20,0,52
15728,2019,Venezuela (Bolivarian Republic of),United States of America,15706,104989,0,120695
15729,2019,Yemen,United States of America,692,811,0,1503
15730,2019,Zambia,United States of America,51,86,0,137
15731,2019,Zimbabwe,United States of America,825,867,0,1692
15732,2019,Stateless,United States of America,168,0,0,168
15733,2019,Curacao ,United States of America,35,0,0,35
15734,2019,Unknown ,United States of America,6182,2607,0,8789
15735,2019,Afghanistan,Uzbekistan,13,0,0,13
15736,2019,Stateless,Uzbekistan,0,0,0,0
15737,2019,Venezuela (Bolivarian Republic of),Saint Vincent and the Grenadines,0,0,0,0
15738,2019,Afghanistan,Venezuela (Bolivarian Republic of),10,0,0,10
15739,2019,Chile,Venezuela (Bolivarian Republic of),10,0,0,10
15740,2019,Congo,Venezuela (Bolivarian Republic of),5,0,0,5
15741,2019,Colombia,Venezuela (Bolivarian Republic of),67622,49,0,67671
15742,2019,Palestinian,Venezuela (Bolivarian Republic of),7,0,0,7
15743,2019,Haiti,Venezuela (Bolivarian Republic of),7,0,0,7
15744,2019,Iraq,Venezuela (Bolivarian Republic of),18,0,0,18
15745,2019,Liberia,Venezuela (Bolivarian Republic of),9,0,0,9
15746,2019,Libya,Venezuela (Bolivarian Republic of),5,0,0,5
15747,2019,Lebanon,Venezuela (Bolivarian Republic of),12,0,0,12
15748,2019,Nigeria,Venezuela (Bolivarian Republic of),7,0,0,7
15749,2019,Peru,Venezuela (Bolivarian Republic of),5,0,0,5
15750,2019,Rwanda,Venezuela (Bolivarian Republic of),5,0,0,5
15751,2019,Sierra Leone,Venezuela (Bolivarian Republic of),5,0,0,5
15752,2019,Syrian Arab Rep.,Venezuela (Bolivarian Republic of),5,0,0,5
15753,2019,Türkiye,Venezuela (Bolivarian Republic of),6,0,0,6
15754,2019,Venezuela (Bolivarian Republic of),Venezuela (Bolivarian Republic of),0,0,0,0
15755,2019,Western Sahara,Venezuela (Bolivarian Republic of),11,0,0,11
15756,2019,Egypt,Yemen,16,9,0,25
15757,2019,Cameroon,Yemen,0,5,0,5
15758,2019,Dem. Rep. of the Congo,Yemen,0,5,0,5
15759,2019,Djibouti,Yemen,5,6,0,11
15760,2019,Eritrea,Yemen,1365,475,0,1840
15761,2019,Ethiopia,Yemen,6565,8668,0,15233
15762,2019,Palestinian,Yemen,625,309,0,934
15763,2019,Iran (Islamic Rep. of),Yemen,5,0,0,5
15764,2019,Iraq,Yemen,3321,73,0,3394
15765,2019,Jordan,Yemen,17,8,0,25
15766,2019,Lebanon,Yemen,0,6,0,6
15767,2019,Mali,Yemen,0,5,0,5
15768,2019,Pakistan,Yemen,0,9,0,9
15769,2019,Somalia,Yemen,252899,155,0,253054
15770,2019,Viet Nam,Yemen,15,0,0,15
15771,2019,Sudan,Yemen,119,529,0,648
15772,2019,Syrian Arab Rep.,Yemen,3551,407,0,3958
15773,2019,United Rep. of Tanzania,Yemen,0,0,0,0
15774,2019,Yemen,Yemen,0,0,3625716,0
15775,2019,Angola,Zambia,0,0,0,0
15776,2019,Burundi,Zambia,5490,1528,0,7018
15777,2019,Cameroon,Zambia,5,21,0,26
15778,2019,Congo,Zambia,7,0,0,7
15779,2019,Dem. Rep. of the Congo,Zambia,47568,3093,0,50661
15780,2019,Eritrea,Zambia,22,30,0,52
15781,2019,Ethiopia,Zambia,27,19,0,46
15782,2019,Palestinian,Zambia,14,0,0,14
15783,2019,Liberia,Zambia,8,0,0,8
15784,2019,Nigeria,Zambia,0,5,0,5
15785,2019,South Africa,Zambia,6,0,0,6
15786,2019,Rwanda,Zambia,774,64,0,838
15787,2019,Sierra Leone,Zambia,5,5,0,10
15788,2019,Somalia,Zambia,3379,245,0,3624
15789,2019,Sudan,Zambia,28,0,0,28
15790,2019,Syrian Arab Rep.,Zambia,15,6,0,21
15791,2019,Türkiye,Zambia,53,7,0,60
15792,2019,Uganda,Zambia,46,44,0,90
15793,2019,Unknown ,Zambia,71,0,0,71
15794,2019,Burundi,Zimbabwe,660,202,0,862
15795,2019,Central African Rep.,Zimbabwe,0,5,0,5
15796,2019,Cameroon,Zimbabwe,0,7,0,7
15797,2019,Congo,Zimbabwe,20,0,0,20
15798,2019,Dem. Rep. of the Congo,Zimbabwe,7483,2977,0,10460
15799,2019,Eritrea,Zimbabwe,20,5,0,25
15800,2019,Ethiopia,Zimbabwe,71,12,0,83
15801,2019,Cote d'Ivoire,Zimbabwe,12,20,0,32
15802,2019,Kenya,Zimbabwe,0,8,0,8
15803,2019,Mali,Zimbabwe,6,67,0,73
15804,2019,Mozambique,Zimbabwe,0,8119,0,8119
15805,2019,South Africa,Zimbabwe,0,0,0,0
15806,2019,Rwanda,Zimbabwe,649,62,0,711
15807,2019,Somalia,Zimbabwe,14,19,0,33
15808,2019,Sudan,Zimbabwe,5,0,0,5
15809,2019,South Sudan,Zimbabwe,8,24,0,32
15810,2019,Uganda,Zimbabwe,8,5,0,13
15811,2019,Zambia,Zimbabwe,0,0,0,0
15812,2019,Zimbabwe,Zimbabwe,0,0,270000,0
15813,2019,Venezuela (Bolivarian Republic of),Anguilla,0,0,0,0
15814,2019,Colombia,Aruba,0,8,0,8
15815,2019,Venezuela (Bolivarian Republic of),Aruba,0,398,0,398
15816,2019,Colombia,Curacao ,28,49,0,77
15817,2019,Venezuela (Bolivarian Republic of),Curacao ,14,296,0,310
15818,2019,Cuba,Sint Maarten (Dutch part),0,5,0,5
15819,2019,Iran (Islamic Rep. of),Sint Maarten (Dutch part),5,0,0,5
