,Year,Country of origin,Country of asylum,Refugees under UNHCR's mandate,Asylum-seekers,IDPs of concern to UNHCR,International total
21311,2021,Afghanistan,Afghanistan,0,0,3457744,0
21312,2021,Bangladesh,Afghanistan,0,5,0,5
21313,2021,Iran (Islamic Rep. of),Afghanistan,38,25,0,63
21314,2021,Pakistan,Afghanistan,66911,215,0,67126
21315,2021,Tajikistan,Afghanistan,0,6,0,6
21316,2021,Afghanistan,Albania,5,0,0,5
21317,2021,Egypt,Albania,0,0,0,0
21318,2021,China,Albania,14,0,0,14
21319,2021,Palestinian,Albania,8,0,0,8
21320,2021,Serbia and Kosovo: S/RES/1244 (1999),Albania,57,0,0,57
21321,2021,Syrian Arab Rep.,Albania,15,6,0,21
21322,2021,Uzbekistan,Albania,5,0,0,5
21323,2021,Venezuela (Bolivarian Republic of),Albania,5,0,0,5
21324,2021,Stateless,Albania,0,0,0,0
21325,2021,Benin,Algeria,5,53,0,58
21326,2021,Burkina Faso,Algeria,9,10,0,19
21327,2021,Central African Rep.,Algeria,103,34,0,137
21328,2021,Chad,Algeria,5,30,0,35
21329,2021,Cameroon,Algeria,154,382,0,536
21330,2021,Congo,Algeria,0,5,0,5
21331,2021,Dem. Rep. of the Congo,Algeria,81,109,0,190
21332,2021,Eritrea,Algeria,5,5,0,10
21333,2021,Gambia,Algeria,0,5,0,5
21334,2021,Palestinian,Algeria,185,0,0,185
21335,2021,Ghana,Algeria,0,7,0,7
21336,2021,Guinea-Bissau,Algeria,0,5,0,5
21337,2021,Guinea,Algeria,44,345,0,389
21338,2021,Cote d'Ivoire,Algeria,81,222,0,303
21339,2021,Iraq,Algeria,13,5,0,18
21340,2021,Liberia,Algeria,0,50,0,50
21341,2021,Libya,Algeria,21,17,0,38
21342,2021,Mali,Algeria,206,387,0,593
21343,2021,Niger,Algeria,9,126,0,135
21344,2021,Nigeria,Algeria,5,239,0,244
21345,2021,Senegal,Algeria,0,7,0,7
21346,2021,Sierra Leone,Algeria,0,23,0,23
21347,2021,Somalia,Algeria,5,0,0,5
21348,2021,Sudan,Algeria,33,28,0,61
21349,2021,Syrian Arab Rep.,Algeria,6659,0,0,6659
21350,2021,Togo,Algeria,0,14,0,14
21351,2021,Türkiye,Algeria,0,22,0,22
21352,2021,Western Sahara,Algeria,90000,0,0,90000
21353,2021,Yemen,Algeria,267,0,0,267
21354,2021,Angola,Angola,0,0,0,0
21355,2021,Burundi,Angola,18,99,0,117
21356,2021,Central African Rep.,Angola,7,77,0,84
21357,2021,Chad,Angola,189,779,0,968
21358,2021,Congo,Angola,65,58,0,123
21359,2021,Dem. Rep. of the Congo,Angola,23163,500,0,23663
21360,2021,Eritrea,Angola,83,1791,0,1874
21361,2021,Ethiopia,Angola,0,57,0,57
21362,2021,Guinea-Bissau,Angola,7,268,0,275
21363,2021,Guinea,Angola,126,9146,0,9272
21364,2021,Cote d'Ivoire,Angola,417,5940,0,6357
21365,2021,Liberia,Angola,164,478,0,642
21366,2021,Mauritania,Angola,323,5402,0,5725
21367,2021,Rwanda,Angola,499,141,0,640
21368,2021,Sierra Leone,Angola,413,1497,0,1910
21369,2021,Somalia,Angola,271,1731,0,2002
21370,2021,Sudan,Angola,279,1670,0,1949
21371,2021,Syrian Arab Rep.,Angola,0,5,0,5
21372,2021,United Rep. of Tanzania,Angola,5,0,0,5
21373,2021,Türkiye,Angola,0,38,0,38
21374,2021,Uganda,Angola,0,6,0,6
21375,2021,Western Sahara,Angola,16,596,0,612
21376,2021,Afghanistan,Egypt,43,49,0,92
21377,2021,Burundi,Egypt,55,62,0,117
21378,2021,Bangladesh,Egypt,0,5,0,5
21379,2021,Central African Rep.,Egypt,45,30,0,75
21380,2021,Chad,Egypt,60,54,0,114
21381,2021,China,Egypt,0,80,0,80
21382,2021,Cameroon,Egypt,17,38,0,55
21383,2021,Congo,Egypt,14,25,0,39
21384,2021,Dem. Rep. of the Congo,Egypt,47,28,0,75
21385,2021,Djibouti,Egypt,24,11,0,35
21386,2021,Eritrea,Egypt,14141,6785,0,20926
21387,2021,Ethiopia,Egypt,5589,9895,0,15484
21388,2021,Palestinian,Egypt,70021,0,0,70021
21389,2021,Guinea,Egypt,11,55,0,66
21390,2021,Cote d'Ivoire,Egypt,96,10,0,106
21391,2021,Iraq,Egypt,4629,2178,0,6807
21392,2021,Jordan,Egypt,9,9,0,18
21393,2021,Kenya,Egypt,9,12,0,21
21394,2021,Liberia,Egypt,0,10,0,10
21395,2021,Libya,Egypt,5,0,0,5
21396,2021,Lebanon,Egypt,0,6,0,6
21397,2021,Sri Lanka,Egypt,0,10,0,10
21398,2021,Mali,Egypt,0,10,0,10
21399,2021,Nigeria,Egypt,25,196,0,221
21400,2021,Russian Federation,Egypt,9,16,0,25
21401,2021,Rwanda,Egypt,5,0,0,5
21402,2021,Saudi Arabia,Egypt,15,7,0,22
21403,2021,Sierra Leone,Egypt,5,8,0,13
21404,2021,Somalia,Egypt,4698,2067,0,6765
21405,2021,Sudan,Egypt,25476,26527,0,52003
21406,2021,South Sudan,Egypt,18673,2040,0,20713
21407,2021,Syrian Arab Rep.,Egypt,136727,0,0,136727
21408,2021,United Rep. of Tanzania,Egypt,5,0,0,5
21409,2021,Tajikistan,Egypt,12,10,0,22
21410,2021,Turkmenistan,Egypt,5,0,0,5
21411,2021,Togo,Egypt,0,6,0,6
21412,2021,Tunisia,Egypt,5,0,0,5
21413,2021,Türkiye,Egypt,0,360,0,360
21414,2021,Uganda,Egypt,13,19,0,32
21415,2021,Uzbekistan,Egypt,0,17,0,17
21416,2021,Yemen,Egypt,156,9735,0,9891
21417,2021,Zimbabwe,Egypt,42,17,0,59
21418,2021,Stateless,Egypt,0,0,0,0
21419,2021,Unknown ,Egypt,0,5,0,5
21420,2021,Afghanistan,Argentina,12,0,0,12
21421,2021,Albania,Argentina,18,0,0,18
21422,2021,Algeria,Argentina,30,20,0,50
21423,2021,Angola,Argentina,14,15,0,29
21424,2021,Egypt,Argentina,5,19,0,24
21425,2021,Armenia,Argentina,77,183,0,260
21426,2021,Burundi,Argentina,5,0,0,5
21427,2021,Bangladesh,Argentina,5,90,0,95
21428,2021,Bolivia (Plurinational State of),Argentina,63,62,0,125
21429,2021,Brazil,Argentina,0,18,0,18
21430,2021,Bosnia and Herzegovina,Argentina,6,0,0,6
21431,2021,China,Argentina,0,115,0,115
21432,2021,Chile,Argentina,34,7,0,41
21433,2021,Cameroon,Argentina,11,39,0,50
21434,2021,Dem. Rep. of the Congo,Argentina,26,28,0,54
21435,2021,Colombia,Argentina,561,258,0,819
21436,2021,Costa Rica,Argentina,5,0,0,5
21437,2021,Cuba,Argentina,263,819,0,1082
21438,2021,Cabo Verde,Argentina,0,5,0,5
21439,2021,Czechia,Argentina,0,5,0,5
21440,2021,Dominican Rep.,Argentina,9,568,0,577
21441,2021,Ecuador,Argentina,16,31,0,47
21442,2021,Eritrea,Argentina,0,5,0,5
21443,2021,Ethiopia,Argentina,5,0,0,5
21444,2021,Gambia,Argentina,0,10,0,10
21445,2021,Palestinian,Argentina,21,12,0,33
21446,2021,Georgia,Argentina,5,0,0,5
21447,2021,Ghana,Argentina,37,148,0,185
21448,2021,Guinea-Bissau,Argentina,8,5,0,13
21449,2021,Guatemala,Argentina,8,0,0,8
21450,2021,Guinea,Argentina,10,9,0,19
21451,2021,Haiti,Argentina,76,781,0,857
21452,2021,Honduras,Argentina,6,10,0,16
21453,2021,Hungary,Argentina,0,5,0,5
21454,2021,Cote d'Ivoire,Argentina,20,5,0,25
21455,2021,India,Argentina,23,127,0,150
21456,2021,Iran (Islamic Rep. of),Argentina,30,7,0,37
21457,2021,Iraq,Argentina,22,0,0,22
21458,2021,Jamaica,Argentina,13,0,0,13
21459,2021,Jordan,Argentina,5,5,0,10
21460,2021,Kazakhstan,Argentina,18,13,0,31
21461,2021,Kyrgyzstan,Argentina,5,0,0,5
21462,2021,Liberia,Argentina,42,0,0,42
21463,2021,Libya,Argentina,5,5,0,10
21464,2021,Sri Lanka,Argentina,36,0,0,36
21465,2021,North Macedonia,Argentina,9,0,0,9
21466,2021,Mexico,Argentina,0,6,0,6
21467,2021,Mali,Argentina,9,0,0,9
21468,2021,Morocco,Argentina,0,13,0,13
21469,2021,Nepal,Argentina,0,5,0,5
21470,2021,Nicaragua,Argentina,16,15,0,31
21471,2021,Nigeria,Argentina,42,71,0,113
21472,2021,Pakistan,Argentina,39,18,0,57
21473,2021,Paraguay,Argentina,19,19,0,38
21474,2021,Peru,Argentina,548,84,0,632
21475,2021,Philippines,Argentina,0,5,0,5
21476,2021,Romania,Argentina,51,0,0,51
21477,2021,South Africa,Argentina,0,12,0,12
21478,2021,Russian Federation,Argentina,81,94,0,175
21479,2021,El Salvador,Argentina,47,36,0,83
21480,2021,Senegal,Argentina,43,1383,0,1426
21481,2021,Sierra Leone,Argentina,37,5,0,42
21482,2021,Somalia,Argentina,5,0,0,5
21483,2021,Spain,Argentina,0,5,0,5
21484,2021,Sudan,Argentina,5,0,0,5
21485,2021,Syrian Arab Rep.,Argentina,433,98,0,531
21486,2021,Tunisia,Argentina,0,5,0,5
21487,2021,Türkiye,Argentina,7,0,0,7
21488,2021,Ukraine,Argentina,121,84,0,205
21489,2021,United States of America,Argentina,5,12,0,17
21490,2021,Venezuela (Bolivarian Republic of),Argentina,315,5580,0,5895
21491,2021,Yemen,Argentina,21,0,0,21
21492,2021,Unknown ,Argentina,642,47,0,689
21493,2021,Afghanistan,Armenia,5,0,0,5
21494,2021,Egypt,Armenia,5,0,0,5
21495,2021,Azerbaijan,Armenia,27933,0,0,27933
21496,2021,Congo,Armenia,5,0,0,5
21497,2021,Cuba,Armenia,5,13,0,18
21498,2021,Palestinian,Armenia,7,0,0,7
21499,2021,Georgia,Armenia,8,5,0,13
21500,2021,Cote d'Ivoire,Armenia,6,0,0,6
21501,2021,Iran (Islamic Rep. of),Armenia,139,88,0,227
21502,2021,Iraq,Armenia,1095,39,0,1134
21503,2021,Lebanon,Armenia,26,5,0,31
21504,2021,Myanmar,Armenia,0,5,0,5
21505,2021,Nigeria,Armenia,5,0,0,5
21506,2021,Russian Federation,Armenia,0,6,0,6
21507,2021,Syrian Arab Rep.,Armenia,5335,8,0,5343
21508,2021,Türkiye,Armenia,16,12,0,28
21509,2021,Ukraine,Armenia,117,0,0,117
21510,2021,Yemen,Armenia,21,0,0,21
21511,2021,Stateless,Armenia,0,0,0,0
21512,2021,Afghanistan,Australia,9648,2670,0,12318
21513,2021,Albania,Australia,37,96,0,133
21514,2021,Algeria,Australia,9,23,0,32
21515,2021,Egypt,Australia,1320,256,0,1576
21516,2021,Argentina,Australia,0,29,0,29
21517,2021,Azerbaijan,Australia,9,12,0,21
21518,2021,Bahrain,Australia,48,6,0,54
21519,2021,Burundi,Australia,48,28,0,76
21520,2021,Bangladesh,Australia,393,1344,0,1737
21521,2021,Bhutan,Australia,5,17,0,22
21522,2021,Belarus,Australia,6,0,0,6
21523,2021,Brazil,Australia,8,194,0,202
21524,2021,Brunei Darussalam,Australia,0,5,0,5
21525,2021,Bosnia and Herzegovina,Australia,0,5,0,5
21526,2021,Cambodia,Australia,67,561,0,628
21527,2021,China,Australia,1579,15774,0,17353
21528,2021,Chile,Australia,0,62,0,62
21529,2021,Cameroon,Australia,28,59,0,87
21530,2021,Congo,Australia,27,34,0,61
21531,2021,Dem. Rep. of the Congo,Australia,64,34,0,98
21532,2021,Colombia,Australia,87,312,0,399
21533,2021,Czechia,Australia,0,5,0,5
21534,2021,Djibouti,Australia,5,0,0,5
21535,2021,Eritrea,Australia,96,11,0,107
21536,2021,Ethiopia,Australia,342,223,0,565
21537,2021,Fiji,Australia,276,2522,0,2798
21538,2021,France,Australia,0,23,0,23
21539,2021,Gambia,Australia,8,11,0,19
21540,2021,Palestinian,Australia,477,185,0,662
21541,2021,United Kingdom of Great Britain and Northern Ireland,Australia,6,96,0,102
21542,2021,Georgia,Australia,13,26,0,39
21543,2021,Germany,Australia,10,5,0,15
21544,2021,Ghana,Australia,41,211,0,252
21545,2021,Greece,Australia,6,49,0,55
21546,2021,Guinea,Australia,8,5,0,13
21547,2021,"China, Hong Kong SAR",Australia,5,442,0,447
21548,2021,Honduras,Australia,5,6,0,11
21549,2021,Hungary,Australia,0,5,0,5
21550,2021,India,Australia,475,6995,0,7470
21551,2021,Indonesia,Australia,235,2328,0,2563
21552,2021,Ireland,Australia,0,79,0,79
21553,2021,Iran (Islamic Rep. of),Australia,12701,3040,0,15741
21554,2021,Iraq,Australia,4488,1119,0,5607
21555,2021,Israel,Australia,9,17,0,26
21556,2021,Italy,Australia,5,50,0,55
21557,2021,Jamaica,Australia,5,0,0,5
21558,2021,Jordan,Australia,136,197,0,333
21559,2021,Japan,Australia,9,22,0,31
21560,2021,Kazakhstan,Australia,5,0,0,5
21561,2021,Kenya,Australia,99,342,0,441
21562,2021,Kyrgyzstan,Australia,12,0,0,12
21563,2021,Rep. of Korea,Australia,24,259,0,283
21564,2021,Dem. People's Rep. of Korea,Australia,0,9,0,9
21565,2021,Kuwait,Australia,26,0,0,26
21566,2021,Lao People's Dem. Rep.,Australia,5,288,0,293
21567,2021,Liberia,Australia,44,18,0,62
21568,2021,Libya,Australia,1245,54,0,1299
21569,2021,Lebanon,Australia,476,957,0,1433
21570,2021,Sri Lanka,Australia,3935,2686,0,6621
21571,2021,North Macedonia,Australia,5,86,0,91
21572,2021,Maldives,Australia,13,16,0,29
21573,2021,Mexico,Australia,14,31,0,45
21574,2021,Malaysia,Australia,687,19065,0,19752
21575,2021,Mongolia,Australia,15,369,0,384
21576,2021,Morocco,Australia,12,19,0,31
21577,2021,Mozambique,Australia,0,5,0,5
21578,2021,Mauritius,Australia,10,140,0,150
21579,2021,Myanmar,Australia,407,777,0,1184
21580,2021,Nepal,Australia,100,641,0,741
21581,2021,Nigeria,Australia,247,537,0,784
21582,2021,Nauru,Australia,5,16,0,21
21583,2021,New Zealand,Australia,26,27,0,53
21584,2021,Oman,Australia,5,0,0,5
21585,2021,Pakistan,Australia,5348,2329,0,7677
21586,2021,Peru,Australia,19,70,0,89
21587,2021,Philippines,Australia,43,1693,0,1736
21588,2021,Papua New Guinea,Australia,497,636,0,1133
21589,2021,Poland,Australia,0,19,0,19
21590,2021,Portugal,Australia,0,12,0,12
21591,2021,Romania,Australia,0,5,0,5
21592,2021,South Africa,Australia,26,469,0,495
21593,2021,Russian Federation,Australia,53,88,0,141
21594,2021,Rwanda,Australia,90,54,0,144
21595,2021,El Salvador,Australia,12,30,0,42
21596,2021,Saudi Arabia,Australia,200,69,0,269
21597,2021,Serbia and Kosovo: S/RES/1244 (1999),Australia,0,21,0,21
21598,2021,Singapore,Australia,6,37,0,43
21599,2021,Sierra Leone,Australia,30,134,0,164
21600,2021,Solomon Islands,Australia,25,314,0,339
21601,2021,Somalia,Australia,524,141,0,665
21602,2021,Viet Nam,Australia,323,3469,0,3792
21603,2021,Sudan,Australia,556,187,0,743
21604,2021,South Sudan,Australia,20,42,0,62
21605,2021,Eswatini,Australia,0,21,0,21
21606,2021,Syrian Arab Rep.,Australia,640,53,0,693
21607,2021,United Rep. of Tanzania,Australia,8,34,0,42
21608,2021,Thailand,Australia,22,2233,0,2255
21609,2021,Timor-Leste,Australia,6,347,0,353
21610,2021,Tonga,Australia,28,811,0,839
21611,2021,Tunisia,Australia,0,9,0,9
21612,2021,Türkiye,Australia,805,502,0,1307
21613,2021,United Arab Emirates,Australia,5,0,0,5
21614,2021,Uganda,Australia,59,91,0,150
21615,2021,Ukraine,Australia,18,99,0,117
21616,2021,United States of America,Australia,17,58,0,75
21617,2021,Uzbekistan,Australia,19,54,0,73
21618,2021,Vanuatu,Australia,0,86,0,86
21619,2021,Venezuela (Bolivarian Republic of),Australia,143,336,0,479
21620,2021,Samoa,Australia,5,150,0,155
21621,2021,Yemen,Australia,181,94,0,275
21622,2021,Zambia,Australia,19,19,0,38
21623,2021,Zimbabwe,Australia,312,196,0,508
21624,2021,Stateless,Australia,3876,1239,0,5115
21625,2021,Tibetan,Australia,10,0,0,10
21626,2021,Unknown ,Australia,1500,1024,0,2524
21627,2021,Afghanistan,Austria,42685,5600,0,48285
21628,2021,Albania,Austria,52,23,0,75
21629,2021,Algeria,Austria,28,173,0,201
21630,2021,Angola,Austria,36,7,0,43
21631,2021,Egypt,Austria,217,387,0,604
21632,2021,Armenia,Austria,307,154,0,461
21633,2021,Azerbaijan,Austria,150,107,0,257
21634,2021,Burundi,Austria,15,0,0,15
21635,2021,Benin,Austria,5,15,0,20
21636,2021,Bangladesh,Austria,360,250,0,610
21637,2021,Burkina Faso,Austria,5,7,0,12
21638,2021,Belarus,Austria,31,20,0,51
21639,2021,Bosnia and Herzegovina,Austria,58,7,0,65
21640,2021,Canada,Austria,5,0,0,5
21641,2021,China,Austria,642,87,0,729
21642,2021,Cameroon,Austria,186,49,0,235
21643,2021,Congo,Austria,80,11,0,91
21644,2021,Dem. Rep. of the Congo,Austria,329,59,0,388
21645,2021,Colombia,Austria,5,13,0,18
21646,2021,Cuba,Austria,15,5,0,20
21647,2021,Eritrea,Austria,471,49,0,520
21648,2021,Ethiopia,Austria,241,67,0,308
21649,2021,Gabon,Austria,5,0,0,5
21650,2021,Gambia,Austria,112,66,0,178
21651,2021,United Kingdom of Great Britain and Northern Ireland,Austria,5,0,0,5
21652,2021,Georgia,Austria,309,211,0,520
21653,2021,Germany,Austria,0,5,0,5
21654,2021,Ghana,Austria,17,23,0,40
21655,2021,Guinea-Bissau,Austria,5,5,0,10
21656,2021,Guatemala,Austria,6,0,0,6
21657,2021,Guinea,Austria,125,30,0,155
21658,2021,Hungary,Austria,0,5,0,5
21659,2021,Cote d'Ivoire,Austria,42,17,0,59
21660,2021,India,Austria,37,595,0,632
21661,2021,Iran (Islamic Rep. of),Austria,7209,1167,0,8376
21662,2021,Iraq,Austria,9959,1637,0,11596
21663,2021,Israel,Austria,10,0,0,10
21664,2021,Jordan,Austria,78,38,0,116
21665,2021,Kazakhstan,Austria,108,23,0,131
21666,2021,Kenya,Austria,17,7,0,24
21667,2021,Kyrgyzstan,Austria,117,19,0,136
21668,2021,Kuwait,Austria,10,9,0,19
21669,2021,Liberia,Austria,10,0,0,10
21670,2021,Libya,Austria,144,68,0,212
21671,2021,Lebanon,Austria,122,117,0,239
21672,2021,Sri Lanka,Austria,71,21,0,92
21673,2021,Mauritania,Austria,5,0,0,5
21674,2021,North Macedonia,Austria,12,52,0,64
21675,2021,Rep. of Moldova,Austria,17,195,0,212
21676,2021,Mali,Austria,14,12,0,26
21677,2021,Mongolia,Austria,116,70,0,186
21678,2021,Morocco,Austria,42,523,0,565
21679,2021,Montenegro,Austria,5,0,0,5
21680,2021,Myanmar,Austria,32,9,0,41
21681,2021,Nepal,Austria,18,31,0,49
21682,2021,Nicaragua,Austria,5,0,0,5
21683,2021,Nigeria,Austria,425,334,0,759
21684,2021,Pakistan,Austria,375,591,0,966
21685,2021,Philippines,Austria,19,13,0,32
21686,2021,Romania,Austria,5,0,0,5
21687,2021,South Africa,Austria,0,8,0,8
21688,2021,Russian Federation,Austria,6526,702,0,7228
21689,2021,Rwanda,Austria,12,5,0,17
21690,2021,Saudi Arabia,Austria,7,0,0,7
21691,2021,Serbia and Kosovo: S/RES/1244 (1999),Austria,437,136,0,573
21692,2021,Senegal,Austria,14,8,0,22
21693,2021,Sierra Leone,Austria,19,8,0,27
21694,2021,Somalia,Austria,8414,1518,0,9932
21695,2021,Viet Nam,Austria,5,9,0,14
21696,2021,Sudan,Austria,296,30,0,326
21697,2021,South Sudan,Austria,6,0,0,6
21698,2021,Syrian Arab Rep.,Austria,62408,10558,0,72966
21699,2021,Tajikistan,Austria,260,24,0,284
21700,2021,Turkmenistan,Austria,8,0,0,8
21701,2021,Togo,Austria,7,6,0,13
21702,2021,Tunisia,Austria,13,243,0,256
21703,2021,Türkiye,Austria,671,671,0,1342
21704,2021,Uganda,Austria,35,6,0,41
21705,2021,Ukraine,Austria,253,113,0,366
21706,2021,United States of America,Austria,5,0,0,5
21707,2021,Uzbekistan,Austria,44,64,0,108
21708,2021,Venezuela (Bolivarian Republic of),Austria,83,32,0,115
21709,2021,Yemen,Austria,426,177,0,603
21710,2021,Zambia,Austria,5,0,0,5
21711,2021,Stateless,Austria,2020,0,0,2020
21712,2021,Unknown ,Austria,5009,546,0,5555
21713,2021,Afghanistan,Azerbaijan,1189,26,0,1215
21714,2021,Azerbaijan,Azerbaijan,0,0,654839,0
21715,2021,Palestinian,Azerbaijan,5,0,0,5
21716,2021,Iran (Islamic Rep. of),Azerbaijan,52,0,0,52
21717,2021,Iraq,Azerbaijan,10,0,0,10
21718,2021,Libya,Azerbaijan,5,0,0,5
21719,2021,Pakistan,Azerbaijan,45,0,0,45
21720,2021,Russian Federation,Azerbaijan,317,8,0,325
21721,2021,Syrian Arab Rep.,Azerbaijan,33,0,0,33
21722,2021,Ukraine,Azerbaijan,5,0,0,5
21723,2021,Uzbekistan,Azerbaijan,5,0,0,5
21724,2021,Yemen,Azerbaijan,10,0,0,10
21725,2021,Stateless,Azerbaijan,0,0,0,0
21726,2021,Egypt,Bahrain,0,5,0,5
21727,2021,Palestinian,Bahrain,0,15,0,15
21728,2021,Iraq,Bahrain,242,117,0,359
21729,2021,Jordan,Bahrain,0,6,0,6
21730,2021,Syrian Arab Rep.,Bahrain,5,36,0,41
21731,2021,Tunisia,Bahrain,0,6,0,6
21732,2021,Yemen,Bahrain,9,5,0,14
21733,2021,Guyana,Barbados,0,5,0,5
21734,2021,Venezuela (Bolivarian Republic of),Barbados,0,5,0,5
21735,2021,Burundi,Burundi,0,0,19176,0
21736,2021,Belgium,Burundi,0,0,0,0
21737,2021,Dem. Rep. of the Congo,Burundi,80817,3899,0,84716
21738,2021,Kenya,Burundi,5,0,0,5
21739,2021,Mali,Burundi,13,0,0,13
21740,2021,Oman,Burundi,0,0,0,0
21741,2021,Pakistan,Burundi,9,0,0,9
21742,2021,Rwanda,Burundi,614,393,0,1007
21743,2021,Somalia,Burundi,5,0,0,5
21744,2021,United Rep. of Tanzania,Burundi,7,0,0,7
21745,2021,Uganda,Burundi,21,5,0,26
21746,2021,Afghanistan,Belgium,5859,7375,0,13234
21747,2021,Albania,Belgium,689,470,0,1159
21748,2021,Algeria,Belgium,70,220,0,290
21749,2021,Angola,Belgium,93,225,0,318
21750,2021,Egypt,Belgium,98,105,0,203
21751,2021,Armenia,Belgium,154,285,0,439
21752,2021,Azerbaijan,Belgium,90,50,0,140
21753,2021,Burundi,Belgium,2246,415,0,2661
21754,2021,Benin,Belgium,38,60,0,98
21755,2021,Bangladesh,Belgium,21,15,0,36
21756,2021,Burkina Faso,Belgium,116,110,0,226
21757,2021,Belarus,Belgium,46,105,0,151
21758,2021,Brazil,Belgium,15,45,0,60
21759,2021,Bosnia and Herzegovina,Belgium,44,65,0,109
21760,2021,Bulgaria,Belgium,17,0,0,17
21761,2021,Cambodia,Belgium,13,0,0,13
21762,2021,Central African Rep.,Belgium,62,25,0,87
21763,2021,Chad,Belgium,46,55,0,101
21764,2021,China,Belgium,1206,80,0,1286
21765,2021,Chile,Belgium,44,10,0,54
21766,2021,Cameroon,Belgium,593,795,0,1388
21767,2021,Congo,Belgium,25,35,0,60
21768,2021,Dem. Rep. of the Congo,Belgium,1573,780,0,2353
21769,2021,Colombia,Belgium,135,240,0,375
21770,2021,Cuba,Belgium,10,5,0,15
21771,2021,Czechia,Belgium,5,0,0,5
21772,2021,Djibouti,Belgium,383,60,0,443
21773,2021,Ecuador,Belgium,0,15,0,15
21774,2021,Eritrea,Belgium,3974,1320,0,5294
21775,2021,Ethiopia,Belgium,175,175,0,350
21776,2021,France,Belgium,0,5,0,5
21777,2021,Gabon,Belgium,26,30,0,56
21778,2021,Gambia,Belgium,36,110,0,146
21779,2021,Palestinian,Belgium,3109,2030,0,5139
21780,2021,Georgia,Belgium,159,435,0,594
21781,2021,Ghana,Belgium,19,70,0,89
21782,2021,Guinea-Bissau,Belgium,7,10,0,17
21783,2021,Guatemala,Belgium,39,35,0,74
21784,2021,Guinea,Belgium,3656,1050,0,4706
21785,2021,Guyana,Belgium,5,0,0,5
21786,2021,Haiti,Belgium,5,5,0,10
21787,2021,Honduras,Belgium,18,25,0,43
21788,2021,Croatia,Belgium,5,0,0,5
21789,2021,Hungary,Belgium,29,0,0,29
21790,2021,Cote d'Ivoire,Belgium,238,210,0,448
21791,2021,India,Belgium,14,10,0,24
21792,2021,Iran (Islamic Rep. of),Belgium,1843,545,0,2388
21793,2021,Iraq,Belgium,5655,995,0,6650
21794,2021,Jamaica,Belgium,5,0,0,5
21795,2021,Jordan,Belgium,23,65,0,88
21796,2021,Kazakhstan,Belgium,60,25,0,85
21797,2021,Kenya,Belgium,15,10,0,25
21798,2021,Kyrgyzstan,Belgium,70,40,0,110
21799,2021,Dem. People's Rep. of Korea,Belgium,32,10,0,42
21800,2021,Kuwait,Belgium,6,5,0,11
21801,2021,Lao People's Dem. Rep.,Belgium,10,0,0,10
21802,2021,Liberia,Belgium,15,35,0,50
21803,2021,Libya,Belgium,145,160,0,305
21804,2021,Lebanon,Belgium,115,155,0,270
21805,2021,Sri Lanka,Belgium,309,50,0,359
21806,2021,Lithuania,Belgium,5,0,0,5
21807,2021,Madagascar,Belgium,0,5,0,5
21808,2021,Mauritania,Belgium,274,200,0,474
21809,2021,North Macedonia,Belgium,133,145,0,278
21810,2021,Rep. of Moldova,Belgium,5,235,0,240
21811,2021,Mali,Belgium,99,85,0,184
21812,2021,Mongolia,Belgium,0,10,0,10
21813,2021,Morocco,Belgium,167,340,0,507
21814,2021,Mozambique,Belgium,0,10,0,10
21815,2021,Montenegro,Belgium,13,10,0,23
21816,2021,Myanmar,Belgium,8,5,0,13
21817,2021,Nepal,Belgium,6,5,0,11
21818,2021,Niger,Belgium,136,125,0,261
21819,2021,Nicaragua,Belgium,26,10,0,36
21820,2021,Nigeria,Belgium,55,310,0,365
21821,2021,Pakistan,Belgium,345,140,0,485
21822,2021,Peru,Belgium,0,70,0,70
21823,2021,Philippines,Belgium,0,5,0,5
21824,2021,Poland,Belgium,98,0,0,98
21825,2021,Romania,Belgium,36,10,0,46
21826,2021,South Africa,Belgium,5,0,0,5
21827,2021,Russian Federation,Belgium,2665,405,0,3070
21828,2021,Rwanda,Belgium,826,325,0,1151
21829,2021,El Salvador,Belgium,542,595,0,1137
21830,2021,Saudi Arabia,Belgium,8,5,0,13
21831,2021,Serbia and Kosovo: S/RES/1244 (1999),Belgium,908,270,0,1178
21832,2021,Senegal,Belgium,396,300,0,696
21833,2021,Sierra Leone,Belgium,27,55,0,82
21834,2021,Somalia,Belgium,2551,1380,0,3931
21835,2021,Spain,Belgium,0,10,0,10
21836,2021,Viet Nam,Belgium,23,25,0,48
21837,2021,Sudan,Belgium,299,165,0,464
21838,2021,Suriname,Belgium,0,15,0,15
21839,2021,South Sudan,Belgium,5,20,0,25
21840,2021,Slovakia,Belgium,0,5,0,5
21841,2021,Syrian Arab Rep.,Belgium,19188,1980,0,21168
21842,2021,United Rep. of Tanzania,Belgium,43,30,0,73
21843,2021,Tajikistan,Belgium,11,5,0,16
21844,2021,Togo,Belgium,163,125,0,288
21845,2021,Tunisia,Belgium,68,120,0,188
21846,2021,Türkiye,Belgium,3031,1005,0,4036
21847,2021,Uganda,Belgium,24,25,0,49
21848,2021,Ukraine,Belgium,289,155,0,444
21849,2021,United States of America,Belgium,0,10,0,10
21850,2021,Uzbekistan,Belgium,37,10,0,47
21851,2021,Venezuela (Bolivarian Republic of),Belgium,479,250,0,729
21852,2021,Yemen,Belgium,257,160,0,417
21853,2021,Stateless,Belgium,319,5,0,324
21854,2021,Tibetan,Belgium,6,0,0,6
21855,2021,Unknown ,Belgium,6979,520,0,7499
21856,2021,Burundi,Benin,5,0,0,5
21857,2021,Burkina Faso,Benin,189,5,0,194
21858,2021,Central African Rep.,Benin,1122,156,0,1278
21859,2021,Chad,Benin,17,35,0,52
21860,2021,Cameroon,Benin,79,75,0,154
21861,2021,Congo,Benin,0,11,0,11
21862,2021,Dem. Rep. of the Congo,Benin,24,55,0,79
21863,2021,Eritrea,Benin,5,0,0,5
21864,2021,Guinea,Benin,0,14,0,14
21865,2021,Cote d'Ivoire,Benin,160,27,0,187
21866,2021,Liberia,Benin,0,5,0,5
21867,2021,Sri Lanka,Benin,5,0,0,5
21868,2021,Mali,Benin,48,14,0,62
21869,2021,Niger,Benin,0,22,0,22
21870,2021,Nigeria,Benin,0,37,0,37
21871,2021,Pakistan,Benin,5,0,0,5
21872,2021,Rwanda,Benin,0,5,0,5
21873,2021,Sudan,Benin,18,7,0,25
21874,2021,Syrian Arab Rep.,Benin,32,12,0,44
21875,2021,Togo,Benin,0,26,0,26
21876,2021,Türkiye,Benin,10,0,0,10
21877,2021,Yemen,Benin,17,0,0,17
21878,2021,Afghanistan,Bangladesh,0,5,0,5
21879,2021,Bangladesh,Bangladesh,0,0,0,0
21880,2021,Myanmar,Bangladesh,918898,0,0,918898
21881,2021,Somalia,Bangladesh,9,33,0,42
21882,2021,Türkiye,Bangladesh,0,10,0,10
21883,2021,Stateless,Bangladesh,0,0,0,0
21884,2021,Cameroon,Bahamas,5,0,0,5
21885,2021,Cuba,Bahamas,0,5,0,5
21886,2021,Jamaica,Bahamas,5,0,0,5
21887,2021,South Africa,Bahamas,0,8,0,8
21888,2021,Burundi,Burkina Faso,28,0,0,28
21889,2021,Benin,Burkina Faso,8,0,0,8
21890,2021,Burkina Faso,Burkina Faso,0,0,1579976,0
21891,2021,Central African Rep.,Burkina Faso,187,122,0,309
21892,2021,Chad,Burkina Faso,74,0,0,74
21893,2021,Cameroon,Burkina Faso,7,0,0,7
21894,2021,Congo,Burkina Faso,26,0,0,26
21895,2021,Dem. Rep. of the Congo,Burkina Faso,30,0,0,30
21896,2021,Cote d'Ivoire,Burkina Faso,5,0,0,5
21897,2021,Mali,Burkina Faso,24560,9209,0,33769
21898,2021,Rwanda,Burkina Faso,16,0,0,16
21899,2021,South Sudan,Burkina Faso,5,0,0,5
21900,2021,Syrian Arab Rep.,Burkina Faso,5,0,0,5
21901,2021,Togo,Burkina Faso,15,0,0,15
21902,2021,Türkiye,Burkina Faso,44,82,0,126
21903,2021,Afghanistan,Belarus,127,14,0,141
21904,2021,Armenia,Belarus,5,0,0,5
21905,2021,Azerbaijan,Belarus,5,0,0,5
21906,2021,Cameroon,Belarus,0,5,0,5
21907,2021,Dem. Rep. of the Congo,Belarus,0,5,0,5
21908,2021,Cuba,Belarus,0,7,0,7
21909,2021,Ethiopia,Belarus,5,5,0,10
21910,2021,Palestinian,Belarus,0,6,0,6
21911,2021,Georgia,Belarus,48,0,0,48
21912,2021,Iran (Islamic Rep. of),Belarus,5,21,0,26
21913,2021,Iraq,Belarus,11,5,0,16
21914,2021,Libya,Belarus,7,0,0,7
21915,2021,Lebanon,Belarus,5,0,0,5
21916,2021,Nigeria,Belarus,0,14,0,14
21917,2021,Russian Federation,Belarus,5,0,0,5
21918,2021,Syrian Arab Rep.,Belarus,68,8,0,76
21919,2021,Tajikistan,Belarus,10,0,0,10
21920,2021,Türkiye,Belarus,18,5,0,23
21921,2021,Ukraine,Belarus,2378,14,0,2392
21922,2021,Yemen,Belarus,32,5,0,37
21923,2021,Stateless,Belarus,0,0,0,0
21924,2021,Argentina,Bolivia (Plurinational State of),13,0,0,13
21925,2021,Colombia,Bolivia (Plurinational State of),200,21,0,221
21926,2021,Cuba,Bolivia (Plurinational State of),48,0,0,48
21927,2021,Ecuador,Bolivia (Plurinational State of),5,6,0,11
21928,2021,Cote d'Ivoire,Bolivia (Plurinational State of),5,0,0,5
21929,2021,Iraq,Bolivia (Plurinational State of),16,0,0,16
21930,2021,Niger,Bolivia (Plurinational State of),5,0,0,5
21931,2021,Pakistan,Bolivia (Plurinational State of),5,0,0,5
21932,2021,Peru,Bolivia (Plurinational State of),525,0,0,525
21933,2021,Russian Federation,Bolivia (Plurinational State of),14,0,0,14
21934,2021,Syrian Arab Rep.,Bolivia (Plurinational State of),22,0,0,22
21935,2021,Ukraine,Bolivia (Plurinational State of),5,0,0,5
21936,2021,Uruguay,Bolivia (Plurinational State of),10,0,0,10
21937,2021,Venezuela (Bolivarian Republic of),Bolivia (Plurinational State of),243,0,0,243
21938,2021,Unknown ,Bolivia (Plurinational State of),0,0,0,0
21939,2021,Angola,Botswana,0,0,0,0
21940,2021,Burundi,Botswana,58,0,0,58
21941,2021,Dem. Rep. of the Congo,Botswana,239,41,0,280
21942,2021,Ethiopia,Botswana,5,0,0,5
21943,2021,Kenya,Botswana,5,0,0,5
21944,2021,Namibia,Botswana,6,0,0,6
21945,2021,Rwanda,Botswana,17,0,0,17
21946,2021,Somalia,Botswana,314,5,0,319
21947,2021,Sudan,Botswana,5,0,0,5
21948,2021,South Sudan,Botswana,5,0,0,5
21949,2021,Uganda,Botswana,19,7,0,26
21950,2021,Zimbabwe,Botswana,15,5,0,20
21951,2021,Afghanistan,Brazil,149,167,0,316
21952,2021,Albania,Brazil,0,7,0,7
21953,2021,Algeria,Brazil,8,36,0,44
21954,2021,Andorra,Brazil,0,5,0,5
21955,2021,Angola,Brazil,1157,5767,0,6924
21956,2021,Egypt,Brazil,62,487,0,549
21957,2021,Argentina,Brazil,6,153,0,159
21958,2021,Armenia,Brazil,5,7,0,12
21959,2021,Burundi,Brazil,46,24,0,70
21960,2021,Belgium,Brazil,0,7,0,7
21961,2021,Benin,Brazil,5,288,0,293
21962,2021,Bangladesh,Brazil,23,5715,0,5738
21963,2021,Bhutan,Brazil,31,35,0,66
21964,2021,Burkina Faso,Brazil,5,315,0,320
21965,2021,Bolivia (Plurinational State of),Brazil,154,462,0,616
21966,2021,Brazil,Brazil,0,0,0,0
21967,2021,Bosnia and Herzegovina,Brazil,5,0,0,5
21968,2021,Bulgaria,Brazil,0,5,0,5
21969,2021,Cambodia,Brazil,0,5,0,5
21970,2021,Canada,Brazil,0,5,0,5
21971,2021,Central African Rep.,Brazil,5,8,0,13
21972,2021,China,Brazil,23,5324,0,5347
21973,2021,Chile,Brazil,21,138,0,159
21974,2021,Cameroon,Brazil,87,607,0,694
21975,2021,Congo,Brazil,20,110,0,130
21976,2021,Dem. Rep. of the Congo,Brazil,1689,2640,0,4329
21977,2021,Colombia,Brazil,1300,2027,0,3327
21978,2021,Costa Rica,Brazil,0,18,0,18
21979,2021,Cuba,Brazil,722,15339,0,16061
21980,2021,Cabo Verde,Brazil,0,211,0,211
21981,2021,Cyprus,Brazil,0,5,0,5
21982,2021,Czechia,Brazil,0,6,0,6
21983,2021,Denmark,Brazil,0,12,0,12
21984,2021,Djibouti,Brazil,0,11,0,11
21985,2021,Dominica,Brazil,0,18,0,18
21986,2021,Dominican Rep.,Brazil,6,1293,0,1299
21987,2021,Ecuador,Brazil,58,105,0,163
21988,2021,Equatorial Guinea,Brazil,0,14,0,14
21989,2021,Eritrea,Brazil,25,119,0,144
21990,2021,Ethiopia,Brazil,27,89,0,116
21991,2021,French Guiana,Brazil,0,19,0,19
21992,2021,Fiji,Brazil,0,21,0,21
21993,2021,France,Brazil,0,44,0,44
21994,2021,Gambia,Brazil,7,353,0,360
21995,2021,Palestinian,Brazil,578,369,0,947
21996,2021,United Kingdom of Great Britain and Northern Ireland,Brazil,0,15,0,15
21997,2021,Georgia,Brazil,11,5,0,16
21998,2021,Germany,Brazil,0,9,0,9
21999,2021,Ghana,Brazil,42,2490,0,2532
22000,2021,Guinea-Bissau,Brazil,25,1668,0,1693
22001,2021,Greece,Brazil,0,6,0,6
22002,2021,Guatemala,Brazil,0,24,0,24
22003,2021,Guinea,Brazil,111,966,0,1077
22004,2021,Guyana,Brazil,5,158,0,163
22005,2021,Haiti,Brazil,8,38709,0,38717
22006,2021,Honduras,Brazil,5,15,0,20
22007,2021,Croatia,Brazil,5,5,0,10
22008,2021,Hungary,Brazil,5,5,0,10
22009,2021,Cote d'Ivoire,Brazil,56,187,0,243
22010,2021,India,Brazil,15,1166,0,1181
22011,2021,Indonesia,Brazil,0,8,0,8
22012,2021,Iran (Islamic Rep. of),Brazil,69,194,0,263
22013,2021,Iraq,Brazil,350,383,0,733
22014,2021,Israel,Brazil,0,33,0,33
22015,2021,Italy,Brazil,0,32,0,32
22016,2021,Jamaica,Brazil,0,11,0,11
22017,2021,Jordan,Brazil,12,99,0,111
22018,2021,Japan,Brazil,0,5,0,5
22019,2021,Kazakhstan,Brazil,0,11,0,11
22020,2021,Kenya,Brazil,10,79,0,89
22021,2021,Rep. of Korea,Brazil,0,285,0,285
22022,2021,Kuwait,Brazil,0,7,0,7
22023,2021,Liberia,Brazil,259,34,0,293
22024,2021,Libya,Brazil,7,59,0,66
22025,2021,Lebanon,Brazil,414,1935,0,2349
22026,2021,Lesotho,Brazil,0,5,0,5
22027,2021,Sri Lanka,Brazil,19,77,0,96
22028,2021,Lithuania,Brazil,0,8,0,8
22029,2021,"China, Macao SAR",Brazil,0,28,0,28
22030,2021,Mauritania,Brazil,60,243,0,303
22031,2021,North Macedonia,Brazil,6,5,0,11
22032,2021,Mexico,Brazil,8,47,0,55
22033,2021,Mali,Brazil,95,432,0,527
22034,2021,Malaysia,Brazil,0,5,0,5
22035,2021,Mongolia,Brazil,0,7,0,7
22036,2021,Morocco,Brazil,30,746,0,776
22037,2021,Mozambique,Brazil,5,87,0,92
22038,2021,Malta,Brazil,0,5,0,5
22039,2021,Myanmar,Brazil,0,6,0,6
22040,2021,Namibia,Brazil,0,41,0,41
22041,2021,Nepal,Brazil,12,416,0,428
22042,2021,Netherlands,Brazil,0,8,0,8
22043,2021,Niger,Brazil,0,8,0,8
22044,2021,Nicaragua,Brazil,21,20,0,41
22045,2021,Nigeria,Brazil,148,3534,0,3682
22046,2021,Norway,Brazil,0,6,0,6
22047,2021,New Zealand,Brazil,0,5,0,5
22048,2021,Pakistan,Brazil,376,1764,0,2140
22049,2021,Panama,Brazil,0,9,0,9
22050,2021,Paraguay,Brazil,5,179,0,184
22051,2021,Peru,Brazil,46,264,0,310
22052,2021,Philippines,Brazil,5,573,0,578
22053,2021,Poland,Brazil,0,13,0,13
22054,2021,Portugal,Brazil,0,108,0,108
22055,2021,Romania,Brazil,0,15,0,15
22056,2021,South Africa,Brazil,6,463,0,469
22057,2021,Russian Federation,Brazil,21,51,0,72
22058,2021,Rwanda,Brazil,18,5,0,23
22059,2021,El Salvador,Brazil,59,6,0,65
22060,2021,Saudi Arabia,Brazil,0,27,0,27
22061,2021,Serbia and Kosovo: S/RES/1244 (1999),Brazil,92,7,0,99
22062,2021,Senegal,Brazil,15,6389,0,6404
22063,2021,Sierra Leone,Brazil,166,361,0,527
22064,2021,Somalia,Brazil,51,588,0,639
22065,2021,Spain,Brazil,0,55,0,55
22066,2021,Viet Nam,Brazil,5,5,0,10
22067,2021,Sao Tome and Principe,Brazil,0,25,0,25
22068,2021,Sudan,Brazil,77,141,0,218
22069,2021,Suriname,Brazil,0,23,0,23
22070,2021,Sweden,Brazil,0,5,0,5
22071,2021,Switzerland,Brazil,0,5,0,5
22072,2021,Syrian Arab Rep.,Brazil,3920,3969,0,7889
22073,2021,United Rep. of Tanzania,Brazil,8,114,0,122
22074,2021,Thailand,Brazil,0,48,0,48
22075,2021,Togo,Brazil,61,636,0,697
22076,2021,Trinidad and Tobago,Brazil,0,7,0,7
22077,2021,Tunisia,Brazil,6,139,0,145
22078,2021,Türkiye,Brazil,11,280,0,291
22079,2021,Uganda,Brazil,6,36,0,42
22080,2021,Ukraine,Brazil,20,83,0,103
22081,2021,Uruguay,Brazil,0,36,0,36
22082,2021,United States of America,Brazil,0,56,0,56
22083,2021,Uzbekistan,Brazil,0,5,0,5
22084,2021,Vanuatu,Brazil,0,57,0,57
22085,2021,Holy See,Brazil,0,12,0,12
22086,2021,Venezuela (Bolivarian Republic of),Brazil,48931,85738,0,134669
22087,2021,Yemen,Brazil,9,149,0,158
22088,2021,Zambia,Brazil,0,7,0,7
22089,2021,Zimbabwe,Brazil,5,13,0,18
22090,2021,Stateless,Brazil,0,0,0,0
22091,2021,Unknown ,Brazil,0,35,0,35
22092,2021,Stateless,Brunei Darussalam,0,0,0,0
22093,2021,Afghanistan,Bosnia and Herzegovina,0,25,0,25
22094,2021,Algeria,Bosnia and Herzegovina,0,0,0,0
22095,2021,Egypt,Bosnia and Herzegovina,0,0,0,0
22096,2021,Azerbaijan,Bosnia and Herzegovina,5,0,0,5
22097,2021,Bangladesh,Bosnia and Herzegovina,0,0,0,0
22098,2021,Bosnia and Herzegovina,Bosnia and Herzegovina,0,0,96305,0
22099,2021,China,Bosnia and Herzegovina,0,0,0,0
22100,2021,Cameroon,Bosnia and Herzegovina,0,0,0,0
22101,2021,Congo,Bosnia and Herzegovina,0,0,0,0
22102,2021,Cuba,Bosnia and Herzegovina,0,0,0,0
22103,2021,Gambia,Bosnia and Herzegovina,0,0,0,0
22104,2021,Palestinian,Bosnia and Herzegovina,5,0,0,5
22105,2021,Ghana,Bosnia and Herzegovina,0,0,0,0
22106,2021,Croatia,Bosnia and Herzegovina,114,0,0,114
22107,2021,India,Bosnia and Herzegovina,0,5,0,5
22108,2021,Iran (Islamic Rep. of),Bosnia and Herzegovina,5,30,0,35
22109,2021,Iraq,Bosnia and Herzegovina,0,6,0,6
22110,2021,Jordan,Bosnia and Herzegovina,0,0,0,0
22111,2021,Libya,Bosnia and Herzegovina,0,0,0,0
22112,2021,Sri Lanka,Bosnia and Herzegovina,0,0,0,0
22113,2021,Mali,Bosnia and Herzegovina,0,0,0,0
22114,2021,Morocco,Bosnia and Herzegovina,0,7,0,7
22115,2021,Nepal,Bosnia and Herzegovina,0,0,0,0
22116,2021,Nigeria,Bosnia and Herzegovina,0,0,0,0
22117,2021,Pakistan,Bosnia and Herzegovina,5,22,0,27
22118,2021,Serbia and Kosovo: S/RES/1244 (1999),Bosnia and Herzegovina,44,5,0,49
22119,2021,Somalia,Bosnia and Herzegovina,0,0,0,0
22120,2021,Syrian Arab Rep.,Bosnia and Herzegovina,28,5,0,33
22121,2021,Togo,Bosnia and Herzegovina,0,0,0,0
22122,2021,Tunisia,Bosnia and Herzegovina,0,5,0,5
22123,2021,Türkiye,Bosnia and Herzegovina,34,35,0,69
22124,2021,Western Sahara,Bosnia and Herzegovina,0,5,0,5
22125,2021,Stateless,Bosnia and Herzegovina,0,0,0,0
22126,2021,Unknown ,Bosnia and Herzegovina,0,0,0,0
22127,2021,Afghanistan,Bulgaria,300,4545,0,4845
22128,2021,Albania,Bulgaria,0,5,0,5
22129,2021,Algeria,Bulgaria,0,27,0,27
22130,2021,Egypt,Bulgaria,17,6,0,23
22131,2021,Armenia,Bulgaria,11,5,0,16
22132,2021,Bangladesh,Bulgaria,8,24,0,32
22133,2021,Cameroon,Bulgaria,0,5,0,5
22134,2021,Congo,Bulgaria,9,0,0,9
22135,2021,Cuba,Bulgaria,0,5,0,5
22136,2021,Eritrea,Bulgaria,12,5,0,17
22137,2021,Ethiopia,Bulgaria,9,0,0,9
22138,2021,Georgia,Bulgaria,0,5,0,5
22139,2021,Guinea,Bulgaria,5,0,0,5
22140,2021,Cote d'Ivoire,Bulgaria,5,0,0,5
22141,2021,India,Bulgaria,5,0,0,5
22142,2021,Iran (Islamic Rep. of),Bulgaria,81,44,0,125
22143,2021,Iraq,Bulgaria,1127,200,0,1327
22144,2021,Jordan,Bulgaria,6,0,0,6
22145,2021,Lebanon,Bulgaria,22,6,0,28
22146,2021,Mauritania,Bulgaria,0,5,0,5
22147,2021,Mali,Bulgaria,5,0,0,5
22148,2021,Morocco,Bulgaria,5,129,0,134
22149,2021,Nigeria,Bulgaria,0,5,0,5
22150,2021,Pakistan,Bulgaria,30,56,0,86
22151,2021,Russian Federation,Bulgaria,12,0,0,12
22152,2021,Serbia and Kosovo: S/RES/1244 (1999),Bulgaria,0,5,0,5
22153,2021,Senegal,Bulgaria,0,5,0,5
22154,2021,Somalia,Bulgaria,47,5,0,52
22155,2021,Sudan,Bulgaria,12,0,0,12
22156,2021,Syrian Arab Rep.,Bulgaria,20067,2368,0,22435
22157,2021,Tunisia,Bulgaria,0,19,0,19
22158,2021,Türkiye,Bulgaria,9,13,0,22
22159,2021,Ukraine,Bulgaria,0,6,0,6
22160,2021,Venezuela (Bolivarian Republic of),Bulgaria,0,5,0,5
22161,2021,Yemen,Bulgaria,23,9,0,32
22162,2021,Stateless,Bulgaria,1003,35,0,1038
22163,2021,Cuba,Belize,0,5,0,5
22164,2021,Guatemala,Belize,0,416,0,416
22165,2021,Honduras,Belize,11,433,0,444
22166,2021,Nicaragua,Belize,5,0,0,5
22167,2021,Peru,Belize,0,5,0,5
22168,2021,El Salvador,Belize,70,1156,0,1226
22169,2021,Unknown ,Belize,0,0,0,0
22170,2021,Myanmar,Cambodia,8,7,0,15
22171,2021,Pakistan,Cambodia,0,5,0,5
22172,2021,Viet Nam,Cambodia,16,0,0,16
22173,2021,Stateless,Cambodia,0,0,0,0
22174,2021,Afghanistan,Canada,2263,399,0,2662
22175,2021,Albania,Canada,749,183,0,932
22176,2021,Algeria,Canada,872,615,0,1487
22177,2021,Angola,Canada,594,816,0,1410
22178,2021,Antigua and Barbuda,Canada,94,33,0,127
22179,2021,Egypt,Canada,3339,335,0,3674
22180,2021,Argentina,Canada,15,58,0,73
22181,2021,Armenia,Canada,32,11,0,43
22182,2021,Australia,Canada,0,7,0,7
22183,2021,Austria,Canada,5,0,0,5
22184,2021,Azerbaijan,Canada,723,52,0,775
22185,2021,Bahrain,Canada,65,5,0,70
22186,2021,Barbados,Canada,250,74,0,324
22187,2021,Burundi,Canada,2870,191,0,3061
22188,2021,Belgium,Canada,9,13,0,22
22189,2021,Benin,Canada,60,65,0,125
22190,2021,Bangladesh,Canada,1840,947,0,2787
22191,2021,Bahamas,Canada,555,404,0,959
22192,2021,Burkina Faso,Canada,116,117,0,233
22193,2021,Belarus,Canada,46,12,0,58
22194,2021,Bolivia (Plurinational State of),Canada,27,30,0,57
22195,2021,Botswana,Canada,71,5,0,76
22196,2021,Brazil,Canada,165,384,0,549
22197,2021,Bosnia and Herzegovina,Canada,5,0,0,5
22198,2021,Bulgaria,Canada,106,18,0,124
22199,2021,Belize,Canada,19,6,0,25
22200,2021,Cambodia,Canada,49,14,0,63
22201,2021,Central African Rep.,Canada,53,32,0,85
22202,2021,Chad,Canada,784,251,0,1035
22203,2021,China,Canada,5925,1318,0,7243
22204,2021,Chile,Canada,104,401,0,505
22205,2021,Cameroon,Canada,1140,401,0,1541
22206,2021,Congo,Canada,300,146,0,446
22207,2021,Dem. Rep. of the Congo,Canada,1361,1602,0,2963
22208,2021,Comoros,Canada,5,5,0,10
22209,2021,Colombia,Canada,5835,3706,0,9541
22210,2021,Costa Rica,Canada,13,52,0,65
22211,2021,Cuba,Canada,458,297,0,755
22212,2021,Cabo Verde,Canada,0,5,0,5
22213,2021,Cyprus,Canada,5,5,0,10
22214,2021,Czechia,Canada,324,66,0,390
22215,2021,Denmark,Canada,8,8,0,16
22216,2021,Djibouti,Canada,1154,36,0,1190
22217,2021,Dominica,Canada,8,5,0,13
22218,2021,Dominican Rep.,Canada,129,169,0,298
22219,2021,Ecuador,Canada,54,114,0,168
22220,2021,Equatorial Guinea,Canada,19,0,0,19
22221,2021,Eritrea,Canada,2086,201,0,2287
22222,2021,Estonia,Canada,6,5,0,11
22223,2021,Ethiopia,Canada,1715,324,0,2039
22224,2021,Fiji,Canada,0,6,0,6
22225,2021,Finland,Canada,5,0,0,5
22226,2021,France,Canada,0,53,0,53
22227,2021,Gabon,Canada,41,39,0,80
22228,2021,Gambia,Canada,101,77,0,178
22229,2021,Palestinian,Canada,2374,242,0,2616
22230,2021,United Kingdom of Great Britain and Northern Ireland,Canada,5,12,0,17
22231,2021,Georgia,Canada,408,170,0,578
22232,2021,Germany,Canada,0,19,0,19
22233,2021,Ghana,Canada,372,285,0,657
22234,2021,Guinea-Bissau,Canada,5,0,0,5
22235,2021,Greece,Canada,0,13,0,13
22236,2021,Grenada,Canada,10,9,0,19
22237,2021,Guatemala,Canada,358,237,0,595
22238,2021,Guinea,Canada,440,295,0,735
22239,2021,Guyana,Canada,90,60,0,150
22240,2021,Haiti,Canada,4295,3057,0,7352
22241,2021,"China, Hong Kong SAR",Canada,17,24,0,41
22242,2021,Honduras,Canada,975,336,0,1311
22243,2021,Croatia,Canada,251,9,0,260
22244,2021,Hungary,Canada,4290,173,0,4463
22245,2021,Iceland,Canada,5,7,0,12
22246,2021,Cote d'Ivoire,Canada,211,162,0,373
22247,2021,India,Canada,2638,9722,0,12360
22248,2021,Indonesia,Canada,106,37,0,143
22249,2021,Ireland,Canada,5,24,0,29
22250,2021,Iran (Islamic Rep. of),Canada,7134,1422,0,8556
22251,2021,Iraq,Canada,123,157,0,280
22252,2021,Israel,Canada,125,33,0,158
22253,2021,Italy,Canada,5,66,0,71
22254,2021,Jamaica,Canada,824,390,0,1214
22255,2021,Jordan,Canada,697,368,0,1065
22256,2021,Japan,Canada,0,5,0,5
22257,2021,Kazakhstan,Canada,165,38,0,203
22258,2021,Kenya,Canada,340,271,0,611
22259,2021,Kyrgyzstan,Canada,70,5,0,75
22260,2021,Rep. of Korea,Canada,33,29,0,62
22261,2021,Dem. People's Rep. of Korea,Canada,255,17,0,272
22262,2021,Kuwait,Canada,61,10,0,71
22263,2021,Lao People's Dem. Rep.,Canada,5,0,0,5
22264,2021,Liberia,Canada,64,107,0,171
22265,2021,Libya,Canada,1862,142,0,2004
22266,2021,Saint Lucia,Canada,419,23,0,442
22267,2021,Lebanon,Canada,989,551,0,1540
22268,2021,Lesotho,Canada,0,5,0,5
22269,2021,Sri Lanka,Canada,2455,625,0,3080
22270,2021,Lithuania,Canada,18,7,0,25
22271,2021,Latvia,Canada,48,5,0,53
22272,2021,Madagascar,Canada,20,20,0,40
22273,2021,Mauritania,Canada,225,109,0,334
22274,2021,North Macedonia,Canada,8,5,0,13
22275,2021,Rep. of Moldova,Canada,45,7,0,52
22276,2021,Mexico,Canada,3609,6212,0,9821
22277,2021,Mali,Canada,238,145,0,383
22278,2021,Malaysia,Canada,0,20,0,20
22279,2021,Malawi,Canada,29,42,0,71
22280,2021,Mongolia,Canada,149,24,0,173
22281,2021,Morocco,Canada,155,160,0,315
22282,2021,Malta,Canada,7,0,0,7
22283,2021,Mauritius,Canada,13,16,0,29
22284,2021,Myanmar,Canada,9,22,0,31
22285,2021,Namibia,Canada,225,14,0,239
22286,2021,Nepal,Canada,25,89,0,114
22287,2021,Netherlands,Canada,10,11,0,21
22288,2021,Niger,Canada,66,71,0,137
22289,2021,Nicaragua,Canada,684,191,0,875
22290,2021,Nigeria,Canada,10172,3847,0,14019
22291,2021,Norway,Canada,0,7,0,7
22292,2021,Pakistan,Canada,7171,1489,0,8660
22293,2021,Panama,Canada,24,14,0,38
22294,2021,Paraguay,Canada,9,6,0,15
22295,2021,Peru,Canada,144,321,0,465
22296,2021,Philippines,Canada,73,162,0,235
22297,2021,Papua New Guinea,Canada,5,0,0,5
22298,2021,Poland,Canada,72,88,0,160
22299,2021,Portugal,Canada,5,26,0,31
22300,2021,Qatar,Canada,5,0,0,5
22301,2021,Romania,Canada,482,330,0,812
22302,2021,South Africa,Canada,66,121,0,187
22303,2021,Russian Federation,Canada,665,91,0,756
22304,2021,Rwanda,Canada,995,422,0,1417
22305,2021,El Salvador,Canada,1604,431,0,2035
22306,2021,Saudi Arabia,Canada,552,70,0,622
22307,2021,Serbia and Kosovo: S/RES/1244 (1999),Canada,183,39,0,222
22308,2021,Senegal,Canada,277,200,0,477
22309,2021,Seychelles,Canada,5,0,0,5
22310,2021,Singapore,Canada,10,0,0,10
22311,2021,Sierra Leone,Canada,28,61,0,89
22312,2021,Somalia,Canada,1498,346,0,1844
22313,2021,Spain,Canada,11,36,0,47
22314,2021,Viet Nam,Canada,30,159,0,189
22315,2021,Saint Kitts and Nevis,Canada,36,6,0,42
22316,2021,Sudan,Canada,2185,199,0,2384
22317,2021,Suriname,Canada,0,5,0,5
22318,2021,South Sudan,Canada,19,14,0,33
22319,2021,Slovakia,Canada,1207,119,0,1326
22320,2021,Slovenia,Canada,6,5,0,11
22321,2021,Eswatini,Canada,70,0,0,70
22322,2021,Syrian Arab Rep.,Canada,190,164,0,354
22323,2021,United Rep. of Tanzania,Canada,171,109,0,280
22324,2021,Thailand,Canada,0,5,0,5
22325,2021,Tajikistan,Canada,42,5,0,47
22326,2021,Turkmenistan,Canada,29,0,0,29
22327,2021,Timor-Leste,Canada,5,0,0,5
22328,2021,Togo,Canada,102,80,0,182
22329,2021,Trinidad and Tobago,Canada,51,37,0,88
22330,2021,Tunisia,Canada,174,160,0,334
22331,2021,Türkiye,Canada,7085,928,0,8013
22332,2021,United Arab Emirates,Canada,14,27,0,41
22333,2021,Uganda,Canada,974,267,0,1241
22334,2021,Ukraine,Canada,1228,98,0,1326
22335,2021,Uruguay,Canada,5,18,0,23
22336,2021,United States of America,Canada,53,1056,0,1109
22337,2021,Uzbekistan,Canada,121,6,0,127
22338,2021,Saint Vincent and the Grenadines,Canada,388,33,0,421
22339,2021,Venezuela (Bolivarian Republic of),Canada,4108,748,0,4856
22340,2021,Yemen,Canada,2127,76,0,2203
22341,2021,Zambia,Canada,7,11,0,18
22342,2021,Zimbabwe,Canada,590,142,0,732
22343,2021,Stateless,Canada,400,98,0,498
22344,2021,Unknown ,Canada,10016,10016,0,20032
22345,2021,Angola,Central African Rep.,12,0,0,12
22346,2021,Burundi,Central African Rep.,24,0,0,24
22347,2021,Central African Rep.,Central African Rep.,0,0,691791,0
22348,2021,Chad,Central African Rep.,1094,54,0,1148
22349,2021,Cameroon,Central African Rep.,42,26,0,68
22350,2021,Congo,Central African Rep.,16,8,0,24
22351,2021,Dem. Rep. of the Congo,Central African Rep.,5577,222,0,5799
22352,2021,Guinea,Central African Rep.,6,0,0,6
22353,2021,Cote d'Ivoire,Central African Rep.,7,0,0,7
22354,2021,Liberia,Central African Rep.,5,0,0,5
22355,2021,Rwanda,Central African Rep.,219,0,0,219
22356,2021,Sudan,Central African Rep.,394,17,0,411
22357,2021,South Sudan,Central African Rep.,1894,438,0,2332
22358,2021,Türkiye,Central African Rep.,8,0,0,8
22359,2021,Uganda,Central African Rep.,7,0,0,7
22360,2021,Cuba,Cayman Islands,57,30,0,87
22361,2021,Venezuela (Bolivarian Republic of),Cayman Islands,0,0,0,0
22362,2021,Burundi,Chad,6,0,0,6
22363,2021,Central African Rep.,Chad,123320,2375,0,125695
22364,2021,Chad,Chad,0,0,406573,0
22365,2021,Cameroon,Chad,35878,20,0,35898
22366,2021,Congo,Chad,11,5,0,16
22367,2021,Dem. Rep. of the Congo,Chad,254,27,0,281
22368,2021,Eritrea,Chad,7,14,0,21
22369,2021,Ethiopia,Chad,19,9,0,28
22370,2021,Cote d'Ivoire,Chad,5,0,0,5
22371,2021,Iran (Islamic Rep. of),Chad,5,0,0,5
22372,2021,Libya,Chad,25,19,0,44
22373,2021,Mali,Chad,7,0,0,7
22374,2021,Niger,Chad,839,0,0,839
22375,2021,Nigeria,Chad,19321,337,0,19658
22376,2021,Rwanda,Chad,15,0,0,15
22377,2021,Somalia,Chad,7,0,0,7
22378,2021,Sudan,Chad,375999,1867,0,377866
22379,2021,South Sudan,Chad,11,5,0,16
22380,2021,Syrian Arab Rep.,Chad,48,19,0,67
22381,2021,Yemen,Chad,5,8,0,13
22382,2021,Afghanistan,China,30,22,0,52
22383,2021,Cameroon,China,22,358,0,380
22384,2021,Dem. Rep. of the Congo,China,10,17,0,27
22385,2021,Eritrea,China,6,0,0,6
22386,2021,Ethiopia,China,0,8,0,8
22387,2021,Palestinian,China,12,10,0,22
22388,2021,Ghana,China,0,22,0,22
22389,2021,Guinea,China,0,5,0,5
22390,2021,Cote d'Ivoire,China,0,23,0,23
22391,2021,Iran (Islamic Rep. of),China,5,0,0,5
22392,2021,Iraq,China,16,0,0,16
22393,2021,Kenya,China,0,16,0,16
22394,2021,Liberia,China,0,6,0,6
22395,2021,Nigeria,China,0,65,0,65
22396,2021,Pakistan,China,32,9,0,41
22397,2021,Rwanda,China,0,9,0,9
22398,2021,Somalia,China,111,5,0,116
22399,2021,Viet Nam,China,303107,0,0,303107
22400,2021,Syrian Arab Rep.,China,43,5,0,48
22401,2021,Uganda,China,5,116,0,121
22402,2021,Yemen,China,31,10,0,41
22403,2021,Zambia,China,0,5,0,5
22404,2021,Zimbabwe,China,6,74,0,80
22405,2021,Afghanistan,Chile,13,87,0,100
22406,2021,Angola,Chile,0,5,0,5
22407,2021,Bangladesh,Chile,0,7,0,7
22408,2021,Bolivia (Plurinational State of),Chile,0,21,0,21
22409,2021,Congo,Chile,8,5,0,13
22410,2021,Dem. Rep. of the Congo,Chile,5,0,0,5
22411,2021,Colombia,Chile,1234,3289,0,4523
22412,2021,Costa Rica,Chile,5,0,0,5
22413,2021,Cuba,Chile,19,1590,0,1609
22414,2021,Dominican Rep.,Chile,0,128,0,128
22415,2021,Ecuador,Chile,23,29,0,52
22416,2021,Palestinian,Chile,15,7,0,22
22417,2021,Ghana,Chile,0,8,0,8
22418,2021,Guatemala,Chile,0,5,0,5
22419,2021,Haiti,Chile,0,55,0,55
22420,2021,Honduras,Chile,5,0,0,5
22421,2021,Iraq,Chile,0,14,0,14
22422,2021,Kenya,Chile,5,0,0,5
22423,2021,Rep. of Korea,Chile,0,5,0,5
22424,2021,Sri Lanka,Chile,5,0,0,5
22425,2021,Nicaragua,Chile,0,5,0,5
22426,2021,Pakistan,Chile,0,7,0,7
22427,2021,Peru,Chile,113,51,0,164
22428,2021,Russian Federation,Chile,5,7,0,12
22429,2021,El Salvador,Chile,9,27,0,36
22430,2021,Senegal,Chile,5,0,0,5
22431,2021,Sierra Leone,Chile,0,5,0,5
22432,2021,Syrian Arab Rep.,Chile,113,32,0,145
22433,2021,Türkiye,Chile,27,5,0,32
22434,2021,United States of America,Chile,0,5,0,5
22435,2021,Venezuela (Bolivarian Republic of),Chile,22,4714,0,4736
22436,2021,Unknown ,Chile,434,46,0,480
22437,2021,Angola,Cameroon,5,0,0,5
22438,2021,Burundi,Cameroon,54,20,0,74
22439,2021,Burkina Faso,Cameroon,0,26,0,26
22440,2021,Central African Rep.,Cameroon,333878,5623,0,339501
22441,2021,Chad,Cameroon,1445,417,0,1862
22442,2021,Cameroon,Cameroon,0,0,933138,0
22443,2021,Congo,Cameroon,40,9,0,49
22444,2021,Dem. Rep. of the Congo,Cameroon,460,136,0,596
22445,2021,Gambia,Cameroon,0,5,0,5
22446,2021,Guinea,Cameroon,7,208,0,215
22447,2021,Cote d'Ivoire,Cameroon,57,42,0,99
22448,2021,Iran (Islamic Rep. of),Cameroon,5,0,0,5
22449,2021,Liberia,Cameroon,9,5,0,14
22450,2021,Mauritania,Cameroon,5,5,0,10
22451,2021,Mali,Cameroon,16,360,0,376
22452,2021,Morocco,Cameroon,7,0,0,7
22453,2021,Niger,Cameroon,0,915,0,915
22454,2021,Nigeria,Cameroon,120928,31,0,120959
22455,2021,Rwanda,Cameroon,260,152,0,412
22456,2021,Senegal,Cameroon,0,8,0,8
22457,2021,Sierra Leone,Cameroon,0,5,0,5
22458,2021,Sudan,Cameroon,65,26,0,91
22459,2021,Syrian Arab Rep.,Cameroon,5,10,0,15
22460,2021,Togo,Cameroon,18,15,0,33
22461,2021,Yemen,Cameroon,5,0,0,5
22462,2021,Angola,Congo,7,45,0,52
22463,2021,Egypt,Congo,0,0,0,0
22464,2021,Burundi,Congo,75,8,0,83
22465,2021,Central African Rep.,Congo,25918,2997,0,28915
22466,2021,Chad,Congo,28,27,0,55
22467,2021,Cameroon,Congo,5,22,0,27
22468,2021,Congo,Congo,0,0,134430,0
22469,2021,Dem. Rep. of the Congo,Congo,12121,9982,0,22103
22470,2021,Guinea,Congo,0,5,0,5
22471,2021,Cote d'Ivoire,Congo,5,5,0,10
22472,2021,Mauritania,Congo,5,45,0,50
22473,2021,Mali,Congo,5,0,0,5
22474,2021,Nigeria,Congo,5,0,0,5
22475,2021,Rwanda,Congo,2556,480,0,3036
22476,2021,Sudan,Congo,30,41,0,71
22477,2021,Syrian Arab Rep.,Congo,5,13,0,18
22478,2021,Angola,Dem. Rep. of the Congo,417,25,0,442
22479,2021,Burundi,Dem. Rep. of the Congo,41031,1114,0,42145
22480,2021,Central African Rep.,Dem. Rep. of the Congo,212630,63,0,212693
22481,2021,Chad,Dem. Rep. of the Congo,5,15,0,20
22482,2021,Cameroon,Dem. Rep. of the Congo,0,19,0,19
22483,2021,Congo,Dem. Rep. of the Congo,647,25,0,672
22484,2021,Dem. Rep. of the Congo,Dem. Rep. of the Congo,0,0,5407840,0
22485,2021,Eritrea,Dem. Rep. of the Congo,7,0,0,7
22486,2021,Ethiopia,Dem. Rep. of the Congo,0,5,0,5
22487,2021,Palestinian,Dem. Rep. of the Congo,0,6,0,6
22488,2021,Cote d'Ivoire,Dem. Rep. of the Congo,12,8,0,20
22489,2021,Liberia,Dem. Rep. of the Congo,5,10,0,15
22490,2021,Lebanon,Dem. Rep. of the Congo,0,5,0,5
22491,2021,Mali,Dem. Rep. of the Congo,0,11,0,11
22492,2021,Niger,Dem. Rep. of the Congo,0,5,0,5
22493,2021,Romania,Dem. Rep. of the Congo,0,5,0,5
22494,2021,Rwanda,Dem. Rep. of the Congo,210978,74,0,211052
22495,2021,Somalia,Dem. Rep. of the Congo,15,73,0,88
22496,2021,Sudan,Dem. Rep. of the Congo,2023,7,0,2030
22497,2021,South Sudan,Dem. Rep. of the Congo,56341,731,0,57072
22498,2021,Syrian Arab Rep.,Dem. Rep. of the Congo,12,12,0,24
22499,2021,Uganda,Dem. Rep. of the Congo,25,0,0,25
22500,2021,Zimbabwe,Dem. Rep. of the Congo,0,5,0,5
22501,2021,Dem. Rep. of the Congo,Comoros,27,0,0,27
22502,2021,Afghanistan,Colombia,9,0,0,9
22503,2021,Bolivia (Plurinational State of),Colombia,5,0,0,5
22504,2021,Colombia,Colombia,0,0,6766002,0
22505,2021,Cuba,Colombia,88,98,0,186
22506,2021,Ecuador,Colombia,5,7,0,12
22507,2021,Eritrea,Colombia,5,0,0,5
22508,2021,Ethiopia,Colombia,7,0,0,7
22509,2021,Ghana,Colombia,5,0,0,5
22510,2021,Haiti,Colombia,0,5,0,5
22511,2021,Honduras,Colombia,5,0,0,5
22512,2021,Hungary,Colombia,5,0,0,5
22513,2021,Iraq,Colombia,8,0,0,8
22514,2021,Liberia,Colombia,5,0,0,5
22515,2021,Nicaragua,Colombia,10,0,0,10
22516,2021,El Salvador,Colombia,7,5,0,12
22517,2021,Serbia and Kosovo: S/RES/1244 (1999),Colombia,5,0,0,5
22518,2021,Sierra Leone,Colombia,5,0,0,5
22519,2021,Somalia,Colombia,11,0,0,11
22520,2021,Syrian Arab Rep.,Colombia,11,7,0,18
22521,2021,Türkiye,Colombia,6,8,0,14
22522,2021,Venezuela (Bolivarian Republic of),Colombia,1297,28785,0,30082
22523,2021,Yemen,Colombia,0,5,0,5
22524,2021,Stateless,Colombia,0,0,0,0
22525,2021,Unknown ,Colombia,5,0,0,5
22526,2021,Angola,Costa Rica,0,62,0,62
22527,2021,Argentina,Costa Rica,0,37,0,37
22528,2021,Burundi,Costa Rica,9,0,0,9
22529,2021,Bangladesh,Costa Rica,0,16,0,16
22530,2021,Burkina Faso,Costa Rica,0,5,0,5
22531,2021,Belarus,Costa Rica,0,5,0,5
22532,2021,Bolivia (Plurinational State of),Costa Rica,0,13,0,13
22533,2021,Brazil,Costa Rica,0,165,0,165
22534,2021,China,Costa Rica,0,309,0,309
22535,2021,Chile,Costa Rica,0,55,0,55
22536,2021,Cameroon,Costa Rica,0,22,0,22
22537,2021,Congo,Costa Rica,0,57,0,57
22538,2021,Dem. Rep. of the Congo,Costa Rica,12,65,0,77
22539,2021,Colombia,Costa Rica,2317,1535,0,3852
22540,2021,Costa Rica,Costa Rica,0,0,0,0
22541,2021,Cuba,Costa Rica,463,2795,0,3258
22542,2021,Dominican Rep.,Costa Rica,0,105,0,105
22543,2021,Ecuador,Costa Rica,0,58,0,58
22544,2021,Eritrea,Costa Rica,0,7,0,7
22545,2021,Ethiopia,Costa Rica,5,0,0,5
22546,2021,French Guiana,Costa Rica,0,5,0,5
22547,2021,Gambia,Costa Rica,0,5,0,5
22548,2021,Germany,Costa Rica,0,19,0,19
22549,2021,Ghana,Costa Rica,0,58,0,58
22550,2021,Greece,Costa Rica,0,5,0,5
22551,2021,Guatemala,Costa Rica,25,108,0,133
22552,2021,Guyana,Costa Rica,0,9,0,9
22553,2021,Haiti,Costa Rica,12,910,0,922
22554,2021,Honduras,Costa Rica,207,966,0,1173
22555,2021,Cote d'Ivoire,Costa Rica,0,6,0,6
22556,2021,India,Costa Rica,0,6,0,6
22557,2021,Indonesia,Costa Rica,5,0,0,5
22558,2021,Iran (Islamic Rep. of),Costa Rica,5,0,0,5
22559,2021,Iraq,Costa Rica,5,0,0,5
22560,2021,Israel,Costa Rica,0,6,0,6
22561,2021,Italy,Costa Rica,0,6,0,6
22562,2021,Jamaica,Costa Rica,0,32,0,32
22563,2021,Lebanon,Costa Rica,0,5,0,5
22564,2021,Latvia,Costa Rica,0,5,0,5
22565,2021,Mexico,Costa Rica,13,53,0,66
22566,2021,Nepal,Costa Rica,0,102,0,102
22567,2021,Niger,Costa Rica,0,5,0,5
22568,2021,Nicaragua,Costa Rica,4027,137274,0,141301
22569,2021,Nigeria,Costa Rica,17,5,0,22
22570,2021,Pakistan,Costa Rica,5,11,0,16
22571,2021,Panama,Costa Rica,6,56,0,62
22572,2021,Peru,Costa Rica,13,53,0,66
22573,2021,Poland,Costa Rica,0,5,0,5
22574,2021,Romania,Costa Rica,0,5,0,5
22575,2021,South Africa,Costa Rica,0,6,0,6
22576,2021,Russian Federation,Costa Rica,27,24,0,51
22577,2021,El Salvador,Costa Rica,1529,53,0,1582
22578,2021,Senegal,Costa Rica,0,5,0,5
22579,2021,Somalia,Costa Rica,7,7,0,14
22580,2021,Spain,Costa Rica,0,9,0,9
22581,2021,Syrian Arab Rep.,Costa Rica,5,25,0,30
22582,2021,Türkiye,Costa Rica,0,5,0,5
22583,2021,Ukraine,Costa Rica,13,5,0,18
22584,2021,Uruguay,Costa Rica,0,5,0,5
22585,2021,United States of America,Costa Rica,5,39,0,44
22586,2021,Venezuela (Bolivarian Republic of),Costa Rica,1492,7288,0,8780
22587,2021,Zimbabwe,Costa Rica,0,5,0,5
22588,2021,Stateless,Costa Rica,0,0,0,0
22589,2021,Afghanistan,Cuba,17,0,0,17
22590,2021,Cuba,Cuba,0,0,0,0
22591,2021,Eritrea,Cuba,5,0,0,5
22592,2021,Ethiopia,Cuba,6,0,0,6
22593,2021,Haiti,Cuba,5,0,0,5
22594,2021,Iran (Islamic Rep. of),Cuba,7,5,0,12
22595,2021,Sudan,Cuba,10,0,0,10
22596,2021,Syrian Arab Rep.,Cuba,36,9,0,45
22597,2021,Western Sahara,Cuba,99,0,0,99
22598,2021,Yemen,Cuba,14,0,0,14
22599,2021,Stateless,Cabo Verde,0,0,0,0
22600,2021,Afghanistan,Cyprus,17,143,0,160
22601,2021,Albania,Cyprus,0,5,0,5
22602,2021,Algeria,Cyprus,8,0,0,8
22603,2021,Angola,Cyprus,0,15,0,15
22604,2021,Egypt,Cyprus,120,477,0,597
22605,2021,Armenia,Cyprus,26,16,0,42
22606,2021,Burundi,Cyprus,0,11,0,11
22607,2021,Bangladesh,Cyprus,10,1807,0,1817
22608,2021,Burkina Faso,Cyprus,0,10,0,10
22609,2021,Belarus,Cyprus,0,6,0,6
22610,2021,Bosnia and Herzegovina,Cyprus,15,0,0,15
22611,2021,Central African Rep.,Cyprus,0,5,0,5
22612,2021,China,Cyprus,5,9,0,14
22613,2021,Cameroon,Cyprus,131,2826,0,2957
22614,2021,Congo,Cyprus,10,160,0,170
22615,2021,Dem. Rep. of the Congo,Cyprus,36,2313,0,2349
22616,2021,Comoros,Cyprus,0,11,0,11
22617,2021,Djibouti,Cyprus,0,9,0,9
22618,2021,Eritrea,Cyprus,53,5,0,58
22619,2021,Ethiopia,Cyprus,10,14,0,24
22620,2021,Gabon,Cyprus,0,5,0,5
22621,2021,Gambia,Cyprus,6,50,0,56
22622,2021,Palestinian,Cyprus,2208,125,0,2333
22623,2021,Georgia,Cyprus,85,584,0,669
22624,2021,Ghana,Cyprus,0,31,0,31
22625,2021,Guinea-Bissau,Cyprus,0,5,0,5
22626,2021,Guinea,Cyprus,6,439,0,445
22627,2021,Haiti,Cyprus,0,5,0,5
22628,2021,Cote d'Ivoire,Cyprus,5,94,0,99
22629,2021,India,Cyprus,10,1971,0,1981
22630,2021,Iran (Islamic Rep. of),Cyprus,624,521,0,1145
22631,2021,Iraq,Cyprus,988,113,0,1101
22632,2021,Jordan,Cyprus,50,83,0,133
22633,2021,Kazakhstan,Cyprus,5,0,0,5
22634,2021,Kenya,Cyprus,0,5,0,5
22635,2021,Kyrgyzstan,Cyprus,5,0,0,5
22636,2021,Liberia,Cyprus,0,168,0,168
22637,2021,Libya,Cyprus,12,5,0,17
22638,2021,Lebanon,Cyprus,53,112,0,165
22639,2021,Sri Lanka,Cyprus,29,430,0,459
22640,2021,Rep. of Moldova,Cyprus,18,15,0,33
22641,2021,Mali,Cyprus,0,6,0,6
22642,2021,Mongolia,Cyprus,0,5,0,5
22643,2021,Morocco,Cyprus,0,11,0,11
22644,2021,Nepal,Cyprus,0,990,0,990
22645,2021,Niger,Cyprus,0,5,0,5
22646,2021,Nigeria,Cyprus,23,2139,0,2162
22647,2021,Pakistan,Cyprus,21,1460,0,1481
22648,2021,Philippines,Cyprus,12,180,0,192
22649,2021,South Africa,Cyprus,0,5,0,5
22650,2021,Russian Federation,Cyprus,77,75,0,152
22651,2021,Rwanda,Cyprus,5,6,0,11
22652,2021,Serbia and Kosovo: S/RES/1244 (1999),Cyprus,59,9,0,68
22653,2021,Senegal,Cyprus,0,39,0,39
22654,2021,Sierra Leone,Cyprus,24,616,0,640
22655,2021,Somalia,Cyprus,371,874,0,1245
22656,2021,Viet Nam,Cyprus,5,271,0,276
22657,2021,Sudan,Cyprus,14,8,0,22
22658,2021,Syrian Arab Rep.,Cyprus,10735,5545,0,16280
22659,2021,Turkmenistan,Cyprus,0,5,0,5
22660,2021,Togo,Cyprus,0,15,0,15
22661,2021,Türkiye,Cyprus,243,262,0,505
22662,2021,Ukraine,Cyprus,31,64,0,95
22663,2021,Uzbekistan,Cyprus,5,5,0,10
22664,2021,Yemen,Cyprus,41,28,0,69
22665,2021,Zimbabwe,Cyprus,0,23,0,23
22666,2021,Stateless,Cyprus,66,0,0,66
22667,2021,Unknown ,Cyprus,0,87,0,87
22668,2021,Afghanistan,Czechia,150,36,0,186
22669,2021,Algeria,Czechia,0,8,0,8
22670,2021,Egypt,Czechia,7,10,0,17
22671,2021,Armenia,Czechia,21,6,0,27
22672,2021,Azerbaijan,Czechia,26,18,0,44
22673,2021,Burundi,Czechia,5,0,0,5
22674,2021,Belarus,Czechia,169,38,0,207
22675,2021,China,Czechia,62,0,0,62
22676,2021,Cameroon,Czechia,0,5,0,5
22677,2021,Dem. Rep. of the Congo,Czechia,6,5,0,11
22678,2021,Colombia,Czechia,0,5,0,5
22679,2021,Cuba,Czechia,36,11,0,47
22680,2021,Eritrea,Czechia,11,0,0,11
22681,2021,Ethiopia,Czechia,5,5,0,10
22682,2021,Georgia,Czechia,12,51,0,63
22683,2021,Guinea,Czechia,5,0,0,5
22684,2021,India,Czechia,0,5,0,5
22685,2021,Iran (Islamic Rep. of),Czechia,6,8,0,14
22686,2021,Iraq,Czechia,89,8,0,97
22687,2021,Kazakhstan,Czechia,76,17,0,93
22688,2021,Kyrgyzstan,Czechia,18,6,0,24
22689,2021,Libya,Czechia,22,5,0,27
22690,2021,Lebanon,Czechia,5,0,0,5
22691,2021,Sri Lanka,Czechia,7,0,0,7
22692,2021,Rep. of Moldova,Czechia,17,18,0,35
22693,2021,Mongolia,Czechia,10,8,0,18
22694,2021,Myanmar,Czechia,149,0,0,149
22695,2021,Nigeria,Czechia,8,9,0,17
22696,2021,Pakistan,Czechia,8,9,0,17
22697,2021,Russian Federation,Czechia,173,19,0,192
22698,2021,Saudi Arabia,Czechia,5,0,0,5
22699,2021,Serbia and Kosovo: S/RES/1244 (1999),Czechia,5,0,0,5
22700,2021,Sierra Leone,Czechia,5,0,0,5
22701,2021,Somalia,Czechia,16,10,0,26
22702,2021,Viet Nam,Czechia,14,28,0,42
22703,2021,Sudan,Czechia,9,0,0,9
22704,2021,Syrian Arab Rep.,Czechia,358,0,0,358
22705,2021,Tajikistan,Czechia,5,0,0,5
22706,2021,Turkmenistan,Czechia,7,0,0,7
22707,2021,Tunisia,Czechia,0,6,0,6
22708,2021,Türkiye,Czechia,11,27,0,38
22709,2021,Uganda,Czechia,5,0,0,5
22710,2021,Ukraine,Czechia,225,120,0,345
22711,2021,Uzbekistan,Czechia,35,17,0,52
22712,2021,Venezuela (Bolivarian Republic of),Czechia,7,8,0,15
22713,2021,Yemen,Czechia,24,5,0,29
22714,2021,Stateless,Czechia,75,6,0,81
22715,2021,Unknown ,Czechia,0,536,0,536
22716,2021,Afghanistan,Denmark,1696,540,0,2236
22717,2021,Algeria,Denmark,0,10,0,10
22718,2021,Egypt,Denmark,17,6,0,23
22719,2021,Armenia,Denmark,76,17,0,93
22720,2021,Azerbaijan,Denmark,30,0,0,30
22721,2021,Bahrain,Denmark,0,5,0,5
22722,2021,Burundi,Denmark,5,0,0,5
22723,2021,Bangladesh,Denmark,19,0,0,19
22724,2021,Belarus,Denmark,5,12,0,17
22725,2021,Bosnia and Herzegovina,Denmark,5,0,0,5
22726,2021,China,Denmark,19,7,0,26
22727,2021,Cameroon,Denmark,8,5,0,13
22728,2021,Dem. Rep. of the Congo,Denmark,66,12,0,78
22729,2021,Colombia,Denmark,5,12,0,17
22730,2021,Eritrea,Denmark,5813,139,0,5952
22731,2021,Ethiopia,Denmark,94,13,0,107
22732,2021,Gambia,Denmark,5,5,0,10
22733,2021,Palestinian,Denmark,5,0,0,5
22734,2021,Georgia,Denmark,0,38,0,38
22735,2021,Ghana,Denmark,5,5,0,10
22736,2021,Guinea-Bissau,Denmark,5,0,0,5
22737,2021,Cote d'Ivoire,Denmark,14,0,0,14
22738,2021,India,Denmark,5,8,0,13
22739,2021,Iran (Islamic Rep. of),Denmark,2790,108,0,2898
22740,2021,Iraq,Denmark,274,54,0,328
22741,2021,Jordan,Denmark,0,10,0,10
22742,2021,Kenya,Denmark,5,0,0,5
22743,2021,Kyrgyzstan,Denmark,5,0,0,5
22744,2021,Libya,Denmark,5,5,0,10
22745,2021,Lebanon,Denmark,30,5,0,35
22746,2021,Sri Lanka,Denmark,35,0,0,35
22747,2021,North Macedonia,Denmark,0,5,0,5
22748,2021,Mongolia,Denmark,0,5,0,5
22749,2021,Morocco,Denmark,10,34,0,44
22750,2021,Myanmar,Denmark,13,5,0,18
22751,2021,Nepal,Denmark,5,0,0,5
22752,2021,Nicaragua,Denmark,13,0,0,13
22753,2021,Nigeria,Denmark,11,5,0,16
22754,2021,Pakistan,Denmark,66,20,0,86
22755,2021,Russian Federation,Denmark,630,29,0,659
22756,2021,Rwanda,Denmark,13,5,0,18
22757,2021,El Salvador,Denmark,5,0,0,5
22758,2021,Serbia and Kosovo: S/RES/1244 (1999),Denmark,0,5,0,5
22759,2021,Somalia,Denmark,1360,21,0,1381
22760,2021,Sudan,Denmark,53,9,0,62
22761,2021,Syrian Arab Rep.,Denmark,19706,222,0,19928
22762,2021,Thailand,Denmark,5,0,0,5
22763,2021,Tajikistan,Denmark,6,0,0,6
22764,2021,Tunisia,Denmark,5,10,0,15
22765,2021,Türkiye,Denmark,22,33,0,55
22766,2021,Uganda,Denmark,73,5,0,78
22767,2021,Ukraine,Denmark,29,14,0,43
22768,2021,United States of America,Denmark,0,5,0,5
22769,2021,Uzbekistan,Denmark,9,5,0,14
22770,2021,Venezuela (Bolivarian Republic of),Denmark,5,0,0,5
22771,2021,Yemen,Denmark,7,0,0,7
22772,2021,Zambia,Denmark,5,0,0,5
22773,2021,Zimbabwe,Denmark,8,0,0,8
22774,2021,Stateless,Denmark,2923,66,0,2989
22775,2021,Dem. Rep. of the Congo,Djibouti,0,18,0,18
22776,2021,Djibouti,Djibouti,0,0,0,0
22777,2021,Eritrea,Djibouti,617,381,0,998
22778,2021,Ethiopia,Djibouti,2158,10908,0,13066
22779,2021,Iraq,Djibouti,19,0,0,19
22780,2021,Mali,Djibouti,5,5,0,10
22781,2021,Somalia,Djibouti,14178,141,0,14319
22782,2021,Sudan,Djibouti,9,5,0,14
22783,2021,Syrian Arab Rep.,Djibouti,14,5,0,19
22784,2021,Yemen,Djibouti,6232,0,0,6232
22785,2021,Afghanistan,Dominican Rep.,0,8,0,8
22786,2021,Colombia,Dominican Rep.,0,5,0,5
22787,2021,Cuba,Dominican Rep.,0,51,0,51
22788,2021,Haiti,Dominican Rep.,162,285,0,447
22789,2021,Honduras,Dominican Rep.,0,5,0,5
22790,2021,Sri Lanka,Dominican Rep.,0,5,0,5
22791,2021,Nicaragua,Dominican Rep.,0,5,0,5
22792,2021,Venezuela (Bolivarian Republic of),Dominican Rep.,0,278,0,278
22793,2021,Afghanistan,Ecuador,147,0,0,147
22794,2021,Albania,Ecuador,6,0,0,6
22795,2021,Angola,Ecuador,5,0,0,5
22796,2021,Egypt,Ecuador,5,7,0,12
22797,2021,Bangladesh,Ecuador,5,0,0,5
22798,2021,Burkina Faso,Ecuador,5,0,0,5
22799,2021,Brazil,Ecuador,5,0,0,5
22800,2021,China,Ecuador,12,0,0,12
22801,2021,Chile,Ecuador,5,0,0,5
22802,2021,Cameroon,Ecuador,20,6,0,26
22803,2021,Congo,Ecuador,5,0,0,5
22804,2021,Dem. Rep. of the Congo,Ecuador,8,5,0,13
22805,2021,Colombia,Ecuador,54491,2719,0,57210
22806,2021,Cuba,Ecuador,219,61,0,280
22807,2021,Dominican Rep.,Ecuador,5,0,0,5
22808,2021,Eritrea,Ecuador,11,5,0,16
22809,2021,Ethiopia,Ecuador,5,0,0,5
22810,2021,Palestinian,Ecuador,11,6,0,17
22811,2021,Ghana,Ecuador,5,0,0,5
22812,2021,Guinea,Ecuador,9,0,0,9
22813,2021,Haiti,Ecuador,22,0,0,22
22814,2021,Cote d'Ivoire,Ecuador,5,0,0,5
22815,2021,India,Ecuador,5,5,0,10
22816,2021,Iran (Islamic Rep. of),Ecuador,67,5,0,72
22817,2021,Iraq,Ecuador,55,0,0,55
22818,2021,Liberia,Ecuador,6,0,0,6
22819,2021,Lebanon,Ecuador,19,12,0,31
22820,2021,Sri Lanka,Ecuador,18,5,0,23
22821,2021,Mali,Ecuador,5,0,0,5
22822,2021,Morocco,Ecuador,5,0,0,5
22823,2021,Nepal,Ecuador,5,0,0,5
22824,2021,Nicaragua,Ecuador,5,0,0,5
22825,2021,Nigeria,Ecuador,40,5,0,45
22826,2021,Pakistan,Ecuador,29,0,0,29
22827,2021,Panama,Ecuador,5,0,0,5
22828,2021,Peru,Ecuador,82,8,0,90
22829,2021,South Africa,Ecuador,0,5,0,5
22830,2021,Russian Federation,Ecuador,36,5,0,41
22831,2021,Rwanda,Ecuador,5,0,0,5
22832,2021,El Salvador,Ecuador,27,5,0,32
22833,2021,Saudi Arabia,Ecuador,8,0,0,8
22834,2021,Somalia,Ecuador,8,0,0,8
22835,2021,Spain,Ecuador,5,0,0,5
22836,2021,Viet Nam,Ecuador,5,0,0,5
22837,2021,Sudan,Ecuador,5,0,0,5
22838,2021,Syrian Arab Rep.,Ecuador,157,0,0,157
22839,2021,Türkiye,Ecuador,5,0,0,5
22840,2021,United Arab Emirates,Ecuador,5,0,0,5
22841,2021,Ukraine,Ecuador,15,0,0,15
22842,2021,United States of America,Ecuador,8,0,0,8
22843,2021,Uzbekistan,Ecuador,5,0,0,5
22844,2021,Venezuela (Bolivarian Republic of),Ecuador,798,4255,0,5053
22845,2021,Western Sahara,Ecuador,5,0,0,5
22846,2021,Yemen,Ecuador,117,12,0,129
22847,2021,Zimbabwe,Ecuador,6,6,0,12
22848,2021,Unknown ,Ecuador,26,0,0,26
22849,2021,Eritrea,Eritrea,0,0,0,0
22850,2021,Ethiopia,Eritrea,15,0,0,15
22851,2021,Sudan,Eritrea,99,0,0,99
22852,2021,South Sudan,Eritrea,7,0,0,7
22853,2021,Afghanistan,Estonia,20,5,0,25
22854,2021,Egypt,Estonia,5,0,0,5
22855,2021,Azerbaijan,Estonia,5,0,0,5
22856,2021,Belarus,Estonia,5,0,0,5
22857,2021,Eritrea,Estonia,10,0,0,10
22858,2021,Georgia,Estonia,5,0,0,5
22859,2021,Iran (Islamic Rep. of),Estonia,5,0,0,5
22860,2021,Iraq,Estonia,23,0,0,23
22861,2021,Sri Lanka,Estonia,5,0,0,5
22862,2021,Russian Federation,Estonia,53,5,0,58
22863,2021,Serbia and Kosovo: S/RES/1244 (1999),Estonia,6,0,0,6
22864,2021,Sudan,Estonia,16,0,0,16
22865,2021,Syrian Arab Rep.,Estonia,105,0,0,105
22866,2021,Türkiye,Estonia,25,5,0,30
22867,2021,Ukraine,Estonia,28,0,0,28
22868,2021,Yemen,Estonia,5,0,0,5
22869,2021,Stateless,Estonia,0,0,0,0
22870,2021,Egypt,Ethiopia,5,0,0,5
22871,2021,Burundi,Ethiopia,55,74,0,129
22872,2021,Chad,Ethiopia,0,5,0,5
22873,2021,Cameroon,Ethiopia,0,5,0,5
22874,2021,Dem. Rep. of the Congo,Ethiopia,769,294,0,1063
22875,2021,Cuba,Ethiopia,5,0,0,5
22876,2021,Djibouti,Ethiopia,56,5,0,61
22877,2021,Eritrea,Ethiopia,158294,236,0,158530
22878,2021,Ethiopia,Ethiopia,0,0,3646267,0
22879,2021,Palestinian,Ethiopia,0,14,0,14
22880,2021,Cote d'Ivoire,Ethiopia,5,0,0,5
22881,2021,Iraq,Ethiopia,10,0,0,10
22882,2021,Jordan,Ethiopia,0,19,0,19
22883,2021,Kenya,Ethiopia,4033,0,0,4033
22884,2021,Lebanon,Ethiopia,0,18,0,18
22885,2021,Mali,Ethiopia,0,5,0,5
22886,2021,Nigeria,Ethiopia,5,5,0,10
22887,2021,Rwanda,Ethiopia,11,7,0,18
22888,2021,Somalia,Ethiopia,223018,44,0,223062
22889,2021,Sudan,Ethiopia,45843,590,0,46433
22890,2021,South Sudan,Ethiopia,386750,179,0,386929
22891,2021,Syrian Arab Rep.,Ethiopia,38,629,0,667
22892,2021,Uganda,Ethiopia,13,5,0,18
22893,2021,Yemen,Ethiopia,2373,117,0,2490
22894,2021,Afghanistan,Fiji,8,0,0,8
22895,2021,Bangladesh,Fiji,5,0,0,5
22896,2021,Pakistan,Fiji,5,0,0,5
22897,2021,Afghanistan,Finland,3652,526,0,4178
22898,2021,Albania,Finland,5,5,0,10
22899,2021,Algeria,Finland,7,6,0,13
22900,2021,Angola,Finland,60,5,0,65
22901,2021,Egypt,Finland,40,5,0,45
22902,2021,Armenia,Finland,0,5,0,5
22903,2021,Azerbaijan,Finland,70,5,0,75
22904,2021,Burundi,Finland,6,0,0,6
22905,2021,Bangladesh,Finland,25,5,0,30
22906,2021,Burkina Faso,Finland,5,0,0,5
22907,2021,Belarus,Finland,16,5,0,21
22908,2021,Brazil,Finland,0,5,0,5
22909,2021,Cambodia,Finland,5,0,0,5
22910,2021,Central African Rep.,Finland,6,0,0,6
22911,2021,China,Finland,190,11,0,201
22912,2021,Cameroon,Finland,123,37,0,160
22913,2021,Congo,Finland,5,0,0,5
22914,2021,Dem. Rep. of the Congo,Finland,99,14,0,113
22915,2021,Colombia,Finland,0,11,0,11
22916,2021,Cuba,Finland,5,6,0,11
22917,2021,Dominican Rep.,Finland,5,0,0,5
22918,2021,Eritrea,Finland,869,6,0,875
22919,2021,Ethiopia,Finland,151,19,0,170
22920,2021,Gambia,Finland,28,9,0,37
22921,2021,Georgia,Finland,0,46,0,46
22922,2021,Ghana,Finland,35,12,0,47
22923,2021,Guatemala,Finland,5,0,0,5
22924,2021,Guinea,Finland,24,0,0,24
22925,2021,Honduras,Finland,28,17,0,45
22926,2021,Cote d'Ivoire,Finland,7,5,0,12
22927,2021,India,Finland,5,0,0,5
22928,2021,Indonesia,Finland,5,0,0,5
22929,2021,Iran (Islamic Rep. of),Finland,966,85,0,1051
22930,2021,Iraq,Finland,9166,590,0,9756
22931,2021,Jordan,Finland,6,5,0,11
22932,2021,Kazakhstan,Finland,8,0,0,8
22933,2021,Kenya,Finland,17,12,0,29
22934,2021,Kyrgyzstan,Finland,20,0,0,20
22935,2021,Liberia,Finland,6,0,0,6
22936,2021,Libya,Finland,34,6,0,40
22937,2021,Lebanon,Finland,13,6,0,19
22938,2021,Sri Lanka,Finland,33,6,0,39
22939,2021,Rep. of Moldova,Finland,6,0,0,6
22940,2021,Mali,Finland,8,0,0,8
22941,2021,Morocco,Finland,39,16,0,55
22942,2021,Myanmar,Finland,32,5,0,37
22943,2021,Nicaragua,Finland,63,36,0,99
22944,2021,Nigeria,Finland,139,57,0,196
22945,2021,Pakistan,Finland,75,23,0,98
22946,2021,Russian Federation,Finland,844,184,0,1028
22947,2021,Rwanda,Finland,39,28,0,67
22948,2021,El Salvador,Finland,10,5,0,15
22949,2021,Serbia and Kosovo: S/RES/1244 (1999),Finland,36,7,0,43
22950,2021,Senegal,Finland,5,0,0,5
22951,2021,Sierra Leone,Finland,5,10,0,15
22952,2021,Somalia,Finland,2512,226,0,2738
22953,2021,Viet Nam,Finland,8,0,0,8
22954,2021,Sudan,Finland,55,5,0,60
22955,2021,South Sudan,Finland,8,0,0,8
22956,2021,Syrian Arab Rep.,Finland,2660,66,0,2726
22957,2021,United Rep. of Tanzania,Finland,6,0,0,6
22958,2021,Tajikistan,Finland,9,0,0,9
22959,2021,Togo,Finland,5,0,0,5
22960,2021,Tunisia,Finland,5,0,0,5
22961,2021,Türkiye,Finland,819,149,0,968
22962,2021,Uganda,Finland,36,6,0,42
22963,2021,Ukraine,Finland,11,14,0,25
22964,2021,United States of America,Finland,0,5,0,5
22965,2021,Uzbekistan,Finland,10,0,0,10
22966,2021,Venezuela (Bolivarian Republic of),Finland,7,6,0,13
22967,2021,Yemen,Finland,311,12,0,323
22968,2021,Zimbabwe,Finland,6,0,0,6
22969,2021,Stateless,Finland,422,25,0,447
22970,2021,Unknown ,Finland,137,48,0,185
22971,2021,Afghanistan,France,49990,9494,0,59484
22972,2021,Albania,France,9860,2932,0,12792
22973,2021,Algeria,France,3209,484,0,3693
22974,2021,Angola,France,6704,966,0,7670
22975,2021,Egypt,France,1586,395,0,1981
22976,2021,Argentina,France,12,5,0,17
22977,2021,Armenia,France,6407,659,0,7066
22978,2021,Azerbaijan,France,4667,241,0,4908
22979,2021,Bahrain,France,21,0,0,21
22980,2021,Burundi,France,1769,648,0,2417
22981,2021,Benin,France,162,277,0,439
22982,2021,Bangladesh,France,8608,5309,0,13917
22983,2021,Bhutan,France,173,0,0,173
22984,2021,Burkina Faso,France,492,322,0,814
22985,2021,Belarus,France,810,46,0,856
22986,2021,Bolivia (Plurinational State of),France,65,7,0,72
22987,2021,Brazil,France,57,26,0,83
22988,2021,Bosnia and Herzegovina,France,6921,192,0,7113
22989,2021,Bulgaria,France,70,0,0,70
22990,2021,Cambodia,France,11059,5,0,11064
22991,2021,Canada,France,5,0,0,5
22992,2021,Central African Rep.,France,5069,362,0,5431
22993,2021,Chad,France,3106,1210,0,4316
22994,2021,China,France,10015,248,0,10263
22995,2021,Chile,France,153,0,0,153
22996,2021,Cameroon,France,2485,1355,0,3840
22997,2021,Congo,France,5661,794,0,6455
22998,2021,Dem. Rep. of the Congo,France,31133,2940,0,34073
22999,2021,Comoros,France,1633,1209,0,2842
23000,2021,Colombia,France,1036,634,0,1670
23001,2021,Cuba,France,304,180,0,484
23002,2021,Cabo Verde,France,0,5,0,5
23003,2021,Djibouti,France,518,141,0,659
23004,2021,Dominica,France,5,0,0,5
23005,2021,Dominican Rep.,France,136,36,0,172
23006,2021,Ecuador,France,37,0,0,37
23007,2021,Equatorial Guinea,France,60,0,0,60
23008,2021,Eritrea,France,10723,944,0,11667
23009,2021,Estonia,France,5,0,0,5
23010,2021,Ethiopia,France,2899,499,0,3398
23011,2021,Gabon,France,457,404,0,861
23012,2021,Gambia,France,506,345,0,851
23013,2021,Palestinian,France,1954,38,0,1992
23014,2021,Georgia,France,5760,2274,0,8034
23015,2021,Ghana,France,589,53,0,642
23016,2021,Guinea-Bissau,France,1287,35,0,1322
23017,2021,Guatemala,France,21,5,0,26
23018,2021,Guinea,France,19979,3216,0,23195
23019,2021,Guyana,France,29,0,0,29
23020,2021,Haiti,France,6666,629,0,7295
23021,2021,Honduras,France,48,6,0,54
23022,2021,Croatia,France,63,0,0,63
23023,2021,Hungary,France,74,0,0,74
23024,2021,Cote d'Ivoire,France,10842,4019,0,14861
23025,2021,India,France,319,25,0,344
23026,2021,Indonesia,France,9,0,0,9
23027,2021,Iran (Islamic Rep. of),France,3967,391,0,4358
23028,2021,Iraq,France,13830,751,0,14581
23029,2021,Israel,France,9,0,0,9
23030,2021,Jamaica,France,39,0,0,39
23031,2021,Jordan,France,61,5,0,66
23032,2021,Kazakhstan,France,1047,37,0,1084
23033,2021,Kenya,France,190,0,0,190
23034,2021,Kyrgyzstan,France,526,30,0,556
23035,2021,Kuwait,France,435,64,0,499
23036,2021,Lao People's Dem. Rep.,France,6532,0,0,6532
23037,2021,Liberia,France,334,22,0,356
23038,2021,Libya,France,2259,269,0,2528
23039,2021,Saint Lucia,France,7,0,0,7
23040,2021,Lebanon,France,301,160,0,461
23041,2021,Sri Lanka,France,33792,614,0,34406
23042,2021,Lithuania,France,6,0,0,6
23043,2021,Latvia,France,38,0,0,38
23044,2021,Madagascar,France,388,295,0,683
23045,2021,Mauritania,France,7860,1123,0,8983
23046,2021,North Macedonia,France,723,254,0,977
23047,2021,Rep. of Moldova,France,449,282,0,731
23048,2021,Maldives,France,6,0,0,6
23049,2021,Mexico,France,36,5,0,41
23050,2021,Mali,France,7561,1881,0,9442
23051,2021,Malaysia,France,28,5,0,33
23052,2021,Mongolia,France,832,48,0,880
23053,2021,Morocco,France,1296,207,0,1503
23054,2021,Mozambique,France,19,0,0,19
23055,2021,Montenegro,France,197,6,0,203
23056,2021,Mauritius,France,44,0,0,44
23057,2021,Myanmar,France,355,12,0,367
23058,2021,Nepal,France,217,35,0,252
23059,2021,Niger,France,197,34,0,231
23060,2021,Nicaragua,France,68,7,0,75
23061,2021,Nigeria,France,5491,4010,0,9501
23062,2021,Pakistan,France,2742,1810,0,4552
23063,2021,Paraguay,France,9,5,0,14
23064,2021,Peru,France,473,41,0,514
23065,2021,Philippines,France,7,6,0,13
23066,2021,Poland,France,135,0,0,135
23067,2021,Romania,France,171,5,0,176
23068,2021,South Africa,France,142,7,0,149
23069,2021,Russian Federation,France,32918,1281,0,34199
23070,2021,Rwanda,France,4432,412,0,4844
23071,2021,El Salvador,France,111,5,0,116
23072,2021,Saudi Arabia,France,42,0,0,42
23073,2021,Serbia and Kosovo: S/RES/1244 (1999),France,17972,1190,0,19162
23074,2021,Senegal,France,2682,1136,0,3818
23075,2021,Sierra Leone,France,1117,326,0,1443
23076,2021,Somalia,France,9048,4209,0,13257
23077,2021,Viet Nam,France,8018,0,0,8018
23078,2021,Sudan,France,23719,1238,0,24957
23079,2021,Suriname,France,11,17,0,28
23080,2021,South Sudan,France,218,0,0,218
23081,2021,Slovakia,France,142,0,0,142
23082,2021,Syrian Arab Rep.,France,37375,1369,0,38744
23083,2021,United Rep. of Tanzania,France,27,8,0,35
23084,2021,Thailand,France,15,5,0,20
23085,2021,Tajikistan,France,121,25,0,146
23086,2021,Turkmenistan,France,41,0,0,41
23087,2021,Togo,France,1091,213,0,1304
23088,2021,Tunisia,France,563,91,0,654
23089,2021,Türkiye,France,16053,5211,0,21264
23090,2021,Uganda,France,215,15,0,230
23091,2021,Ukraine,France,2801,588,0,3389
23092,2021,United States of America,France,9,5,0,14
23093,2021,Uzbekistan,France,300,5,0,305
23094,2021,Venezuela (Bolivarian Republic of),France,1232,425,0,1657
23095,2021,Western Sahara,France,855,83,0,938
23096,2021,Yemen,France,921,95,0,1016
23097,2021,Zimbabwe,France,85,5,0,90
23098,2021,Stateless,France,1725,199,0,1924
23099,2021,Tibetan,France,32,0,0,32
23100,2021,Unknown ,France,6976,1517,0,8493
23101,2021,Burundi,Gabon,6,0,0,6
23102,2021,Central African Rep.,Gabon,19,10,0,29
23103,2021,Chad,Gabon,86,13,0,99
23104,2021,Cameroon,Gabon,5,5,0,10
23105,2021,Congo,Gabon,60,0,0,60
23106,2021,Dem. Rep. of the Congo,Gabon,73,25,0,98
23107,2021,Mauritania,Gabon,6,0,0,6
23108,2021,Sao Tome and Principe,Gabon,6,0,0,6
23109,2021,Sudan,Gabon,5,0,0,5
23110,2021,Togo,Gabon,6,0,0,6
23111,2021,Central African Rep.,Gambia,8,8,0,16
23112,2021,Congo,Gambia,6,5,0,11
23113,2021,Dem. Rep. of the Congo,Gambia,61,7,0,68
23114,2021,Guinea-Bissau,Gambia,0,6,0,6
23115,2021,Guinea,Gambia,5,5,0,10
23116,2021,Cote d'Ivoire,Gambia,150,6,0,156
23117,2021,Liberia,Gambia,15,0,0,15
23118,2021,Rwanda,Gambia,5,0,0,5
23119,2021,Senegal,Gambia,4045,159,0,4204
23120,2021,Sierra Leone,Gambia,105,11,0,116
23121,2021,Togo,Gambia,18,0,0,18
23122,2021,Afghanistan,United Kingdom of Great Britain and Northern Ireland,9642,4943,0,14585
23123,2021,Albania,United Kingdom of Great Britain and Northern Ireland,4153,12103,0,16256
23124,2021,Algeria,United Kingdom of Great Britain and Northern Ireland,312,529,0,841
23125,2021,Angola,United Kingdom of Great Britain and Northern Ireland,139,154,0,293
23126,2021,Antigua and Barbuda,United Kingdom of Great Britain and Northern Ireland,5,12,0,17
23127,2021,Egypt,United Kingdom of Great Britain and Northern Ireland,978,1039,0,2017
23128,2021,Argentina,United Kingdom of Great Britain and Northern Ireland,0,22,0,22
23129,2021,Armenia,United Kingdom of Great Britain and Northern Ireland,56,10,0,66
23130,2021,Australia,United Kingdom of Great Britain and Northern Ireland,5,0,0,5
23131,2021,Azerbaijan,United Kingdom of Great Britain and Northern Ireland,143,71,0,214
23132,2021,Bahrain,United Kingdom of Great Britain and Northern Ireland,116,6,0,122
23133,2021,Barbados,United Kingdom of Great Britain and Northern Ireland,15,17,0,32
23134,2021,Burundi,United Kingdom of Great Britain and Northern Ireland,52,19,0,71
23135,2021,Benin,United Kingdom of Great Britain and Northern Ireland,9,29,0,38
23136,2021,Bangladesh,United Kingdom of Great Britain and Northern Ireland,1781,3114,0,4895
23137,2021,Bhutan,United Kingdom of Great Britain and Northern Ireland,23,0,0,23
23138,2021,Burkina Faso,United Kingdom of Great Britain and Northern Ireland,12,12,0,24
23139,2021,Belarus,United Kingdom of Great Britain and Northern Ireland,101,72,0,173
23140,2021,Bolivia (Plurinational State of),United Kingdom of Great Britain and Northern Ireland,19,19,0,38
23141,2021,Botswana,United Kingdom of Great Britain and Northern Ireland,33,105,0,138
23142,2021,Brazil,United Kingdom of Great Britain and Northern Ireland,39,273,0,312
23143,2021,Bosnia and Herzegovina,United Kingdom of Great Britain and Northern Ireland,12,5,0,17
23144,2021,Belize,United Kingdom of Great Britain and Northern Ireland,0,5,0,5
23145,2021,Canada,United Kingdom of Great Britain and Northern Ireland,11,15,0,26
23146,2021,Central African Rep.,United Kingdom of Great Britain and Northern Ireland,10,16,0,26
23147,2021,Chad,United Kingdom of Great Britain and Northern Ireland,107,282,0,389
23148,2021,China,United Kingdom of Great Britain and Northern Ireland,1026,2428,0,3454
23149,2021,Chile,United Kingdom of Great Britain and Northern Ireland,0,10,0,10
23150,2021,Cameroon,United Kingdom of Great Britain and Northern Ireland,776,378,0,1154
23151,2021,Congo,United Kingdom of Great Britain and Northern Ireland,89,60,0,149
23152,2021,Dem. Rep. of the Congo,United Kingdom of Great Britain and Northern Ireland,929,225,0,1154
23153,2021,Comoros,United Kingdom of Great Britain and Northern Ireland,5,0,0,5
23154,2021,Colombia,United Kingdom of Great Britain and Northern Ireland,15,58,0,73
23155,2021,Costa Rica,United Kingdom of Great Britain and Northern Ireland,0,7,0,7
23156,2021,Cuba,United Kingdom of Great Britain and Northern Ireland,12,16,0,28
23157,2021,Cabo Verde,United Kingdom of Great Britain and Northern Ireland,5,0,0,5
23158,2021,Cyprus,United Kingdom of Great Britain and Northern Ireland,0,5,0,5
23159,2021,Djibouti,United Kingdom of Great Britain and Northern Ireland,6,5,0,11
23160,2021,Dominica,United Kingdom of Great Britain and Northern Ireland,22,25,0,47
23161,2021,Dominican Rep.,United Kingdom of Great Britain and Northern Ireland,0,5,0,5
23162,2021,Ecuador,United Kingdom of Great Britain and Northern Ireland,5,18,0,23
23163,2021,Equatorial Guinea,United Kingdom of Great Britain and Northern Ireland,0,9,0,9
23164,2021,Eritrea,United Kingdom of Great Britain and Northern Ireland,14753,6489,0,21242
23165,2021,Ethiopia,United Kingdom of Great Britain and Northern Ireland,1921,1323,0,3244
23166,2021,Fiji,United Kingdom of Great Britain and Northern Ireland,8,0,0,8
23167,2021,Gabon,United Kingdom of Great Britain and Northern Ireland,8,7,0,15
23168,2021,Gambia,United Kingdom of Great Britain and Northern Ireland,923,276,0,1199
23169,2021,Palestinian,United Kingdom of Great Britain and Northern Ireland,599,548,0,1147
23170,2021,United Kingdom of Great Britain and Northern Ireland,United Kingdom of Great Britain and Northern Ireland,20,0,0,20
23171,2021,Georgia,United Kingdom of Great Britain and Northern Ireland,74,715,0,789
23172,2021,Ghana,United Kingdom of Great Britain and Northern Ireland,364,426,0,790
23173,2021,Guinea-Bissau,United Kingdom of Great Britain and Northern Ireland,7,8,0,15
23174,2021,Greece,United Kingdom of Great Britain and Northern Ireland,5,5,0,10
23175,2021,Grenada,United Kingdom of Great Britain and Northern Ireland,24,43,0,67
23176,2021,Guatemala,United Kingdom of Great Britain and Northern Ireland,9,26,0,35
23177,2021,Guinea,United Kingdom of Great Britain and Northern Ireland,210,146,0,356
23178,2021,Guyana,United Kingdom of Great Britain and Northern Ireland,20,6,0,26
23179,2021,Haiti,United Kingdom of Great Britain and Northern Ireland,0,11,0,11
23180,2021,"China, Hong Kong SAR",United Kingdom of Great Britain and Northern Ireland,15,0,0,15
23181,2021,Honduras,United Kingdom of Great Britain and Northern Ireland,119,765,0,884
23182,2021,Cote d'Ivoire,United Kingdom of Great Britain and Northern Ireland,197,109,0,306
23183,2021,India,United Kingdom of Great Britain and Northern Ireland,508,2679,0,3187
23184,2021,Indonesia,United Kingdom of Great Britain and Northern Ireland,41,89,0,130
23185,2021,Iran (Islamic Rep. of),United Kingdom of Great Britain and Northern Ireland,21434,13754,0,35188
23186,2021,Iraq,United Kingdom of Great Britain and Northern Ireland,7263,12068,0,19331
23187,2021,Israel,United Kingdom of Great Britain and Northern Ireland,120,15,0,135
23188,2021,Italy,United Kingdom of Great Britain and Northern Ireland,5,0,0,5
23189,2021,Jamaica,United Kingdom of Great Britain and Northern Ireland,264,201,0,465
23190,2021,Jordan,United Kingdom of Great Britain and Northern Ireland,110,132,0,242
23191,2021,Japan,United Kingdom of Great Britain and Northern Ireland,0,7,0,7
23192,2021,Kazakhstan,United Kingdom of Great Britain and Northern Ireland,42,66,0,108
23193,2021,Kenya,United Kingdom of Great Britain and Northern Ireland,316,342,0,658
23194,2021,Kyrgyzstan,United Kingdom of Great Britain and Northern Ireland,38,20,0,58
23195,2021,Rep. of Korea,United Kingdom of Great Britain and Northern Ireland,5,0,0,5
23196,2021,Dem. People's Rep. of Korea,United Kingdom of Great Britain and Northern Ireland,51,21,0,72
23197,2021,Kuwait,United Kingdom of Great Britain and Northern Ireland,692,1062,0,1754
23198,2021,Lao People's Dem. Rep.,United Kingdom of Great Britain and Northern Ireland,5,0,0,5
23199,2021,Liberia,United Kingdom of Great Britain and Northern Ireland,29,28,0,57
23200,2021,Libya,United Kingdom of Great Britain and Northern Ireland,4468,856,0,5324
23201,2021,Saint Lucia,United Kingdom of Great Britain and Northern Ireland,26,44,0,70
23202,2021,Lebanon,United Kingdom of Great Britain and Northern Ireland,205,176,0,381
23203,2021,Sri Lanka,United Kingdom of Great Britain and Northern Ireland,4668,1591,0,6259
23204,2021,Lithuania,United Kingdom of Great Britain and Northern Ireland,0,5,0,5
23205,2021,Mauritania,United Kingdom of Great Britain and Northern Ireland,7,7,0,14
23206,2021,North Macedonia,United Kingdom of Great Britain and Northern Ireland,15,11,0,26
23207,2021,Rep. of Moldova,United Kingdom of Great Britain and Northern Ireland,5,5,0,10
23208,2021,Maldives,United Kingdom of Great Britain and Northern Ireland,46,0,0,46
23209,2021,Mexico,United Kingdom of Great Britain and Northern Ireland,16,75,0,91
23210,2021,Mali,United Kingdom of Great Britain and Northern Ireland,28,67,0,95
23211,2021,Malaysia,United Kingdom of Great Britain and Northern Ireland,307,417,0,724
23212,2021,Malawi,United Kingdom of Great Britain and Northern Ireland,293,73,0,366
23213,2021,Mongolia,United Kingdom of Great Britain and Northern Ireland,53,66,0,119
23214,2021,Morocco,United Kingdom of Great Britain and Northern Ireland,221,368,0,589
23215,2021,Mozambique,United Kingdom of Great Britain and Northern Ireland,7,5,0,12
23216,2021,Mauritius,United Kingdom of Great Britain and Northern Ireland,69,106,0,175
23217,2021,Myanmar,United Kingdom of Great Britain and Northern Ireland,367,87,0,454
23218,2021,Namibia,United Kingdom of Great Britain and Northern Ireland,193,784,0,977
23219,2021,Nepal,United Kingdom of Great Britain and Northern Ireland,63,447,0,510
23220,2021,Netherlands,United Kingdom of Great Britain and Northern Ireland,5,0,0,5
23221,2021,Niger,United Kingdom of Great Britain and Northern Ireland,194,24,0,218
23222,2021,Nicaragua,United Kingdom of Great Britain and Northern Ireland,54,165,0,219
23223,2021,Nigeria,United Kingdom of Great Britain and Northern Ireland,3101,3001,0,6102
23224,2021,Norway,United Kingdom of Great Britain and Northern Ireland,5,0,0,5
23225,2021,Oman,United Kingdom of Great Britain and Northern Ireland,22,24,0,46
23226,2021,Pakistan,United Kingdom of Great Britain and Northern Ireland,8245,4420,0,12665
23227,2021,Peru,United Kingdom of Great Britain and Northern Ireland,0,9,0,9
23228,2021,Philippines,United Kingdom of Great Britain and Northern Ireland,61,592,0,653
23229,2021,Poland,United Kingdom of Great Britain and Northern Ireland,0,5,0,5
23230,2021,Qatar,United Kingdom of Great Britain and Northern Ireland,17,11,0,28
23231,2021,Romania,United Kingdom of Great Britain and Northern Ireland,0,11,0,11
23232,2021,South Africa,United Kingdom of Great Britain and Northern Ireland,126,119,0,245
23233,2021,Russian Federation,United Kingdom of Great Britain and Northern Ireland,876,704,0,1580
23234,2021,Rwanda,United Kingdom of Great Britain and Northern Ireland,98,38,0,136
23235,2021,El Salvador,United Kingdom of Great Britain and Northern Ireland,820,2287,0,3107
23236,2021,Saudi Arabia,United Kingdom of Great Britain and Northern Ireland,288,195,0,483
23237,2021,Serbia and Kosovo: S/RES/1244 (1999),United Kingdom of Great Britain and Northern Ireland,77,56,0,133
23238,2021,Senegal,United Kingdom of Great Britain and Northern Ireland,98,66,0,164
23239,2021,Seychelles,United Kingdom of Great Britain and Northern Ireland,9,0,0,9
23240,2021,Singapore,United Kingdom of Great Britain and Northern Ireland,5,10,0,15
23241,2021,Sierra Leone,United Kingdom of Great Britain and Northern Ireland,328,309,0,637
23242,2021,Somalia,United Kingdom of Great Britain and Northern Ireland,2488,1141,0,3629
23243,2021,Viet Nam,United Kingdom of Great Britain and Northern Ireland,2772,3904,0,6676
23244,2021,Saint Kitts and Nevis,United Kingdom of Great Britain and Northern Ireland,6,21,0,27
23245,2021,Sudan,United Kingdom of Great Britain and Northern Ireland,11305,3577,0,14882
23246,2021,South Sudan,United Kingdom of Great Britain and Northern Ireland,78,135,0,213
23247,2021,Eswatini,United Kingdom of Great Britain and Northern Ireland,55,5,0,60
23248,2021,Sweden,United Kingdom of Great Britain and Northern Ireland,0,5,0,5
23249,2021,Syrian Arab Rep.,United Kingdom of Great Britain and Northern Ireland,11980,4795,0,16775
23250,2021,United Rep. of Tanzania,United Kingdom of Great Britain and Northern Ireland,106,91,0,197
23251,2021,Thailand,United Kingdom of Great Britain and Northern Ireland,36,115,0,151
23252,2021,Tajikistan,United Kingdom of Great Britain and Northern Ireland,14,10,0,24
23253,2021,Turkmenistan,United Kingdom of Great Britain and Northern Ireland,21,41,0,62
23254,2021,Togo,United Kingdom of Great Britain and Northern Ireland,15,35,0,50
23255,2021,Trinidad and Tobago,United Kingdom of Great Britain and Northern Ireland,99,154,0,253
23256,2021,Tunisia,United Kingdom of Great Britain and Northern Ireland,66,106,0,172
23257,2021,Türkiye,United Kingdom of Great Britain and Northern Ireland,2646,1756,0,4402
23258,2021,United Arab Emirates,United Kingdom of Great Britain and Northern Ireland,22,14,0,36
23259,2021,Uganda,United Kingdom of Great Britain and Northern Ireland,1157,265,0,1422
23260,2021,Ukraine,United Kingdom of Great Britain and Northern Ireland,225,266,0,491
23261,2021,United States of America,United Kingdom of Great Britain and Northern Ireland,67,121,0,188
23262,2021,Uzbekistan,United Kingdom of Great Britain and Northern Ireland,70,67,0,137
23263,2021,Vanuatu,United Kingdom of Great Britain and Northern Ireland,0,6,0,6
23264,2021,Saint Vincent and the Grenadines,United Kingdom of Great Britain and Northern Ireland,39,33,0,72
23265,2021,Venezuela (Bolivarian Republic of),United Kingdom of Great Britain and Northern Ireland,67,31,0,98
23266,2021,Samoa,United Kingdom of Great Britain and Northern Ireland,0,5,0,5
23267,2021,Western Sahara,United Kingdom of Great Britain and Northern Ireland,12,5,0,17
23268,2021,Yemen,United Kingdom of Great Britain and Northern Ireland,1251,769,0,2020
23269,2021,Zambia,United Kingdom of Great Britain and Northern Ireland,82,53,0,135
23270,2021,Zimbabwe,United Kingdom of Great Britain and Northern Ireland,1174,442,0,1616
23271,2021,Stateless,United Kingdom of Great Britain and Northern Ireland,3070,1849,0,4919
23272,2021,Unknown ,United Kingdom of Great Britain and Northern Ireland,1807,336,0,2143
23273,2021,Afghanistan,Georgia,20,49,0,69
23274,2021,Algeria,Georgia,0,5,0,5
23275,2021,Egypt,Georgia,65,61,0,126
23276,2021,Azerbaijan,Georgia,0,5,0,5
23277,2021,Belarus,Georgia,0,12,0,12
23278,2021,Cameroon,Georgia,0,5,0,5
23279,2021,Dem. Rep. of the Congo,Georgia,5,5,0,10
23280,2021,Eritrea,Georgia,10,20,0,30
23281,2021,Ethiopia,Georgia,0,5,0,5
23282,2021,Palestinian,Georgia,0,15,0,15
23283,2021,Georgia,Georgia,0,0,290156,0
23284,2021,Ghana,Georgia,0,5,0,5
23285,2021,India,Georgia,0,9,0,9
23286,2021,Iran (Islamic Rep. of),Georgia,44,472,0,516
23287,2021,Iraq,Georgia,401,45,0,446
23288,2021,Jordan,Georgia,0,77,0,77
23289,2021,Kazakhstan,Georgia,5,12,0,17
23290,2021,Lebanon,Georgia,10,37,0,47
23291,2021,Sri Lanka,Georgia,0,5,0,5
23292,2021,Morocco,Georgia,0,5,0,5
23293,2021,Nigeria,Georgia,0,35,0,35
23294,2021,Pakistan,Georgia,11,10,0,21
23295,2021,South Africa,Georgia,0,5,0,5
23296,2021,Russian Federation,Georgia,223,81,0,304
23297,2021,Saudi Arabia,Georgia,0,6,0,6
23298,2021,Somalia,Georgia,5,10,0,15
23299,2021,Sudan,Georgia,6,7,0,13
23300,2021,Syrian Arab Rep.,Georgia,444,18,0,462
23301,2021,Thailand,Georgia,0,5,0,5
23302,2021,Tajikistan,Georgia,5,7,0,12
23303,2021,Turkmenistan,Georgia,0,6,0,6
23304,2021,Türkiye,Georgia,0,147,0,147
23305,2021,Ukraine,Georgia,481,0,0,481
23306,2021,Yemen,Georgia,55,20,0,75
23307,2021,Stateless,Georgia,0,0,0,0
23308,2021,Unknown ,Georgia,28,23,0,51
23309,2021,Afghanistan,Germany,159409,43964,0,203373
23310,2021,Albania,Germany,1274,1676,0,2950
23311,2021,Algeria,Germany,630,1223,0,1853
23312,2021,Angola,Germany,835,401,0,1236
23313,2021,Egypt,Germany,2259,1179,0,3438
23314,2021,Argentina,Germany,14,19,0,33
23315,2021,Armenia,Germany,2744,1896,0,4640
23316,2021,Australia,Germany,6,0,0,6
23317,2021,Austria,Germany,5,0,0,5
23318,2021,Azerbaijan,Germany,3878,2468,0,6346
23319,2021,Bahrain,Germany,74,5,0,79
23320,2021,Burundi,Germany,145,54,0,199
23321,2021,Belgium,Germany,7,0,0,7
23322,2021,Benin,Germany,107,125,0,232
23323,2021,Bangladesh,Germany,816,361,0,1177
23324,2021,Bhutan,Germany,21,0,0,21
23325,2021,Burkina Faso,Germany,106,158,0,264
23326,2021,Belarus,Germany,195,312,0,507
23327,2021,Bolivia (Plurinational State of),Germany,6,6,0,12
23328,2021,Botswana,Germany,7,0,0,7
23329,2021,Brazil,Germany,36,46,0,82
23330,2021,Bosnia and Herzegovina,Germany,1316,1000,0,2316
23331,2021,Bulgaria,Germany,70,5,0,75
23332,2021,Cambodia,Germany,30,46,0,76
23333,2021,Canada,Germany,24,0,0,24
23334,2021,Central African Rep.,Germany,51,15,0,66
23335,2021,Chad,Germany,123,202,0,325
23336,2021,China,Germany,2019,379,0,2398
23337,2021,Chile,Germany,156,5,0,161
23338,2021,Cameroon,Germany,927,1642,0,2569
23339,2021,Congo,Germany,285,57,0,342
23340,2021,Dem. Rep. of the Congo,Germany,1761,541,0,2302
23341,2021,Comoros,Germany,0,13,0,13
23342,2021,Colombia,Germany,79,880,0,959
23343,2021,Cuba,Germany,84,46,0,130
23344,2021,Cabo Verde,Germany,0,5,0,5
23345,2021,Czechia,Germany,404,5,0,409
23346,2021,Djibouti,Germany,38,14,0,52
23347,2021,Dominica,Germany,5,0,0,5
23348,2021,Dominican Rep.,Germany,8,5,0,13
23349,2021,Ecuador,Germany,12,5,0,17
23350,2021,Equatorial Guinea,Germany,27,5,0,32
23351,2021,Eritrea,Germany,63128,3038,0,66166
23352,2021,Ethiopia,Germany,6508,3388,0,9896
23353,2021,France,Germany,13,0,0,13
23354,2021,Gabon,Germany,15,28,0,43
23355,2021,Gambia,Germany,1369,1300,0,2669
23356,2021,Palestinian,Germany,2025,905,0,2930
23357,2021,United Kingdom of Great Britain and Northern Ireland,Germany,22,10,0,32
23358,2021,Georgia,Germany,711,4285,0,4996
23359,2021,Ghana,Germany,678,782,0,1460
23360,2021,Guinea-Bissau,Germany,125,93,0,218
23361,2021,Greece,Germany,44,5,0,49
23362,2021,Guatemala,Germany,5,9,0,14
23363,2021,Guinea,Germany,4054,3160,0,7214
23364,2021,Haiti,Germany,14,23,0,37
23365,2021,Honduras,Germany,80,75,0,155
23366,2021,Croatia,Germany,265,5,0,270
23367,2021,Hungary,Germany,223,5,0,228
23368,2021,Cote d'Ivoire,Germany,760,1116,0,1876
23369,2021,India,Germany,414,566,0,980
23370,2021,Indonesia,Germany,16,7,0,23
23371,2021,Iran (Islamic Rep. of),Germany,46223,14128,0,60351
23372,2021,Iraq,Germany,147869,29206,0,177075
23373,2021,Israel,Germany,31,19,0,50
23374,2021,Italy,Germany,31,0,0,31
23375,2021,Jamaica,Germany,72,42,0,114
23376,2021,Jordan,Germany,496,405,0,901
23377,2021,Japan,Germany,23,5,0,28
23378,2021,Kazakhstan,Germany,112,157,0,269
23379,2021,Kenya,Germany,163,543,0,706
23380,2021,Kyrgyzstan,Germany,248,130,0,378
23381,2021,Rep. of Korea,Germany,22,5,0,27
23382,2021,Dem. People's Rep. of Korea,Germany,89,5,0,94
23383,2021,Kuwait,Germany,48,58,0,106
23384,2021,Lao People's Dem. Rep.,Germany,40,0,0,40
23385,2021,Liberia,Germany,135,289,0,424
23386,2021,Libya,Germany,2687,983,0,3670
23387,2021,Lebanon,Germany,1872,1836,0,3708
23388,2021,Sri Lanka,Germany,3591,487,0,4078
23389,2021,Lithuania,Germany,5,0,0,5
23390,2021,Latvia,Germany,6,0,0,6
23391,2021,Madagascar,Germany,5,9,0,14
23392,2021,Mauritania,Germany,65,74,0,139
23393,2021,North Macedonia,Germany,607,3007,0,3614
23394,2021,Rep. of Moldova,Germany,129,2364,0,2493
23395,2021,Mexico,Germany,24,7,0,31
23396,2021,Mali,Germany,392,364,0,756
23397,2021,Malaysia,Germany,19,10,0,29
23398,2021,Malawi,Germany,7,5,0,12
23399,2021,Mongolia,Germany,235,204,0,439
23400,2021,Morocco,Germany,866,1156,0,2022
23401,2021,Mozambique,Germany,13,32,0,45
23402,2021,Montenegro,Germany,212,207,0,419
23403,2021,Mauritius,Germany,5,5,0,10
23404,2021,Myanmar,Germany,890,472,0,1362
23405,2021,Namibia,Germany,0,47,0,47
23406,2021,Nepal,Germany,61,23,0,84
23407,2021,Netherlands,Germany,31,5,0,36
23408,2021,Niger,Germany,60,93,0,153
23409,2021,Nicaragua,Germany,5,202,0,207
23410,2021,Nigeria,Germany,10023,11392,0,21415
23411,2021,Norway,Germany,0,10,0,10
23412,2021,New Zealand,Germany,7,0,0,7
23413,2021,Oman,Germany,8,10,0,18
23414,2021,Pakistan,Germany,8788,4457,0,13245
23415,2021,Panama,Germany,0,5,0,5
23416,2021,Paraguay,Germany,5,9,0,14
23417,2021,Peru,Germany,31,12,0,43
23418,2021,Philippines,Germany,37,24,0,61
23419,2021,Poland,Germany,573,0,0,573
23420,2021,Portugal,Germany,6,0,0,6
23421,2021,Qatar,Germany,5,0,0,5
23422,2021,Romania,Germany,129,10,0,139
23423,2021,South Africa,Germany,20,54,0,74
23424,2021,Russian Federation,Germany,9584,10362,0,19946
23425,2021,Rwanda,Germany,324,447,0,771
23426,2021,El Salvador,Germany,143,65,0,208
23427,2021,Saudi Arabia,Germany,175,23,0,198
23428,2021,Serbia and Kosovo: S/RES/1244 (1999),Germany,6387,2182,0,8569
23429,2021,Senegal,Germany,202,318,0,520
23430,2021,Singapore,Germany,7,5,0,12
23431,2021,Sierra Leone,Germany,825,622,0,1447
23432,2021,Solomon Islands,Germany,6,0,0,6
23433,2021,Somalia,Germany,30283,5913,0,36196
23434,2021,Spain,Germany,21,12,0,33
23435,2021,Viet Nam,Germany,1096,276,0,1372
23436,2021,Sudan,Germany,2909,941,0,3850
23437,2021,South Sudan,Germany,249,72,0,321
23438,2021,Slovakia,Germany,72,0,0,72
23439,2021,Slovenia,Germany,6,0,0,6
23440,2021,Eswatini,Germany,5,5,0,10
23441,2021,Sweden,Germany,9,0,0,9
23442,2021,Syrian Arab Rep.,Germany,621740,53750,0,675490
23443,2021,United Rep. of Tanzania,Germany,79,286,0,365
23444,2021,Thailand,Germany,27,14,0,41
23445,2021,Tajikistan,Germany,1178,809,0,1987
23446,2021,Turkmenistan,Germany,90,119,0,209
23447,2021,Togo,Germany,986,400,0,1386
23448,2021,Trinidad and Tobago,Germany,7,5,0,12
23449,2021,Tunisia,Germany,251,784,0,1035
23450,2021,Türkiye,Germany,35953,14831,0,50784
23451,2021,United Arab Emirates,Germany,33,0,0,33
23452,2021,Uganda,Germany,247,337,0,584
23453,2021,Ukraine,Germany,918,1328,0,2246
23454,2021,United States of America,Germany,125,23,0,148
23455,2021,Uzbekistan,Germany,154,69,0,223
23456,2021,Saint Vincent and the Grenadines,Germany,5,0,0,5
23457,2021,Venezuela (Bolivarian Republic of),Germany,1113,728,0,1841
23458,2021,Yemen,Germany,3082,1173,0,4255
23459,2021,Zambia,Germany,5,9,0,14
23460,2021,Zimbabwe,Germany,312,211,0,523
23461,2021,Stateless,Germany,11901,841,0,12742
23462,2021,Unknown ,Germany,37702,6777,0,44479
23463,2021,Egypt,Ghana,0,16,0,16
23464,2021,Burundi,Ghana,14,15,0,29
23465,2021,Benin,Ghana,11,5,0,16
23466,2021,Central African Rep.,Ghana,149,93,0,242
23467,2021,Chad,Ghana,38,21,0,59
23468,2021,Cameroon,Ghana,270,270,0,540
23469,2021,Congo,Ghana,7,5,0,12
23470,2021,Dem. Rep. of the Congo,Ghana,59,19,0,78
23471,2021,Eritrea,Ghana,102,78,0,180
23472,2021,Ethiopia,Ghana,8,6,0,14
23473,2021,Palestinian,Ghana,18,10,0,28
23474,2021,Cote d'Ivoire,Ghana,5968,988,0,6956
23475,2021,Iraq,Ghana,12,5,0,17
23476,2021,Liberia,Ghana,661,0,0,661
23477,2021,Libya,Ghana,7,6,0,13
23478,2021,Lebanon,Ghana,8,0,0,8
23479,2021,Mali,Ghana,0,5,0,5
23480,2021,Nigeria,Ghana,9,11,0,20
23481,2021,Pakistan,Ghana,60,5,0,65
23482,2021,Rwanda,Ghana,29,5,0,34
23483,2021,Sierra Leone,Ghana,87,20,0,107
23484,2021,Somalia,Ghana,67,29,0,96
23485,2021,Sudan,Ghana,584,109,0,693
23486,2021,South Sudan,Ghana,7,5,0,12
23487,2021,Syrian Arab Rep.,Ghana,229,70,0,299
23488,2021,Togo,Ghana,3407,69,0,3476
23489,2021,Türkiye,Ghana,52,9,0,61
23490,2021,Uganda,Ghana,9,0,0,9
23491,2021,Uzbekistan,Ghana,9,0,0,9
23492,2021,Yemen,Ghana,13,5,0,18
23493,2021,Burundi,Guinea-Bissau,5,0,0,5
23494,2021,Cote d'Ivoire,Guinea-Bissau,6,6,0,12
23495,2021,Liberia,Guinea-Bissau,7,0,0,7
23496,2021,Nigeria,Guinea-Bissau,0,6,0,6
23497,2021,Senegal,Guinea-Bissau,1818,8,0,1826
23498,2021,Sierra Leone,Guinea-Bissau,10,5,0,15
23499,2021,Türkiye,Guinea-Bissau,0,5,0,5
23500,2021,Afghanistan,Greece,28543,9142,0,37685
23501,2021,Albania,Greece,182,917,0,1099
23502,2021,Algeria,Greece,132,132,0,264
23503,2021,Angola,Greece,16,64,0,80
23504,2021,Egypt,Greece,418,1561,0,1979
23505,2021,Armenia,Greece,12,45,0,57
23506,2021,Azerbaijan,Greece,5,0,0,5
23507,2021,Burundi,Greece,73,23,0,96
23508,2021,Benin,Greece,0,5,0,5
23509,2021,Bangladesh,Greece,328,3564,0,3892
23510,2021,Burkina Faso,Greece,40,35,0,75
23511,2021,Belarus,Greece,5,5,0,10
23512,2021,Brazil,Greece,0,6,0,6
23513,2021,Bosnia and Herzegovina,Greece,0,5,0,5
23514,2021,Central African Rep.,Greece,20,5,0,25
23515,2021,Chad,Greece,11,0,0,11
23516,2021,China,Greece,114,222,0,336
23517,2021,Cameroon,Greece,929,529,0,1458
23518,2021,Congo,Greece,162,53,0,215
23519,2021,Dem. Rep. of the Congo,Greece,1994,2555,0,4549
23520,2021,Comoros,Greece,7,33,0,40
23521,2021,Colombia,Greece,0,5,0,5
23522,2021,Cuba,Greece,7,79,0,86
23523,2021,Djibouti,Greece,12,8,0,20
23524,2021,Dominican Rep.,Greece,10,5,0,15
23525,2021,Ecuador,Greece,0,5,0,5
23526,2021,Equatorial Guinea,Greece,5,0,0,5
23527,2021,Eritrea,Greece,1354,182,0,1536
23528,2021,Ethiopia,Greece,501,42,0,543
23529,2021,Gabon,Greece,5,9,0,14
23530,2021,Gambia,Greece,99,77,0,176
23531,2021,Palestinian,Greece,5508,385,0,5893
23532,2021,Georgia,Greece,262,705,0,967
23533,2021,Ghana,Greece,89,277,0,366
23534,2021,Guinea,Greece,192,109,0,301
23535,2021,Haiti,Greece,38,14,0,52
23536,2021,Cote d'Ivoire,Greece,105,38,0,143
23537,2021,India,Greece,40,333,0,373
23538,2021,Indonesia,Greece,14,17,0,31
23539,2021,Iran (Islamic Rep. of),Greece,3201,971,0,4172
23540,2021,Iraq,Greece,13634,1646,0,15280
23541,2021,Jordan,Greece,44,0,0,44
23542,2021,Kazakhstan,Greece,5,0,0,5
23543,2021,Kenya,Greece,30,10,0,40
23544,2021,Kyrgyzstan,Greece,0,5,0,5
23545,2021,Kuwait,Greece,153,21,0,174
23546,2021,Liberia,Greece,5,0,0,5
23547,2021,Libya,Greece,65,19,0,84
23548,2021,Lebanon,Greece,84,26,0,110
23549,2021,Sri Lanka,Greece,55,43,0,98
23550,2021,Mauritania,Greece,68,0,0,68
23551,2021,North Macedonia,Greece,0,5,0,5
23552,2021,Rep. of Moldova,Greece,13,63,0,76
23553,2021,Mali,Greece,145,59,0,204
23554,2021,Morocco,Greece,230,117,0,347
23555,2021,Myanmar,Greece,100,7,0,107
23556,2021,Nepal,Greece,28,88,0,116
23557,2021,Niger,Greece,19,6,0,25
23558,2021,Nigeria,Greece,374,158,0,532
23559,2021,Pakistan,Greece,1279,3790,0,5069
23560,2021,Philippines,Greece,7,5,0,12
23561,2021,Russian Federation,Greece,21,35,0,56
23562,2021,Rwanda,Greece,10,0,0,10
23563,2021,El Salvador,Greece,12,0,0,12
23564,2021,Saudi Arabia,Greece,8,0,0,8
23565,2021,Serbia and Kosovo: S/RES/1244 (1999),Greece,23,6,0,29
23566,2021,Senegal,Greece,63,41,0,104
23567,2021,Sierra Leone,Greece,206,111,0,317
23568,2021,Somalia,Greece,4131,1292,0,5423
23569,2021,Viet Nam,Greece,5,5,0,10
23570,2021,Sudan,Greece,561,53,0,614
23571,2021,South Sudan,Greece,50,9,0,59
23572,2021,Syrian Arab Rep.,Greece,39372,3933,0,43305
23573,2021,United Rep. of Tanzania,Greece,13,5,0,18
23574,2021,Tajikistan,Greece,5,6,0,11
23575,2021,Turkmenistan,Greece,7,5,0,12
23576,2021,Togo,Greece,88,87,0,175
23577,2021,Tunisia,Greece,28,19,0,47
23578,2021,Türkiye,Greece,1219,2983,0,4202
23579,2021,Uganda,Greece,71,42,0,113
23580,2021,Ukraine,Greece,169,99,0,268
23581,2021,Uzbekistan,Greece,12,0,0,12
23582,2021,Venezuela (Bolivarian Republic of),Greece,14,5,0,19
23583,2021,Western Sahara,Greece,10,0,0,10
23584,2021,Yemen,Greece,933,26,0,959
23585,2021,Zimbabwe,Greece,13,5,0,18
23586,2021,Stateless,Greece,785,50,0,835
23587,2021,Unknown ,Greece,11050,0,0,11050
23588,2021,Venezuela (Bolivarian Republic of),Grenada,0,0,0,0
23589,2021,Belize,Guatemala,0,5,0,5
23590,2021,Colombia,Guatemala,10,16,0,26
23591,2021,Cuba,Guatemala,8,22,0,30
23592,2021,Guatemala,Guatemala,0,0,0,0
23593,2021,Haiti,Guatemala,0,0,0,0
23594,2021,Honduras,Guatemala,72,574,0,646
23595,2021,Sri Lanka,Guatemala,0,5,0,5
23596,2021,Mexico,Guatemala,0,11,0,11
23597,2021,Nicaragua,Guatemala,70,221,0,291
23598,2021,Panama,Guatemala,0,5,0,5
23599,2021,Russian Federation,Guatemala,5,0,0,5
23600,2021,El Salvador,Guatemala,278,485,0,763
23601,2021,Venezuela (Bolivarian Republic of),Guatemala,36,126,0,162
23602,2021,Burundi,Guinea,6,0,0,6
23603,2021,Central African Rep.,Guinea,30,0,0,30
23604,2021,Cameroon,Guinea,5,0,0,5
23605,2021,Congo,Guinea,8,0,0,8
23606,2021,Dem. Rep. of the Congo,Guinea,58,0,0,58
23607,2021,Eritrea,Guinea,14,0,0,14
23608,2021,Gambia,Guinea,5,0,0,5
23609,2021,Guinea,Guinea,0,0,0,0
23610,2021,Cote d'Ivoire,Guinea,3559,200,0,3759
23611,2021,Liberia,Guinea,338,20,0,358
23612,2021,Sri Lanka,Guinea,10,0,0,10
23613,2021,Mali,Guinea,9,0,0,9
23614,2021,Nigeria,Guinea,10,0,0,10
23615,2021,Rwanda,Guinea,10,0,0,10
23616,2021,Sierra Leone,Guinea,1651,33,0,1684
23617,2021,Somalia,Guinea,6,0,0,6
23618,2021,Syrian Arab Rep.,Guinea,14,0,0,14
23619,2021,Togo,Guinea,8,0,0,8
23620,2021,Cameroon,Guyana,0,5,0,5
23621,2021,Cuba,Guyana,40,78,0,118
23622,2021,Guyana,Guyana,0,0,0,0
23623,2021,Haiti,Guyana,0,11,0,11
23624,2021,Venezuela (Bolivarian Republic of),Guyana,0,0,0,0
23625,2021,Afghanistan,"China, Hong Kong SAR",11,0,0,11
23626,2021,Egypt,"China, Hong Kong SAR",13,0,0,13
23627,2021,Burundi,"China, Hong Kong SAR",12,0,0,12
23628,2021,Bangladesh,"China, Hong Kong SAR",13,0,0,13
23629,2021,Central African Rep.,"China, Hong Kong SAR",5,0,0,5
23630,2021,Cameroon,"China, Hong Kong SAR",5,0,0,5
23631,2021,Dem. Rep. of the Congo,"China, Hong Kong SAR",5,0,0,5
23632,2021,Ethiopia,"China, Hong Kong SAR",7,0,0,7
23633,2021,Palestinian,"China, Hong Kong SAR",5,0,0,5
23634,2021,Indonesia,"China, Hong Kong SAR",12,0,0,12
23635,2021,Sri Lanka,"China, Hong Kong SAR",20,0,0,20
23636,2021,Nepal,"China, Hong Kong SAR",8,0,0,8
23637,2021,Pakistan,"China, Hong Kong SAR",25,0,0,25
23638,2021,Philippines,"China, Hong Kong SAR",8,0,0,8
23639,2021,Rwanda,"China, Hong Kong SAR",35,0,0,35
23640,2021,Somalia,"China, Hong Kong SAR",36,0,0,36
23641,2021,Sudan,"China, Hong Kong SAR",5,0,0,5
23642,2021,Uganda,"China, Hong Kong SAR",5,0,0,5
23643,2021,Yemen,"China, Hong Kong SAR",36,0,0,36
23644,2021,Zimbabwe,"China, Hong Kong SAR",5,0,0,5
23645,2021,Cuba,Honduras,0,0,0,0
23646,2021,Haiti,Honduras,0,10,0,10
23647,2021,Honduras,Honduras,0,0,247090,0
23648,2021,Mexico,Honduras,0,5,0,5
23649,2021,Nicaragua,Honduras,113,68,0,181
23650,2021,El Salvador,Honduras,22,0,0,22
23651,2021,Venezuela (Bolivarian Republic of),Honduras,9,16,0,25
23652,2021,Unknown ,Honduras,0,0,0,0
23653,2021,Afghanistan,Croatia,93,397,0,490
23654,2021,Egypt,Croatia,8,0,0,8
23655,2021,Azerbaijan,Croatia,5,0,0,5
23656,2021,Bangladesh,Croatia,7,6,0,13
23657,2021,Belarus,Croatia,5,0,0,5
23658,2021,China,Croatia,0,0,0,0
23659,2021,Cameroon,Croatia,5,0,0,5
23660,2021,Congo,Croatia,5,0,0,5
23661,2021,Dem. Rep. of the Congo,Croatia,7,0,0,7
23662,2021,Cuba,Croatia,0,11,0,11
23663,2021,Eritrea,Croatia,24,0,0,24
23664,2021,Gambia,Croatia,0,0,0,0
23665,2021,Georgia,Croatia,5,0,0,5
23666,2021,Croatia,Croatia,0,0,0,0
23667,2021,Iran (Islamic Rep. of),Croatia,41,43,0,84
23668,2021,Iraq,Croatia,119,18,0,137
23669,2021,Kazakhstan,Croatia,5,0,0,5
23670,2021,Libya,Croatia,5,0,0,5
23671,2021,Mauritania,Croatia,5,0,0,5
23672,2021,Montenegro,Croatia,0,5,0,5
23673,2021,Nigeria,Croatia,12,0,0,12
23674,2021,Pakistan,Croatia,10,20,0,30
23675,2021,Russian Federation,Croatia,15,6,0,21
23676,2021,Serbia and Kosovo: S/RES/1244 (1999),Croatia,5,0,0,5
23677,2021,Somalia,Croatia,29,0,0,29
23678,2021,Sudan,Croatia,5,0,0,5
23679,2021,Syrian Arab Rep.,Croatia,548,12,0,560
23680,2021,Türkiye,Croatia,26,39,0,65
23681,2021,Ukraine,Croatia,8,0,0,8
23682,2021,United States of America,Croatia,0,5,0,5
23683,2021,Uzbekistan,Croatia,5,0,0,5
23684,2021,Yemen,Croatia,7,0,0,7
23685,2021,Stateless,Croatia,11,0,0,11
23686,2021,Afghanistan,Hungary,1467,0,0,1467
23687,2021,Algeria,Hungary,14,0,0,14
23688,2021,Angola,Hungary,5,0,0,5
23689,2021,Egypt,Hungary,11,0,0,11
23690,2021,Armenia,Hungary,39,0,0,39
23691,2021,Azerbaijan,Hungary,12,0,0,12
23692,2021,Bangladesh,Hungary,11,0,0,11
23693,2021,China,Hungary,5,0,0,5
23694,2021,Cameroon,Hungary,43,0,0,43
23695,2021,Congo,Hungary,15,0,0,15
23696,2021,Dem. Rep. of the Congo,Hungary,25,0,0,25
23697,2021,Cuba,Hungary,76,0,0,76
23698,2021,Eritrea,Hungary,47,0,0,47
23699,2021,Ethiopia,Hungary,43,0,0,43
23700,2021,Palestinian,Hungary,87,0,0,87
23701,2021,Georgia,Hungary,59,0,0,59
23702,2021,Ghana,Hungary,5,0,0,5
23703,2021,Guinea,Hungary,5,0,0,5
23704,2021,Cote d'Ivoire,Hungary,15,0,0,15
23705,2021,Iran (Islamic Rep. of),Hungary,193,5,0,198
23706,2021,Iraq,Hungary,608,0,0,608
23707,2021,Libya,Hungary,7,0,0,7
23708,2021,Lebanon,Hungary,5,0,0,5
23709,2021,Sri Lanka,Hungary,11,0,0,11
23710,2021,Rep. of Moldova,Hungary,5,0,0,5
23711,2021,Nepal,Hungary,10,0,0,10
23712,2021,Nigeria,Hungary,53,0,0,53
23713,2021,Pakistan,Hungary,92,0,0,92
23714,2021,Russian Federation,Hungary,37,0,0,37
23715,2021,Serbia and Kosovo: S/RES/1244 (1999),Hungary,41,0,0,41
23716,2021,Sierra Leone,Hungary,5,0,0,5
23717,2021,Somalia,Hungary,606,0,0,606
23718,2021,Sudan,Hungary,65,0,0,65
23719,2021,Syrian Arab Rep.,Hungary,869,0,0,869
23720,2021,Tunisia,Hungary,7,0,0,7
23721,2021,Türkiye,Hungary,33,0,0,33
23722,2021,Uganda,Hungary,7,0,0,7
23723,2021,Ukraine,Hungary,13,0,0,13
23724,2021,Uzbekistan,Hungary,6,0,0,6
23725,2021,Yemen,Hungary,16,0,0,16
23726,2021,Zimbabwe,Hungary,5,0,0,5
23727,2021,Stateless,Hungary,64,0,0,64
23728,2021,Unknown ,Hungary,934,0,0,934
23729,2021,Afghanistan,Iceland,179,18,0,197
23730,2021,Albania,Iceland,5,5,0,10
23731,2021,Egypt,Iceland,10,0,0,10
23732,2021,Azerbaijan,Iceland,5,0,0,5
23733,2021,Bangladesh,Iceland,5,0,0,5
23734,2021,Belarus,Iceland,0,5,0,5
23735,2021,Chad,Iceland,5,0,0,5
23736,2021,China,Iceland,5,0,0,5
23737,2021,Cameroon,Iceland,5,0,0,5
23738,2021,Dem. Rep. of the Congo,Iceland,5,0,0,5
23739,2021,Colombia,Iceland,0,11,0,11
23740,2021,Eritrea,Iceland,9,0,0,9
23741,2021,Ethiopia,Iceland,6,6,0,12
23742,2021,Palestinian,Iceland,133,14,0,147
23743,2021,Georgia,Iceland,5,0,0,5
23744,2021,Ghana,Iceland,5,0,0,5
23745,2021,Honduras,Iceland,12,0,0,12
23746,2021,Cote d'Ivoire,Iceland,5,0,0,5
23747,2021,Iran (Islamic Rep. of),Iceland,95,0,0,95
23748,2021,Iraq,Iceland,314,26,0,340
23749,2021,Kazakhstan,Iceland,5,0,0,5
23750,2021,Kenya,Iceland,5,0,0,5
23751,2021,Libya,Iceland,13,0,0,13
23752,2021,Sri Lanka,Iceland,5,0,0,5
23753,2021,North Macedonia,Iceland,5,0,0,5
23754,2021,Mali,Iceland,5,0,0,5
23755,2021,Morocco,Iceland,8,0,0,8
23756,2021,Mozambique,Iceland,5,0,0,5
23757,2021,Nigeria,Iceland,65,5,0,70
23758,2021,Pakistan,Iceland,22,0,0,22
23759,2021,Peru,Iceland,5,0,0,5
23760,2021,Russian Federation,Iceland,20,0,0,20
23761,2021,El Salvador,Iceland,20,0,0,20
23762,2021,Senegal,Iceland,5,0,0,5
23763,2021,Somalia,Iceland,97,10,0,107
23764,2021,Sudan,Iceland,7,0,0,7
23765,2021,South Sudan,Iceland,5,0,0,5
23766,2021,Syrian Arab Rep.,Iceland,195,16,0,211
23767,2021,Tajikistan,Iceland,5,0,0,5
23768,2021,Tunisia,Iceland,5,0,0,5
23769,2021,Türkiye,Iceland,10,0,0,10
23770,2021,Uganda,Iceland,17,0,0,17
23771,2021,Ukraine,Iceland,20,0,0,20
23772,2021,Venezuela (Bolivarian Republic of),Iceland,429,190,0,619
23773,2021,Yemen,Iceland,12,0,0,12
23774,2021,Stateless,Iceland,20,0,0,20
23775,2021,Unknown ,Iceland,12,0,0,12
23776,2021,Egypt,Cote d'Ivoire,5,0,0,5
23777,2021,Burundi,Cote d'Ivoire,34,0,0,34
23778,2021,Benin,Cote d'Ivoire,0,7,0,7
23779,2021,Burkina Faso,Cote d'Ivoire,2127,0,0,2127
23780,2021,Cambodia,Cote d'Ivoire,8,0,0,8
23781,2021,Central African Rep.,Cote d'Ivoire,550,25,0,575
23782,2021,Chad,Cote d'Ivoire,5,0,0,5
23783,2021,Cameroon,Cote d'Ivoire,6,10,0,16
23784,2021,Congo,Cote d'Ivoire,82,7,0,89
23785,2021,Dem. Rep. of the Congo,Cote d'Ivoire,122,18,0,140
23786,2021,Eritrea,Cote d'Ivoire,8,0,0,8
23787,2021,Ethiopia,Cote d'Ivoire,5,5,0,10
23788,2021,Guinea,Cote d'Ivoire,0,5,0,5
23789,2021,Cote d'Ivoire,Cote d'Ivoire,0,0,0,0
23790,2021,Iran (Islamic Rep. of),Cote d'Ivoire,7,0,0,7
23791,2021,Iraq,Cote d'Ivoire,5,0,0,5
23792,2021,Liberia,Cote d'Ivoire,1071,21,0,1092
23793,2021,Lebanon,Cote d'Ivoire,5,0,0,5
23794,2021,Mauritania,Cote d'Ivoire,5,5,0,10
23795,2021,Mali,Cote d'Ivoire,25,5,0,30
23796,2021,Nigeria,Cote d'Ivoire,6,0,0,6
23797,2021,Rwanda,Cote d'Ivoire,49,5,0,54
23798,2021,Somalia,Cote d'Ivoire,5,0,0,5
23799,2021,Viet Nam,Cote d'Ivoire,5,0,0,5
23800,2021,Sudan,Cote d'Ivoire,9,0,0,9
23801,2021,Syrian Arab Rep.,Cote d'Ivoire,148,9,0,157
23802,2021,Togo,Cote d'Ivoire,18,7,0,25
23803,2021,Türkiye,Cote d'Ivoire,34,0,0,34
23804,2021,Yemen,Cote d'Ivoire,5,0,0,5
23805,2021,Stateless,Cote d'Ivoire,0,0,0,0
23806,2021,Afghanistan,India,9678,6569,0,16247
23807,2021,Egypt,India,0,10,0,10
23808,2021,Burundi,India,0,5,0,5
23809,2021,Bangladesh,India,8,0,0,8
23810,2021,China,India,73407,0,0,73407
23811,2021,Cameroon,India,17,207,0,224
23812,2021,Congo,India,8,36,0,44
23813,2021,Dem. Rep. of the Congo,India,54,127,0,181
23814,2021,Eritrea,India,13,10,0,23
23815,2021,Ethiopia,India,23,35,0,58
23816,2021,Palestinian,India,52,11,0,63
23817,2021,Ghana,India,0,69,0,69
23818,2021,Guinea,India,0,11,0,11
23819,2021,Cote d'Ivoire,India,5,176,0,181
23820,2021,Iran (Islamic Rep. of),India,58,44,0,102
23821,2021,Iraq,India,150,47,0,197
23822,2021,Kenya,India,0,35,0,35
23823,2021,Liberia,India,0,5,0,5
23824,2021,Libya,India,8,6,0,14
23825,2021,Sri Lanka,India,92431,0,0,92431
23826,2021,Maldives,India,5,0,0,5
23827,2021,Myanmar,India,35832,3785,0,39617
23828,2021,Nigeria,India,0,552,0,552
23829,2021,Russian Federation,India,0,15,0,15
23830,2021,Rwanda,India,5,10,0,15
23831,2021,Saudi Arabia,India,5,0,0,5
23832,2021,Senegal,India,0,28,0,28
23833,2021,Sierra Leone,India,0,8,0,8
23834,2021,Somalia,India,497,279,0,776
23835,2021,Sudan,India,61,144,0,205
23836,2021,South Sudan,India,5,100,0,105
23837,2021,Syrian Arab Rep.,India,69,64,0,133
23838,2021,United Rep. of Tanzania,India,0,13,0,13
23839,2021,Tajikistan,India,0,5,0,5
23840,2021,Turkmenistan,India,0,5,0,5
23841,2021,Türkiye,India,8,0,0,8
23842,2021,Uganda,India,0,38,0,38
23843,2021,Ukraine,India,0,5,0,5
23844,2021,Uzbekistan,India,0,10,0,10
23845,2021,Venezuela (Bolivarian Republic of),India,5,6,0,11
23846,2021,Yemen,India,9,898,0,907
23847,2021,Stateless,India,0,0,0,0
23848,2021,Afghanistan,Indonesia,5828,1610,0,7438
23849,2021,Angola,Indonesia,7,0,0,7
23850,2021,Egypt,Indonesia,18,15,0,33
23851,2021,China,Indonesia,11,5,0,16
23852,2021,Cameroon,Indonesia,0,17,0,17
23853,2021,Dem. Rep. of the Congo,Indonesia,10,0,0,10
23854,2021,Eritrea,Indonesia,133,123,0,256
23855,2021,Ethiopia,Indonesia,125,35,0,160
23856,2021,Palestinian,Indonesia,208,87,0,295
23857,2021,Cote d'Ivoire,Indonesia,0,5,0,5
23858,2021,Indonesia,Indonesia,0,0,0,0
23859,2021,Iran (Islamic Rep. of),Indonesia,300,21,0,321
23860,2021,Iraq,Indonesia,466,195,0,661
23861,2021,Kuwait,Indonesia,5,0,0,5
23862,2021,Liberia,Indonesia,0,5,0,5
23863,2021,Libya,Indonesia,14,5,0,19
23864,2021,Sri Lanka,Indonesia,407,31,0,438
23865,2021,Mali,Indonesia,0,5,0,5
23866,2021,Myanmar,Indonesia,480,202,0,682
23867,2021,Nigeria,Indonesia,0,5,0,5
23868,2021,Pakistan,Indonesia,281,16,0,297
23869,2021,Russian Federation,Indonesia,5,5,0,10
23870,2021,Saudi Arabia,Indonesia,0,6,0,6
23871,2021,Somalia,Indonesia,1146,210,0,1356
23872,2021,Viet Nam,Indonesia,15,0,0,15
23873,2021,Sudan,Indonesia,397,102,0,499
23874,2021,Syrian Arab Rep.,Indonesia,20,24,0,44
23875,2021,Türkiye,Indonesia,0,11,0,11
23876,2021,Uganda,Indonesia,5,22,0,27
23877,2021,Venezuela (Bolivarian Republic of),Indonesia,0,5,0,5
23878,2021,Yemen,Indonesia,101,349,0,450
23879,2021,Stateless,Indonesia,0,0,0,0
23880,2021,Afghanistan,Ireland,549,170,0,719
23881,2021,Albania,Ireland,206,413,0,619
23882,2021,Algeria,Ireland,68,301,0,369
23883,2021,Angola,Ireland,52,25,0,77
23884,2021,Egypt,Ireland,51,64,0,115
23885,2021,Armenia,Ireland,14,0,0,14
23886,2021,Azerbaijan,Ireland,5,0,0,5
23887,2021,Bahrain,Ireland,5,6,0,11
23888,2021,Burundi,Ireland,29,5,0,34
23889,2021,Benin,Ireland,5,0,0,5
23890,2021,Bangladesh,Ireland,101,192,0,293
23891,2021,Bhutan,Ireland,10,0,0,10
23892,2021,Belarus,Ireland,18,8,0,26
23893,2021,Bolivia (Plurinational State of),Ireland,23,41,0,64
23894,2021,Botswana,Ireland,11,88,0,99
23895,2021,Brazil,Ireland,22,148,0,170
23896,2021,Bosnia and Herzegovina,Ireland,5,0,0,5
23897,2021,Chad,Ireland,5,0,0,5
23898,2021,China,Ireland,71,60,0,131
23899,2021,Cameroon,Ireland,104,31,0,135
23900,2021,Congo,Ireland,15,5,0,20
23901,2021,Dem. Rep. of the Congo,Ireland,458,132,0,590
23902,2021,Colombia,Ireland,0,5,0,5
23903,2021,Cuba,Ireland,5,0,0,5
23904,2021,Eritrea,Ireland,96,15,0,111
23905,2021,Ethiopia,Ireland,58,23,0,81
23906,2021,Gambia,Ireland,0,6,0,6
23907,2021,Palestinian,Ireland,130,24,0,154
23908,2021,Georgia,Ireland,152,801,0,953
23909,2021,Ghana,Ireland,36,70,0,106
23910,2021,Guatemala,Ireland,5,10,0,15
23911,2021,Guinea,Ireland,17,12,0,29
23912,2021,Honduras,Ireland,0,6,0,6
23913,2021,Cote d'Ivoire,Ireland,15,9,0,24
23914,2021,India,Ireland,16,68,0,84
23915,2021,Indonesia,Ireland,5,0,0,5
23916,2021,Iran (Islamic Rep. of),Ireland,155,15,0,170
23917,2021,Iraq,Ireland,398,59,0,457
23918,2021,Israel,Ireland,12,9,0,21
23919,2021,Jordan,Ireland,7,16,0,23
23920,2021,Kazakhstan,Ireland,18,0,0,18
23921,2021,Kenya,Ireland,53,27,0,80
23922,2021,Kyrgyzstan,Ireland,5,0,0,5
23923,2021,Dem. People's Rep. of Korea,Ireland,9,0,0,9
23924,2021,Kuwait,Ireland,51,11,0,62
23925,2021,Liberia,Ireland,12,0,0,12
23926,2021,Libya,Ireland,236,8,0,244
23927,2021,Lebanon,Ireland,9,13,0,22
23928,2021,Lesotho,Ireland,0,7,0,7
23929,2021,Sri Lanka,Ireland,25,7,0,32
23930,2021,North Macedonia,Ireland,6,0,0,6
23931,2021,Rep. of Moldova,Ireland,51,0,0,51
23932,2021,Mexico,Ireland,9,10,0,19
23933,2021,Mali,Ireland,5,0,0,5
23934,2021,Malaysia,Ireland,9,18,0,27
23935,2021,Malawi,Ireland,142,125,0,267
23936,2021,Mongolia,Ireland,8,5,0,13
23937,2021,Morocco,Ireland,14,70,0,84
23938,2021,Mozambique,Ireland,5,0,0,5
23939,2021,Montenegro,Ireland,5,0,0,5
23940,2021,Mauritius,Ireland,21,24,0,45
23941,2021,Myanmar,Ireland,13,5,0,18
23942,2021,Nepal,Ireland,9,20,0,29
23943,2021,Niger,Ireland,5,0,0,5
23944,2021,Nicaragua,Ireland,11,15,0,26
23945,2021,Nigeria,Ireland,396,1021,0,1417
23946,2021,Pakistan,Ireland,391,479,0,870
23947,2021,South Africa,Ireland,163,475,0,638
23948,2021,Russian Federation,Ireland,83,15,0,98
23949,2021,Rwanda,Ireland,35,0,0,35
23950,2021,El Salvador,Ireland,34,42,0,76
23951,2021,Saudi Arabia,Ireland,20,0,0,20
23952,2021,Serbia and Kosovo: S/RES/1244 (1999),Ireland,55,31,0,86
23953,2021,Senegal,Ireland,5,5,0,10
23954,2021,Sierra Leone,Ireland,63,32,0,95
23955,2021,Somalia,Ireland,493,338,0,831
23956,2021,Viet Nam,Ireland,10,33,0,43
23957,2021,Sudan,Ireland,229,14,0,243
23958,2021,South Sudan,Ireland,5,0,0,5
23959,2021,Eswatini,Ireland,18,21,0,39
23960,2021,Syrian Arab Rep.,Ireland,2832,53,0,2885
23961,2021,United Rep. of Tanzania,Ireland,5,11,0,16
23962,2021,Turks and Caicos Islands,Ireland,0,5,0,5
23963,2021,Togo,Ireland,19,31,0,50
23964,2021,Tunisia,Ireland,6,5,0,11
23965,2021,Türkiye,Ireland,20,27,0,47
23966,2021,Uganda,Ireland,45,41,0,86
23967,2021,Ukraine,Ireland,79,15,0,94
23968,2021,United States of America,Ireland,0,21,0,21
23969,2021,Uzbekistan,Ireland,17,0,0,17
23970,2021,Venezuela (Bolivarian Republic of),Ireland,140,61,0,201
23971,2021,Yemen,Ireland,27,8,0,35
23972,2021,Zambia,Ireland,6,0,0,6
23973,2021,Zimbabwe,Ireland,703,539,0,1242
23974,2021,Stateless,Ireland,7,0,0,7
23975,2021,Unknown ,Ireland,0,379,0,379
23976,2021,Afghanistan,Iran (Islamic Rep. of),778054,0,0,778054
23977,2021,Iraq,Iran (Islamic Rep. of),20264,0,0,20264
23978,2021,Kuwait,Iran (Islamic Rep. of),8,0,0,8
23979,2021,Myanmar,Iran (Islamic Rep. of),0,34,0,34
23980,2021,Pakistan,Iran (Islamic Rep. of),10,0,0,10
23981,2021,Uzbekistan,Iran (Islamic Rep. of),7,0,0,7
23982,2021,Stateless,Iran (Islamic Rep. of),0,0,0,0
23983,2021,Afghanistan,Iraq,11,96,0,107
23984,2021,Egypt,Iraq,0,22,0,22
23985,2021,Bahrain,Iraq,0,25,0,25
23986,2021,Eritrea,Iraq,5,28,0,33
23987,2021,Ethiopia,Iraq,0,7,0,7
23988,2021,Palestinian,Iraq,7885,142,0,8027
23989,2021,Indonesia,Iraq,0,5,0,5
23990,2021,Iran (Islamic Rep. of),Iraq,4116,5851,0,9967
23991,2021,Iraq,Iraq,0,0,1186556,0
23992,2021,Kazakhstan,Iraq,0,5,0,5
23993,2021,Kyrgyzstan,Iraq,0,15,0,15
23994,2021,Kuwait,Iraq,0,301,0,301
23995,2021,Lebanon,Iraq,0,10,0,10
23996,2021,Pakistan,Iraq,0,33,0,33
23997,2021,Saudi Arabia,Iraq,0,6,0,6
23998,2021,Somalia,Iraq,6,5,0,11
23999,2021,Sudan,Iraq,92,692,0,784
24000,2021,South Sudan,Iraq,0,15,0,15
24001,2021,Syrian Arab Rep.,Iraq,254561,0,0,254561
24002,2021,Tunisia,Iraq,0,5,0,5
24003,2021,Türkiye,Iraq,13396,4080,0,17476
24004,2021,Yemen,Iraq,0,165,0,165
24005,2021,Stateless,Iraq,0,0,0,0
24006,2021,Albania,Israel,0,12,0,12
24007,2021,Armenia,Israel,0,31,0,31
24008,2021,Azerbaijan,Israel,0,39,0,39
24009,2021,Benin,Israel,0,5,0,5
24010,2021,Burkina Faso,Israel,0,6,0,6
24011,2021,Belarus,Israel,5,618,0,623
24012,2021,Bolivia (Plurinational State of),Israel,0,5,0,5
24013,2021,Botswana,Israel,0,5,0,5
24014,2021,Brazil,Israel,0,5,0,5
24015,2021,Cambodia,Israel,0,5,0,5
24016,2021,Central African Rep.,Israel,0,15,0,15
24017,2021,Chad,Israel,5,5,0,10
24018,2021,China,Israel,0,563,0,563
24019,2021,Cameroon,Israel,0,43,0,43
24020,2021,Congo,Israel,0,25,0,25
24021,2021,Dem. Rep. of the Congo,Israel,0,204,0,204
24022,2021,Colombia,Israel,0,189,0,189
24023,2021,Ecuador,Israel,0,21,0,21
24024,2021,Eritrea,Israel,221,11018,0,11239
24025,2021,Ethiopia,Israel,106,813,0,919
24026,2021,Georgia,Israel,5,204,0,209
24027,2021,Ghana,Israel,0,316,0,316
24028,2021,Honduras,Israel,0,7,0,7
24029,2021,Cote d'Ivoire,Israel,7,12,0,19
24030,2021,India,Israel,0,1116,0,1116
24031,2021,Iran (Islamic Rep. of),Israel,6,0,0,6
24032,2021,Iraq,Israel,10,0,0,10
24033,2021,Kazakhstan,Israel,0,105,0,105
24034,2021,Kenya,Israel,0,105,0,105
24035,2021,Kyrgyzstan,Israel,0,46,0,46
24036,2021,Dem. People's Rep. of Korea,Israel,5,0,0,5
24037,2021,Lesotho,Israel,0,6,0,6
24038,2021,Sri Lanka,Israel,0,957,0,957
24039,2021,North Macedonia,Israel,0,23,0,23
24040,2021,Rep. of Moldova,Israel,0,361,0,361
24041,2021,Mexico,Israel,0,5,0,5
24042,2021,Mali,Israel,0,5,0,5
24043,2021,Malawi,Israel,0,75,0,75
24044,2021,Mozambique,Israel,0,5,0,5
24045,2021,Montenegro,Israel,0,7,0,7
24046,2021,Myanmar,Israel,0,104,0,104
24047,2021,Nepal,Israel,0,81,0,81
24048,2021,Nigeria,Israel,8,877,0,885
24049,2021,Peru,Israel,0,9,0,9
24050,2021,Philippines,Israel,0,51,0,51
24051,2021,Romania,Israel,0,21,0,21
24052,2021,South Africa,Israel,0,391,0,391
24053,2021,Russian Federation,Israel,5,2537,0,2542
24054,2021,Rwanda,Israel,0,18,0,18
24055,2021,Serbia and Kosovo: S/RES/1244 (1999),Israel,0,81,0,81
24056,2021,Sierra Leone,Israel,5,12,0,17
24057,2021,Somalia,Israel,0,11,0,11
24058,2021,Viet Nam,Israel,0,9,0,9
24059,2021,Sudan,Israel,490,4391,0,4881
24060,2021,South Sudan,Israel,72,89,0,161
24061,2021,United Rep. of Tanzania,Israel,0,6,0,6
24062,2021,Thailand,Israel,0,19,0,19
24063,2021,Tajikistan,Israel,0,5,0,5
24064,2021,Turkmenistan,Israel,0,5,0,5
24065,2021,Togo,Israel,0,6,0,6
24066,2021,Türkiye,Israel,5,211,0,216
24067,2021,Uganda,Israel,0,203,0,203
24068,2021,Ukraine,Israel,27,544,0,571
24069,2021,Uzbekistan,Israel,0,349,0,349
24070,2021,Venezuela (Bolivarian Republic of),Israel,0,5,0,5
24071,2021,Zambia,Israel,0,5,0,5
24072,2021,Zimbabwe,Israel,0,19,0,19
24073,2021,Stateless,Israel,0,0,0,0
24074,2021,Unknown ,Israel,209,42,0,251
24075,2021,Afghanistan,Italy,15561,2375,0,17936
24076,2021,Albania,Italy,860,336,0,1196
24077,2021,Algeria,Italy,27,124,0,151
24078,2021,Angola,Italy,5,11,0,16
24079,2021,Egypt,Italy,868,2332,0,3200
24080,2021,Argentina,Italy,10,25,0,35
24081,2021,Armenia,Italy,213,119,0,332
24082,2021,Azerbaijan,Italy,6,24,0,30
24083,2021,Burundi,Italy,5,5,0,10
24084,2021,Benin,Italy,164,41,0,205
24085,2021,Bangladesh,Italy,5046,5416,0,10462
24086,2021,Burkina Faso,Italy,786,220,0,1006
24087,2021,Belarus,Italy,46,41,0,87
24088,2021,Bolivia (Plurinational State of),Italy,5,0,0,5
24089,2021,Brazil,Italy,342,170,0,512
24090,2021,Bosnia and Herzegovina,Italy,90,61,0,151
24091,2021,Central African Rep.,Italy,0,22,0,22
24092,2021,Chad,Italy,0,56,0,56
24093,2021,China,Italy,397,0,0,397
24094,2021,Chile,Italy,13,13,0,26
24095,2021,Cameroon,Italy,1687,384,0,2071
24096,2021,Congo,Italy,320,19,0,339
24097,2021,Dem. Rep. of the Congo,Italy,709,19,0,728
24098,2021,Comoros,Italy,0,5,0,5
24099,2021,Colombia,Italy,950,374,0,1324
24100,2021,Cuba,Italy,54,110,0,164
24101,2021,Cabo Verde,Italy,5,0,0,5
24102,2021,Dominican Rep.,Italy,12,12,0,24
24103,2021,Ecuador,Italy,11,23,0,34
24104,2021,Eritrea,Italy,3236,9330,0,12566
24105,2021,Ethiopia,Italy,969,75,0,1044
24106,2021,Gabon,Italy,0,6,0,6
24107,2021,Gambia,Italy,6056,691,0,6747
24108,2021,Palestinian,Italy,716,138,0,854
24109,2021,Georgia,Italy,623,1174,0,1797
24110,2021,Ghana,Italy,2704,403,0,3107
24111,2021,Guinea-Bissau,Italy,464,57,0,521
24112,2021,Guatemala,Italy,12,9,0,21
24113,2021,Guinea,Italy,2460,674,0,3134
24114,2021,"China, Hong Kong SAR",Italy,48,168,0,216
24115,2021,Honduras,Italy,464,48,0,512
24116,2021,Cote d'Ivoire,Italy,4182,1226,0,5408
24117,2021,India,Italy,252,337,0,589
24118,2021,Iran (Islamic Rep. of),Italy,1278,164,0,1442
24119,2021,Iraq,Italy,5311,1029,0,6340
24120,2021,Israel,Italy,0,5,0,5
24121,2021,Jordan,Italy,5,8,0,13
24122,2021,Kazakhstan,Italy,0,12,0,12
24123,2021,Kenya,Italy,16,11,0,27
24124,2021,Kyrgyzstan,Italy,5,6,0,11
24125,2021,Liberia,Italy,342,40,0,382
24126,2021,Libya,Italy,1141,241,0,1382
24127,2021,Lebanon,Italy,14,59,0,73
24128,2021,Liechtenstein,Italy,5,5,0,10
24129,2021,Sri Lanka,Italy,362,184,0,546
24130,2021,Madagascar,Italy,0,5,0,5
24131,2021,Mauritania,Italy,273,5,0,278
24132,2021,North Macedonia,Italy,15,63,0,78
24133,2021,Rep. of Moldova,Italy,36,104,0,140
24134,2021,Mexico,Italy,0,5,0,5
24135,2021,Mali,Italy,11375,1135,0,12510
24136,2021,Malaysia,Italy,0,5,0,5
24137,2021,Morocco,Italy,920,887,0,1807
24138,2021,Montenegro,Italy,13,10,0,23
24139,2021,Mauritius,Italy,5,9,0,14
24140,2021,Myanmar,Italy,5,9,0,14
24141,2021,Nepal,Italy,15,72,0,87
24142,2021,Niger,Italy,478,40,0,518
24143,2021,Nicaragua,Italy,9,5,0,14
24144,2021,Nigeria,Italy,20557,3983,0,24540
24145,2021,Pakistan,Italy,16570,9262,0,25832
24146,2021,Paraguay,Italy,0,9,0,9
24147,2021,Peru,Italy,669,470,0,1139
24148,2021,Philippines,Italy,17,43,0,60
24149,2021,South Africa,Italy,0,10,0,10
24150,2021,Russian Federation,Italy,248,83,0,331
24151,2021,El Salvador,Italy,3718,634,0,4352
24152,2021,Serbia and Kosovo: S/RES/1244 (1999),Italy,1373,321,0,1694
24153,2021,Senegal,Italy,4647,561,0,5208
24154,2021,Sierra Leone,Italy,438,100,0,538
24155,2021,Somalia,Italy,8151,973,0,9124
24156,2021,Sudan,Italy,1211,340,0,1551
24157,2021,South Sudan,Italy,0,15,0,15
24158,2021,Syrian Arab Rep.,Italy,3527,903,0,4430
24159,2021,United Rep. of Tanzania,Italy,0,7,0,7
24160,2021,Thailand,Italy,0,5,0,5
24161,2021,Turkmenistan,Italy,0,5,0,5
24162,2021,Togo,Italy,755,78,0,833
24163,2021,Tunisia,Italy,537,1103,0,1640
24164,2021,Türkiye,Italy,1610,378,0,1988
24165,2021,Uganda,Italy,7,0,0,7
24166,2021,Ukraine,Italy,3379,680,0,4059
24167,2021,Uruguay,Italy,5,5,0,10
24168,2021,United States of America,Italy,5,0,0,5
24169,2021,Venezuela (Bolivarian Republic of),Italy,2906,391,0,3297
24170,2021,Western Sahara,Italy,5,0,0,5
24171,2021,Yemen,Italy,0,42,0,42
24172,2021,Stateless,Italy,9,13,0,22
24173,2021,Unknown ,Italy,2517,574,0,3091
24174,2021,Haiti,Jamaica,31,5,0,36
24175,2021,Venezuela (Bolivarian Republic of),Jamaica,0,0,0,0
24176,2021,Afghanistan,Jordan,8,10,0,18
24177,2021,Algeria,Jordan,0,5,0,5
24178,2021,Egypt,Jordan,128,507,0,635
24179,2021,Bangladesh,Jordan,0,10,0,10
24180,2021,Bosnia and Herzegovina,Jordan,9,0,0,9
24181,2021,Bulgaria,Jordan,0,0,0,0
24182,2021,Central African Rep.,Jordan,7,0,0,7
24183,2021,Chad,Jordan,11,15,0,26
24184,2021,Comoros,Jordan,0,5,0,5
24185,2021,Eritrea,Jordan,38,5,0,43
24186,2021,Ethiopia,Jordan,19,21,0,40
24187,2021,Palestinian,Jordan,0,0,0,0
24188,2021,Ghana,Jordan,0,5,0,5
24189,2021,India,Jordan,0,5,0,5
24190,2021,Iran (Islamic Rep. of),Jordan,5,0,0,5
24191,2021,Iraq,Jordan,34204,32159,0,66363
24192,2021,Jordan,Jordan,0,0,0,0
24193,2021,Kenya,Jordan,5,5,0,10
24194,2021,Libya,Jordan,40,112,0,152
24195,2021,Lebanon,Jordan,5,105,0,110
24196,2021,Sri Lanka,Jordan,9,5,0,14
24197,2021,Morocco,Jordan,0,10,0,10
24198,2021,Niger,Jordan,0,5,0,5
24199,2021,Nigeria,Jordan,5,62,0,67
24200,2021,Pakistan,Jordan,5,22,0,27
24201,2021,Philippines,Jordan,5,0,0,5
24202,2021,Russian Federation,Jordan,24,7,0,31
24203,2021,Saudi Arabia,Jordan,0,0,0,0
24204,2021,Senegal,Jordan,0,5,0,5
24205,2021,Somalia,Jordan,601,55,0,656
24206,2021,Sudan,Jordan,3697,2196,0,5893
24207,2021,South Sudan,Jordan,11,8,0,19
24208,2021,Syrian Arab Rep.,Jordan,672952,0,0,672952
24209,2021,Tajikistan,Jordan,0,15,0,15
24210,2021,Tunisia,Jordan,11,8,0,19
24211,2021,Ukraine,Jordan,0,9,0,9
24212,2021,United States of America,Jordan,0,0,0,0
24213,2021,Venezuela (Bolivarian Republic of),Jordan,0,5,0,5
24214,2021,Yemen,Jordan,1024,11753,0,12777
24215,2021,Stateless,Jordan,0,63,0,63
24216,2021,Afghanistan,Japan,84,0,0,84
24217,2021,Burundi,Japan,9,0,0,9
24218,2021,Bangladesh,Japan,18,0,0,18
24219,2021,China,Japan,77,0,0,77
24220,2021,Cameroon,Japan,19,0,0,19
24221,2021,Dem. Rep. of the Congo,Japan,23,0,0,23
24222,2021,Ethiopia,Japan,32,0,0,32
24223,2021,Guinea,Japan,5,0,0,5
24224,2021,Iran (Islamic Rep. of),Japan,19,0,0,19
24225,2021,Iraq,Japan,17,0,0,17
24226,2021,Sri Lanka,Japan,59,0,0,59
24227,2021,Myanmar,Japan,583,0,0,583
24228,2021,Nigeria,Japan,5,0,0,5
24229,2021,Pakistan,Japan,34,0,0,34
24230,2021,Rwanda,Japan,5,0,0,5
24231,2021,Somalia,Japan,5,0,0,5
24232,2021,Sudan,Japan,16,0,0,16
24233,2021,Syrian Arab Rep.,Japan,93,0,0,93
24234,2021,Türkiye,Japan,46,0,0,46
24235,2021,Uganda,Japan,6,0,0,6
24236,2021,Yemen,Japan,15,0,0,15
24237,2021,Stateless,Japan,9,0,0,9
24238,2021,Unknown ,Japan,329,16709,0,17038
24239,2021,Afghanistan,Kazakhstan,327,287,0,614
24240,2021,China,Kazakhstan,6,7,0,13
24241,2021,Syrian Arab Rep.,Kazakhstan,14,11,0,25
24242,2021,Uzbekistan,Kazakhstan,5,0,0,5
24243,2021,Stateless,Kazakhstan,0,0,0,0
24244,2021,Afghanistan,Kenya,12,5,0,17
24245,2021,Egypt,Kenya,0,16,0,16
24246,2021,Burundi,Kenya,7203,11950,0,19153
24247,2021,Central African Rep.,Kenya,0,11,0,11
24248,2021,Chad,Kenya,0,5,0,5
24249,2021,Cameroon,Kenya,0,54,0,54
24250,2021,Congo,Kenya,93,79,0,172
24251,2021,Dem. Rep. of the Congo,Kenya,30411,17873,0,48284
24252,2021,Eritrea,Kenya,902,1298,0,2200
24253,2021,Ethiopia,Kenya,20647,9720,0,30367
24254,2021,Cote d'Ivoire,Kenya,0,5,0,5
24255,2021,India,Kenya,0,5,0,5
24256,2021,Iraq,Kenya,5,0,0,5
24257,2021,Kenya,Kenya,0,0,0,0
24258,2021,Sri Lanka,Kenya,9,0,0,9
24259,2021,Mozambique,Kenya,8,0,0,8
24260,2021,Nigeria,Kenya,6,9,0,15
24261,2021,Pakistan,Kenya,9,12,0,21
24262,2021,Rwanda,Kenya,766,1223,0,1989
24263,2021,Somalia,Kenya,280479,8176,0,288655
24264,2021,Sudan,Kenya,4213,5766,0,9979
24265,2021,South Sudan,Kenya,135255,96,0,135351
24266,2021,Syrian Arab Rep.,Kenya,5,5,0,10
24267,2021,United Rep. of Tanzania,Kenya,11,104,0,115
24268,2021,Türkiye,Kenya,121,80,0,201
24269,2021,Uganda,Kenya,794,2292,0,3086
24270,2021,Yemen,Kenya,93,211,0,304
24271,2021,Zimbabwe,Kenya,6,6,0,12
24272,2021,Stateless,Kenya,0,0,0,0
24273,2021,Afghanistan,Kyrgyzstan,213,309,0,522
24274,2021,Iraq,Kyrgyzstan,6,0,0,6
24275,2021,Pakistan,Kyrgyzstan,0,6,0,6
24276,2021,Syrian Arab Rep.,Kyrgyzstan,75,6,0,81
24277,2021,Turkmenistan,Kyrgyzstan,5,0,0,5
24278,2021,Türkiye,Kyrgyzstan,0,350,0,350
24279,2021,Ukraine,Kyrgyzstan,18,0,0,18
24280,2021,Venezuela (Bolivarian Republic of),Kyrgyzstan,0,5,0,5
24281,2021,Yemen,Kyrgyzstan,0,5,0,5
24282,2021,Stateless,Kyrgyzstan,0,0,0,0
24283,2021,Afghanistan,Rep. of Korea,46,59,0,105
24284,2021,Algeria,Rep. of Korea,6,73,0,79
24285,2021,Angola,Rep. of Korea,9,18,0,27
24286,2021,Egypt,Rep. of Korea,72,753,0,825
24287,2021,Argentina,Rep. of Korea,0,8,0,8
24288,2021,Azerbaijan,Rep. of Korea,0,8,0,8
24289,2021,Burundi,Rep. of Korea,47,15,0,62
24290,2021,Bangladesh,Rep. of Korea,129,1004,0,1133
24291,2021,Burkina Faso,Rep. of Korea,0,5,0,5
24292,2021,Bolivia (Plurinational State of),Rep. of Korea,0,5,0,5
24293,2021,Brazil,Rep. of Korea,0,13,0,13
24294,2021,Cambodia,Rep. of Korea,0,47,0,47
24295,2021,China,Rep. of Korea,50,1121,0,1171
24296,2021,Cameroon,Rep. of Korea,23,164,0,187
24297,2021,Congo,Rep. of Korea,0,8,0,8
24298,2021,Dem. Rep. of the Congo,Rep. of Korea,62,24,0,86
24299,2021,Colombia,Rep. of Korea,0,5,0,5
24300,2021,Eritrea,Rep. of Korea,10,0,0,10
24301,2021,Ethiopia,Rep. of Korea,171,164,0,335
24302,2021,Gambia,Rep. of Korea,0,44,0,44
24303,2021,Palestinian,Rep. of Korea,8,6,0,14
24304,2021,Ghana,Rep. of Korea,7,195,0,202
24305,2021,Guinea,Rep. of Korea,5,116,0,121
24306,2021,Haiti,Rep. of Korea,0,23,0,23
24307,2021,Cote d'Ivoire,Rep. of Korea,38,22,0,60
24308,2021,India,Rep. of Korea,0,1294,0,1294
24309,2021,Indonesia,Rep. of Korea,0,29,0,29
24310,2021,Iran (Islamic Rep. of),Rep. of Korea,62,54,0,116
24311,2021,Iraq,Rep. of Korea,28,84,0,112
24312,2021,Jordan,Rep. of Korea,7,16,0,23
24313,2021,Kazakhstan,Rep. of Korea,5,669,0,674
24314,2021,Kenya,Rep. of Korea,5,36,0,41
24315,2021,Kyrgyzstan,Rep. of Korea,0,101,0,101
24316,2021,Liberia,Rep. of Korea,12,164,0,176
24317,2021,Libya,Rep. of Korea,15,60,0,75
24318,2021,Sri Lanka,Rep. of Korea,8,191,0,199
24319,2021,Mali,Rep. of Korea,8,78,0,86
24320,2021,Malaysia,Rep. of Korea,0,875,0,875
24321,2021,Mongolia,Rep. of Korea,0,177,0,177
24322,2021,Morocco,Rep. of Korea,5,176,0,181
24323,2021,Mozambique,Rep. of Korea,0,7,0,7
24324,2021,Myanmar,Rep. of Korea,396,107,0,503
24325,2021,Nepal,Rep. of Korea,5,391,0,396
24326,2021,Nigeria,Rep. of Korea,13,343,0,356
24327,2021,Pakistan,Rep. of Korea,118,938,0,1056
24328,2021,Peru,Rep. of Korea,0,9,0,9
24329,2021,Philippines,Rep. of Korea,0,331,0,331
24330,2021,South Africa,Rep. of Korea,0,50,0,50
24331,2021,Russian Federation,Rep. of Korea,13,1000,0,1013
24332,2021,Rwanda,Rep. of Korea,0,30,0,30
24333,2021,Saudi Arabia,Rep. of Korea,0,5,0,5
24334,2021,Senegal,Rep. of Korea,0,50,0,50
24335,2021,Sierra Leone,Rep. of Korea,0,26,0,26
24336,2021,Somalia,Rep. of Korea,5,0,0,5
24337,2021,Viet Nam,Rep. of Korea,0,63,0,63
24338,2021,Sudan,Rep. of Korea,32,46,0,78
24339,2021,Syrian Arab Rep.,Rep. of Korea,1250,28,0,1278
24340,2021,United Rep. of Tanzania,Rep. of Korea,5,34,0,39
24341,2021,Thailand,Rep. of Korea,10,179,0,189
24342,2021,Tajikistan,Rep. of Korea,0,24,0,24
24343,2021,Togo,Rep. of Korea,0,14,0,14
24344,2021,Tunisia,Rep. of Korea,0,55,0,55
24345,2021,Türkiye,Rep. of Korea,0,186,0,186
24346,2021,Uganda,Rep. of Korea,38,50,0,88
24347,2021,Ukraine,Rep. of Korea,14,24,0,38
24348,2021,United States of America,Rep. of Korea,0,5,0,5
24349,2021,Uzbekistan,Rep. of Korea,9,201,0,210
24350,2021,Venezuela (Bolivarian Republic of),Rep. of Korea,0,12,0,12
24351,2021,Yemen,Rep. of Korea,813,18,0,831
24352,2021,Zimbabwe,Rep. of Korea,0,6,0,6
24353,2021,Stateless,Rep. of Korea,0,5,0,5
24354,2021,Unknown ,Rep. of Korea,0,5,0,5
24355,2021,Afghanistan,Kuwait,0,17,0,17
24356,2021,Egypt,Kuwait,6,19,0,25
24357,2021,Djibouti,Kuwait,0,5,0,5
24358,2021,Eritrea,Kuwait,5,28,0,33
24359,2021,Ethiopia,Kuwait,0,7,0,7
24360,2021,Palestinian,Kuwait,5,5,0,10
24361,2021,Iran (Islamic Rep. of),Kuwait,9,83,0,92
24362,2021,Iraq,Kuwait,334,308,0,642
24363,2021,Jordan,Kuwait,0,6,0,6
24364,2021,Lebanon,Kuwait,0,5,0,5
24365,2021,Sri Lanka,Kuwait,0,6,0,6
24366,2021,Pakistan,Kuwait,0,12,0,12
24367,2021,Philippines,Kuwait,0,5,0,5
24368,2021,Somalia,Kuwait,202,443,0,645
24369,2021,Sudan,Kuwait,0,17,0,17
24370,2021,Syrian Arab Rep.,Kuwait,150,104,0,254
24371,2021,Ukraine,Kuwait,0,5,0,5
24372,2021,Yemen,Kuwait,9,10,0,19
24373,2021,Stateless,Kuwait,0,0,0,0
24374,2021,Unknown ,Kuwait,0,0,0,0
24375,2021,Burkina Faso,Liberia,0,5,0,5
24376,2021,Central African Rep.,Liberia,5,0,0,5
24377,2021,Cameroon,Liberia,5,0,0,5
24378,2021,Dem. Rep. of the Congo,Liberia,28,5,0,33
24379,2021,Guinea,Liberia,0,5,0,5
24380,2021,Cote d'Ivoire,Liberia,8018,9779,0,17797
24381,2021,Mali,Liberia,19,0,0,19
24382,2021,Nigeria,Liberia,0,6,0,6
24383,2021,Pakistan,Liberia,5,0,0,5
24384,2021,Rwanda,Liberia,5,0,0,5
24385,2021,Sierra Leone,Liberia,15,0,0,15
24386,2021,Somalia,Liberia,5,0,0,5
24387,2021,Sudan,Liberia,11,0,0,11
24388,2021,South Sudan,Liberia,5,0,0,5
24389,2021,Syrian Arab Rep.,Liberia,27,18,0,45
24390,2021,Togo,Liberia,5,0,0,5
24391,2021,Türkiye,Liberia,16,0,0,16
24392,2021,Afghanistan,Libya,0,5,0,5
24393,2021,Burkina Faso,Libya,0,5,0,5
24394,2021,Chad,Libya,0,12,0,12
24395,2021,Dem. Rep. of the Congo,Libya,0,5,0,5
24396,2021,Eritrea,Libya,344,3992,0,4336
24397,2021,Ethiopia,Libya,32,939,0,971
24398,2021,Palestinian,Libya,560,1487,0,2047
24399,2021,Cote d'Ivoire,Libya,0,9,0,9
24400,2021,Iran (Islamic Rep. of),Libya,0,5,0,5
24401,2021,Iraq,Libya,333,187,0,520
24402,2021,Libya,Libya,0,0,179047,0
24403,2021,Mali,Libya,0,25,0,25
24404,2021,Niger,Libya,0,5,0,5
24405,2021,Nigeria,Libya,0,41,0,41
24406,2021,Somalia,Libya,24,1275,0,1299
24407,2021,Sudan,Libya,1336,15707,0,17043
24408,2021,South Sudan,Libya,8,309,0,317
24409,2021,Syrian Arab Rep.,Libya,492,12632,0,13124
24410,2021,Yemen,Libya,12,101,0,113
24411,2021,Afghanistan,Lebanon,24,11,0,35
24412,2021,Algeria,Lebanon,6,6,0,12
24413,2021,Egypt,Lebanon,121,370,0,491
24414,2021,Armenia,Lebanon,0,11,0,11
24415,2021,Bahrain,Lebanon,14,5,0,19
24416,2021,Bangladesh,Lebanon,0,101,0,101
24417,2021,Cameroon,Lebanon,8,26,0,34
24418,2021,Congo,Lebanon,0,5,0,5
24419,2021,Dem. Rep. of the Congo,Lebanon,0,11,0,11
24420,2021,Eritrea,Lebanon,19,18,0,37
24421,2021,Ethiopia,Lebanon,46,907,0,953
24422,2021,Gambia,Lebanon,0,8,0,8
24423,2021,Palestinian,Lebanon,0,0,0,0
24424,2021,Ghana,Lebanon,0,8,0,8
24425,2021,Cote d'Ivoire,Lebanon,0,10,0,10
24426,2021,India,Lebanon,0,12,0,12
24427,2021,Iran (Islamic Rep. of),Lebanon,35,46,0,81
24428,2021,Iraq,Lebanon,3750,5233,0,8983
24429,2021,Jordan,Lebanon,36,87,0,123
24430,2021,Kenya,Lebanon,5,13,0,18
24431,2021,Kuwait,Lebanon,9,0,0,9
24432,2021,Libya,Lebanon,11,17,0,28
24433,2021,Lebanon,Lebanon,0,0,0,0
24434,2021,Sri Lanka,Lebanon,0,19,0,19
24435,2021,Madagascar,Lebanon,0,15,0,15
24436,2021,Morocco,Lebanon,5,8,0,13
24437,2021,Nigeria,Lebanon,5,68,0,73
24438,2021,Pakistan,Lebanon,6,14,0,20
24439,2021,Philippines,Lebanon,0,39,0,39
24440,2021,Saudi Arabia,Lebanon,7,7,0,14
24441,2021,Somalia,Lebanon,11,0,0,11
24442,2021,Sudan,Lebanon,728,1524,0,2252
24443,2021,South Sudan,Lebanon,38,0,0,38
24444,2021,Syrian Arab Rep.,Lebanon,840929,0,0,840929
24445,2021,Togo,Lebanon,0,10,0,10
24446,2021,Tunisia,Lebanon,11,0,0,11
24447,2021,Türkiye,Lebanon,7,6,0,13
24448,2021,Ukraine,Lebanon,0,0,0,0
24449,2021,Venezuela (Bolivarian Republic of),Lebanon,0,5,0,5
24450,2021,Yemen,Lebanon,34,97,0,131
24451,2021,Cameroon,Lesotho,0,5,0,5
24452,2021,Dem. Rep. of the Congo,Lesotho,205,145,0,350
24453,2021,Eritrea,Lesotho,43,44,0,87
24454,2021,Ethiopia,Lesotho,24,16,0,40
24455,2021,Nigeria,Lesotho,0,5,0,5
24456,2021,Somalia,Lesotho,5,6,0,11
24457,2021,Uganda,Lesotho,9,5,0,14
24458,2021,Zambia,Lesotho,5,0,0,5
24459,2021,Zimbabwe,Lesotho,5,0,0,5
24460,2021,Afghanistan,Liechtenstein,5,0,0,5
24461,2021,Albania,Liechtenstein,0,5,0,5
24462,2021,Belarus,Liechtenstein,0,5,0,5
24463,2021,China,Liechtenstein,35,0,0,35
24464,2021,Eritrea,Liechtenstein,12,0,0,12
24465,2021,Iran (Islamic Rep. of),Liechtenstein,11,0,0,11
24466,2021,Iraq,Liechtenstein,7,5,0,12
24467,2021,Somalia,Liechtenstein,26,0,0,26
24468,2021,Sudan,Liechtenstein,0,7,0,7
24469,2021,Syrian Arab Rep.,Liechtenstein,32,0,0,32
24470,2021,Ukraine,Liechtenstein,5,0,0,5
24471,2021,Afghanistan,Sri Lanka,113,27,0,140
24472,2021,Palestinian,Sri Lanka,6,5,0,11
24473,2021,Iran (Islamic Rep. of),Sri Lanka,24,0,0,24
24474,2021,Sri Lanka,Sri Lanka,0,0,8767,0
24475,2021,Myanmar,Sri Lanka,35,0,0,35
24476,2021,Nigeria,Sri Lanka,0,10,0,10
24477,2021,Pakistan,Sri Lanka,709,149,0,858
24478,2021,Sudan,Sri Lanka,5,5,0,10
24479,2021,Yemen,Sri Lanka,15,5,0,20
24480,2021,Stateless,Sri Lanka,0,0,0,0
24481,2021,Afghanistan,Lithuania,230,9,0,239
24482,2021,Azerbaijan,Lithuania,17,0,0,17
24483,2021,Belarus,Lithuania,35,65,0,100
24484,2021,Chile,Lithuania,0,5,0,5
24485,2021,Cameroon,Lithuania,6,0,0,6
24486,2021,Cuba,Lithuania,5,0,0,5
24487,2021,Eritrea,Lithuania,40,0,0,40
24488,2021,Ethiopia,Lithuania,5,0,0,5
24489,2021,Georgia,Lithuania,5,0,0,5
24490,2021,Iran (Islamic Rep. of),Lithuania,13,0,0,13
24491,2021,Iraq,Lithuania,65,15,0,80
24492,2021,Sri Lanka,Lithuania,10,5,0,15
24493,2021,Nigeria,Lithuania,5,0,0,5
24494,2021,Pakistan,Lithuania,5,0,0,5
24495,2021,Russian Federation,Lithuania,688,8,0,696
24496,2021,Somalia,Lithuania,22,0,0,22
24497,2021,Syrian Arab Rep.,Lithuania,463,5,0,468
24498,2021,Tajikistan,Lithuania,85,5,0,90
24499,2021,Türkiye,Lithuania,63,0,0,63
24500,2021,Ukraine,Lithuania,64,5,0,69
24501,2021,Uzbekistan,Lithuania,17,0,0,17
24502,2021,Stateless,Lithuania,37,0,0,37
24503,2021,Afghanistan,Luxembourg,427,200,0,627
24504,2021,Albania,Luxembourg,38,5,0,43
24505,2021,Algeria,Luxembourg,0,20,0,20
24506,2021,Angola,Luxembourg,9,10,0,19
24507,2021,Egypt,Luxembourg,0,5,0,5
24508,2021,Armenia,Luxembourg,5,0,0,5
24509,2021,Azerbaijan,Luxembourg,13,0,0,13
24510,2021,Burundi,Luxembourg,5,0,0,5
24511,2021,Bhutan,Luxembourg,5,0,0,5
24512,2021,Burkina Faso,Luxembourg,0,5,0,5
24513,2021,Belarus,Luxembourg,0,10,0,10
24514,2021,Bosnia and Herzegovina,Luxembourg,5,0,0,5
24515,2021,China,Luxembourg,7,0,0,7
24516,2021,Cameroon,Luxembourg,17,35,0,52
24517,2021,Dem. Rep. of the Congo,Luxembourg,43,10,0,53
24518,2021,Colombia,Luxembourg,0,20,0,20
24519,2021,Eritrea,Luxembourg,1329,330,0,1659
24520,2021,Ethiopia,Luxembourg,63,40,0,103
24521,2021,Gabon,Luxembourg,5,0,0,5
24522,2021,Gambia,Luxembourg,6,10,0,16
24523,2021,Georgia,Luxembourg,0,5,0,5
24524,2021,Guinea,Luxembourg,12,15,0,27
24525,2021,Cote d'Ivoire,Luxembourg,5,15,0,20
24526,2021,Iran (Islamic Rep. of),Luxembourg,211,85,0,296
24527,2021,Iraq,Luxembourg,788,105,0,893
24528,2021,Dem. People's Rep. of Korea,Luxembourg,11,0,0,11
24529,2021,Kuwait,Luxembourg,5,0,0,5
24530,2021,Libya,Luxembourg,5,25,0,30
24531,2021,Lebanon,Luxembourg,5,15,0,20
24532,2021,Sri Lanka,Luxembourg,5,0,0,5
24533,2021,Mali,Luxembourg,0,5,0,5
24534,2021,Morocco,Luxembourg,0,15,0,15
24535,2021,Montenegro,Luxembourg,6,0,0,6
24536,2021,Niger,Luxembourg,0,5,0,5
24537,2021,Nigeria,Luxembourg,9,10,0,19
24538,2021,Pakistan,Luxembourg,0,5,0,5
24539,2021,Russian Federation,Luxembourg,17,10,0,27
24540,2021,Rwanda,Luxembourg,13,5,0,18
24541,2021,Serbia and Kosovo: S/RES/1244 (1999),Luxembourg,130,0,0,130
24542,2021,Senegal,Luxembourg,5,10,0,15
24543,2021,Somalia,Luxembourg,57,35,0,92
24544,2021,Sudan,Luxembourg,56,45,0,101
24545,2021,Syrian Arab Rep.,Luxembourg,2409,415,0,2824
24546,2021,United Rep. of Tanzania,Luxembourg,0,5,0,5
24547,2021,Tajikistan,Luxembourg,0,5,0,5
24548,2021,Turkmenistan,Luxembourg,5,0,0,5
24549,2021,Togo,Luxembourg,8,5,0,13
24550,2021,Tunisia,Luxembourg,0,10,0,10
24551,2021,Türkiye,Luxembourg,103,70,0,173
24552,2021,Uganda,Luxembourg,5,0,0,5
24553,2021,Ukraine,Luxembourg,5,10,0,15
24554,2021,Venezuela (Bolivarian Republic of),Luxembourg,8,100,0,108
24555,2021,Yemen,Luxembourg,30,5,0,35
24556,2021,Stateless,Luxembourg,111,0,0,111
24557,2021,Unknown ,Luxembourg,10,30,0,40
24558,2021,Afghanistan,Latvia,81,46,0,127
24559,2021,Egypt,Latvia,5,5,0,10
24560,2021,Azerbaijan,Latvia,11,6,0,17
24561,2021,Belarus,Latvia,61,33,0,94
24562,2021,China,Latvia,5,0,0,5
24563,2021,Cuba,Latvia,0,5,0,5
24564,2021,Eritrea,Latvia,35,0,0,35
24565,2021,Palestinian,Latvia,7,0,0,7
24566,2021,Iran (Islamic Rep. of),Latvia,17,0,0,17
24567,2021,Iraq,Latvia,40,95,0,135
24568,2021,Kazakhstan,Latvia,5,0,0,5
24569,2021,Kyrgyzstan,Latvia,5,0,0,5
24570,2021,Lebanon,Latvia,5,0,0,5
24571,2021,Sri Lanka,Latvia,5,0,0,5
24572,2021,Russian Federation,Latvia,59,9,0,68
24573,2021,Somalia,Latvia,5,0,0,5
24574,2021,Syrian Arab Rep.,Latvia,312,5,0,317
24575,2021,Tajikistan,Latvia,5,0,0,5
24576,2021,Türkiye,Latvia,31,0,0,31
24577,2021,Ukraine,Latvia,0,5,0,5
24578,2021,Uzbekistan,Latvia,11,0,0,11
24579,2021,Stateless,Latvia,0,0,0,0
24580,2021,Afghanistan,Madagascar,20,0,0,20
24581,2021,Burundi,Madagascar,5,0,0,5
24582,2021,Congo,Madagascar,0,5,0,5
24583,2021,Dem. Rep. of the Congo,Madagascar,11,0,0,11
24584,2021,Comoros,Madagascar,5,0,0,5
24585,2021,Guinea,Madagascar,6,0,0,6
24586,2021,Madagascar,Madagascar,0,0,0,0
24587,2021,Pakistan,Madagascar,99,106,0,205
24588,2021,Syrian Arab Rep.,Madagascar,5,0,0,5
24589,2021,Yemen,Madagascar,14,11,0,25
24590,2021,Benin,Mauritania,0,10,0,10
24591,2021,Burkina Faso,Mauritania,18,70,0,88
24592,2021,Central African Rep.,Mauritania,653,94,0,747
24593,2021,Chad,Mauritania,5,5,0,10
24594,2021,China,Mauritania,5,0,0,5
24595,2021,Cameroon,Mauritania,19,131,0,150
24596,2021,Congo,Mauritania,7,14,0,21
24597,2021,Dem. Rep. of the Congo,Mauritania,31,29,0,60
24598,2021,Ethiopia,Mauritania,8,8,0,16
24599,2021,Gambia,Mauritania,0,11,0,11
24600,2021,Palestinian,Mauritania,78,43,0,121
24601,2021,Ghana,Mauritania,0,11,0,11
24602,2021,Guinea,Mauritania,17,162,0,179
24603,2021,Cote d'Ivoire,Mauritania,277,221,0,498
24604,2021,Iraq,Mauritania,24,0,0,24
24605,2021,Liberia,Mauritania,7,17,0,24
24606,2021,Libya,Mauritania,8,16,0,24
24607,2021,Lebanon,Mauritania,0,14,0,14
24608,2021,Mali,Mauritania,74196,1716,0,75912
24609,2021,Niger,Mauritania,5,19,0,24
24610,2021,Nigeria,Mauritania,13,68,0,81
24611,2021,Russian Federation,Mauritania,11,0,0,11
24612,2021,Senegal,Mauritania,107,213,0,320
24613,2021,Sierra Leone,Mauritania,0,140,0,140
24614,2021,Somalia,Mauritania,5,5,0,10
24615,2021,Sudan,Mauritania,13,18,0,31
24616,2021,Syrian Arab Rep.,Mauritania,368,141,0,509
24617,2021,Togo,Mauritania,17,136,0,153
24618,2021,Türkiye,Mauritania,5,15,0,20
24619,2021,Western Sahara,Mauritania,26000,0,0,26000
24620,2021,Yemen,Mauritania,45,42,0,87
24621,2021,Afghanistan,North Macedonia,8,0,0,8
24622,2021,Congo,North Macedonia,5,0,0,5
24623,2021,Cuba,North Macedonia,0,5,0,5
24624,2021,Iraq,North Macedonia,5,0,0,5
24625,2021,North Macedonia,North Macedonia,0,0,116,0
24626,2021,Morocco,North Macedonia,0,5,0,5
24627,2021,Pakistan,North Macedonia,5,5,0,10
24628,2021,Russian Federation,North Macedonia,0,5,0,5
24629,2021,Serbia and Kosovo: S/RES/1244 (1999),North Macedonia,252,0,0,252
24630,2021,Syrian Arab Rep.,North Macedonia,17,0,0,17
24631,2021,Türkiye,North Macedonia,0,5,0,5
24632,2021,Stateless,North Macedonia,0,0,0,0
24633,2021,Iraq,Monaco,5,0,0,5
24634,2021,Viet Nam,Monaco,7,0,0,7
24635,2021,Syrian Arab Rep.,Monaco,5,0,0,5
24636,2021,Afghanistan,Rep. of Moldova,12,0,0,12
24637,2021,Armenia,Rep. of Moldova,11,0,0,11
24638,2021,Azerbaijan,Rep. of Moldova,5,0,0,5
24639,2021,Cuba,Rep. of Moldova,0,8,0,8
24640,2021,Palestinian,Rep. of Moldova,5,0,0,5
24641,2021,Georgia,Rep. of Moldova,0,6,0,6
24642,2021,Iraq,Rep. of Moldova,17,0,0,17
24643,2021,Kyrgyzstan,Rep. of Moldova,10,0,0,10
24644,2021,Libya,Rep. of Moldova,5,0,0,5
24645,2021,Russian Federation,Rep. of Moldova,5,5,0,10
24646,2021,Sudan,Rep. of Moldova,9,0,0,9
24647,2021,Syrian Arab Rep.,Rep. of Moldova,166,7,0,173
24648,2021,Tajikistan,Rep. of Moldova,6,0,0,6
24649,2021,Turkmenistan,Rep. of Moldova,5,0,0,5
24650,2021,Türkiye,Rep. of Moldova,61,23,0,84
24651,2021,Ukraine,Rep. of Moldova,18,7,0,25
24652,2021,Uzbekistan,Rep. of Moldova,8,0,0,8
24653,2021,Yemen,Rep. of Moldova,6,0,0,6
24654,2021,Stateless,Rep. of Moldova,0,0,0,0
24655,2021,Afghanistan,Mexico,5,6,0,11
24656,2021,Albania,Mexico,8,0,0,8
24657,2021,Algeria,Mexico,5,5,0,10
24658,2021,Angola,Mexico,10,345,0,355
24659,2021,Egypt,Mexico,5,11,0,16
24660,2021,Argentina,Mexico,5,195,0,200
24661,2021,Burundi,Mexico,0,5,0,5
24662,2021,Benin,Mexico,5,14,0,19
24663,2021,Bangladesh,Mexico,10,37,0,47
24664,2021,Burkina Faso,Mexico,14,82,0,96
24665,2021,Belarus,Mexico,0,5,0,5
24666,2021,Bolivia (Plurinational State of),Mexico,0,37,0,37
24667,2021,Brazil,Mexico,161,4240,0,4401
24668,2021,Belize,Mexico,24,57,0,81
24669,2021,Cambodia,Mexico,24,46,0,70
24670,2021,Canada,Mexico,0,19,0,19
24671,2021,Central African Rep.,Mexico,0,5,0,5
24672,2021,Chad,Mexico,0,9,0,9
24673,2021,China,Mexico,5,16,0,21
24674,2021,Chile,Mexico,383,7104,0,7487
24675,2021,Cameroon,Mexico,30,430,0,460
24676,2021,Congo,Mexico,25,108,0,133
24677,2021,Dem. Rep. of the Congo,Mexico,73,457,0,530
24678,2021,Colombia,Mexico,530,1765,0,2295
24679,2021,Costa Rica,Mexico,33,119,0,152
24680,2021,Cuba,Mexico,3722,9837,0,13559
24681,2021,Dominica,Mexico,0,10,0,10
24682,2021,Dominican Rep.,Mexico,32,197,0,229
24683,2021,Ecuador,Mexico,43,297,0,340
24684,2021,Eritrea,Mexico,7,102,0,109
24685,2021,Ethiopia,Mexico,6,25,0,31
24686,2021,French Guiana,Mexico,0,72,0,72
24687,2021,France,Mexico,0,17,0,17
24688,2021,Gambia,Mexico,0,5,0,5
24689,2021,Palestinian,Mexico,5,7,0,12
24690,2021,Germany,Mexico,0,10,0,10
24691,2021,Ghana,Mexico,43,402,0,445
24692,2021,Guinea-Bissau,Mexico,0,5,0,5
24693,2021,Guatemala,Mexico,3113,6123,0,9236
24694,2021,Guinea,Mexico,42,162,0,204
24695,2021,Guyana,Mexico,0,23,0,23
24696,2021,Haiti,Mexico,3294,52404,0,55698
24697,2021,Honduras,Mexico,30787,46081,0,76868
24698,2021,Cote d'Ivoire,Mexico,6,37,0,43
24699,2021,India,Mexico,14,88,0,102
24700,2021,Iran (Islamic Rep. of),Mexico,41,11,0,52
24701,2021,Iraq,Mexico,44,7,0,51
24702,2021,Israel,Mexico,0,13,0,13
24703,2021,Italy,Mexico,0,8,0,8
24704,2021,Jamaica,Mexico,6,14,0,20
24705,2021,Kyrgyzstan,Mexico,8,9,0,17
24706,2021,Rep. of Korea,Mexico,0,5,0,5
24707,2021,Liberia,Mexico,0,5,0,5
24708,2021,Sri Lanka,Mexico,20,30,0,50
24709,2021,Mauritania,Mexico,6,71,0,77
24710,2021,Mali,Mexico,5,52,0,57
24711,2021,Morocco,Mexico,5,7,0,12
24712,2021,Nepal,Mexico,0,15,0,15
24713,2021,Nicaragua,Mexico,1619,3891,0,5510
24714,2021,Nigeria,Mexico,45,72,0,117
24715,2021,Pakistan,Mexico,12,28,0,40
24716,2021,Panama,Mexico,53,106,0,159
24717,2021,Paraguay,Mexico,0,5,0,5
24718,2021,Peru,Mexico,33,145,0,178
24719,2021,Portugal,Mexico,5,7,0,12
24720,2021,Romania,Mexico,7,0,0,7
24721,2021,South Africa,Mexico,0,12,0,12
24722,2021,Russian Federation,Mexico,44,31,0,75
24723,2021,Rwanda,Mexico,0,5,0,5
24724,2021,El Salvador,Mexico,12265,11443,0,23708
24725,2021,Senegal,Mexico,0,338,0,338
24726,2021,Sierra Leone,Mexico,11,92,0,103
24727,2021,Somalia,Mexico,5,50,0,55
24728,2021,Spain,Mexico,5,15,0,20
24729,2021,Sudan,Mexico,0,11,0,11
24730,2021,Syrian Arab Rep.,Mexico,34,35,0,69
24731,2021,Tajikistan,Mexico,0,5,0,5
24732,2021,Togo,Mexico,19,72,0,91
24733,2021,Türkiye,Mexico,8,7,0,15
24734,2021,Uganda,Mexico,0,45,0,45
24735,2021,Ukraine,Mexico,19,5,0,24
24736,2021,Uruguay,Mexico,13,42,0,55
24737,2021,United States of America,Mexico,38,110,0,148
24738,2021,Uzbekistan,Mexico,0,21,0,21
24739,2021,Venezuela (Bolivarian Republic of),Mexico,16585,9212,0,25797
24740,2021,Yemen,Mexico,24,77,0,101
24741,2021,Stateless,Mexico,0,0,0,0
24742,2021,Burundi,Mali,18,0,0,18
24743,2021,Bangladesh,Mali,0,32,0,32
24744,2021,Burkina Faso,Mali,14731,0,0,14731
24745,2021,Central African Rep.,Mali,1136,271,0,1407
24746,2021,Chad,Mali,0,5,0,5
24747,2021,Cameroon,Mali,6,6,0,12
24748,2021,Congo,Mali,34,5,0,39
24749,2021,Dem. Rep. of the Congo,Mali,293,45,0,338
24750,2021,Eritrea,Mali,5,0,0,5
24751,2021,Guinea,Mali,0,10,0,10
24752,2021,Cote d'Ivoire,Mali,427,40,0,467
24753,2021,Liberia,Mali,5,0,0,5
24754,2021,Mauritania,Mali,14965,0,0,14965
24755,2021,Mali,Mali,0,0,350110,0
24756,2021,Niger,Mali,18255,0,0,18255
24757,2021,Nigeria,Mali,0,5,0,5
24758,2021,Pakistan,Mali,11,0,0,11
24759,2021,Rwanda,Mali,15,5,0,20
24760,2021,Syrian Arab Rep.,Mali,24,433,0,457
24761,2021,Togo,Mali,29,0,0,29
24762,2021,Türkiye,Mali,21,6,0,27
24763,2021,Afghanistan,Malaysia,1604,1199,0,2803
24764,2021,Algeria,Malaysia,0,10,0,10
24765,2021,Egypt,Malaysia,18,83,0,101
24766,2021,Australia,Malaysia,5,0,0,5
24767,2021,Bangladesh,Malaysia,37,17,0,54
24768,2021,Cambodia,Malaysia,77,10,0,87
24769,2021,Central African Rep.,Malaysia,5,0,0,5
24770,2021,China,Malaysia,46,0,0,46
24771,2021,Cameroon,Malaysia,10,22,0,32
24772,2021,Dem. Rep. of the Congo,Malaysia,10,0,0,10
24773,2021,Eritrea,Malaysia,25,15,0,40
24774,2021,Ethiopia,Malaysia,12,11,0,23
24775,2021,Palestinian,Malaysia,249,526,0,775
24776,2021,United Kingdom of Great Britain and Northern Ireland,Malaysia,6,0,0,6
24777,2021,Guinea,Malaysia,7,25,0,32
24778,2021,Cote d'Ivoire,Malaysia,5,0,0,5
24779,2021,India,Malaysia,5,19,0,24
24780,2021,Indonesia,Malaysia,946,35,0,981
24781,2021,Iran (Islamic Rep. of),Malaysia,274,169,0,443
24782,2021,Iraq,Malaysia,420,788,0,1208
24783,2021,Jordan,Malaysia,10,0,0,10
24784,2021,Liberia,Malaysia,21,6,0,27
24785,2021,Libya,Malaysia,11,20,0,31
24786,2021,Lebanon,Malaysia,5,5,0,10
24787,2021,Sri Lanka,Malaysia,795,895,0,1690
24788,2021,Mali,Malaysia,5,0,0,5
24789,2021,Morocco,Malaysia,5,0,0,5
24790,2021,Myanmar,Malaysia,120598,34807,0,155405
24791,2021,Nepal,Malaysia,11,0,0,11
24792,2021,Nigeria,Malaysia,5,39,0,44
24793,2021,Pakistan,Malaysia,3632,3116,0,6748
24794,2021,Philippines,Malaysia,20,0,0,20
24795,2021,Russian Federation,Malaysia,6,0,0,6
24796,2021,Sierra Leone,Malaysia,9,36,0,45
24797,2021,Somalia,Malaysia,2168,1047,0,3215
24798,2021,Viet Nam,Malaysia,5,0,0,5
24799,2021,Sudan,Malaysia,182,127,0,309
24800,2021,South Sudan,Malaysia,24,40,0,64
24801,2021,Syrian Arab Rep.,Malaysia,449,2858,0,3307
24802,2021,Thailand,Malaysia,26,24,0,50
24803,2021,Uganda,Malaysia,5,11,0,16
24804,2021,United States of America,Malaysia,7,0,0,7
24805,2021,Uzbekistan,Malaysia,0,7,0,7
24806,2021,Yemen,Malaysia,321,3400,0,3721
24807,2021,Zimbabwe,Malaysia,5,5,0,10
24808,2021,Stateless,Malaysia,0,0,0,0
24809,2021,Burundi,Malawi,3951,8288,0,12239
24810,2021,Dem. Rep. of the Congo,Malawi,14941,17502,0,32443
24811,2021,Eritrea,Malawi,0,8,0,8
24812,2021,Ethiopia,Malawi,11,68,0,79
24813,2021,Cote d'Ivoire,Malawi,5,0,0,5
24814,2021,Mozambique,Malawi,0,5,0,5
24815,2021,Rwanda,Malawi,2514,4916,0,7430
24816,2021,Somalia,Malawi,66,63,0,129
24817,2021,South Sudan,Malawi,5,0,0,5
24818,2021,United Rep. of Tanzania,Malawi,0,5,0,5
24819,2021,Türkiye,Malawi,31,25,0,56
24820,2021,Uganda,Malawi,5,16,0,21
24821,2021,Zimbabwe,Malawi,0,8,0,8
24822,2021,Afghanistan,Mongolia,0,5,0,5
24823,2021,Mongolia,Mongolia,0,0,0,0
24824,2021,Stateless,Mongolia,0,0,0,0
24825,2021,Afghanistan,Morocco,12,5,0,17
24826,2021,Algeria,Morocco,10,14,0,24
24827,2021,Angola,Morocco,0,6,0,6
24828,2021,Egypt,Morocco,5,11,0,16
24829,2021,Burundi,Morocco,8,0,0,8
24830,2021,Benin,Morocco,0,5,0,5
24831,2021,Bangladesh,Morocco,0,72,0,72
24832,2021,Burkina Faso,Morocco,0,38,0,38
24833,2021,Central African Rep.,Morocco,594,394,0,988
24834,2021,Chad,Morocco,5,50,0,55
24835,2021,Cameroon,Morocco,176,1073,0,1249
24836,2021,Congo,Morocco,18,64,0,82
24837,2021,Dem. Rep. of the Congo,Morocco,194,190,0,384
24838,2021,Eritrea,Morocco,19,50,0,69
24839,2021,Ethiopia,Morocco,0,11,0,11
24840,2021,Gabon,Morocco,0,8,0,8
24841,2021,Gambia,Morocco,0,128,0,128
24842,2021,Palestinian,Morocco,89,169,0,258
24843,2021,Ghana,Morocco,0,12,0,12
24844,2021,Guinea-Bissau,Morocco,0,49,0,49
24845,2021,Guinea,Morocco,146,2508,0,2654
24846,2021,Cote d'Ivoire,Morocco,391,1047,0,1438
24847,2021,India,Morocco,0,5,0,5
24848,2021,Iraq,Morocco,127,7,0,134
24849,2021,Jordan,Morocco,0,5,0,5
24850,2021,Liberia,Morocco,7,61,0,68
24851,2021,Libya,Morocco,49,15,0,64
24852,2021,Lebanon,Morocco,5,37,0,42
24853,2021,Sri Lanka,Morocco,0,5,0,5
24854,2021,Mauritania,Morocco,7,14,0,21
24855,2021,Mali,Morocco,58,765,0,823
24856,2021,Niger,Morocco,0,13,0,13
24857,2021,Nigeria,Morocco,25,413,0,438
24858,2021,Pakistan,Morocco,16,7,0,23
24859,2021,Senegal,Morocco,106,1118,0,1224
24860,2021,Sierra Leone,Morocco,0,93,0,93
24861,2021,Somalia,Morocco,22,16,0,38
24862,2021,Sudan,Morocco,54,938,0,992
24863,2021,South Sudan,Morocco,28,411,0,439
24864,2021,Syrian Arab Rep.,Morocco,5082,0,0,5082
24865,2021,Togo,Morocco,0,13,0,13
24866,2021,Türkiye,Morocco,5,28,0,33
24867,2021,Yemen,Morocco,14,1088,0,1102
24868,2021,Angola,Mozambique,5,0,0,5
24869,2021,Burundi,Mozambique,908,8353,0,9261
24870,2021,Central African Rep.,Mozambique,0,12,0,12
24871,2021,Cameroon,Mozambique,0,5,0,5
24872,2021,Congo,Mozambique,16,37,0,53
24873,2021,Dem. Rep. of the Congo,Mozambique,2993,7700,0,10693
24874,2021,Comoros,Mozambique,0,511,0,511
24875,2021,Eritrea,Mozambique,0,26,0,26
24876,2021,Ethiopia,Mozambique,8,18,0,26
24877,2021,Guinea,Mozambique,0,5,0,5
24878,2021,Mozambique,Mozambique,0,0,744949,0
24879,2021,New Zealand,Mozambique,0,37,0,37
24880,2021,Rwanda,Mozambique,697,3241,0,3938
24881,2021,Somalia,Mozambique,160,4370,0,4530
24882,2021,Sudan,Mozambique,5,30,0,35
24883,2021,South Sudan,Mozambique,0,5,0,5
24884,2021,Uganda,Mozambique,5,36,0,41
24885,2021,Afghanistan,Malta,0,5,0,5
24886,2021,Algeria,Malta,0,27,0,27
24887,2021,Egypt,Malta,73,97,0,170
24888,2021,Armenia,Malta,0,5,0,5
24889,2021,Bangladesh,Malta,14,188,0,202
24890,2021,Burkina Faso,Malta,5,14,0,19
24891,2021,Belarus,Malta,9,0,0,9
24892,2021,Central African Rep.,Malta,0,5,0,5
24893,2021,Chad,Malta,9,48,0,57
24894,2021,China,Malta,17,0,0,17
24895,2021,Cameroon,Malta,10,55,0,65
24896,2021,Dem. Rep. of the Congo,Malta,5,8,0,13
24897,2021,Comoros,Malta,0,5,0,5
24898,2021,Colombia,Malta,0,26,0,26
24899,2021,Eritrea,Malta,867,325,0,1192
24900,2021,Ethiopia,Malta,175,43,0,218
24901,2021,Gambia,Malta,26,90,0,116
24902,2021,Palestinian,Malta,74,29,0,103
24903,2021,Georgia,Malta,5,33,0,38
24904,2021,Ghana,Malta,8,46,0,54
24905,2021,Guinea-Bissau,Malta,0,6,0,6
24906,2021,Guinea,Malta,0,93,0,93
24907,2021,Cote d'Ivoire,Malta,12,109,0,121
24908,2021,India,Malta,0,5,0,5
24909,2021,Iran (Islamic Rep. of),Malta,31,11,0,42
24910,2021,Iraq,Malta,81,0,0,81
24911,2021,Jordan,Malta,5,0,0,5
24912,2021,Liberia,Malta,6,0,0,6
24913,2021,Libya,Malta,2851,228,0,3079
24914,2021,Lebanon,Malta,0,5,0,5
24915,2021,Sri Lanka,Malta,7,5,0,12
24916,2021,North Macedonia,Malta,5,7,0,12
24917,2021,Mali,Malta,20,107,0,127
24918,2021,Morocco,Malta,30,97,0,127
24919,2021,Nepal,Malta,0,18,0,18
24920,2021,Niger,Malta,0,33,0,33
24921,2021,Nigeria,Malta,124,203,0,327
24922,2021,Pakistan,Malta,59,53,0,112
24923,2021,South Africa,Malta,0,5,0,5
24924,2021,Russian Federation,Malta,18,0,0,18
24925,2021,El Salvador,Malta,0,5,0,5
24926,2021,Saudi Arabia,Malta,5,0,0,5
24927,2021,Serbia and Kosovo: S/RES/1244 (1999),Malta,7,0,0,7
24928,2021,Senegal,Malta,5,71,0,76
24929,2021,Sierra Leone,Malta,5,40,0,45
24930,2021,Somalia,Malta,1776,160,0,1936
24931,2021,Sudan,Malta,224,733,0,957
24932,2021,South Sudan,Malta,22,63,0,85
24933,2021,Syrian Arab Rep.,Malta,1918,412,0,2330
24934,2021,Togo,Malta,5,8,0,13
24935,2021,Tunisia,Malta,13,10,0,23
24936,2021,Türkiye,Malta,7,11,0,18
24937,2021,Uganda,Malta,0,5,0,5
24938,2021,Ukraine,Malta,142,54,0,196
24939,2021,Uzbekistan,Malta,0,5,0,5
24940,2021,Venezuela (Bolivarian Republic of),Malta,24,58,0,82
24941,2021,Yemen,Malta,5,5,0,10
24942,2021,Zimbabwe,Malta,5,0,0,5
24943,2021,Stateless,Malta,0,0,0,0
24944,2021,Unknown ,Malta,626,0,0,626
24945,2021,Afghanistan,Montenegro,0,5,0,5
24946,2021,Algeria,Montenegro,0,9,0,9
24947,2021,Belarus,Montenegro,5,0,0,5
24948,2021,Bosnia and Herzegovina,Montenegro,5,0,0,5
24949,2021,Cuba,Montenegro,0,54,0,54
24950,2021,Ecuador,Montenegro,0,5,0,5
24951,2021,Ghana,Montenegro,5,0,0,5
24952,2021,Croatia,Montenegro,5,0,0,5
24953,2021,Iran (Islamic Rep. of),Montenegro,17,14,0,31
24954,2021,Morocco,Montenegro,0,12,0,12
24955,2021,Pakistan,Montenegro,0,10,0,10
24956,2021,Russian Federation,Montenegro,6,13,0,19
24957,2021,Serbia and Kosovo: S/RES/1244 (1999),Montenegro,125,5,0,130
24958,2021,Venezuela (Bolivarian Republic of),Montenegro,0,5,0,5
24959,2021,Yemen,Montenegro,7,0,0,7
24960,2021,Stateless,Montenegro,0,0,0,0
24961,2021,Unknown ,Montenegro,0,0,0,0
24962,2021,Pakistan,Mauritius,5,0,0,5
24963,2021,South Africa,Mauritius,5,0,0,5
24964,2021,Myanmar,Myanmar,0,0,671011,0
24965,2021,Stateless,Myanmar,0,0,0,0
24966,2021,Angola,Namibia,5,0,0,5
24967,2021,Burundi,Namibia,310,135,0,445
24968,2021,Central African Rep.,Namibia,5,8,0,13
24969,2021,Cameroon,Namibia,24,18,0,42
24970,2021,Congo,Namibia,5,11,0,16
24971,2021,Dem. Rep. of the Congo,Namibia,3187,2484,0,5671
24972,2021,Kenya,Namibia,5,5,0,10
24973,2021,Namibia,Namibia,0,0,0,0
24974,2021,Nigeria,Namibia,0,5,0,5
24975,2021,Rwanda,Namibia,125,29,0,154
24976,2021,Somalia,Namibia,5,5,0,10
24977,2021,Sudan,Namibia,7,0,0,7
24978,2021,United Rep. of Tanzania,Namibia,0,5,0,5
24979,2021,Uganda,Namibia,7,6,0,13
24980,2021,Zimbabwe,Namibia,48,36,0,84
24981,2021,Afghanistan,Nepal,52,12,0,64
24982,2021,Bangladesh,Nepal,5,0,0,5
24983,2021,Bhutan,Nepal,6365,0,0,6365
24984,2021,India,Nepal,0,0,0,0
24985,2021,Iran (Islamic Rep. of),Nepal,9,0,0,9
24986,2021,Sri Lanka,Nepal,19,0,0,19
24987,2021,Myanmar,Nepal,377,101,0,478
24988,2021,Nepal,Nepal,0,0,0,0
24989,2021,Pakistan,Nepal,186,10,0,196
24990,2021,Somalia,Nepal,21,9,0,30
24991,2021,Yemen,Nepal,0,5,0,5
24992,2021,Stateless,Nepal,0,0,0,0
24993,2021,Tibetan,Nepal,12540,0,0,12540
24994,2021,Afghanistan,Netherlands,6660,829,0,7489
24995,2021,Albania,Netherlands,6,5,0,11
24996,2021,Algeria,Netherlands,19,519,0,538
24997,2021,Angola,Netherlands,21,10,0,31
24998,2021,Egypt,Netherlands,342,141,0,483
24999,2021,Argentina,Netherlands,8,7,0,15
25000,2021,Armenia,Netherlands,141,20,0,161
25001,2021,Azerbaijan,Netherlands,172,72,0,244
25002,2021,Bahrain,Netherlands,12,0,0,12
25003,2021,Burundi,Netherlands,84,10,0,94
25004,2021,Bangladesh,Netherlands,43,6,0,49
25005,2021,Bhutan,Netherlands,42,0,0,42
25006,2021,Burkina Faso,Netherlands,12,5,0,17
25007,2021,Belarus,Netherlands,32,59,0,91
25008,2021,Brazil,Netherlands,0,9,0,9
25009,2021,Bosnia and Herzegovina,Netherlands,6,0,0,6
25010,2021,Cambodia,Netherlands,6,0,0,6
25011,2021,Central African Rep.,Netherlands,7,0,0,7
25012,2021,Chad,Netherlands,5,14,0,19
25013,2021,China,Netherlands,770,105,0,875
25014,2021,Chile,Netherlands,0,5,0,5
25015,2021,Cameroon,Netherlands,71,18,0,89
25016,2021,Congo,Netherlands,225,21,0,246
25017,2021,Dem. Rep. of the Congo,Netherlands,74,14,0,88
25018,2021,Colombia,Netherlands,118,162,0,280
25019,2021,Cuba,Netherlands,52,26,0,78
25020,2021,Eritrea,Netherlands,14699,582,0,15281
25021,2021,Ethiopia,Netherlands,348,152,0,500
25022,2021,Gambia,Netherlands,47,87,0,134
25023,2021,Palestinian,Netherlands,148,21,0,169
25024,2021,Georgia,Netherlands,25,16,0,41
25025,2021,Ghana,Netherlands,8,21,0,29
25026,2021,Guatemala,Netherlands,0,5,0,5
25027,2021,Guinea,Netherlands,393,81,0,474
25028,2021,Guyana,Netherlands,5,0,0,5
25029,2021,Haiti,Netherlands,0,11,0,11
25030,2021,Honduras,Netherlands,6,7,0,13
25031,2021,Cote d'Ivoire,Netherlands,146,8,0,154
25032,2021,India,Netherlands,6,42,0,48
25033,2021,Indonesia,Netherlands,11,0,0,11
25034,2021,Iran (Islamic Rep. of),Netherlands,5438,499,0,5937
25035,2021,Iraq,Netherlands,5998,799,0,6797
25036,2021,Jamaica,Netherlands,179,11,0,190
25037,2021,Jordan,Netherlands,72,41,0,113
25038,2021,Kazakhstan,Netherlands,48,10,0,58
25039,2021,Kenya,Netherlands,28,5,0,33
25040,2021,Kyrgyzstan,Netherlands,12,0,0,12
25041,2021,Rep. of Korea,Netherlands,0,5,0,5
25042,2021,Dem. People's Rep. of Korea,Netherlands,27,5,0,32
25043,2021,Kuwait,Netherlands,5,0,0,5
25044,2021,Liberia,Netherlands,34,13,0,47
25045,2021,Libya,Netherlands,268,76,0,344
25046,2021,Lebanon,Netherlands,118,73,0,191
25047,2021,Sri Lanka,Netherlands,290,44,0,334
25048,2021,Mauritania,Netherlands,6,5,0,11
25049,2021,Rep. of Moldova,Netherlands,5,20,0,25
25050,2021,Mexico,Netherlands,7,0,0,7
25051,2021,Mali,Netherlands,14,8,0,22
25052,2021,Malaysia,Netherlands,8,0,0,8
25053,2021,Mongolia,Netherlands,28,6,0,34
25054,2021,Morocco,Netherlands,75,341,0,416
25055,2021,Myanmar,Netherlands,203,20,0,223
25056,2021,Nepal,Netherlands,101,5,0,106
25057,2021,Niger,Netherlands,5,8,0,13
25058,2021,Nicaragua,Netherlands,40,5,0,45
25059,2021,Nigeria,Netherlands,332,273,0,605
25060,2021,Pakistan,Netherlands,768,310,0,1078
25061,2021,Peru,Netherlands,8,5,0,13
25062,2021,Philippines,Netherlands,6,5,0,11
25063,2021,South Africa,Netherlands,0,5,0,5
25064,2021,Russian Federation,Netherlands,467,121,0,588
25065,2021,Rwanda,Netherlands,32,11,0,43
25066,2021,El Salvador,Netherlands,38,30,0,68
25067,2021,Saudi Arabia,Netherlands,35,20,0,55
25068,2021,Serbia and Kosovo: S/RES/1244 (1999),Netherlands,19,11,0,30
25069,2021,Senegal,Netherlands,17,20,0,37
25070,2021,Sierra Leone,Netherlands,303,60,0,363
25071,2021,Somalia,Netherlands,7284,826,0,8110
25072,2021,Viet Nam,Netherlands,11,7,0,18
25073,2021,Sudan,Netherlands,676,100,0,776
25074,2021,South Sudan,Netherlands,0,8,0,8
25075,2021,Syrian Arab Rep.,Netherlands,39388,6362,0,45750
25076,2021,United Rep. of Tanzania,Netherlands,8,5,0,13
25077,2021,Tajikistan,Netherlands,28,9,0,37
25078,2021,Turkmenistan,Netherlands,18,10,0,28
25079,2021,Togo,Netherlands,14,0,0,14
25080,2021,Trinidad and Tobago,Netherlands,83,12,0,95
25081,2021,Tunisia,Netherlands,23,148,0,171
25082,2021,Türkiye,Netherlands,4394,1834,0,6228
25083,2021,Uganda,Netherlands,488,87,0,575
25084,2021,Ukraine,Netherlands,34,35,0,69
25085,2021,United States of America,Netherlands,32,11,0,43
25086,2021,Uzbekistan,Netherlands,9,15,0,24
25087,2021,Venezuela (Bolivarian Republic of),Netherlands,107,67,0,174
25088,2021,Yemen,Netherlands,1789,973,0,2762
25089,2021,Zambia,Netherlands,8,0,0,8
25090,2021,Zimbabwe,Netherlands,35,0,0,35
25091,2021,Stateless,Netherlands,2531,45,0,2576
25092,2021,Unknown ,Netherlands,2821,592,0,3413
25093,2021,Burkina Faso,Niger,0,0,0,0
25094,2021,Central African Rep.,Niger,142,64,0,206
25095,2021,Chad,Niger,111,3408,0,3519
25096,2021,Cameroon,Niger,21,199,0,220
25097,2021,Congo,Niger,5,0,0,5
25098,2021,Dem. Rep. of the Congo,Niger,49,31,0,80
25099,2021,Eritrea,Niger,72,157,0,229
25100,2021,Ethiopia,Niger,30,19,0,49
25101,2021,Ghana,Niger,0,5,0,5
25102,2021,Guinea,Niger,0,21,0,21
25103,2021,Cote d'Ivoire,Niger,25,14,0,39
25104,2021,Liberia,Niger,0,9,0,9
25105,2021,Libya,Niger,6,0,0,6
25106,2021,Mali,Niger,61490,95,0,61585
25107,2021,Niger,Niger,0,0,224016,0
25108,2021,Nigeria,Niger,187065,11101,0,198166
25109,2021,Pakistan,Niger,0,6,0,6
25110,2021,Rwanda,Niger,12,0,0,12
25111,2021,Sierra Leone,Niger,0,5,0,5
25112,2021,Somalia,Niger,43,34,0,77
25113,2021,Sudan,Niger,850,1292,0,2142
25114,2021,South Sudan,Niger,9,10,0,19
25115,2021,Syrian Arab Rep.,Niger,5,0,0,5
25116,2021,Togo,Niger,5,19,0,24
25117,2021,Yemen,Niger,5,12,0,17
25118,2021,Colombia,Nicaragua,6,0,0,6
25119,2021,Cuba,Nicaragua,14,0,0,14
25120,2021,Guatemala,Nicaragua,7,0,0,7
25121,2021,Honduras,Nicaragua,74,26,0,100
25122,2021,El Salvador,Nicaragua,212,100,0,312
25123,2021,Unknown ,Nicaragua,0,0,0,0
25124,2021,Afghanistan,Nigeria,5,0,0,5
25125,2021,Egypt,Nigeria,0,8,0,8
25126,2021,Benin,Nigeria,5,0,0,5
25127,2021,Central African Rep.,Nigeria,828,293,0,1121
25128,2021,Chad,Nigeria,87,10,0,97
25129,2021,Cameroon,Nigeria,72971,393,0,73364
25130,2021,Congo,Nigeria,5,5,0,10
25131,2021,Dem. Rep. of the Congo,Nigeria,653,111,0,764
25132,2021,Eritrea,Nigeria,40,10,0,50
25133,2021,Ethiopia,Nigeria,8,0,0,8
25134,2021,Palestinian,Nigeria,16,17,0,33
25135,2021,Ghana,Nigeria,5,5,0,10
25136,2021,Guinea-Bissau,Nigeria,5,0,0,5
25137,2021,Guinea,Nigeria,18,5,0,23
25138,2021,Cote d'Ivoire,Nigeria,137,7,0,144
25139,2021,Iran (Islamic Rep. of),Nigeria,5,0,0,5
25140,2021,Liberia,Nigeria,11,0,0,11
25141,2021,Libya,Nigeria,0,5,0,5
25142,2021,Lebanon,Nigeria,5,41,0,46
25143,2021,Mali,Nigeria,143,28,0,171
25144,2021,Niger,Nigeria,1439,0,0,1439
25145,2021,Nigeria,Nigeria,0,0,3084916,0
25146,2021,Sierra Leone,Nigeria,24,0,0,24
25147,2021,Sudan,Nigeria,47,9,0,56
25148,2021,Syrian Arab Rep.,Nigeria,422,482,0,904
25149,2021,Turkmenistan,Nigeria,0,5,0,5
25150,2021,Togo,Nigeria,27,9,0,36
25151,2021,Türkiye,Nigeria,226,210,0,436
25152,2021,Yemen,Nigeria,0,5,0,5
25153,2021,Afghanistan,Norway,3448,151,0,3599
25154,2021,Albania,Norway,18,6,0,24
25155,2021,Algeria,Norway,6,5,0,11
25156,2021,Angola,Norway,5,0,0,5
25157,2021,Egypt,Norway,44,0,0,44
25158,2021,Armenia,Norway,5,0,0,5
25159,2021,Azerbaijan,Norway,14,0,0,14
25160,2021,Burundi,Norway,30,0,0,30
25161,2021,Bangladesh,Norway,5,0,0,5
25162,2021,Belarus,Norway,5,0,0,5
25163,2021,Bulgaria,Norway,5,0,0,5
25164,2021,Central African Rep.,Norway,15,0,0,15
25165,2021,China,Norway,281,104,0,385
25166,2021,Cameroon,Norway,16,7,0,23
25167,2021,Congo,Norway,5,0,0,5
25168,2021,Dem. Rep. of the Congo,Norway,376,0,0,376
25169,2021,Colombia,Norway,8,40,0,48
25170,2021,Eritrea,Norway,11460,83,0,11543
25171,2021,Ethiopia,Norway,1301,67,0,1368
25172,2021,Gambia,Norway,13,0,0,13
25173,2021,Ghana,Norway,7,0,0,7
25174,2021,Guinea-Bissau,Norway,5,0,0,5
25175,2021,Guinea,Norway,30,0,0,30
25176,2021,Honduras,Norway,5,0,0,5
25177,2021,Cote d'Ivoire,Norway,13,0,0,13
25178,2021,Iran (Islamic Rep. of),Norway,1496,146,0,1642
25179,2021,Iraq,Norway,1021,84,0,1105
25180,2021,Israel,Norway,8,0,0,8
25181,2021,Jordan,Norway,5,0,0,5
25182,2021,Kazakhstan,Norway,10,0,0,10
25183,2021,Kenya,Norway,7,0,0,7
25184,2021,Kyrgyzstan,Norway,12,0,0,12
25185,2021,Liberia,Norway,5,0,0,5
25186,2021,Libya,Norway,56,5,0,61
25187,2021,Lebanon,Norway,24,5,0,29
25188,2021,Sri Lanka,Norway,45,5,0,50
25189,2021,Mauritania,Norway,5,0,0,5
25190,2021,Rep. of Moldova,Norway,5,5,0,10
25191,2021,Mali,Norway,8,0,0,8
25192,2021,Morocco,Norway,14,5,0,19
25193,2021,Myanmar,Norway,22,5,0,27
25194,2021,Nepal,Norway,5,0,0,5
25195,2021,Nicaragua,Norway,10,0,0,10
25196,2021,Nigeria,Norway,118,5,0,123
25197,2021,Pakistan,Norway,77,12,0,89
25198,2021,Russian Federation,Norway,311,16,0,327
25199,2021,Rwanda,Norway,15,5,0,20
25200,2021,El Salvador,Norway,9,0,0,9
25201,2021,Saudi Arabia,Norway,8,0,0,8
25202,2021,Serbia and Kosovo: S/RES/1244 (1999),Norway,26,0,0,26
25203,2021,Sierra Leone,Norway,9,0,0,9
25204,2021,Somalia,Norway,3984,29,0,4013
25205,2021,Viet Nam,Norway,38,0,0,38
25206,2021,Sudan,Norway,1703,11,0,1714
25207,2021,South Sudan,Norway,50,0,0,50
25208,2021,Syrian Arab Rep.,Norway,15865,315,0,16180
25209,2021,Tajikistan,Norway,5,0,0,5
25210,2021,Turkmenistan,Norway,5,0,0,5
25211,2021,Tunisia,Norway,5,5,0,10
25212,2021,Türkiye,Norway,1104,61,0,1165
25213,2021,Uganda,Norway,110,0,0,110
25214,2021,Ukraine,Norway,13,0,0,13
25215,2021,Uzbekistan,Norway,155,0,0,155
25216,2021,Venezuela (Bolivarian Republic of),Norway,19,22,0,41
25217,2021,Yemen,Norway,201,5,0,206
25218,2021,Zimbabwe,Norway,9,0,0,9
25219,2021,Stateless,Norway,2297,54,0,2351
25220,2021,Unknown ,Norway,28,5,0,33
25221,2021,Afghanistan,Nauru,28,0,0,28
25222,2021,Bangladesh,Nauru,17,19,0,36
25223,2021,India,Nauru,7,5,0,12
25224,2021,Indonesia,Nauru,5,5,0,10
25225,2021,Iran (Islamic Rep. of),Nauru,508,7,0,515
25226,2021,Iraq,Nauru,42,0,0,42
25227,2021,Kuwait,Nauru,5,0,0,5
25228,2021,Lebanon,Nauru,12,0,0,12
25229,2021,Sri Lanka,Nauru,77,12,0,89
25230,2021,Malaysia,Nauru,5,0,0,5
25231,2021,Myanmar,Nauru,71,0,0,71
25232,2021,Nepal,Nauru,10,6,0,16
25233,2021,Pakistan,Nauru,29,17,0,46
25234,2021,Somalia,Nauru,73,0,0,73
25235,2021,Sudan,Nauru,5,0,0,5
25236,2021,Syrian Arab Rep.,Nauru,0,5,0,5
25237,2021,Stateless,Nauru,59,0,0,59
25238,2021,Afghanistan,New Zealand,65,9,0,74
25239,2021,Egypt,New Zealand,31,5,0,36
25240,2021,Bahrain,New Zealand,10,0,0,10
25241,2021,Burundi,New Zealand,0,5,0,5
25242,2021,Bangladesh,New Zealand,10,15,0,25
25243,2021,Brazil,New Zealand,0,5,0,5
25244,2021,China,New Zealand,255,87,0,342
25245,2021,Chile,New Zealand,5,5,0,10
25246,2021,Cameroon,New Zealand,5,0,0,5
25247,2021,Dem. Rep. of the Congo,New Zealand,5,0,0,5
25248,2021,Colombia,New Zealand,32,9,0,41
25249,2021,Czechia,New Zealand,12,0,0,12
25250,2021,Eritrea,New Zealand,6,0,0,6
25251,2021,Ethiopia,New Zealand,14,0,0,14
25252,2021,Fiji,New Zealand,16,23,0,39
25253,2021,Palestinian,New Zealand,12,5,0,17
25254,2021,Hungary,New Zealand,8,0,0,8
25255,2021,India,New Zealand,14,168,0,182
25256,2021,Indonesia,New Zealand,6,60,0,66
25257,2021,Ireland,New Zealand,0,5,0,5
25258,2021,Iran (Islamic Rep. of),New Zealand,107,13,0,120
25259,2021,Iraq,New Zealand,58,0,0,58
25260,2021,Jordan,New Zealand,8,0,0,8
25261,2021,Kiribati,New Zealand,0,5,0,5
25262,2021,Kuwait,New Zealand,5,0,0,5
25263,2021,Libya,New Zealand,21,0,0,21
25264,2021,Lebanon,New Zealand,0,5,0,5
25265,2021,Sri Lanka,New Zealand,46,52,0,98
25266,2021,Maldives,New Zealand,5,0,0,5
25267,2021,Malaysia,New Zealand,17,21,0,38
25268,2021,Mongolia,New Zealand,6,0,0,6
25269,2021,Myanmar,New Zealand,12,17,0,29
25270,2021,Nepal,New Zealand,5,0,0,5
25271,2021,Pakistan,New Zealand,54,5,0,59
25272,2021,Philippines,New Zealand,10,12,0,22
25273,2021,Papua New Guinea,New Zealand,5,0,0,5
25274,2021,South Africa,New Zealand,7,10,0,17
25275,2021,Russian Federation,New Zealand,32,15,0,47
25276,2021,Saudi Arabia,New Zealand,62,0,0,62
25277,2021,Somalia,New Zealand,10,0,0,10
25278,2021,Viet Nam,New Zealand,7,5,0,12
25279,2021,Sudan,New Zealand,6,5,0,11
25280,2021,Syrian Arab Rep.,New Zealand,72,0,0,72
25281,2021,Thailand,New Zealand,0,7,0,7
25282,2021,Tonga,New Zealand,0,5,0,5
25283,2021,Türkiye,New Zealand,58,6,0,64
25284,2021,Uganda,New Zealand,5,5,0,10
25285,2021,Uruguay,New Zealand,0,7,0,7
25286,2021,United States of America,New Zealand,0,8,0,8
25287,2021,Venezuela (Bolivarian Republic of),New Zealand,5,0,0,5
25288,2021,Yemen,New Zealand,9,0,0,9
25289,2021,Zimbabwe,New Zealand,13,5,0,18
25290,2021,Unknown ,New Zealand,643,102,0,745
25291,2021,Iran (Islamic Rep. of),Oman,0,5,0,5
25292,2021,Iraq,Oman,282,459,0,741
25293,2021,Pakistan,Oman,5,0,0,5
25294,2021,Sudan,Oman,0,6,0,6
25295,2021,Syrian Arab Rep.,Oman,8,27,0,35
25296,2021,Afghanistan,Pakistan,1490562,13260,0,1503822
25297,2021,Algeria,Pakistan,22,0,0,22
25298,2021,China,Pakistan,0,16,0,16
25299,2021,Palestinian,Pakistan,21,0,0,21
25300,2021,India,Pakistan,0,5,0,5
25301,2021,Iran (Islamic Rep. of),Pakistan,39,14,0,53
25302,2021,Iraq,Pakistan,21,7,0,28
25303,2021,Sri Lanka,Pakistan,0,11,0,11
25304,2021,Myanmar,Pakistan,23,31,0,54
25305,2021,Pakistan,Pakistan,0,0,98898,0
25306,2021,Russian Federation,Pakistan,6,0,0,6
25307,2021,Somalia,Pakistan,176,27,0,203
25308,2021,Syrian Arab Rep.,Pakistan,50,23,0,73
25309,2021,United Rep. of Tanzania,Pakistan,0,5,0,5
25310,2021,Tajikistan,Pakistan,7,0,0,7
25311,2021,Türkiye,Pakistan,6,0,0,6
25312,2021,Yemen,Pakistan,137,30,0,167
25313,2021,Stateless,Pakistan,0,0,0,0
25314,2021,Afghanistan,Panama,5,6,0,11
25315,2021,Armenia,Panama,0,5,0,5
25316,2021,Bangladesh,Panama,0,15,0,15
25317,2021,Belarus,Panama,7,0,0,7
25318,2021,Bosnia and Herzegovina,Panama,5,0,0,5
25319,2021,Cameroon,Panama,9,5,0,14
25320,2021,Dem. Rep. of the Congo,Panama,5,0,0,5
25321,2021,Colombia,Panama,1683,1062,0,2745
25322,2021,Cuba,Panama,120,1554,0,1674
25323,2021,Dominican Rep.,Panama,5,0,0,5
25324,2021,Ecuador,Panama,0,15,0,15
25325,2021,Eritrea,Panama,0,38,0,38
25326,2021,Guatemala,Panama,12,8,0,20
25327,2021,Haiti,Panama,19,0,0,19
25328,2021,Honduras,Panama,6,88,0,94
25329,2021,Croatia,Panama,5,0,0,5
25330,2021,Cote d'Ivoire,Panama,0,5,0,5
25331,2021,India,Panama,0,7,0,7
25332,2021,Iran (Islamic Rep. of),Panama,5,0,0,5
25333,2021,Italy,Panama,0,5,0,5
25334,2021,Jamaica,Panama,0,5,0,5
25335,2021,Liberia,Panama,5,0,0,5
25336,2021,Sri Lanka,Panama,0,7,0,7
25337,2021,Mexico,Panama,5,0,0,5
25338,2021,Nepal,Panama,0,14,0,14
25339,2021,Nicaragua,Panama,179,5230,0,5409
25340,2021,Nigeria,Panama,10,34,0,44
25341,2021,Pakistan,Panama,0,16,0,16
25342,2021,Panama,Panama,0,0,0,0
25343,2021,Peru,Panama,23,0,0,23
25344,2021,El Salvador,Panama,363,952,0,1315
25345,2021,Sierra Leone,Panama,5,0,0,5
25346,2021,Somalia,Panama,0,101,0,101
25347,2021,Sudan,Panama,5,0,0,5
25348,2021,Ukraine,Panama,0,5,0,5
25349,2021,Venezuela (Bolivarian Republic of),Panama,61,2453,0,2514
25350,2021,Argentina,Paraguay,0,16,0,16
25351,2021,Bangladesh,Paraguay,0,5,0,5
25352,2021,Bolivia (Plurinational State of),Paraguay,16,16,0,32
25353,2021,Brazil,Paraguay,0,11,0,11
25354,2021,Cameroon,Paraguay,0,5,0,5
25355,2021,Colombia,Paraguay,17,214,0,231
25356,2021,Cuba,Paraguay,927,55,0,982
25357,2021,Dominican Rep.,Paraguay,0,10,0,10
25358,2021,Ecuador,Paraguay,0,5,0,5
25359,2021,Guatemala,Paraguay,0,6,0,6
25360,2021,Haiti,Paraguay,0,5,0,5
25361,2021,Iraq,Paraguay,6,0,0,6
25362,2021,Lebanon,Paraguay,0,6,0,6
25363,2021,Sri Lanka,Paraguay,5,0,0,5
25364,2021,Nigeria,Paraguay,0,5,0,5
25365,2021,Peru,Paraguay,0,23,0,23
25366,2021,South Africa,Paraguay,0,5,0,5
25367,2021,El Salvador,Paraguay,12,5,0,17
25368,2021,Syrian Arab Rep.,Paraguay,84,17,0,101
25369,2021,Türkiye,Paraguay,5,5,0,10
25370,2021,Uruguay,Paraguay,0,6,0,6
25371,2021,Venezuela (Bolivarian Republic of),Paraguay,3412,440,0,3852
25372,2021,Unknown ,Paraguay,0,0,0,0
25373,2021,Afghanistan,Peru,0,5,0,5
25374,2021,Angola,Peru,0,10,0,10
25375,2021,Argentina,Peru,0,15,0,15
25376,2021,Bangladesh,Peru,26,0,0,26
25377,2021,Bolivia (Plurinational State of),Peru,20,30,0,50
25378,2021,Brazil,Peru,5,12,0,17
25379,2021,China,Peru,0,13,0,13
25380,2021,Chile,Peru,0,12,0,12
25381,2021,Cameroon,Peru,20,0,0,20
25382,2021,Congo,Peru,0,9,0,9
25383,2021,Dem. Rep. of the Congo,Peru,8,0,0,8
25384,2021,Colombia,Peru,712,1666,0,2378
25385,2021,Costa Rica,Peru,0,5,0,5
25386,2021,Cuba,Peru,519,2739,0,3258
25387,2021,Dominica,Peru,0,5,0,5
25388,2021,Dominican Rep.,Peru,20,55,0,75
25389,2021,Ecuador,Peru,0,270,0,270
25390,2021,Ethiopia,Peru,5,0,0,5
25391,2021,Gambia,Peru,5,0,0,5
25392,2021,Palestinian,Peru,41,8,0,49
25393,2021,Germany,Peru,0,5,0,5
25394,2021,Ghana,Peru,5,0,0,5
25395,2021,Haiti,Peru,85,56,0,141
25396,2021,Honduras,Peru,0,7,0,7
25397,2021,India,Peru,6,5,0,11
25398,2021,Iran (Islamic Rep. of),Peru,6,0,0,6
25399,2021,Iraq,Peru,42,0,0,42
25400,2021,Italy,Peru,0,5,0,5
25401,2021,Jordan,Peru,0,5,0,5
25402,2021,Sri Lanka,Peru,0,7,0,7
25403,2021,Mexico,Peru,0,11,0,11
25404,2021,Nepal,Peru,0,5,0,5
25405,2021,Nicaragua,Peru,7,7,0,14
25406,2021,Nigeria,Peru,24,18,0,42
25407,2021,Pakistan,Peru,0,10,0,10
25408,2021,Panama,Peru,0,11,0,11
25409,2021,Paraguay,Peru,0,5,0,5
25410,2021,Peru,Peru,0,0,0,0
25411,2021,Philippines,Peru,0,21,0,21
25412,2021,Poland,Peru,0,5,0,5
25413,2021,Portugal,Peru,0,16,0,16
25414,2021,Russian Federation,Peru,0,5,0,5
25415,2021,El Salvador,Peru,10,5,0,15
25416,2021,Spain,Peru,0,19,0,19
25417,2021,Syrian Arab Rep.,Peru,47,11,0,58
25418,2021,Turkmenistan,Peru,0,8,0,8
25419,2021,Türkiye,Peru,46,40,0,86
25420,2021,Ukraine,Peru,17,0,0,17
25421,2021,Uruguay,Peru,0,5,0,5
25422,2021,United States of America,Peru,0,5,0,5
25423,2021,Venezuela (Bolivarian Republic of),Peru,4098,531822,0,535920
25424,2021,Yemen,Peru,0,63,0,63
25425,2021,Anguilla,Peru,0,5,0,5
25426,2021,Unknown ,Peru,16,6,0,22
25427,2021,Afghanistan,Philippines,9,5,0,14
25428,2021,Egypt,Philippines,0,5,0,5
25429,2021,Burundi,Philippines,13,0,0,13
25430,2021,Cambodia,Philippines,13,0,0,13
25431,2021,Chad,Philippines,0,6,0,6
25432,2021,China,Philippines,5,5,0,10
25433,2021,Cameroon,Philippines,34,76,0,110
25434,2021,Congo,Philippines,5,15,0,20
25435,2021,Dem. Rep. of the Congo,Philippines,10,16,0,26
25436,2021,Eritrea,Philippines,21,16,0,37
25437,2021,Ethiopia,Philippines,5,5,0,10
25438,2021,Palestinian,Philippines,59,15,0,74
25439,2021,Ghana,Philippines,5,0,0,5
25440,2021,Guinea,Philippines,0,12,0,12
25441,2021,Cote d'Ivoire,Philippines,28,29,0,57
25442,2021,Iran (Islamic Rep. of),Philippines,73,22,0,95
25443,2021,Iraq,Philippines,55,14,0,69
25444,2021,Liberia,Philippines,5,6,0,11
25445,2021,Libya,Philippines,0,5,0,5
25446,2021,Lebanon,Philippines,5,12,0,17
25447,2021,Sri Lanka,Philippines,18,0,0,18
25448,2021,Malaysia,Philippines,0,5,0,5
25449,2021,Morocco,Philippines,5,0,0,5
25450,2021,Myanmar,Philippines,10,0,0,10
25451,2021,Nigeria,Philippines,6,17,0,23
25452,2021,Pakistan,Philippines,103,25,0,128
25453,2021,Philippines,Philippines,0,0,105214,0
25454,2021,Russian Federation,Philippines,5,0,0,5
25455,2021,Rwanda,Philippines,18,0,0,18
25456,2021,Saudi Arabia,Philippines,0,21,0,21
25457,2021,Somalia,Philippines,30,31,0,61
25458,2021,Viet Nam,Philippines,18,6,0,24
25459,2021,Sudan,Philippines,7,47,0,54
25460,2021,Syrian Arab Rep.,Philippines,130,44,0,174
25461,2021,Thailand,Philippines,5,0,0,5
25462,2021,Türkiye,Philippines,55,21,0,76
25463,2021,United Arab Emirates,Philippines,6,6,0,12
25464,2021,Uganda,Philippines,5,0,0,5
25465,2021,United States of America,Philippines,0,5,0,5
25466,2021,Yemen,Philippines,30,86,0,116
25467,2021,Stateless,Philippines,5,0,0,5
25468,2021,Unknown ,Philippines,0,8,0,8
25469,2021,Afghanistan,Papua New Guinea,30,0,0,30
25470,2021,Bangladesh,Papua New Guinea,15,5,0,20
25471,2021,India,Papua New Guinea,0,5,0,5
25472,2021,Indonesia,Papua New Guinea,11601,28,0,11629
25473,2021,Iran (Islamic Rep. of),Papua New Guinea,74,77,0,151
25474,2021,Iraq,Papua New Guinea,32,5,0,37
25475,2021,Sri Lanka,Papua New Guinea,6,0,0,6
25476,2021,Myanmar,Papua New Guinea,5,0,0,5
25477,2021,Pakistan,Papua New Guinea,27,5,0,32
25478,2021,Papua New Guinea,Papua New Guinea,0,0,24000,0
25479,2021,Somalia,Papua New Guinea,11,0,0,11
25480,2021,Sudan,Papua New Guinea,33,0,0,33
25481,2021,Stateless,Papua New Guinea,5,0,0,5
25482,2021,Afghanistan,Poland,846,305,0,1151
25483,2021,Angola,Poland,0,5,0,5
25484,2021,Egypt,Poland,40,16,0,56
25485,2021,Armenia,Poland,5,13,0,18
25486,2021,Azerbaijan,Poland,10,0,0,10
25487,2021,Bangladesh,Poland,6,0,0,6
25488,2021,Belarus,Poland,1264,1331,0,2595
25489,2021,Bosnia and Herzegovina,Poland,7,0,0,7
25490,2021,Central African Rep.,Poland,5,0,0,5
25491,2021,China,Poland,17,0,0,17
25492,2021,Cameroon,Poland,0,9,0,9
25493,2021,Congo,Poland,6,10,0,16
25494,2021,Dem. Rep. of the Congo,Poland,0,18,0,18
25495,2021,Cuba,Poland,8,26,0,34
25496,2021,Djibouti,Poland,0,5,0,5
25497,2021,Eritrea,Poland,5,0,0,5
25498,2021,Ethiopia,Poland,5,5,0,10
25499,2021,Palestinian,Poland,5,16,0,21
25500,2021,Georgia,Poland,5,22,0,27
25501,2021,Guinea,Poland,5,7,0,12
25502,2021,India,Poland,0,5,0,5
25503,2021,Iran (Islamic Rep. of),Poland,50,45,0,95
25504,2021,Iraq,Poland,113,1116,0,1229
25505,2021,Kazakhstan,Poland,40,10,0,50
25506,2021,Kyrgyzstan,Poland,32,6,0,38
25507,2021,Lao People's Dem. Rep.,Poland,5,0,0,5
25508,2021,Libya,Poland,21,16,0,37
25509,2021,Lebanon,Poland,5,0,0,5
25510,2021,Sri Lanka,Poland,11,0,0,11
25511,2021,Nepal,Poland,7,0,0,7
25512,2021,Nigeria,Poland,7,9,0,16
25513,2021,Pakistan,Poland,29,6,0,35
25514,2021,Russian Federation,Poland,1078,424,0,1502
25515,2021,Rwanda,Poland,5,0,0,5
25516,2021,Sierra Leone,Poland,7,0,0,7
25517,2021,Somalia,Poland,16,63,0,79
25518,2021,Viet Nam,Poland,5,0,0,5
25519,2021,Syrian Arab Rep.,Poland,254,62,0,316
25520,2021,Tajikistan,Poland,148,68,0,216
25521,2021,Turkmenistan,Poland,34,9,0,43
25522,2021,Türkiye,Poland,238,46,0,284
25523,2021,Ukraine,Poland,422,109,0,531
25524,2021,Uzbekistan,Poland,16,0,0,16
25525,2021,Venezuela (Bolivarian Republic of),Poland,17,0,0,17
25526,2021,Yemen,Poland,22,31,0,53
25527,2021,Stateless,Poland,54,5,0,59
25528,2021,Unknown ,Poland,0,5,0,5
25529,2021,Afghanistan,Portugal,121,594,0,715
25530,2021,Albania,Portugal,0,5,0,5
25531,2021,Algeria,Portugal,0,19,0,19
25532,2021,Angola,Portugal,0,223,0,223
25533,2021,Egypt,Portugal,5,18,0,23
25534,2021,Armenia,Portugal,5,0,0,5
25535,2021,Azerbaijan,Portugal,0,5,0,5
25536,2021,Benin,Portugal,0,5,0,5
25537,2021,Bangladesh,Portugal,6,24,0,30
25538,2021,Belarus,Portugal,16,11,0,27
25539,2021,Brazil,Portugal,0,24,0,24
25540,2021,Bosnia and Herzegovina,Portugal,6,0,0,6
25541,2021,Central African Rep.,Portugal,8,0,0,8
25542,2021,China,Portugal,6,0,0,6
25543,2021,Cameroon,Portugal,15,39,0,54
25544,2021,Congo,Portugal,13,8,0,21
25545,2021,Dem. Rep. of the Congo,Portugal,43,51,0,94
25546,2021,Comoros,Portugal,0,5,0,5
25547,2021,Colombia,Portugal,24,21,0,45
25548,2021,Cuba,Portugal,5,10,0,15
25549,2021,Eritrea,Portugal,201,0,0,201
25550,2021,Ethiopia,Portugal,11,0,0,11
25551,2021,Gambia,Portugal,8,118,0,126
25552,2021,Palestinian,Portugal,5,5,0,10
25553,2021,Georgia,Portugal,0,7,0,7
25554,2021,Ghana,Portugal,0,33,0,33
25555,2021,Guinea-Bissau,Portugal,6,112,0,118
25556,2021,Guinea,Portugal,92,111,0,203
25557,2021,Cote d'Ivoire,Portugal,32,26,0,58
25558,2021,India,Portugal,0,67,0,67
25559,2021,Iran (Islamic Rep. of),Portugal,50,27,0,77
25560,2021,Iraq,Portugal,202,0,0,202
25561,2021,Jordan,Portugal,0,14,0,14
25562,2021,Kenya,Portugal,5,5,0,10
25563,2021,Libya,Portugal,15,0,0,15
25564,2021,Sri Lanka,Portugal,33,7,0,40
25565,2021,Mauritania,Portugal,0,5,0,5
25566,2021,Mali,Portugal,15,33,0,48
25567,2021,Morocco,Portugal,9,126,0,135
25568,2021,Mauritius,Portugal,0,5,0,5
25569,2021,Nepal,Portugal,0,5,0,5
25570,2021,Nigeria,Portugal,30,66,0,96
25571,2021,Pakistan,Portugal,80,42,0,122
25572,2021,Russian Federation,Portugal,22,0,0,22
25573,2021,Senegal,Portugal,5,71,0,76
25574,2021,Sierra Leone,Portugal,25,47,0,72
25575,2021,Somalia,Portugal,51,0,0,51
25576,2021,Sudan,Portugal,62,10,0,72
25577,2021,South Sudan,Portugal,30,0,0,30
25578,2021,Syrian Arab Rep.,Portugal,861,0,0,861
25579,2021,Togo,Portugal,7,14,0,21
25580,2021,Türkiye,Portugal,29,13,0,42
25581,2021,Uganda,Portugal,5,0,0,5
25582,2021,Ukraine,Portugal,447,40,0,487
25583,2021,United States of America,Portugal,0,5,0,5
25584,2021,Venezuela (Bolivarian Republic of),Portugal,0,76,0,76
25585,2021,Yemen,Portugal,9,0,0,9
25586,2021,Stateless,Portugal,31,0,0,31
25587,2021,Unknown ,Portugal,0,10,0,10
25588,2021,Afghanistan,Qatar,0,7,0,7
25589,2021,Egypt,Qatar,13,22,0,35
25590,2021,Eritrea,Qatar,0,5,0,5
25591,2021,Palestinian,Qatar,0,7,0,7
25592,2021,Iraq,Qatar,136,126,0,262
25593,2021,Morocco,Qatar,0,5,0,5
25594,2021,Pakistan,Qatar,5,0,0,5
25595,2021,Somalia,Qatar,8,5,0,13
25596,2021,Sudan,Qatar,0,15,0,15
25597,2021,Syrian Arab Rep.,Qatar,30,109,0,139
25598,2021,Yemen,Qatar,5,9,0,14
25599,2021,Stateless,Qatar,0,0,0,0
25600,2021,Afghanistan,Romania,332,734,0,1066
25601,2021,Algeria,Romania,0,6,0,6
25602,2021,Angola,Romania,8,0,0,8
25603,2021,Egypt,Romania,16,7,0,23
25604,2021,Burundi,Romania,8,0,0,8
25605,2021,Bangladesh,Romania,11,72,0,83
25606,2021,Central African Rep.,Romania,5,0,0,5
25607,2021,China,Romania,5,0,0,5
25608,2021,Cameroon,Romania,26,11,0,37
25609,2021,Congo,Romania,5,0,0,5
25610,2021,Dem. Rep. of the Congo,Romania,17,5,0,22
25611,2021,Comoros,Romania,5,0,0,5
25612,2021,Cuba,Romania,5,0,0,5
25613,2021,Eritrea,Romania,77,23,0,100
25614,2021,Ethiopia,Romania,6,5,0,11
25615,2021,Gambia,Romania,5,0,0,5
25616,2021,Palestinian,Romania,58,12,0,70
25617,2021,Guinea-Bissau,Romania,0,5,0,5
25618,2021,Guinea,Romania,11,0,0,11
25619,2021,India,Romania,5,122,0,127
25620,2021,Iran (Islamic Rep. of),Romania,120,14,0,134
25621,2021,Iraq,Romania,529,71,0,600
25622,2021,Jordan,Romania,6,0,0,6
25623,2021,Kuwait,Romania,5,0,0,5
25624,2021,Libya,Romania,5,0,0,5
25625,2021,Lebanon,Romania,10,0,0,10
25626,2021,Sri Lanka,Romania,0,5,0,5
25627,2021,Mali,Romania,5,5,0,10
25628,2021,Morocco,Romania,5,9,0,14
25629,2021,Myanmar,Romania,30,0,0,30
25630,2021,Nepal,Romania,0,5,0,5
25631,2021,Nigeria,Romania,8,8,0,16
25632,2021,Pakistan,Romania,28,45,0,73
25633,2021,Rwanda,Romania,8,5,0,13
25634,2021,Sierra Leone,Romania,5,0,0,5
25635,2021,Somalia,Romania,270,48,0,318
25636,2021,Viet Nam,Romania,0,5,0,5
25637,2021,Sudan,Romania,24,11,0,35
25638,2021,Syrian Arab Rep.,Romania,2258,179,0,2437
25639,2021,Tunisia,Romania,5,20,0,25
25640,2021,Türkiye,Romania,55,59,0,114
25641,2021,Uganda,Romania,5,0,0,5
25642,2021,Ukraine,Romania,17,0,0,17
25643,2021,Yemen,Romania,65,5,0,70
25644,2021,Zimbabwe,Romania,5,0,0,5
25645,2021,Stateless,Romania,127,8,0,135
25646,2021,Afghanistan,South Africa,5,20,0,25
25647,2021,Algeria,South Africa,5,184,0,189
25648,2021,Angola,South Africa,24,11,0,35
25649,2021,Egypt,South Africa,7,228,0,235
25650,2021,Bahrain,South Africa,0,5,0,5
25651,2021,Burundi,South Africa,2611,6752,0,9363
25652,2021,Benin,South Africa,5,36,0,41
25653,2021,Bangladesh,South Africa,200,24561,0,24761
25654,2021,Bahamas,South Africa,0,14,0,14
25655,2021,Burkina Faso,South Africa,0,40,0,40
25656,2021,Central African Rep.,South Africa,9,5,0,14
25657,2021,Chad,South Africa,5,5,0,10
25658,2021,China,South Africa,0,69,0,69
25659,2021,Cameroon,South Africa,323,1684,0,2007
25660,2021,Congo,South Africa,4385,7778,0,12163
25661,2021,Dem. Rep. of the Congo,South Africa,22658,34077,0,56735
25662,2021,Comoros,South Africa,0,14,0,14
25663,2021,Eritrea,South Africa,1395,1033,0,2428
25664,2021,Estonia,South Africa,5,6,0,11
25665,2021,Ethiopia,South Africa,15284,46123,0,61407
25666,2021,Gabon,South Africa,0,11,0,11
25667,2021,Gambia,South Africa,0,5,0,5
25668,2021,Palestinian,South Africa,39,10,0,49
25669,2021,Ghana,South Africa,7,1335,0,1342
25670,2021,Guinea-Bissau,South Africa,0,9,0,9
25671,2021,Guinea,South Africa,0,51,0,51
25672,2021,Cote d'Ivoire,South Africa,26,168,0,194
25673,2021,India,South Africa,5,3994,0,3999
25674,2021,Iraq,South Africa,14,6,0,20
25675,2021,Jordan,South Africa,5,5,0,10
25676,2021,Kenya,South Africa,141,950,0,1091
25677,2021,Liberia,South Africa,47,55,0,102
25678,2021,Lesotho,South Africa,0,18,0,18
25679,2021,Sri Lanka,South Africa,10,17,0,27
25680,2021,Mali,South Africa,5,120,0,125
25681,2021,Malawi,South Africa,8,1520,0,1528
25682,2021,Morocco,South Africa,5,6,0,11
25683,2021,Mozambique,South Africa,0,261,0,261
25684,2021,Nepal,South Africa,0,88,0,88
25685,2021,Niger,South Africa,0,688,0,688
25686,2021,Nigeria,South Africa,11,5207,0,5218
25687,2021,Pakistan,South Africa,11,8559,0,8570
25688,2021,Russian Federation,South Africa,10,0,0,10
25689,2021,Rwanda,South Africa,1014,1040,0,2054
25690,2021,Senegal,South Africa,5,779,0,784
25691,2021,Sierra Leone,South Africa,19,13,0,32
25692,2021,Solomon Islands,South Africa,7,0,0,7
25693,2021,Somalia,South Africa,22529,4551,0,27080
25694,2021,Sudan,South Africa,86,62,0,148
25695,2021,Eswatini,South Africa,7,18,0,25
25696,2021,Syrian Arab Rep.,South Africa,38,20,0,58
25697,2021,United Rep. of Tanzania,South Africa,31,497,0,528
25698,2021,Thailand,South Africa,0,49,0,49
25699,2021,Timor-Leste,South Africa,0,7,0,7
25700,2021,Togo,South Africa,11,30,0,41
25701,2021,Türkiye,South Africa,5,10,0,15
25702,2021,Uganda,South Africa,460,3927,0,4387
25703,2021,Ukraine,South Africa,5,0,0,5
25704,2021,Yemen,South Africa,5,10,0,15
25705,2021,Zambia,South Africa,60,202,0,262
25706,2021,Zimbabwe,South Africa,3965,10468,0,14433
25707,2021,Afghanistan,Russian Federation,921,193,0,1114
25708,2021,Egypt,Russian Federation,6,0,0,6
25709,2021,Armenia,Russian Federation,13,5,0,18
25710,2021,Azerbaijan,Russian Federation,24,0,0,24
25711,2021,Belgium,Russian Federation,0,15,0,15
25712,2021,Bangladesh,Russian Federation,5,0,0,5
25713,2021,China,Russian Federation,23,16,0,39
25714,2021,Cameroon,Russian Federation,5,5,0,10
25715,2021,Congo,Russian Federation,5,0,0,5
25716,2021,Dem. Rep. of the Congo,Russian Federation,14,0,0,14
25717,2021,Cuba,Russian Federation,7,5,0,12
25718,2021,Estonia,Russian Federation,5,0,0,5
25719,2021,Ethiopia,Russian Federation,0,5,0,5
25720,2021,Palestinian,Russian Federation,5,0,0,5
25721,2021,Georgia,Russian Federation,134,5,0,139
25722,2021,Germany,Russian Federation,15,0,0,15
25723,2021,Iran (Islamic Rep. of),Russian Federation,5,0,0,5
25724,2021,Iraq,Russian Federation,16,0,0,16
25725,2021,Israel,Russian Federation,5,0,0,5
25726,2021,Kazakhstan,Russian Federation,31,5,0,36
25727,2021,Kyrgyzstan,Russian Federation,35,5,0,40
25728,2021,Rep. of Korea,Russian Federation,5,0,0,5
25729,2021,Dem. People's Rep. of Korea,Russian Federation,43,5,0,48
25730,2021,Libya,Russian Federation,7,0,0,7
25731,2021,Lebanon,Russian Federation,5,0,0,5
25732,2021,Lithuania,Russian Federation,5,0,0,5
25733,2021,Latvia,Russian Federation,9,0,0,9
25734,2021,Rep. of Moldova,Russian Federation,22,0,0,22
25735,2021,Nigeria,Russian Federation,0,5,0,5
25736,2021,Pakistan,Russian Federation,6,0,0,6
25737,2021,Philippines,Russian Federation,5,0,0,5
25738,2021,Sudan,Russian Federation,5,0,0,5
25739,2021,Syrian Arab Rep.,Russian Federation,297,62,0,359
25740,2021,Tajikistan,Russian Federation,31,28,0,59
25741,2021,Turkmenistan,Russian Federation,51,5,0,56
25742,2021,Türkiye,Russian Federation,5,0,0,5
25743,2021,Ukraine,Russian Federation,8921,126,0,9047
25744,2021,United States of America,Russian Federation,5,0,0,5
25745,2021,Uzbekistan,Russian Federation,80,11,0,91
25746,2021,Yemen,Russian Federation,84,13,0,97
25747,2021,Stateless,Russian Federation,36,5,0,41
25748,2021,Unknown ,Russian Federation,5,5,0,10
25749,2021,Angola,Rwanda,9,0,0,9
25750,2021,Burundi,Rwanda,47884,59,0,47943
25751,2021,Chad,Rwanda,6,0,0,6
25752,2021,Cameroon,Rwanda,0,7,0,7
25753,2021,Dem. Rep. of the Congo,Rwanda,73763,145,0,73908
25754,2021,Eritrea,Rwanda,131,108,0,239
25755,2021,Ethiopia,Rwanda,5,5,0,10
25756,2021,Rwanda,Rwanda,0,0,0,0
25757,2021,Somalia,Rwanda,13,7,0,20
25758,2021,Sudan,Rwanda,78,54,0,132
25759,2021,South Sudan,Rwanda,7,8,0,15
25760,2021,Stateless,Rwanda,0,0,0,0
25761,2021,Colombia,El Salvador,18,7,0,25
25762,2021,Guatemala,El Salvador,0,8,0,8
25763,2021,Honduras,El Salvador,26,11,0,37
25764,2021,Iraq,El Salvador,5,0,0,5
25765,2021,Mexico,El Salvador,5,0,0,5
25766,2021,Nicaragua,El Salvador,22,27,0,49
25767,2021,El Salvador,El Salvador,0,0,71500,0
25768,2021,Syrian Arab Rep.,El Salvador,5,0,0,5
25769,2021,United States of America,El Salvador,5,0,0,5
25770,2021,Venezuela (Bolivarian Republic of),El Salvador,12,13,0,25
25771,2021,Afghanistan,Saudi Arabia,0,231,0,231
25772,2021,Egypt,Saudi Arabia,0,20,0,20
25773,2021,Burkina Faso,Saudi Arabia,0,11,0,11
25774,2021,Chad,Saudi Arabia,9,87,0,96
25775,2021,China,Saudi Arabia,14,25,0,39
25776,2021,Eritrea,Saudi Arabia,36,131,0,167
25777,2021,Ethiopia,Saudi Arabia,0,9,0,9
25778,2021,Palestinian,Saudi Arabia,7,434,0,441
25779,2021,Iran (Islamic Rep. of),Saudi Arabia,0,5,0,5
25780,2021,Iraq,Saudi Arabia,32,197,0,229
25781,2021,Jordan,Saudi Arabia,0,19,0,19
25782,2021,Liberia,Saudi Arabia,9,0,0,9
25783,2021,Libya,Saudi Arabia,0,8,0,8
25784,2021,Lebanon,Saudi Arabia,0,13,0,13
25785,2021,Mali,Saudi Arabia,0,5,0,5
25786,2021,Myanmar,Saudi Arabia,0,115,0,115
25787,2021,Nigeria,Saudi Arabia,0,9,0,9
25788,2021,Pakistan,Saudi Arabia,0,25,0,25
25789,2021,Somalia,Saudi Arabia,16,66,0,82
25790,2021,Sudan,Saudi Arabia,0,96,0,96
25791,2021,South Sudan,Saudi Arabia,0,7,0,7
25792,2021,Syrian Arab Rep.,Saudi Arabia,186,9884,0,10070
25793,2021,Turkmenistan,Saudi Arabia,0,5,0,5
25794,2021,Tunisia,Saudi Arabia,6,6,0,12
25795,2021,Yemen,Saudi Arabia,18,1016,0,1034
25796,2021,Stateless,Saudi Arabia,0,0,0,0
25797,2021,Unknown ,Saudi Arabia,0,25,0,25
25798,2021,Afghanistan,Serbia and Kosovo: S/RES/1244 (1999),27,15,0,42
25799,2021,Algeria,Serbia and Kosovo: S/RES/1244 (1999),0,10,0,10
25800,2021,Burundi,Serbia and Kosovo: S/RES/1244 (1999),8,35,0,43
25801,2021,Bangladesh,Serbia and Kosovo: S/RES/1244 (1999),0,0,0,0
25802,2021,Bosnia and Herzegovina,Serbia and Kosovo: S/RES/1244 (1999),7996,0,0,7996
25803,2021,Bulgaria,Serbia and Kosovo: S/RES/1244 (1999),0,5,0,5
25804,2021,Cameroon,Serbia and Kosovo: S/RES/1244 (1999),0,6,0,6
25805,2021,Congo,Serbia and Kosovo: S/RES/1244 (1999),0,7,0,7
25806,2021,Dem. Rep. of the Congo,Serbia and Kosovo: S/RES/1244 (1999),0,7,0,7
25807,2021,Cuba,Serbia and Kosovo: S/RES/1244 (1999),7,0,0,7
25808,2021,Ethiopia,Serbia and Kosovo: S/RES/1244 (1999),5,0,0,5
25809,2021,Palestinian,Serbia and Kosovo: S/RES/1244 (1999),6,0,0,6
25810,2021,Guinea-Bissau,Serbia and Kosovo: S/RES/1244 (1999),0,7,0,7
25811,2021,Guinea,Serbia and Kosovo: S/RES/1244 (1999),0,5,0,5
25812,2021,Croatia,Serbia and Kosovo: S/RES/1244 (1999),17334,0,0,17334
25813,2021,Iran (Islamic Rep. of),Serbia and Kosovo: S/RES/1244 (1999),19,21,0,40
25814,2021,Iraq,Serbia and Kosovo: S/RES/1244 (1999),16,7,0,23
25815,2021,Jordan,Serbia and Kosovo: S/RES/1244 (1999),0,7,0,7
25816,2021,Libya,Serbia and Kosovo: S/RES/1244 (1999),46,0,0,46
25817,2021,North Macedonia,Serbia and Kosovo: S/RES/1244 (1999),0,0,0,0
25818,2021,Morocco,Serbia and Kosovo: S/RES/1244 (1999),0,26,0,26
25819,2021,Nigeria,Serbia and Kosovo: S/RES/1244 (1999),0,7,0,7
25820,2021,Pakistan,Serbia and Kosovo: S/RES/1244 (1999),5,5,0,10
25821,2021,Russian Federation,Serbia and Kosovo: S/RES/1244 (1999),5,6,0,11
25822,2021,Serbia and Kosovo: S/RES/1244 (1999),Serbia and Kosovo: S/RES/1244 (1999),0,0,211823,0
25823,2021,Somalia,Serbia and Kosovo: S/RES/1244 (1999),7,16,0,23
25824,2021,Sudan,Serbia and Kosovo: S/RES/1244 (1999),5,0,0,5
25825,2021,Syrian Arab Rep.,Serbia and Kosovo: S/RES/1244 (1999),45,9,0,54
25826,2021,Türkiye,Serbia and Kosovo: S/RES/1244 (1999),98,17,0,115
25827,2021,Ukraine,Serbia and Kosovo: S/RES/1244 (1999),15,0,0,15
25828,2021,Stateless,Serbia and Kosovo: S/RES/1244 (1999),0,0,0,0
25829,2021,Unknown ,Serbia and Kosovo: S/RES/1244 (1999),0,5,0,5
25830,2021,Burundi,Senegal,11,8,0,19
25831,2021,Benin,Senegal,0,5,0,5
25832,2021,Burkina Faso,Senegal,0,6,0,6
25833,2021,Central African Rep.,Senegal,220,495,0,715
25834,2021,Chad,Senegal,5,33,0,38
25835,2021,Cameroon,Senegal,0,27,0,27
25836,2021,Congo,Senegal,0,102,0,102
25837,2021,Dem. Rep. of the Congo,Senegal,11,198,0,209
25838,2021,Eritrea,Senegal,0,14,0,14
25839,2021,Gambia,Senegal,31,384,0,415
25840,2021,Ghana,Senegal,0,5,0,5
25841,2021,Guinea-Bissau,Senegal,0,5,0,5
25842,2021,Guinea,Senegal,0,135,0,135
25843,2021,Haiti,Senegal,0,5,0,5
25844,2021,Cote d'Ivoire,Senegal,23,164,0,187
25845,2021,Liberia,Senegal,8,63,0,71
25846,2021,Sri Lanka,Senegal,0,6,0,6
25847,2021,Mauritania,Senegal,14148,77,0,14225
25848,2021,Mali,Senegal,0,71,0,71
25849,2021,Nigeria,Senegal,0,69,0,69
25850,2021,Pakistan,Senegal,0,12,0,12
25851,2021,Rwanda,Senegal,12,7,0,19
25852,2021,Sierra Leone,Senegal,0,51,0,51
25853,2021,Sudan,Senegal,5,8,0,13
25854,2021,Syrian Arab Rep.,Senegal,0,14,0,14
25855,2021,Togo,Senegal,0,32,0,32
25856,2021,Türkiye,Senegal,5,49,0,54
25857,2021,Stateless,Singapore,0,0,0,0
25858,2021,Cote d'Ivoire,Sierra Leone,10,0,0,10
25859,2021,Liberia,Sierra Leone,335,0,0,335
25860,2021,Solomon Islands,Solomon Islands,0,0,1000,0
25861,2021,Egypt,Somalia,0,5,0,5
25862,2021,Bangladesh,Somalia,6,0,0,6
25863,2021,Cameroon,Somalia,5,0,0,5
25864,2021,Djibouti,Somalia,0,7,0,7
25865,2021,Eritrea,Somalia,52,39,0,91
25866,2021,Ethiopia,Somalia,4400,15994,0,20394
25867,2021,Palestinian,Somalia,9,0,0,9
25868,2021,Mozambique,Somalia,0,5,0,5
25869,2021,Somalia,Somalia,0,0,2967500,0
25870,2021,Sudan,Somalia,0,8,0,8
25871,2021,Syrian Arab Rep.,Somalia,991,65,0,1056
25872,2021,United Rep. of Tanzania,Somalia,0,135,0,135
25873,2021,Yemen,Somalia,8341,0,0,8341
25874,2021,Afghanistan,Spain,1188,1060,0,2248
25875,2021,Albania,Spain,5,90,0,95
25876,2021,Algeria,Spain,110,1165,0,1275
25877,2021,Angola,Spain,38,15,0,53
25878,2021,Egypt,Spain,94,175,0,269
25879,2021,Argentina,Spain,18,670,0,688
25880,2021,Armenia,Spain,45,295,0,340
25881,2021,Azerbaijan,Spain,51,65,0,116
25882,2021,Burundi,Spain,8,0,0,8
25883,2021,Benin,Spain,5,15,0,20
25884,2021,Bangladesh,Spain,21,285,0,306
25885,2021,Burkina Faso,Spain,5,245,0,250
25886,2021,Belarus,Spain,9,210,0,219
25887,2021,Bolivia (Plurinational State of),Spain,9,220,0,229
25888,2021,Brazil,Spain,47,1170,0,1217
25889,2021,Bosnia and Herzegovina,Spain,0,5,0,5
25890,2021,Canada,Spain,0,5,0,5
25891,2021,Central African Rep.,Spain,136,40,0,176
25892,2021,Chad,Spain,30,5,0,35
25893,2021,China,Spain,32,900,0,932
25894,2021,Chile,Spain,18,330,0,348
25895,2021,Cameroon,Spain,122,710,0,832
25896,2021,Congo,Spain,69,25,0,94
25897,2021,Dem. Rep. of the Congo,Spain,84,75,0,159
25898,2021,Comoros,Spain,0,5,0,5
25899,2021,Colombia,Spain,2158,20320,0,22478
25900,2021,Costa Rica,Spain,5,70,0,75
25901,2021,Cuba,Spain,136,3065,0,3201
25902,2021,Djibouti,Spain,0,5,0,5
25903,2021,Dominican Rep.,Spain,11,230,0,241
25904,2021,Ecuador,Spain,13,485,0,498
25905,2021,Equatorial Guinea,Spain,30,110,0,140
25906,2021,Eritrea,Spain,309,55,0,364
25907,2021,Ethiopia,Spain,56,25,0,81
25908,2021,France,Spain,0,5,0,5
25909,2021,Gabon,Spain,5,5,0,10
25910,2021,Gambia,Spain,51,525,0,576
25911,2021,Palestinian,Spain,1351,410,0,1761
25912,2021,Georgia,Spain,40,1920,0,1960
25913,2021,Ghana,Spain,11,110,0,121
25914,2021,Guinea-Bissau,Spain,5,125,0,130
25915,2021,Guatemala,Spain,99,610,0,709
25916,2021,Guinea,Spain,187,1230,0,1417
25917,2021,Haiti,Spain,10,170,0,180
25918,2021,Honduras,Spain,1540,6750,0,8290
25919,2021,Cote d'Ivoire,Spain,383,805,0,1188
25920,2021,India,Spain,12,50,0,62
25921,2021,Iran (Islamic Rep. of),Spain,87,190,0,277
25922,2021,Iraq,Spain,296,145,0,441
25923,2021,Israel,Spain,0,15,0,15
25924,2021,Jamaica,Spain,61,20,0,81
25925,2021,Jordan,Spain,27,35,0,62
25926,2021,Kazakhstan,Spain,16,40,0,56
25927,2021,Kenya,Spain,15,5,0,20
25928,2021,Kyrgyzstan,Spain,6,30,0,36
25929,2021,Rep. of Korea,Spain,0,5,0,5
25930,2021,Kuwait,Spain,0,5,0,5
25931,2021,Liberia,Spain,7,45,0,52
25932,2021,Libya,Spain,167,30,0,197
25933,2021,Lebanon,Spain,30,80,0,110
25934,2021,Sri Lanka,Spain,67,30,0,97
25935,2021,Mauritania,Spain,18,195,0,213
25936,2021,North Macedonia,Spain,0,15,0,15
25937,2021,Rep. of Moldova,Spain,0,110,0,110
25938,2021,Mexico,Spain,40,135,0,175
25939,2021,Mali,Spain,1457,6040,0,7497
25940,2021,Mongolia,Spain,5,20,0,25
25941,2021,Morocco,Spain,722,6355,0,7077
25942,2021,Myanmar,Spain,8,5,0,13
25943,2021,Nepal,Spain,0,10,0,10
25944,2021,Niger,Spain,22,10,0,32
25945,2021,Nicaragua,Spain,1797,4805,0,6602
25946,2021,Nigeria,Spain,162,1395,0,1557
25947,2021,Oman,Spain,0,5,0,5
25948,2021,Pakistan,Spain,458,610,0,1068
25949,2021,Panama,Spain,19,120,0,139
25950,2021,Paraguay,Spain,57,750,0,807
25951,2021,Peru,Spain,285,3325,0,3610
25952,2021,Philippines,Spain,0,15,0,15
25953,2021,South Africa,Spain,5,0,0,5
25954,2021,Russian Federation,Spain,450,1870,0,2320
25955,2021,Rwanda,Spain,5,0,0,5
25956,2021,El Salvador,Spain,859,3540,0,4399
25957,2021,Saudi Arabia,Spain,5,5,0,10
25958,2021,Serbia and Kosovo: S/RES/1244 (1999),Spain,5,30,0,35
25959,2021,Senegal,Spain,41,3065,0,3106
25960,2021,Sierra Leone,Spain,28,40,0,68
25961,2021,Somalia,Spain,686,225,0,911
25962,2021,Viet Nam,Spain,7,30,0,37
25963,2021,Sudan,Spain,322,140,0,462
25964,2021,South Sudan,Spain,5,5,0,10
25965,2021,Syrian Arab Rep.,Spain,14987,1605,0,16592
25966,2021,Tajikistan,Spain,5,15,0,20
25967,2021,Turkmenistan,Spain,0,5,0,5
25968,2021,Togo,Spain,5,40,0,45
25969,2021,Trinidad and Tobago,Spain,5,5,0,10
25970,2021,Tunisia,Spain,65,440,0,505
25971,2021,Türkiye,Spain,167,475,0,642
25972,2021,United Arab Emirates,Spain,0,5,0,5
25973,2021,Uganda,Spain,7,5,0,12
25974,2021,Ukraine,Spain,1515,2820,0,4335
25975,2021,Uruguay,Spain,7,335,0,342
25976,2021,United States of America,Spain,19,85,0,104
25977,2021,Uzbekistan,Spain,13,10,0,23
25978,2021,Venezuela (Bolivarian Republic of),Spain,88492,19205,0,107697
25979,2021,Western Sahara,Spain,20,0,0,20
25980,2021,Yemen,Spain,392,325,0,717
25981,2021,Stateless,Spain,0,10,0,10
25982,2021,Tibetan,Spain,5,0,0,5
25983,2021,Unknown ,Spain,32,60,0,92
25984,2021,Stateless,Viet Nam,0,0,0,0
25985,2021,Venezuela (Bolivarian Republic of),Saint Kitts and Nevis,0,0,0,0
25986,2021,Afghanistan,Sudan,0,0,0,0
25987,2021,Egypt,Sudan,17,11,0,28
25988,2021,Argentina,Sudan,0,0,0,0
25989,2021,Burundi,Sudan,11,7,0,18
25990,2021,Central African Rep.,Sudan,27613,6,0,27619
25991,2021,Chad,Sudan,3931,5,0,3936
25992,2021,Cameroon,Sudan,7,0,0,7
25993,2021,Congo,Sudan,18,5,0,23
25994,2021,Dem. Rep. of the Congo,Sudan,492,352,0,844
25995,2021,Eritrea,Sudan,115678,11063,0,126741
25996,2021,Ethiopia,Sudan,56806,14533,0,71339
25997,2021,Palestinian,Sudan,49,25,0,74
25998,2021,India,Sudan,0,5,0,5
25999,2021,Iraq,Sudan,9,13,0,22
26000,2021,Jordan,Sudan,0,0,0,0
26001,2021,Kuwait,Sudan,0,0,0,0
26002,2021,Nigeria,Sudan,12,0,0,12
26003,2021,Saudi Arabia,Sudan,0,0,0,0
26004,2021,Somalia,Sudan,354,205,0,559
26005,2021,Sudan,Sudan,0,0,3036590,0
26006,2021,South Sudan,Sudan,803634,0,0,803634
26007,2021,Syrian Arab Rep.,Sudan,93482,0,0,93482
26008,2021,Türkiye,Sudan,5,0,0,5
26009,2021,Uganda,Sudan,5,0,0,5
26010,2021,Yemen,Sudan,1795,389,0,2184
26011,2021,Colombia,Suriname,0,6,0,6
26012,2021,Cuba,Suriname,17,1777,0,1794
26013,2021,Dominican Rep.,Suriname,0,9,0,9
26014,2021,Guyana,Suriname,0,5,0,5
26015,2021,Nigeria,Suriname,0,5,0,5
26016,2021,Venezuela (Bolivarian Republic of),Suriname,12,331,0,343
26017,2021,Burundi,South Sudan,182,878,0,1060
26018,2021,Central African Rep.,South Sudan,2457,0,0,2457
26019,2021,Cameroon,South Sudan,0,5,0,5
26020,2021,Dem. Rep. of the Congo,South Sudan,17958,19,0,17977
26021,2021,Eritrea,South Sudan,365,2614,0,2979
26022,2021,Ethiopia,South Sudan,4532,749,0,5281
26023,2021,Somalia,South Sudan,5,30,0,35
26024,2021,Sudan,South Sudan,308174,19,0,308193
26025,2021,South Sudan,South Sudan,0,0,2017236,0
26026,2021,Stateless,South Sudan,0,0,0,0
26027,2021,Afghanistan,Slovakia,319,23,0,342
26028,2021,Angola,Slovakia,24,0,0,24
26029,2021,Egypt,Slovakia,5,0,0,5
26030,2021,Armenia,Slovakia,34,0,0,34
26031,2021,Burundi,Slovakia,5,0,0,5
26032,2021,Bosnia and Herzegovina,Slovakia,36,0,0,36
26033,2021,Bulgaria,Slovakia,8,0,0,8
26034,2021,Cambodia,Slovakia,5,0,0,5
26035,2021,China,Slovakia,5,0,0,5
26036,2021,Cameroon,Slovakia,9,0,0,9
26037,2021,Dem. Rep. of the Congo,Slovakia,16,0,0,16
26038,2021,Cuba,Slovakia,32,0,0,32
26039,2021,Palestinian,Slovakia,7,0,0,7
26040,2021,Iran (Islamic Rep. of),Slovakia,39,0,0,39
26041,2021,Iraq,Slovakia,214,0,0,214
26042,2021,Liberia,Slovakia,5,0,0,5
26043,2021,Libya,Slovakia,7,0,0,7
26044,2021,Sri Lanka,Slovakia,0,9,0,9
26045,2021,Morocco,Slovakia,0,11,0,11
26046,2021,Pakistan,Slovakia,8,0,0,8
26047,2021,Romania,Slovakia,37,0,0,37
26048,2021,Russian Federation,Slovakia,38,0,0,38
26049,2021,Serbia and Kosovo: S/RES/1244 (1999),Slovakia,46,0,0,46
26050,2021,Somalia,Slovakia,34,0,0,34
26051,2021,Viet Nam,Slovakia,16,0,0,16
26052,2021,Syrian Arab Rep.,Slovakia,25,0,0,25
26053,2021,Türkiye,Slovakia,5,0,0,5
26054,2021,Uganda,Slovakia,5,0,0,5
26055,2021,Ukraine,Slovakia,24,0,0,24
26056,2021,Uzbekistan,Slovakia,5,0,0,5
26057,2021,Yemen,Slovakia,24,0,0,24
26058,2021,Stateless,Slovakia,9,0,0,9
26059,2021,Afghanistan,Slovenia,60,339,0,399
26060,2021,Algeria,Slovenia,0,13,0,13
26061,2021,Bangladesh,Slovenia,0,23,0,23
26062,2021,Bosnia and Herzegovina,Slovenia,6,0,0,6
26063,2021,Cameroon,Slovenia,6,8,0,14
26064,2021,Dem. Rep. of the Congo,Slovenia,6,0,0,6
26065,2021,Cuba,Slovenia,0,24,0,24
26066,2021,Eritrea,Slovenia,86,0,0,86
26067,2021,Palestinian,Slovenia,26,5,0,31
26068,2021,India,Slovenia,0,8,0,8
26069,2021,Iran (Islamic Rep. of),Slovenia,80,19,0,99
26070,2021,Iraq,Slovenia,53,24,0,77
26071,2021,Kazakhstan,Slovenia,20,0,0,20
26072,2021,Morocco,Slovenia,0,12,0,12
26073,2021,Nepal,Slovenia,0,10,0,10
26074,2021,Nigeria,Slovenia,6,5,0,11
26075,2021,Pakistan,Slovenia,5,29,0,34
26076,2021,Russian Federation,Slovenia,21,0,0,21
26077,2021,Serbia and Kosovo: S/RES/1244 (1999),Slovenia,11,8,0,19
26078,2021,Somalia,Slovenia,51,0,0,51
26079,2021,Sudan,Slovenia,6,0,0,6
26080,2021,Syrian Arab Rep.,Slovenia,326,13,0,339
26081,2021,Tunisia,Slovenia,0,5,0,5
26082,2021,Türkiye,Slovenia,59,27,0,86
26083,2021,Ukraine,Slovenia,5,0,0,5
26084,2021,Yemen,Slovenia,6,0,0,6
26085,2021,Stateless,Slovenia,0,0,0,0
26086,2021,Unknown ,Slovenia,0,0,0,0
26087,2021,Angola,Eswatini,12,0,0,12
26088,2021,Burundi,Eswatini,175,84,0,259
26089,2021,Cameroon,Eswatini,0,6,0,6
26090,2021,Congo,Eswatini,5,7,0,12
26091,2021,Dem. Rep. of the Congo,Eswatini,426,210,0,636
26092,2021,Eritrea,Eswatini,0,5,0,5
26093,2021,Ethiopia,Eswatini,12,40,0,52
26094,2021,Rwanda,Eswatini,145,91,0,236
26095,2021,Somalia,Eswatini,107,198,0,305
26096,2021,Eswatini,Eswatini,0,0,0,0
26097,2021,United Rep. of Tanzania,Eswatini,0,5,0,5
26098,2021,Uganda,Eswatini,6,0,0,6
26099,2021,Zimbabwe,Eswatini,7,0,0,7
26100,2021,Afghanistan,Sweden,27562,1824,0,29386
26101,2021,Albania,Sweden,290,155,0,445
26102,2021,Algeria,Sweden,55,69,0,124
26103,2021,Angola,Sweden,21,13,0,34
26104,2021,Egypt,Sweden,422,154,0,576
26105,2021,Argentina,Sweden,0,5,0,5
26106,2021,Armenia,Sweden,291,120,0,411
26107,2021,Azerbaijan,Sweden,585,216,0,801
26108,2021,Bahrain,Sweden,16,0,0,16
26109,2021,Burundi,Sweden,221,24,0,245
26110,2021,Benin,Sweden,10,0,0,10
26111,2021,Bangladesh,Sweden,250,152,0,402
26112,2021,Burkina Faso,Sweden,5,0,0,5
26113,2021,Belarus,Sweden,97,83,0,180
26114,2021,Bolivia (Plurinational State of),Sweden,51,5,0,56
26115,2021,Brazil,Sweden,6,19,0,25
26116,2021,Bosnia and Herzegovina,Sweden,58,56,0,114
26117,2021,Bulgaria,Sweden,5,0,0,5
26118,2021,Central African Rep.,Sweden,71,0,0,71
26119,2021,Chad,Sweden,18,0,0,18
26120,2021,China,Sweden,248,30,0,278
26121,2021,Chile,Sweden,9,17,0,26
26122,2021,Cameroon,Sweden,231,135,0,366
26123,2021,Congo,Sweden,28,18,0,46
26124,2021,Dem. Rep. of the Congo,Sweden,824,65,0,889
26125,2021,Comoros,Sweden,5,0,0,5
26126,2021,Colombia,Sweden,40,126,0,166
26127,2021,Cuba,Sweden,23,17,0,40
26128,2021,Djibouti,Sweden,30,17,0,47
26129,2021,Ecuador,Sweden,5,5,0,10
26130,2021,Equatorial Guinea,Sweden,5,0,0,5
26131,2021,Eritrea,Sweden,26428,349,0,26777
26132,2021,Ethiopia,Sweden,2500,399,0,2899
26133,2021,Gambia,Sweden,179,78,0,257
26134,2021,Palestinian,Sweden,1322,488,0,1810
26135,2021,United Kingdom of Great Britain and Northern Ireland,Sweden,5,0,0,5
26136,2021,Georgia,Sweden,88,135,0,223
26137,2021,Ghana,Sweden,57,50,0,107
26138,2021,Guinea-Bissau,Sweden,8,5,0,13
26139,2021,Greece,Sweden,18,0,0,18
26140,2021,Guatemala,Sweden,11,0,0,11
26141,2021,Guinea,Sweden,66,15,0,81
26142,2021,Honduras,Sweden,29,10,0,39
26143,2021,Croatia,Sweden,0,5,0,5
26144,2021,Hungary,Sweden,5,0,0,5
26145,2021,Cote d'Ivoire,Sweden,30,8,0,38
26146,2021,India,Sweden,20,36,0,56
26147,2021,Indonesia,Sweden,15,0,0,15
26148,2021,Iran (Islamic Rep. of),Sweden,7350,800,0,8150
26149,2021,Iraq,Sweden,10643,1242,0,11885
26150,2021,Israel,Sweden,22,5,0,27
26151,2021,Jamaica,Sweden,5,0,0,5
26152,2021,Jordan,Sweden,279,137,0,416
26153,2021,Kazakhstan,Sweden,203,101,0,304
26154,2021,Kenya,Sweden,82,38,0,120
26155,2021,Kyrgyzstan,Sweden,154,63,0,217
26156,2021,Rep. of Korea,Sweden,7,5,0,12
26157,2021,Kuwait,Sweden,32,0,0,32
26158,2021,Liberia,Sweden,10,5,0,15
26159,2021,Libya,Sweden,263,53,0,316
26160,2021,Lebanon,Sweden,509,227,0,736
26161,2021,Sri Lanka,Sweden,27,27,0,54
26162,2021,Lithuania,Sweden,0,7,0,7
26163,2021,Mauritania,Sweden,13,0,0,13
26164,2021,North Macedonia,Sweden,36,23,0,59
26165,2021,Rep. of Moldova,Sweden,8,13,0,21
26166,2021,Mexico,Sweden,0,5,0,5
26167,2021,Mali,Sweden,41,5,0,46
26168,2021,Malaysia,Sweden,14,0,0,14
26169,2021,Mongolia,Sweden,240,139,0,379
26170,2021,Morocco,Sweden,256,148,0,404
26171,2021,Mozambique,Sweden,0,5,0,5
26172,2021,Montenegro,Sweden,21,18,0,39
26173,2021,Myanmar,Sweden,6,5,0,11
26174,2021,Nepal,Sweden,9,5,0,14
26175,2021,Niger,Sweden,5,0,0,5
26176,2021,Nicaragua,Sweden,63,40,0,103
26177,2021,Nigeria,Sweden,598,327,0,925
26178,2021,Pakistan,Sweden,609,203,0,812
26179,2021,Peru,Sweden,7,38,0,45
26180,2021,Philippines,Sweden,6,12,0,18
26181,2021,Romania,Sweden,38,5,0,43
26182,2021,Russian Federation,Sweden,1314,354,0,1668
26183,2021,Rwanda,Sweden,55,31,0,86
26184,2021,El Salvador,Sweden,142,43,0,185
26185,2021,Saudi Arabia,Sweden,60,0,0,60
26186,2021,Serbia and Kosovo: S/RES/1244 (1999),Sweden,517,231,0,748
26187,2021,Senegal,Sweden,57,27,0,84
26188,2021,Sierra Leone,Sweden,68,10,0,78
26189,2021,Somalia,Sweden,10330,528,0,10858
26190,2021,Viet Nam,Sweden,19,40,0,59
26191,2021,Sudan,Sweden,1091,89,0,1180
26192,2021,South Sudan,Sweden,63,0,0,63
26193,2021,Eswatini,Sweden,5,0,0,5
26194,2021,Syrian Arab Rep.,Sweden,115233,1510,0,116743
26195,2021,United Rep. of Tanzania,Sweden,65,39,0,104
26196,2021,Thailand,Sweden,0,10,0,10
26197,2021,Tajikistan,Sweden,62,25,0,87
26198,2021,Turkmenistan,Sweden,16,10,0,26
26199,2021,Tunisia,Sweden,44,45,0,89
26200,2021,Türkiye,Sweden,2303,539,0,2842
26201,2021,United Arab Emirates,Sweden,5,0,0,5
26202,2021,Uganda,Sweden,748,79,0,827
26203,2021,Ukraine,Sweden,226,334,0,560
26204,2021,United States of America,Sweden,21,7,0,28
26205,2021,Uzbekistan,Sweden,495,453,0,948
26206,2021,Venezuela (Bolivarian Republic of),Sweden,41,41,0,82
26207,2021,Yemen,Sweden,1727,62,0,1789
26208,2021,Zambia,Sweden,13,0,0,13
26209,2021,Zimbabwe,Sweden,16,5,0,21
26210,2021,Stateless,Sweden,21762,560,0,22322
26211,2021,Unknown ,Sweden,537,278,0,815
26212,2021,Afghanistan,Switzerland,15060,1500,0,16560
26213,2021,Albania,Switzerland,114,51,0,165
26214,2021,Algeria,Switzerland,173,211,0,384
26215,2021,Angola,Switzerland,703,46,0,749
26216,2021,Egypt,Switzerland,140,11,0,151
26217,2021,Armenia,Switzerland,163,24,0,187
26218,2021,Azerbaijan,Switzerland,207,70,0,277
26219,2021,Burundi,Switzerland,189,5,0,194
26220,2021,Benin,Switzerland,24,0,0,24
26221,2021,Bangladesh,Switzerland,43,7,0,50
26222,2021,Burkina Faso,Switzerland,22,0,0,22
26223,2021,Belarus,Switzerland,52,19,0,71
26224,2021,Brazil,Switzerland,14,0,0,14
26225,2021,Bosnia and Herzegovina,Switzerland,1483,12,0,1495
26226,2021,Bulgaria,Switzerland,5,0,0,5
26227,2021,Cambodia,Switzerland,279,0,0,279
26228,2021,Central African Rep.,Switzerland,19,0,0,19
26229,2021,Chad,Switzerland,35,14,0,49
26230,2021,China,Switzerland,2443,76,0,2519
26231,2021,Chile,Switzerland,9,0,0,9
26232,2021,Cameroon,Switzerland,201,39,0,240
26233,2021,Congo,Switzerland,49,5,0,54
26234,2021,Dem. Rep. of the Congo,Switzerland,1204,65,0,1269
26235,2021,Colombia,Switzerland,288,98,0,386
26236,2021,Cuba,Switzerland,41,7,0,48
26237,2021,Czechia,Switzerland,5,0,0,5
26238,2021,Djibouti,Switzerland,17,0,0,17
26239,2021,Ecuador,Switzerland,5,0,0,5
26240,2021,Equatorial Guinea,Switzerland,5,0,0,5
26241,2021,Eritrea,Switzerland,38588,278,0,38866
26242,2021,Ethiopia,Switzerland,1781,146,0,1927
26243,2021,France,Switzerland,8,0,0,8
26244,2021,Gabon,Switzerland,5,0,0,5
26245,2021,Gambia,Switzerland,53,12,0,65
26246,2021,United Kingdom of Great Britain and Northern Ireland,Switzerland,5,0,0,5
26247,2021,Georgia,Switzerland,243,192,0,435
26248,2021,Germany,Switzerland,5,0,0,5
26249,2021,Ghana,Switzerland,23,15,0,38
26250,2021,Guinea-Bissau,Switzerland,47,0,0,47
26251,2021,Guatemala,Switzerland,7,0,0,7
26252,2021,Guinea,Switzerland,188,27,0,215
26253,2021,Honduras,Switzerland,5,7,0,12
26254,2021,Croatia,Switzerland,16,0,0,16
26255,2021,Hungary,Switzerland,5,0,0,5
26256,2021,Cote d'Ivoire,Switzerland,198,17,0,215
26257,2021,India,Switzerland,33,9,0,42
26258,2021,Indonesia,Switzerland,0,5,0,5
26259,2021,Iran (Islamic Rep. of),Switzerland,2246,675,0,2921
26260,2021,Iraq,Switzerland,4488,445,0,4933
26261,2021,Israel,Switzerland,5,0,0,5
26262,2021,Italy,Switzerland,6,5,0,11
26263,2021,Jamaica,Switzerland,7,0,0,7
26264,2021,Jordan,Switzerland,57,7,0,64
26265,2021,Kazakhstan,Switzerland,28,9,0,37
26266,2021,Kenya,Switzerland,42,0,0,42
26267,2021,Kyrgyzstan,Switzerland,16,11,0,27
26268,2021,Lao People's Dem. Rep.,Switzerland,107,0,0,107
26269,2021,Liberia,Switzerland,32,0,0,32
26270,2021,Libya,Switzerland,304,33,0,337
26271,2021,Lebanon,Switzerland,47,23,0,70
26272,2021,Sri Lanka,Switzerland,6059,659,0,6718
26273,2021,Madagascar,Switzerland,5,0,0,5
26274,2021,Mauritania,Switzerland,9,0,0,9
26275,2021,North Macedonia,Switzerland,155,31,0,186
26276,2021,Rep. of Moldova,Switzerland,10,0,0,10
26277,2021,Mali,Switzerland,33,5,0,38
26278,2021,Mongolia,Switzerland,176,9,0,185
26279,2021,Morocco,Switzerland,85,96,0,181
26280,2021,Montenegro,Switzerland,51,9,0,60
26281,2021,Myanmar,Switzerland,41,5,0,46
26282,2021,Nepal,Switzerland,18,5,0,23
26283,2021,Netherlands,Switzerland,5,0,0,5
26284,2021,Niger,Switzerland,8,0,0,8
26285,2021,Nicaragua,Switzerland,7,8,0,15
26286,2021,Nigeria,Switzerland,282,71,0,353
26287,2021,Pakistan,Switzerland,296,95,0,391
26288,2021,Paraguay,Switzerland,5,0,0,5
26289,2021,Peru,Switzerland,5,5,0,10
26290,2021,Philippines,Switzerland,12,0,0,12
26291,2021,Portugal,Switzerland,5,0,0,5
26292,2021,Romania,Switzerland,14,0,0,14
26293,2021,South Africa,Switzerland,7,0,0,7
26294,2021,Russian Federation,Switzerland,738,77,0,815
26295,2021,Rwanda,Switzerland,103,11,0,114
26296,2021,El Salvador,Switzerland,8,5,0,13
26297,2021,Saudi Arabia,Switzerland,18,5,0,23
26298,2021,Serbia and Kosovo: S/RES/1244 (1999),Switzerland,2110,44,0,2154
26299,2021,Senegal,Switzerland,66,11,0,77
26300,2021,Sierra Leone,Switzerland,39,5,0,44
26301,2021,Somalia,Switzerland,4459,150,0,4609
26302,2021,Spain,Switzerland,5,0,0,5
26303,2021,Viet Nam,Switzerland,760,0,0,760
26304,2021,Sudan,Switzerland,525,13,0,538
26305,2021,South Sudan,Switzerland,53,0,0,53
26306,2021,Syrian Arab Rep.,Switzerland,20146,255,0,20401
26307,2021,United Rep. of Tanzania,Switzerland,14,0,0,14
26308,2021,Tajikistan,Switzerland,26,5,0,31
26309,2021,Turkmenistan,Switzerland,5,0,0,5
26310,2021,Togo,Switzerland,527,12,0,539
26311,2021,Tunisia,Switzerland,177,38,0,215
26312,2021,Türkiye,Switzerland,7234,1118,0,8352
26313,2021,Uganda,Switzerland,58,20,0,78
26314,2021,Ukraine,Switzerland,91,29,0,120
26315,2021,Uzbekistan,Switzerland,57,0,0,57
26316,2021,Venezuela (Bolivarian Republic of),Switzerland,53,45,0,98
26317,2021,Western Sahara,Switzerland,8,0,0,8
26318,2021,Yemen,Switzerland,345,13,0,358
26319,2021,Zimbabwe,Switzerland,9,6,0,15
26320,2021,Stateless,Switzerland,671,0,0,671
26321,2021,Unknown ,Switzerland,1649,73,0,1722
26322,2021,Afghanistan,Syrian Arab Rep.,1119,30,0,1149
26323,2021,Algeria,Syrian Arab Rep.,5,0,0,5
26324,2021,Egypt,Syrian Arab Rep.,32,10,0,42
26325,2021,Bahrain,Syrian Arab Rep.,0,5,0,5
26326,2021,Burkina Faso,Syrian Arab Rep.,0,5,0,5
26327,2021,Chad,Syrian Arab Rep.,9,6,0,15
26328,2021,Eritrea,Syrian Arab Rep.,19,0,0,19
26329,2021,Ethiopia,Syrian Arab Rep.,12,0,0,12
26330,2021,Guinea,Syrian Arab Rep.,54,5,0,59
26331,2021,Iran (Islamic Rep. of),Syrian Arab Rep.,43,12,0,55
26332,2021,Iraq,Syrian Arab Rep.,11394,8406,0,19800
26333,2021,Jordan,Syrian Arab Rep.,19,0,0,19
26334,2021,Libya,Syrian Arab Rep.,9,10,0,19
26335,2021,Lebanon,Syrian Arab Rep.,24,10,0,34
26336,2021,Sri Lanka,Syrian Arab Rep.,0,5,0,5
26337,2021,Morocco,Syrian Arab Rep.,0,5,0,5
26338,2021,Pakistan,Syrian Arab Rep.,221,5,0,226
26339,2021,Saudi Arabia,Syrian Arab Rep.,6,0,0,6
26340,2021,Sierra Leone,Syrian Arab Rep.,20,0,0,20
26341,2021,Somalia,Syrian Arab Rep.,345,22,0,367
26342,2021,Sudan,Syrian Arab Rep.,726,82,0,808
26343,2021,South Sudan,Syrian Arab Rep.,74,0,0,74
26344,2021,Syrian Arab Rep.,Syrian Arab Rep.,0,0,6865308,0
26345,2021,United Rep. of Tanzania,Syrian Arab Rep.,0,7,0,7
26346,2021,Tunisia,Syrian Arab Rep.,5,5,0,10
26347,2021,Türkiye,Syrian Arab Rep.,6,8,0,14
26348,2021,Yemen,Syrian Arab Rep.,161,127,0,288
26349,2021,Stateless,Syrian Arab Rep.,0,0,0,0
26350,2021,Unknown ,Syrian Arab Rep.,5,0,0,5
26351,2021,Burundi,United Rep. of Tanzania,155172,8893,0,164065
26352,2021,Dem. Rep. of the Congo,United Rep. of Tanzania,51647,18746,0,70393
26353,2021,Iran (Islamic Rep. of),United Rep. of Tanzania,5,5,0,10
26354,2021,Lebanon,United Rep. of Tanzania,5,0,0,5
26355,2021,Rwanda,United Rep. of Tanzania,69,30,0,99
26356,2021,Somalia,United Rep. of Tanzania,162,0,0,162
26357,2021,Sudan,United Rep. of Tanzania,0,6,0,6
26358,2021,South Sudan,United Rep. of Tanzania,6,0,0,6
26359,2021,Syrian Arab Rep.,United Rep. of Tanzania,5,19,0,24
26360,2021,United Rep. of Tanzania,United Rep. of Tanzania,6,0,0,6
26361,2021,Türkiye,United Rep. of Tanzania,0,10,0,10
26362,2021,Uganda,United Rep. of Tanzania,15,5,0,20
26363,2021,Yemen,United Rep. of Tanzania,9,55,0,64
26364,2021,Sri Lanka,Turks and Caicos Islands,7,0,0,7
26365,2021,Afghanistan,Thailand,168,5,0,173
26366,2021,Egypt,Thailand,17,0,0,17
26367,2021,Cambodia,Thailand,317,85,0,402
26368,2021,China,Thailand,181,13,0,194
26369,2021,Cameroon,Thailand,53,15,0,68
26370,2021,Dem. Rep. of the Congo,Thailand,20,0,0,20
26371,2021,Ethiopia,Thailand,12,5,0,17
26372,2021,Palestinian,Thailand,265,5,0,270
26373,2021,Guinea,Thailand,0,5,0,5
26374,2021,Cote d'Ivoire,Thailand,18,0,0,18
26375,2021,Iran (Islamic Rep. of),Thailand,87,14,0,101
26376,2021,Iraq,Thailand,157,0,0,157
26377,2021,Jordan,Thailand,5,0,0,5
26378,2021,Lao People's Dem. Rep.,Thailand,8,0,0,8
26379,2021,Sri Lanka,Thailand,106,19,0,125
26380,2021,Morocco,Thailand,0,5,0,5
26381,2021,Myanmar,Thailand,96086,0,0,96086
26382,2021,Nepal,Thailand,5,0,0,5
26383,2021,Nigeria,Thailand,5,11,0,16
26384,2021,Pakistan,Thailand,1578,84,0,1662
26385,2021,Somalia,Thailand,196,10,0,206
26386,2021,Viet Nam,Thailand,961,396,0,1357
26387,2021,Syrian Arab Rep.,Thailand,215,5,0,220
26388,2021,United Rep. of Tanzania,Thailand,5,0,0,5
26389,2021,Yemen,Thailand,36,0,0,36
26390,2021,Zimbabwe,Thailand,9,0,0,9
26391,2021,Stateless,Thailand,0,0,0,0
26392,2021,Afghanistan,Tajikistan,10719,3046,0,13765
26393,2021,Iran (Islamic Rep. of),Tajikistan,5,0,0,5
26394,2021,Stateless,Tajikistan,0,0,0,0
26395,2021,Afghanistan,Turkmenistan,10,0,0,10
26396,2021,Azerbaijan,Turkmenistan,6,0,0,6
26397,2021,Stateless,Turkmenistan,0,0,0,0
26398,2021,Burundi,Togo,5,0,0,5
26399,2021,Benin,Togo,21,30,0,51
26400,2021,Central African Rep.,Togo,251,268,0,519
26401,2021,Chad,Togo,13,14,0,27
26402,2021,Cameroon,Togo,7,17,0,24
26403,2021,Congo,Togo,32,51,0,83
26404,2021,Dem. Rep. of the Congo,Togo,108,94,0,202
26405,2021,Gabon,Togo,0,6,0,6
26406,2021,Palestinian,Togo,0,5,0,5
26407,2021,Ghana,Togo,8513,0,0,8513
26408,2021,Cote d'Ivoire,Togo,1428,212,0,1640
26409,2021,Iraq,Togo,5,0,0,5
26410,2021,Liberia,Togo,0,6,0,6
26411,2021,Lebanon,Togo,11,16,0,27
26412,2021,Sri Lanka,Togo,0,5,0,5
26413,2021,Mali,Togo,76,42,0,118
26414,2021,Niger,Togo,10,0,0,10
26415,2021,Nigeria,Togo,9,14,0,23
26416,2021,Rwanda,Togo,113,12,0,125
26417,2021,Syrian Arab Rep.,Togo,18,8,0,26
26418,2021,Türkiye,Togo,63,10,0,73
26419,2021,Bangladesh,Trinidad and Tobago,8,91,0,99
26420,2021,China,Trinidad and Tobago,0,127,0,127
26421,2021,Cameroon,Trinidad and Tobago,0,9,0,9
26422,2021,Colombia,Trinidad and Tobago,11,64,0,75
26423,2021,Cuba,Trinidad and Tobago,174,2339,0,2513
26424,2021,Dominican Rep.,Trinidad and Tobago,0,139,0,139
26425,2021,Ghana,Trinidad and Tobago,0,46,0,46
26426,2021,Grenada,Trinidad and Tobago,0,5,0,5
26427,2021,Guyana,Trinidad and Tobago,21,64,0,85
26428,2021,Haiti,Trinidad and Tobago,0,15,0,15
26429,2021,India,Trinidad and Tobago,0,5,0,5
26430,2021,Jamaica,Trinidad and Tobago,42,160,0,202
26431,2021,Sri Lanka,Trinidad and Tobago,5,0,0,5
26432,2021,Mexico,Trinidad and Tobago,6,0,0,6
26433,2021,Nicaragua,Trinidad and Tobago,0,5,0,5
26434,2021,Nigeria,Trinidad and Tobago,5,154,0,159
26435,2021,Pakistan,Trinidad and Tobago,9,17,0,26
26436,2021,Peru,Trinidad and Tobago,0,5,0,5
26437,2021,Philippines,Trinidad and Tobago,0,5,0,5
26438,2021,Viet Nam,Trinidad and Tobago,0,7,0,7
26439,2021,Syrian Arab Rep.,Trinidad and Tobago,64,38,0,102
26440,2021,Tajikistan,Trinidad and Tobago,0,5,0,5
26441,2021,Trinidad and Tobago,Trinidad and Tobago,0,0,0,0
26442,2021,Saint Vincent and the Grenadines,Trinidad and Tobago,5,0,0,5
26443,2021,Venezuela (Bolivarian Republic of),Trinidad and Tobago,3221,18322,0,21543
26444,2021,Algeria,Tunisia,10,12,0,22
26445,2021,Egypt,Tunisia,0,15,0,15
26446,2021,Burundi,Tunisia,0,7,0,7
26447,2021,Benin,Tunisia,0,7,0,7
26448,2021,Bangladesh,Tunisia,0,6,0,6
26449,2021,Burkina Faso,Tunisia,11,63,0,74
26450,2021,Central African Rep.,Tunisia,16,27,0,43
26451,2021,Chad,Tunisia,5,27,0,32
26452,2021,Cameroon,Tunisia,42,434,0,476
26453,2021,Congo,Tunisia,0,8,0,8
26454,2021,Dem. Rep. of the Congo,Tunisia,0,106,0,106
26455,2021,Comoros,Tunisia,0,7,0,7
26456,2021,Eritrea,Tunisia,142,168,0,310
26457,2021,Ethiopia,Tunisia,5,46,0,51
26458,2021,Gambia,Tunisia,0,20,0,20
26459,2021,Palestinian,Tunisia,34,38,0,72
26460,2021,Ghana,Tunisia,0,6,0,6
26461,2021,Guinea,Tunisia,10,488,0,498
26462,2021,Cote d'Ivoire,Tunisia,60,3488,0,3548
26463,2021,Iran (Islamic Rep. of),Tunisia,8,0,0,8
26464,2021,Iraq,Tunisia,21,11,0,32
26465,2021,Liberia,Tunisia,5,72,0,77
26466,2021,Libya,Tunisia,46,139,0,185
26467,2021,Lebanon,Tunisia,6,23,0,29
26468,2021,Mali,Tunisia,14,106,0,120
26469,2021,Morocco,Tunisia,0,5,0,5
26470,2021,Niger,Tunisia,0,7,0,7
26471,2021,Nigeria,Tunisia,0,115,0,115
26472,2021,Rwanda,Tunisia,6,5,0,11
26473,2021,Senegal,Tunisia,0,37,0,37
26474,2021,Sierra Leone,Tunisia,5,133,0,138
26475,2021,Somalia,Tunisia,26,116,0,142
26476,2021,Sudan,Tunisia,172,344,0,516
26477,2021,South Sudan,Tunisia,5,21,0,26
26478,2021,Syrian Arab Rep.,Tunisia,2523,0,0,2523
26479,2021,Togo,Tunisia,0,13,0,13
26480,2021,Yemen,Tunisia,14,20,0,34
26481,2021,Afghanistan,Türkiye,7647,133062,0,140709
26482,2021,Iran (Islamic Rep. of),Türkiye,3942,18933,0,22875
26483,2021,Iraq,Türkiye,9258,144376,0,153634
26484,2021,Syrian Arab Rep.,Türkiye,3737369,0,0,3737369
26485,2021,Unknown ,Türkiye,1601,8599,0,10200
26486,2021,Afghanistan,United Arab Emirates,5,30,0,35
26487,2021,Algeria,United Arab Emirates,0,0,0,0
26488,2021,Egypt,United Arab Emirates,5,8,0,13
26489,2021,Chad,United Arab Emirates,7,0,0,7
26490,2021,Eritrea,United Arab Emirates,0,7,0,7
26491,2021,Ethiopia,United Arab Emirates,8,5,0,13
26492,2021,Palestinian,United Arab Emirates,16,5,0,21
26493,2021,Iran (Islamic Rep. of),United Arab Emirates,5,7,0,12
26494,2021,Iraq,United Arab Emirates,800,544,0,1344
26495,2021,Jordan,United Arab Emirates,6,0,0,6
26496,2021,Kuwait,United Arab Emirates,5,0,0,5
26497,2021,Lebanon,United Arab Emirates,16,10,0,26
26498,2021,Morocco,United Arab Emirates,0,0,0,0
26499,2021,Pakistan,United Arab Emirates,5,0,0,5
26500,2021,Philippines,United Arab Emirates,0,0,0,0
26501,2021,Russian Federation,United Arab Emirates,0,5,0,5
26502,2021,Somalia,United Arab Emirates,19,0,0,19
26503,2021,Sudan,United Arab Emirates,13,6,0,19
26504,2021,Syrian Arab Rep.,United Arab Emirates,439,6526,0,6965
26505,2021,Yemen,United Arab Emirates,6,50,0,56
26506,2021,Egypt,Uganda,8,0,0,8
26507,2021,Burundi,Uganda,46109,1891,0,48000
26508,2021,Central African Rep.,Uganda,29,14,0,43
26509,2021,Chad,Uganda,7,5,0,12
26510,2021,Cameroon,Uganda,5,8,0,13
26511,2021,Congo,Uganda,31,0,0,31
26512,2021,Dem. Rep. of the Congo,Uganda,447540,8997,0,456537
26513,2021,Eritrea,Uganda,11201,10220,0,21421
26514,2021,Ethiopia,Uganda,2691,1504,0,4195
26515,2021,Palestinian,Uganda,5,0,0,5
26516,2021,Guinea,Uganda,5,0,0,5
26517,2021,Iran (Islamic Rep. of),Uganda,5,0,0,5
26518,2021,Kenya,Uganda,239,20,0,259
26519,2021,Mali,Uganda,0,5,0,5
26520,2021,Pakistan,Uganda,227,0,0,227
26521,2021,Rwanda,Uganda,17537,8235,0,25772
26522,2021,Senegal,Uganda,10,0,0,10
26523,2021,Somalia,Uganda,42202,11790,0,53992
26524,2021,Sudan,Uganda,3003,632,0,3635
26525,2021,South Sudan,Uganda,958927,41,0,958968
26526,2021,Syrian Arab Rep.,Uganda,18,8,0,26
26527,2021,United Rep. of Tanzania,Uganda,15,0,0,15
26528,2021,Türkiye,Uganda,63,13,0,76
26529,2021,Uganda,Uganda,0,0,0,0
26530,2021,Yemen,Uganda,26,5,0,31
26531,2021,Stateless,Uganda,0,0,0,0
26532,2021,Afghanistan,Ukraine,890,1068,0,1958
26533,2021,Algeria,Ukraine,0,12,0,12
26534,2021,Angola,Ukraine,24,5,0,29
26535,2021,Egypt,Ukraine,5,15,0,20
26536,2021,Armenia,Ukraine,52,0,0,52
26537,2021,Azerbaijan,Ukraine,70,29,0,99
26538,2021,Bangladesh,Ukraine,5,140,0,145
26539,2021,Belarus,Ukraine,43,55,0,98
26540,2021,China,Ukraine,0,5,0,5
26541,2021,Cameroon,Ukraine,5,32,0,37
26542,2021,Congo,Ukraine,26,12,0,38
26543,2021,Dem. Rep. of the Congo,Ukraine,26,36,0,62
26544,2021,Eritrea,Ukraine,11,27,0,38
26545,2021,Ethiopia,Ukraine,26,10,0,36
26546,2021,Palestinian,Ukraine,10,41,0,51
26547,2021,Georgia,Ukraine,25,0,0,25
26548,2021,Ghana,Ukraine,0,11,0,11
26549,2021,Guinea,Ukraine,5,20,0,25
26550,2021,Haiti,Ukraine,0,5,0,5
26551,2021,Cote d'Ivoire,Ukraine,0,16,0,16
26552,2021,India,Ukraine,7,26,0,33
26553,2021,Iran (Islamic Rep. of),Ukraine,74,53,0,127
26554,2021,Iraq,Ukraine,74,68,0,142
26555,2021,Jordan,Ukraine,5,5,0,10
26556,2021,Kazakhstan,Ukraine,9,9,0,18
26557,2021,Kyrgyzstan,Ukraine,11,28,0,39
26558,2021,Libya,Ukraine,5,14,0,19
26559,2021,Lebanon,Ukraine,9,13,0,22
26560,2021,Sri Lanka,Ukraine,8,30,0,38
26561,2021,Rep. of Moldova,Ukraine,0,5,0,5
26562,2021,Morocco,Ukraine,0,10,0,10
26563,2021,Myanmar,Ukraine,0,6,0,6
26564,2021,Nigeria,Ukraine,7,33,0,40
26565,2021,Pakistan,Ukraine,10,65,0,75
26566,2021,Russian Federation,Ukraine,175,167,0,342
26567,2021,Rwanda,Ukraine,5,0,0,5
26568,2021,Serbia and Kosovo: S/RES/1244 (1999),Ukraine,5,0,0,5
26569,2021,Senegal,Ukraine,0,5,0,5
26570,2021,Sierra Leone,Ukraine,5,0,0,5
26571,2021,Somalia,Ukraine,83,102,0,185
26572,2021,Viet Nam,Ukraine,0,13,0,13
26573,2021,Sudan,Ukraine,27,25,0,52
26574,2021,Syrian Arab Rep.,Ukraine,512,147,0,659
26575,2021,Tajikistan,Ukraine,23,187,0,210
26576,2021,Turkmenistan,Ukraine,7,0,0,7
26577,2021,Tunisia,Ukraine,0,5,0,5
26578,2021,Türkiye,Ukraine,6,14,0,20
26579,2021,Ukraine,Ukraine,0,0,854000,0
26580,2021,Uzbekistan,Ukraine,40,93,0,133
26581,2021,Yemen,Ukraine,5,47,0,52
26582,2021,Stateless,Ukraine,47,10,0,57
26583,2021,Afghanistan,Uruguay,5,6,0,11
26584,2021,Angola,Uruguay,14,0,0,14
26585,2021,Egypt,Uruguay,0,5,0,5
26586,2021,Argentina,Uruguay,0,11,0,11
26587,2021,Bangladesh,Uruguay,0,149,0,149
26588,2021,Bolivia (Plurinational State of),Uruguay,5,6,0,11
26589,2021,Brazil,Uruguay,0,23,0,23
26590,2021,Chile,Uruguay,0,5,0,5
26591,2021,Cameroon,Uruguay,12,5,0,17
26592,2021,Congo,Uruguay,5,0,0,5
26593,2021,Colombia,Uruguay,162,85,0,247
26594,2021,Cuba,Uruguay,28,10313,0,10341
26595,2021,Dominican Rep.,Uruguay,0,317,0,317
26596,2021,Ecuador,Uruguay,8,24,0,32
26597,2021,Palestinian,Uruguay,0,5,0,5
26598,2021,Ghana,Uruguay,0,26,0,26
26599,2021,Guinea-Bissau,Uruguay,0,5,0,5
26600,2021,Guatemala,Uruguay,5,0,0,5
26601,2021,Guinea,Uruguay,0,11,0,11
26602,2021,Haiti,Uruguay,5,23,0,28
26603,2021,India,Uruguay,0,8,0,8
26604,2021,Libya,Uruguay,5,0,0,5
26605,2021,Latvia,Uruguay,5,0,0,5
26606,2021,Mexico,Uruguay,5,0,0,5
26607,2021,Morocco,Uruguay,0,17,0,17
26608,2021,Nicaragua,Uruguay,9,0,0,9
26609,2021,Nigeria,Uruguay,22,36,0,58
26610,2021,Pakistan,Uruguay,0,40,0,40
26611,2021,Paraguay,Uruguay,5,5,0,10
26612,2021,Peru,Uruguay,7,41,0,48
26613,2021,Russian Federation,Uruguay,13,5,0,18
26614,2021,El Salvador,Uruguay,48,7,0,55
26615,2021,Senegal,Uruguay,0,261,0,261
26616,2021,Somalia,Uruguay,5,0,0,5
26617,2021,Syrian Arab Rep.,Uruguay,66,5,0,71
26618,2021,Türkiye,Uruguay,13,5,0,18
26619,2021,Ukraine,Uruguay,11,6,0,17
26620,2021,Venezuela (Bolivarian Republic of),Uruguay,414,2064,0,2478
26621,2021,Stateless,Uruguay,0,0,0,0
26622,2021,Unknown ,Uruguay,0,0,0,0
26623,2021,Afghanistan,United States of America,1649,1212,0,2861
26624,2021,Albania,United States of America,1272,2821,0,4093
26625,2021,Algeria,United States of America,147,541,0,688
26626,2021,Angola,United States of America,299,3361,0,3660
26627,2021,Antigua and Barbuda,United States of America,6,10,0,16
26628,2021,Egypt,United States of America,14248,9451,0,23699
26629,2021,Argentina,United States of America,23,499,0,522
26630,2021,Armenia,United States of America,1286,5344,0,6630
26631,2021,Australia,United States of America,0,14,0,14
26632,2021,Austria,United States of America,13,5,0,18
26633,2021,Azerbaijan,United States of America,521,1672,0,2193
26634,2021,Bahrain,United States of America,35,64,0,99
26635,2021,Burundi,United States of America,839,767,0,1606
26636,2021,Belgium,United States of America,13,54,0,67
26637,2021,Benin,United States of America,76,280,0,356
26638,2021,Bangladesh,United States of America,2344,10262,0,12606
26639,2021,Bahamas,United States of America,181,240,0,421
26640,2021,Bhutan,United States of America,27,435,0,462
26641,2021,Burkina Faso,United States of America,1373,3628,0,5001
26642,2021,Belarus,United States of America,1488,3591,0,5079
26643,2021,Bolivia (Plurinational State of),United States of America,81,845,0,926
26644,2021,Botswana,United States of America,0,10,0,10
26645,2021,Brazil,United States of America,1032,19429,0,20461
26646,2021,Bosnia and Herzegovina,United States of America,85,218,0,303
26647,2021,Bulgaria,United States of America,169,307,0,476
26648,2021,Belize,United States of America,38,296,0,334
26649,2021,Cambodia,United States of America,120,69,0,189
26650,2021,Canada,United States of America,15,82,0,97
26651,2021,Central African Rep.,United States of America,175,143,0,318
26652,2021,Cayman Islands,United States of America,5,0,0,5
26653,2021,Chad,United States of America,220,273,0,493
26654,2021,China,United States of America,68937,88722,0,157659
26655,2021,Chile,United States of America,23,874,0,897
26656,2021,Cameroon,United States of America,5081,5485,0,10566
26657,2021,Congo,United States of America,1038,2582,0,3620
26658,2021,Dem. Rep. of the Congo,United States of America,1460,2543,0,4003
26659,2021,Comoros,United States of America,5,5,0,10
26660,2021,Colombia,United States of America,2557,38168,0,40725
26661,2021,Costa Rica,United States of America,174,718,0,892
26662,2021,Cuba,United States of America,2689,18040,0,20729
26663,2021,Cabo Verde,United States of America,0,42,0,42
26664,2021,Czechia,United States of America,8,74,0,82
26665,2021,Denmark,United States of America,0,5,0,5
26666,2021,Djibouti,United States of America,359,649,0,1008
26667,2021,Dominica,United States of America,14,61,0,75
26668,2021,Dominican Rep.,United States of America,247,1359,0,1606
26669,2021,Ecuador,United States of America,1525,25743,0,27268
26670,2021,Equatorial Guinea,United States of America,17,97,0,114
26671,2021,Eritrea,United States of America,5271,1073,0,6344
26672,2021,Estonia,United States of America,250,37,0,287
26673,2021,Ethiopia,United States of America,7659,8671,0,16330
26674,2021,Fiji,United States of America,114,425,0,539
26675,2021,France,United States of America,17,132,0,149
26676,2021,Gabon,United States of America,48,344,0,392
26677,2021,Gambia,United States of America,1357,805,0,2162
26678,2021,Palestinian,United States of America,20,136,0,156
26679,2021,United Kingdom of Great Britain and Northern Ireland,United States of America,27,144,0,171
26680,2021,Georgia,United States of America,465,2573,0,3038
26681,2021,Germany,United States of America,29,176,0,205
26682,2021,Ghana,United States of America,499,1049,0,1548
26683,2021,Guinea-Bissau,United States of America,18,48,0,66
26684,2021,Greece,United States of America,14,88,0,102
26685,2021,Grenada,United States of America,18,40,0,58
26686,2021,Guatemala,United States of America,23180,152784,0,175964
26687,2021,Guinea,United States of America,1584,1218,0,2802
26688,2021,Guyana,United States of America,110,526,0,636
26689,2021,Haiti,United States of America,14695,38333,0,53028
26690,2021,"China, Hong Kong SAR",United States of America,11,182,0,193
26691,2021,Honduras,United States of America,17149,113713,0,130862
26692,2021,Croatia,United States of America,20,27,0,47
26693,2021,Hungary,United States of America,9,410,0,419
26694,2021,Cote d'Ivoire,United States of America,907,1449,0,2356
26695,2021,India,United States of America,9315,46602,0,55917
26696,2021,Indonesia,United States of America,930,3219,0,4149
26697,2021,Ireland,United States of America,0,33,0,33
26698,2021,Iran (Islamic Rep. of),United States of America,5331,3685,0,9016
26699,2021,Iraq,United States of America,5339,4510,0,9849
26700,2021,Israel,United States of America,97,637,0,734
26701,2021,Italy,United States of America,9,462,0,471
26702,2021,Jamaica,United States of America,892,1419,0,2311
26703,2021,Jordan,United States of America,670,3848,0,4518
26704,2021,Japan,United States of America,7,90,0,97
26705,2021,Kazakhstan,United States of America,1099,4551,0,5650
26706,2021,Kenya,United States of America,1617,6810,0,8427
26707,2021,Kyrgyzstan,United States of America,1590,2210,0,3800
26708,2021,Rep. of Korea,United States of America,21,290,0,311
26709,2021,Dem. People's Rep. of Korea,United States of America,6,36,0,42
26710,2021,Kuwait,United States of America,136,304,0,440
26711,2021,Lao People's Dem. Rep.,United States of America,61,186,0,247
26712,2021,Liberia,United States of America,1208,1207,0,2415
26713,2021,Libya,United States of America,385,1892,0,2277
26714,2021,Saint Lucia,United States of America,5,24,0,29
26715,2021,Lebanon,United States of America,381,1918,0,2299
26716,2021,Lesotho,United States of America,6,0,0,6
26717,2021,Sri Lanka,United States of America,1007,2252,0,3259
26718,2021,Lithuania,United States of America,15,87,0,102
26719,2021,Latvia,United States of America,16,110,0,126
26720,2021,"China, Macao SAR",United States of America,0,6,0,6
26721,2021,Madagascar,United States of America,7,24,0,31
26722,2021,Mauritania,United States of America,916,1115,0,2031
26723,2021,North Macedonia,United States of America,102,245,0,347
26724,2021,Rep. of Moldova,United States of America,1344,3079,0,4423
26725,2021,Maldives,United States of America,5,5,0,10
26726,2021,Mexico,United States of America,12606,111313,0,123919
26727,2021,Marshall Islands,United States of America,7,0,0,7
26728,2021,Mali,United States of America,896,645,0,1541
26729,2021,Malaysia,United States of America,88,409,0,497
26730,2021,Malawi,United States of America,34,178,0,212
26731,2021,Mongolia,United States of America,635,3501,0,4136
26732,2021,Morocco,United States of America,132,312,0,444
26733,2021,Mozambique,United States of America,28,53,0,81
26734,2021,Montenegro,United States of America,100,537,0,637
26735,2021,Mauritius,United States of America,31,46,0,77
26736,2021,Myanmar,United States of America,1223,3096,0,4319
26737,2021,Namibia,United States of America,17,29,0,46
26738,2021,Nepal,United States of America,6271,7702,0,13973
26739,2021,Netherlands,United States of America,7,69,0,76
26740,2021,Niger,United States of America,144,414,0,558
26741,2021,Nicaragua,United States of America,2083,11762,0,13845
26742,2021,Nigeria,United States of America,2948,25904,0,28852
26743,2021,Niue,United States of America,11,0,0,11
26744,2021,Oman,United States of America,18,32,0,50
26745,2021,Pakistan,United States of America,3818,9467,0,13285
26746,2021,Panama,United States of America,11,186,0,197
26747,2021,Paraguay,United States of America,11,110,0,121
26748,2021,Peru,United States of America,480,3983,0,4463
26749,2021,Philippines,United States of America,168,1728,0,1896
26750,2021,Poland,United States of America,9,921,0,930
26751,2021,Portugal,United States of America,5,270,0,275
26752,2021,Qatar,United States of America,20,24,0,44
26753,2021,Romania,United States of America,447,4030,0,4477
26754,2021,South Africa,United States of America,59,1311,0,1370
26755,2021,Russian Federation,United States of America,6718,21873,0,28591
26756,2021,Rwanda,United States of America,1223,1456,0,2679
26757,2021,El Salvador,United States of America,28996,131244,0,160240
26758,2021,Saudi Arabia,United States of America,628,1064,0,1692
26759,2021,Serbia and Kosovo: S/RES/1244 (1999),United States of America,717,2008,0,2725
26760,2021,Senegal,United States of America,385,719,0,1104
26761,2021,Singapore,United States of America,6,48,0,54
26762,2021,Sierra Leone,United States of America,399,511,0,910
26763,2021,Somalia,United States of America,1515,331,0,1846
26764,2021,Spain,United States of America,8,262,0,270
26765,2021,Viet Nam,United States of America,406,1580,0,1986
26766,2021,Saint Kitts and Nevis,United States of America,5,5,0,10
26767,2021,Sudan,United States of America,1375,1254,0,2629
26768,2021,Suriname,United States of America,11,58,0,69
26769,2021,South Sudan,United States of America,54,71,0,125
26770,2021,Slovakia,United States of America,5,47,0,52
26771,2021,Slovenia,United States of America,5,5,0,10
26772,2021,Eswatini,United States of America,5,10,0,15
26773,2021,Sweden,United States of America,0,33,0,33
26774,2021,Switzerland,United States of America,0,16,0,16
26775,2021,Syrian Arab Rep.,United States of America,8799,3500,0,12299
26776,2021,United Rep. of Tanzania,United States of America,109,281,0,390
26777,2021,Turks and Caicos Islands,United States of America,14,0,0,14
26778,2021,Thailand,United States of America,35,512,0,547
26779,2021,Tajikistan,United States of America,298,710,0,1008
26780,2021,Turkmenistan,United States of America,204,474,0,678
26781,2021,Timor-Leste,United States of America,0,14,0,14
26782,2021,Togo,United States of America,524,708,0,1232
26783,2021,Trinidad and Tobago,United States of America,40,288,0,328
26784,2021,Tunisia,United States of America,97,377,0,474
26785,2021,Türkiye,United States of America,4181,6780,0,10961
26786,2021,United Arab Emirates,United States of America,70,163,0,233
26787,2021,Uganda,United States of America,1773,3646,0,5419
26788,2021,Ukraine,United States of America,2608,11404,0,14012
26789,2021,Uruguay,United States of America,5,189,0,194
26790,2021,Uzbekistan,United States of America,1219,3447,0,4666
26791,2021,Vanuatu,United States of America,0,23,0,23
26792,2021,Saint Vincent and the Grenadines,United States of America,30,19,0,49
26793,2021,Venezuela (Bolivarian Republic of),United States of America,18735,246745,0,265480
26794,2021,Samoa,United States of America,0,5,0,5
26795,2021,Yemen,United States of America,679,1121,0,1800
26796,2021,Zambia,United States of America,40,178,0,218
26797,2021,Zimbabwe,United States of America,691,1261,0,1952
26798,2021,Stateless,United States of America,47,0,0,47
26799,2021,Guadeloupe,United States of America,0,88,0,88
26800,2021,Curacao ,United States of America,35,0,0,35
26801,2021,Unknown ,United States of America,6276,4292,0,10568
26802,2021,Afghanistan,Uzbekistan,13032,0,0,13032
26803,2021,Stateless,Uzbekistan,0,0,0,0
26804,2021,Bangladesh,Vanuatu,0,5,0,5
26805,2021,Venezuela (Bolivarian Republic of),Saint Vincent and the Grenadines,0,0,0,0
26806,2021,Afghanistan,Venezuela (Bolivarian Republic of),10,0,0,10
26807,2021,Chile,Venezuela (Bolivarian Republic of),10,0,0,10
26808,2021,Congo,Venezuela (Bolivarian Republic of),5,0,0,5
26809,2021,Colombia,Venezuela (Bolivarian Republic of),39168,516,0,39684
26810,2021,Palestinian,Venezuela (Bolivarian Republic of),7,0,0,7
26811,2021,Haiti,Venezuela (Bolivarian Republic of),12,0,0,12
26812,2021,Iraq,Venezuela (Bolivarian Republic of),18,0,0,18
26813,2021,Liberia,Venezuela (Bolivarian Republic of),9,0,0,9
26814,2021,Libya,Venezuela (Bolivarian Republic of),5,0,0,5
26815,2021,Lebanon,Venezuela (Bolivarian Republic of),12,0,0,12
26816,2021,Nigeria,Venezuela (Bolivarian Republic of),7,0,0,7
26817,2021,Peru,Venezuela (Bolivarian Republic of),5,0,0,5
26818,2021,Rwanda,Venezuela (Bolivarian Republic of),5,0,0,5
26819,2021,Sierra Leone,Venezuela (Bolivarian Republic of),5,0,0,5
26820,2021,Syrian Arab Rep.,Venezuela (Bolivarian Republic of),33,0,0,33
26821,2021,Türkiye,Venezuela (Bolivarian Republic of),6,0,0,6
26822,2021,Venezuela (Bolivarian Republic of),Venezuela (Bolivarian Republic of),0,0,0,0
26823,2021,Western Sahara,Venezuela (Bolivarian Republic of),11,0,0,11
26824,2021,Egypt,Yemen,16,10,0,26
26825,2021,Cameroon,Yemen,0,5,0,5
26826,2021,Congo,Yemen,5,5,0,10
26827,2021,Djibouti,Yemen,5,6,0,11
26828,2021,Eritrea,Yemen,1330,479,0,1809
26829,2021,Ethiopia,Yemen,6466,10593,0,17059
26830,2021,Palestinian,Yemen,576,311,0,887
26831,2021,Iran (Islamic Rep. of),Yemen,5,0,0,5
26832,2021,Iraq,Yemen,3163,71,0,3234
26833,2021,Jordan,Yemen,14,11,0,25
26834,2021,Mali,Yemen,0,5,0,5
26835,2021,Pakistan,Yemen,0,9,0,9
26836,2021,Somalia,Yemen,75250,155,0,75405
26837,2021,Viet Nam,Yemen,15,0,0,15
26838,2021,Sudan,Yemen,109,513,0,622
26839,2021,Syrian Arab Rep.,Yemen,2513,420,0,2933
26840,2021,United Rep. of Tanzania,Yemen,0,0,0,0
26841,2021,Yemen,Yemen,0,0,4288739,0
26842,2021,Angola,Zambia,0,0,0,0
26843,2021,Burundi,Zambia,8127,960,0,9087
26844,2021,Central African Rep.,Zambia,0,5,0,5
26845,2021,Cameroon,Zambia,17,28,0,45
26846,2021,Congo,Zambia,24,16,0,40
26847,2021,Dem. Rep. of the Congo,Zambia,62039,2736,0,64775
26848,2021,Eritrea,Zambia,86,6,0,92
26849,2021,Ethiopia,Zambia,44,6,0,50
26850,2021,Palestinian,Zambia,15,0,0,15
26851,2021,Ghana,Zambia,0,10,0,10
26852,2021,India,Zambia,0,5,0,5
26853,2021,Liberia,Zambia,8,0,0,8
26854,2021,Nigeria,Zambia,0,5,0,5
26855,2021,South Africa,Zambia,6,0,0,6
26856,2021,Rwanda,Zambia,812,18,0,830
26857,2021,Sierra Leone,Zambia,5,0,0,5
26858,2021,Somalia,Zambia,3540,567,0,4107
26859,2021,Sudan,Zambia,29,0,0,29
26860,2021,South Sudan,Zambia,5,0,0,5
26861,2021,Syrian Arab Rep.,Zambia,36,5,0,41
26862,2021,Türkiye,Zambia,82,0,0,82
26863,2021,Uganda,Zambia,208,27,0,235
26864,2021,Unknown ,Zambia,71,0,0,71
26865,2021,Angola,Zimbabwe,0,6,0,6
26866,2021,Burundi,Zimbabwe,665,220,0,885
26867,2021,Central African Rep.,Zimbabwe,0,5,0,5
26868,2021,Cameroon,Zimbabwe,0,8,0,8
26869,2021,Congo,Zimbabwe,20,0,0,20
26870,2021,Dem. Rep. of the Congo,Zimbabwe,7994,3187,0,11181
26871,2021,Eritrea,Zimbabwe,20,5,0,25
26872,2021,Ethiopia,Zimbabwe,67,14,0,81
26873,2021,Cote d'Ivoire,Zimbabwe,12,25,0,37
26874,2021,Kenya,Zimbabwe,0,8,0,8
26875,2021,Mali,Zimbabwe,6,114,0,120
26876,2021,Mozambique,Zimbabwe,0,8240,0,8240
26877,2021,South Africa,Zimbabwe,0,0,0,0
26878,2021,Rwanda,Zimbabwe,660,66,0,726
26879,2021,Sierra Leone,Zimbabwe,0,6,0,6
26880,2021,Somalia,Zimbabwe,13,22,0,35
26881,2021,Sudan,Zimbabwe,8,0,0,8
26882,2021,South Sudan,Zimbabwe,8,25,0,33
26883,2021,Uganda,Zimbabwe,10,0,0,10
26884,2021,Zambia,Zimbabwe,0,0,0,0
26885,2021,Zimbabwe,Zimbabwe,0,0,0,0
26886,2021,Venezuela (Bolivarian Republic of),Anguilla,0,0,0,0
26887,2021,Venezuela (Bolivarian Republic of),Aruba,0,0,0,0
26888,2021,Aruba,Aruba,0,0,0,0
26889,2021,Venezuela (Bolivarian Republic of),Curacao ,0,0,0,0
26890,2021,Curacao ,Curacao ,0,0,0,0
26891,2021,Venezuela (Bolivarian Republic of),Sint Maarten (Dutch part),0,41,0,41
