,Year,Country of origin,Country of asylum,Refugees under UNHCR's mandate,Asylum-seekers,IDPs of concern to UNHCR,International total
0,2017,Afghanistan,Afghanistan,0,0,1837079,0
1,2017,Iran (Islamic Rep. of),Afghanistan,34,5,0,39
2,2017,Pakistan,Afghanistan,75893,101,0,75994
3,2017,Tajikistan,Afghanistan,0,7,0,7
4,2017,Türkiye,Afghanistan,0,102,0,102
5,2017,Egypt,Albania,5,0,0,5
6,2017,China,Albania,12,0,0,12
7,2017,Dem. Rep. of the Congo,Albania,5,0,0,5
8,2017,Palestinian,Albania,5,0,0,5
9,2017,Iran (Islamic Rep. of),Albania,12,5,0,17
10,2017,Iraq,Albania,5,0,0,5
11,2017,Serbia and Kosovo: S/RES/1244 (1999),Albania,60,5,0,65
12,2017,Syrian Arab Rep.,Albania,5,22,0,27
13,2017,Türkiye,Albania,5,0,0,5
14,2017,Uzbekistan,Albania,5,0,0,5
15,2017,Venezuela (Bolivarian Republic of),Albania,5,0,0,5
16,2017,Stateless,Albania,0,0,0,0
17,2017,Central African Rep.,Algeria,43,27,0,70
18,2017,Chad,Algeria,0,5,0,5
19,2017,Cameroon,Algeria,16,31,0,47
20,2017,Congo,Algeria,0,5,0,5
21,2017,Dem. Rep. of the Congo,Algeria,47,76,0,123
22,2017,Palestinian,Algeria,4014,85,0,4099
23,2017,Guinea,Algeria,5,24,0,29
24,2017,Cote d'Ivoire,Algeria,39,53,0,92
25,2017,Iraq,Algeria,13,5,0,18
26,2017,Libya,Algeria,19,8,0,27
27,2017,Lebanon,Algeria,0,5,0,5
28,2017,Mali,Algeria,34,37,0,71
29,2017,Nigeria,Algeria,0,5,0,5
30,2017,Sudan,Algeria,0,6,0,6
31,2017,Syrian Arab Rep.,Algeria,8,5821,0,5829
32,2017,Togo,Algeria,5,0,0,5
33,2017,Tunisia,Algeria,0,5,0,5
34,2017,Western Sahara,Algeria,90000,0,0,90000
35,2017,Yemen,Algeria,5,155,0,160
36,2017,Burundi,Angola,9,94,0,103
37,2017,Central African Rep.,Angola,9,76,0,85
38,2017,Chad,Angola,184,780,0,964
39,2017,Congo,Angola,5,58,0,63
40,2017,Dem. Rep. of the Congo,Angola,38516,500,0,39016
41,2017,Eritrea,Angola,34,1767,0,1801
42,2017,Ethiopia,Angola,0,57,0,57
43,2017,Guinea-Bissau,Angola,0,268,0,268
44,2017,Guinea,Angola,107,9145,0,9252
45,2017,Cote d'Ivoire,Angola,510,5938,0,6448
46,2017,Liberia,Angola,155,478,0,633
47,2017,Mauritania,Angola,306,5403,0,5709
48,2017,Rwanda,Angola,273,67,0,340
49,2017,Sierra Leone,Angola,374,1497,0,1871
50,2017,Somalia,Angola,288,1731,0,2019
51,2017,Sudan,Angola,313,1670,0,1983
52,2017,United Rep. of Tanzania,Angola,5,0,0,5
53,2017,Uganda,Angola,6,6,0,12
54,2017,Western Sahara,Angola,18,596,0,614
55,2017,Zambia,Angola,7,0,0,7
56,2017,Afghanistan,Egypt,17,22,0,39
57,2017,Burundi,Egypt,24,31,0,55
58,2017,Benin,Egypt,0,5,0,5
59,2017,Bangladesh,Egypt,0,5,0,5
60,2017,Central African Rep.,Egypt,17,16,0,33
61,2017,Chad,Egypt,46,35,0,81
62,2017,China,Egypt,0,42,0,42
63,2017,Cameroon,Egypt,5,27,0,32
64,2017,Congo,Egypt,5,19,0,24
65,2017,Dem. Rep. of the Congo,Egypt,40,19,0,59
66,2017,Djibouti,Egypt,5,13,0,18
67,2017,Eritrea,Egypt,2727,9966,0,12693
68,2017,Ethiopia,Egypt,2676,11776,0,14452
69,2017,Palestinian,Egypt,70018,0,0,70018
70,2017,Ghana,Egypt,0,10,0,10
71,2017,Guinea,Egypt,5,15,0,20
72,2017,Cote d'Ivoire,Egypt,113,5,0,118
73,2017,India,Egypt,0,5,0,5
74,2017,Iraq,Egypt,4275,2388,0,6663
75,2017,Jordan,Egypt,0,13,0,13
76,2017,Kenya,Egypt,6,5,0,11
77,2017,Liberia,Egypt,0,13,0,13
78,2017,Mali,Egypt,9,5,0,14
79,2017,Myanmar,Egypt,5,0,0,5
80,2017,Niger,Egypt,0,5,0,5
81,2017,Nigeria,Egypt,17,335,0,352
82,2017,Russian Federation,Egypt,18,47,0,65
83,2017,Saudi Arabia,Egypt,0,6,0,6
84,2017,Sierra Leone,Egypt,5,10,0,15
85,2017,Somalia,Egypt,3252,3395,0,6647
86,2017,Sudan,Egypt,17298,18439,0,35737
87,2017,South Sudan,Egypt,5247,4828,0,10075
88,2017,Syrian Arab Rep.,Egypt,126688,0,0,126688
89,2017,Tajikistan,Egypt,12,29,0,41
90,2017,Turkmenistan,Egypt,5,0,0,5
91,2017,Türkiye,Egypt,0,387,0,387
92,2017,Uganda,Egypt,10,16,0,26
93,2017,Uzbekistan,Egypt,0,73,0,73
94,2017,Yemen,Egypt,85,4500,0,4585
95,2017,Zimbabwe,Egypt,12,47,0,59
96,2017,Stateless,Egypt,5,0,0,5
97,2017,Unknown ,Egypt,0,5,0,5
98,2017,Afghanistan,Argentina,5,9,0,14
99,2017,Albania,Argentina,18,0,0,18
100,2017,Algeria,Argentina,30,5,0,35
101,2017,Angola,Argentina,14,11,0,25
102,2017,Egypt,Argentina,5,5,0,10
103,2017,Armenia,Argentina,78,180,0,258
104,2017,Burundi,Argentina,5,0,0,5
105,2017,Bangladesh,Argentina,5,57,0,62
106,2017,Bolivia (Plurinational State of),Argentina,5,5,0,10
107,2017,Brazil,Argentina,0,6,0,6
108,2017,Bosnia and Herzegovina,Argentina,6,0,0,6
109,2017,China,Argentina,0,60,0,60
110,2017,Chile,Argentina,33,5,0,38
111,2017,Cameroon,Argentina,6,31,0,37
112,2017,Dem. Rep. of the Congo,Argentina,22,23,0,45
113,2017,Colombia,Argentina,544,188,0,732
114,2017,Costa Rica,Argentina,5,0,0,5
115,2017,Cuba,Argentina,255,583,0,838
116,2017,Dominican Rep.,Argentina,0,283,0,283
117,2017,Ecuador,Argentina,17,5,0,22
118,2017,Ethiopia,Argentina,5,0,0,5
119,2017,Gambia,Argentina,0,10,0,10
120,2017,Palestinian,Argentina,10,9,0,19
121,2017,Georgia,Argentina,5,0,0,5
122,2017,Germany,Argentina,0,5,0,5
123,2017,Ghana,Argentina,38,117,0,155
124,2017,Guinea-Bissau,Argentina,8,5,0,13
125,2017,Guatemala,Argentina,0,5,0,5
126,2017,Guinea,Argentina,9,10,0,19
127,2017,Haiti,Argentina,66,593,0,659
128,2017,Honduras,Argentina,5,5,0,10
129,2017,Hungary,Argentina,0,5,0,5
130,2017,Cote d'Ivoire,Argentina,20,0,0,20
131,2017,India,Argentina,22,114,0,136
132,2017,Iran (Islamic Rep. of),Argentina,23,0,0,23
133,2017,Iraq,Argentina,22,6,0,28
134,2017,Jamaica,Argentina,0,9,0,9
135,2017,Kazakhstan,Argentina,18,5,0,23
136,2017,Kyrgyzstan,Argentina,5,0,0,5
137,2017,Liberia,Argentina,44,0,0,44
138,2017,Libya,Argentina,0,5,0,5
139,2017,Sri Lanka,Argentina,37,0,0,37
140,2017,Mauritania,Argentina,0,5,0,5
141,2017,North Macedonia,Argentina,9,0,0,9
142,2017,Mexico,Argentina,0,5,0,5
143,2017,Mali,Argentina,9,0,0,9
144,2017,Morocco,Argentina,0,11,0,11
145,2017,Nepal,Argentina,0,5,0,5
146,2017,Nigeria,Argentina,42,55,0,97
147,2017,Pakistan,Argentina,32,24,0,56
148,2017,Paraguay,Argentina,8,10,0,18
149,2017,Peru,Argentina,547,26,0,573
150,2017,Philippines,Argentina,0,5,0,5
151,2017,Romania,Argentina,51,0,0,51
152,2017,South Africa,Argentina,0,5,0,5
153,2017,Russian Federation,Argentina,65,75,0,140
154,2017,El Salvador,Argentina,22,24,0,46
155,2017,Senegal,Argentina,42,956,0,998
156,2017,Sierra Leone,Argentina,37,6,0,43
157,2017,Somalia,Argentina,5,0,0,5
158,2017,Spain,Argentina,0,5,0,5
159,2017,Viet Nam,Argentina,0,5,0,5
160,2017,Sudan,Argentina,5,0,0,5
161,2017,Syrian Arab Rep.,Argentina,370,84,0,454
162,2017,Türkiye,Argentina,11,0,0,11
163,2017,Ukraine,Argentina,94,159,0,253
164,2017,United States of America,Argentina,5,15,0,20
165,2017,Venezuela (Bolivarian Republic of),Argentina,0,183,0,183
166,2017,Yemen,Argentina,15,0,0,15
167,2017,Stateless,Argentina,6,6,0,12
168,2017,Unknown ,Argentina,567,83,0,650
169,2017,Afghanistan,Armenia,0,5,0,5
170,2017,Azerbaijan,Armenia,2034,0,0,2034
171,2017,Palestinian,Armenia,6,0,0,6
172,2017,Georgia,Armenia,8,0,0,8
173,2017,Cote d'Ivoire,Armenia,6,0,0,6
174,2017,Iran (Islamic Rep. of),Armenia,31,19,0,50
175,2017,Iraq,Armenia,1061,5,0,1066
176,2017,Lebanon,Armenia,19,0,0,19
177,2017,Syrian Arab Rep.,Armenia,14680,12,0,14692
178,2017,Türkiye,Armenia,5,10,0,15
179,2017,Ukraine,Armenia,113,0,0,113
180,2017,Uzbekistan,Armenia,0,5,0,5
181,2017,Yemen,Armenia,5,6,0,11
182,2017,Stateless,Armenia,0,0,0,0
183,2017,Afghanistan,Australia,10922,1795,0,12717
184,2017,Albania,Australia,59,84,0,143
185,2017,Algeria,Australia,10,17,0,27
186,2017,Andorra,Australia,0,5,0,5
187,2017,Angola,Australia,0,5,0,5
188,2017,Antigua and Barbuda,Australia,0,5,0,5
189,2017,Egypt,Australia,1560,230,0,1790
190,2017,Argentina,Australia,0,21,0,21
191,2017,Austria,Australia,0,5,0,5
192,2017,Azerbaijan,Australia,9,13,0,22
193,2017,Bahrain,Australia,97,20,0,117
194,2017,Burundi,Australia,50,35,0,85
195,2017,Bangladesh,Australia,434,857,0,1291
196,2017,Bhutan,Australia,5,19,0,24
197,2017,Belarus,Australia,7,6,0,13
198,2017,Botswana,Australia,0,5,0,5
199,2017,Brazil,Australia,5,27,0,32
200,2017,Brunei Darussalam,Australia,0,9,0,9
201,2017,Bosnia and Herzegovina,Australia,0,15,0,15
202,2017,Bulgaria,Australia,0,6,0,6
203,2017,Cambodia,Australia,31,192,0,223
204,2017,Canada,Australia,0,6,0,6
205,2017,Chad,Australia,5,5,0,10
206,2017,China,Australia,2543,8525,0,11068
207,2017,Chile,Australia,0,14,0,14
208,2017,Cameroon,Australia,42,40,0,82
209,2017,Congo,Australia,13,12,0,25
210,2017,Dem. Rep. of the Congo,Australia,48,61,0,109
211,2017,Colombia,Australia,116,102,0,218
212,2017,Cuba,Australia,0,6,0,6
213,2017,Cyprus,Australia,0,9,0,9
214,2017,Djibouti,Australia,5,5,0,10
215,2017,Dominica,Australia,0,5,0,5
216,2017,Ecuador,Australia,0,5,0,5
217,2017,Eritrea,Australia,138,26,0,164
218,2017,Estonia,Australia,0,6,0,6
219,2017,Ethiopia,Australia,282,267,0,549
220,2017,Fiji,Australia,406,462,0,868
221,2017,Finland,Australia,0,5,0,5
222,2017,France,Australia,0,12,0,12
223,2017,Gabon,Australia,0,5,0,5
224,2017,Gambia,Australia,8,5,0,13
225,2017,Palestinian,Australia,378,150,0,528
226,2017,United Kingdom of Great Britain and Northern Ireland,Australia,5,30,0,35
227,2017,Georgia,Australia,16,13,0,29
228,2017,Germany,Australia,5,10,0,15
229,2017,Ghana,Australia,32,91,0,123
230,2017,Greece,Australia,6,13,0,19
231,2017,Guatemala,Australia,0,5,0,5
232,2017,Guinea,Australia,12,11,0,23
233,2017,Haiti,Australia,0,5,0,5
234,2017,"China, Hong Kong SAR",Australia,5,57,0,62
235,2017,Honduras,Australia,5,6,0,11
236,2017,Hungary,Australia,0,5,0,5
237,2017,Cote d'Ivoire,Australia,5,5,0,10
238,2017,India,Australia,388,2300,0,2688
239,2017,Indonesia,Australia,205,775,0,980
240,2017,Ireland,Australia,0,12,0,12
241,2017,Iran (Islamic Rep. of),Australia,8077,5877,0,13954
242,2017,Iraq,Australia,4042,1563,0,5605
243,2017,Israel,Australia,15,32,0,47
244,2017,Italy,Australia,5,14,0,19
245,2017,Jamaica,Australia,5,5,0,10
246,2017,Jordan,Australia,149,113,0,262
247,2017,Japan,Australia,10,11,0,21
248,2017,Kazakhstan,Australia,7,5,0,12
249,2017,Kenya,Australia,117,81,0,198
250,2017,Kyrgyzstan,Australia,14,15,0,29
251,2017,Rep. of Korea,Australia,45,107,0,152
252,2017,Dem. People's Rep. of Korea,Australia,19,5,0,24
253,2017,Kuwait,Australia,54,5,0,59
254,2017,Lao People's Dem. Rep.,Australia,5,37,0,42
255,2017,Liberia,Australia,37,25,0,62
256,2017,Libya,Australia,992,133,0,1125
257,2017,Lebanon,Australia,548,668,0,1216
258,2017,Sri Lanka,Australia,4489,3258,0,7747
259,2017,Lithuania,Australia,0,6,0,6
260,2017,Madagascar,Australia,0,6,0,6
261,2017,Mauritania,Australia,0,5,0,5
262,2017,North Macedonia,Australia,5,28,0,33
263,2017,Rep. of Moldova,Australia,0,6,0,6
264,2017,Maldives,Australia,10,17,0,27
265,2017,Mexico,Australia,10,10,0,20
266,2017,Mali,Australia,0,6,0,6
267,2017,Malaysia,Australia,240,8539,0,8779
268,2017,Malawi,Australia,0,9,0,9
269,2017,Mongolia,Australia,27,51,0,78
270,2017,Morocco,Australia,12,10,0,22
271,2017,Mozambique,Australia,5,5,0,10
272,2017,Mauritius,Australia,7,59,0,66
273,2017,Myanmar,Australia,516,243,0,759
274,2017,Nepal,Australia,182,327,0,509
275,2017,Nicaragua,Australia,0,5,0,5
276,2017,Nigeria,Australia,187,305,0,492
277,2017,Norway,Australia,0,9,0,9
278,2017,New Zealand,Australia,26,27,0,53
279,2017,Oman,Australia,5,0,0,5
280,2017,Pakistan,Australia,4496,2351,0,6847
281,2017,Peru,Australia,9,21,0,30
282,2017,Philippines,Australia,51,287,0,338
283,2017,Papua New Guinea,Australia,396,372,0,768
284,2017,Poland,Australia,0,5,0,5
285,2017,Portugal,Australia,0,6,0,6
286,2017,Qatar,Australia,0,5,0,5
287,2017,Romania,Australia,9,11,0,20
288,2017,South Africa,Australia,36,88,0,124
289,2017,Russian Federation,Australia,55,33,0,88
290,2017,Rwanda,Australia,64,65,0,129
291,2017,El Salvador,Australia,10,19,0,29
292,2017,Saudi Arabia,Australia,94,97,0,191
293,2017,Serbia and Kosovo: S/RES/1244 (1999),Australia,5,25,0,30
294,2017,Senegal,Australia,0,5,0,5
295,2017,Singapore,Australia,6,6,0,12
296,2017,Sierra Leone,Australia,29,40,0,69
297,2017,Solomon Islands,Australia,21,106,0,127
298,2017,Somalia,Australia,139,257,0,396
299,2017,Viet Nam,Australia,200,1583,0,1783
300,2017,Sudan,Australia,239,303,0,542
301,2017,South Sudan,Australia,7,29,0,36
302,2017,Slovakia,Australia,0,5,0,5
303,2017,Sweden,Australia,0,5,0,5
304,2017,Syrian Arab Rep.,Australia,477,128,0,605
305,2017,United Rep. of Tanzania,Australia,14,14,0,28
306,2017,Thailand,Australia,15,413,0,428
307,2017,Timor-Leste,Australia,8,0,0,8
308,2017,Togo,Australia,5,5,0,10
309,2017,Tonga,Australia,34,96,0,130
310,2017,Tunisia,Australia,5,12,0,17
311,2017,Türkiye,Australia,476,441,0,917
312,2017,United Arab Emirates,Australia,7,5,0,12
313,2017,Uganda,Australia,65,45,0,110
314,2017,Ukraine,Australia,18,82,0,100
315,2017,Uruguay,Australia,0,6,0,6
316,2017,United States of America,Australia,20,35,0,55
317,2017,Uzbekistan,Australia,29,9,0,38
318,2017,Vanuatu,Australia,0,6,0,6
319,2017,Venezuela (Bolivarian Republic of),Australia,26,80,0,106
320,2017,Samoa,Australia,0,11,0,11
321,2017,Yemen,Australia,27,14,0,41
322,2017,Zambia,Australia,10,24,0,34
323,2017,Zimbabwe,Australia,986,117,0,1103
324,2017,Stateless,Australia,2609,2290,0,4899
325,2017,Tibetan,Australia,17,5,0,22
326,2017,Unknown ,Australia,47,398,0,445
327,2017,Afghanistan,Austria,26939,24233,0,51172
328,2017,Albania,Austria,88,51,0,139
329,2017,Algeria,Austria,43,248,0,291
330,2017,Angola,Austria,82,13,0,95
331,2017,Egypt,Austria,185,257,0,442
332,2017,Armenia,Austria,692,673,0,1365
333,2017,Azerbaijan,Austria,323,214,0,537
334,2017,Burundi,Austria,16,7,0,23
335,2017,Benin,Austria,0,45,0,45
336,2017,Bangladesh,Austria,276,445,0,721
337,2017,Bhutan,Austria,5,0,0,5
338,2017,Burkina Faso,Austria,9,5,0,14
339,2017,Belarus,Austria,82,49,0,131
340,2017,Bolivia (Plurinational State of),Austria,11,0,0,11
341,2017,Bosnia and Herzegovina,Austria,117,31,0,148
342,2017,Chad,Austria,0,5,0,5
343,2017,China,Austria,559,331,0,890
344,2017,Cameroon,Austria,233,89,0,322
345,2017,Congo,Austria,131,15,0,146
346,2017,Dem. Rep. of the Congo,Austria,406,120,0,526
347,2017,Colombia,Austria,0,15,0,15
348,2017,Cuba,Austria,14,19,0,33
349,2017,Eritrea,Austria,303,89,0,392
350,2017,Estonia,Austria,5,0,0,5
351,2017,Ethiopia,Austria,188,145,0,333
352,2017,Gabon,Austria,0,5,0,5
353,2017,Gambia,Austria,134,219,0,353
354,2017,Georgia,Austria,555,734,0,1289
355,2017,Ghana,Austria,31,71,0,102
356,2017,Guinea-Bissau,Austria,5,13,0,18
357,2017,Guatemala,Austria,9,0,0,9
358,2017,Guinea,Austria,142,82,0,224
359,2017,Croatia,Austria,5,0,0,5
360,2017,Cote d'Ivoire,Austria,70,39,0,109
361,2017,India,Austria,63,600,0,663
362,2017,Iran (Islamic Rep. of),Austria,4565,3433,0,7998
363,2017,Iraq,Austria,7414,7805,0,15219
364,2017,Israel,Austria,11,6,0,17
365,2017,Jordan,Austria,62,38,0,100
366,2017,Kazakhstan,Austria,100,88,0,188
367,2017,Kenya,Austria,30,22,0,52
368,2017,Kyrgyzstan,Austria,244,51,0,295
369,2017,Kuwait,Austria,5,7,0,12
370,2017,Liberia,Austria,18,25,0,43
371,2017,Libya,Austria,80,146,0,226
372,2017,Lebanon,Austria,68,157,0,225
373,2017,Sri Lanka,Austria,67,47,0,114
374,2017,Madagascar,Austria,5,0,0,5
375,2017,Mauritania,Austria,5,6,0,11
376,2017,North Macedonia,Austria,75,85,0,160
377,2017,Rep. of Moldova,Austria,66,44,0,110
378,2017,Mali,Austria,11,23,0,34
379,2017,Mongolia,Austria,177,288,0,465
380,2017,Morocco,Austria,30,218,0,248
381,2017,Montenegro,Austria,12,5,0,17
382,2017,Myanmar,Austria,36,14,0,50
383,2017,Nepal,Austria,39,82,0,121
384,2017,Niger,Austria,0,5,0,5
385,2017,Nigeria,Austria,407,1659,0,2066
386,2017,Pakistan,Austria,270,1345,0,1615
387,2017,Philippines,Austria,10,18,0,28
388,2017,Romania,Austria,9,0,0,9
389,2017,South Africa,Austria,5,0,0,5
390,2017,Russian Federation,Austria,11301,2239,0,13540
391,2017,Rwanda,Austria,19,11,0,30
392,2017,Saudi Arabia,Austria,5,0,0,5
393,2017,Serbia and Kosovo: S/RES/1244 (1999),Austria,1216,397,0,1613
394,2017,Senegal,Austria,13,31,0,44
395,2017,Sierra Leone,Austria,26,43,0,69
396,2017,Somalia,Austria,5671,2418,0,8089
397,2017,Viet Nam,Austria,17,16,0,33
398,2017,Sudan,Austria,298,109,0,407
399,2017,South Sudan,Austria,5,12,0,17
400,2017,Syrian Arab Rep.,Austria,43888,3937,0,47825
401,2017,United Rep. of Tanzania,Austria,0,5,0,5
402,2017,Tajikistan,Austria,166,129,0,295
403,2017,Turkmenistan,Austria,7,0,0,7
404,2017,Togo,Austria,12,9,0,21
405,2017,Tunisia,Austria,7,94,0,101
406,2017,Türkiye,Austria,802,529,0,1331
407,2017,Uganda,Austria,23,21,0,44
408,2017,Ukraine,Austria,292,770,0,1062
409,2017,United States of America,Austria,5,0,0,5
410,2017,Uzbekistan,Austria,113,126,0,239
411,2017,Venezuela (Bolivarian Republic of),Austria,0,23,0,23
412,2017,Yemen,Austria,163,120,0,283
413,2017,Zambia,Austria,5,0,0,5
414,2017,Zimbabwe,Austria,22,5,0,27
415,2017,Stateless,Austria,2326,0,0,2326
416,2017,Unknown ,Austria,3308,756,0,4064
417,2017,Afghanistan,Azerbaijan,587,70,0,657
418,2017,Azerbaijan,Azerbaijan,0,0,612785,0
419,2017,Palestinian,Azerbaijan,5,0,0,5
420,2017,Iran (Islamic Rep. of),Azerbaijan,56,0,0,56
421,2017,Iraq,Azerbaijan,8,0,0,8
422,2017,Sri Lanka,Azerbaijan,0,5,0,5
423,2017,Pakistan,Azerbaijan,16,8,0,24
424,2017,Russian Federation,Azerbaijan,419,28,0,447
425,2017,Syrian Arab Rep.,Azerbaijan,15,0,0,15
426,2017,Türkiye,Azerbaijan,0,8,0,8
427,2017,Ukraine,Azerbaijan,6,0,0,6
428,2017,Uzbekistan,Azerbaijan,0,5,0,5
429,2017,Yemen,Azerbaijan,8,0,0,8
430,2017,Stateless,Azerbaijan,0,0,0,0
431,2017,Egypt,Bahrain,0,5,0,5
432,2017,Iraq,Bahrain,246,95,0,341
433,2017,Jordan,Bahrain,0,6,0,6
434,2017,Yemen,Bahrain,9,5,0,14
435,2017,Angola,Burundi,0,5,0,5
436,2017,Burundi,Burundi,0,0,57258,0
437,2017,Benin,Burundi,0,0,0,0
438,2017,Central African Rep.,Burundi,0,6,0,6
439,2017,Dem. Rep. of the Congo,Burundi,61867,2737,0,64604
440,2017,Mali,Burundi,13,5,0,18
441,2017,Rwanda,Burundi,422,793,0,1215
442,2017,Somalia,Burundi,23,0,0,23
443,2017,United Rep. of Tanzania,Burundi,0,0,0,0
444,2017,Türkiye,Burundi,21,5,0,26
445,2017,Uganda,Burundi,7,0,0,7
446,2017,Stateless,Burundi,0,0,0,0
447,2017,Afghanistan,Belgium,3201,3915,0,7116
448,2017,Albania,Belgium,534,385,0,919
449,2017,Algeria,Belgium,46,100,0,146
450,2017,Angola,Belgium,91,145,0,236
451,2017,Egypt,Belgium,50,75,0,125
452,2017,Armenia,Belgium,127,220,0,347
453,2017,Azerbaijan,Belgium,75,65,0,140
454,2017,Burundi,Belgium,454,355,0,809
455,2017,Benin,Belgium,30,35,0,65
456,2017,Bangladesh,Belgium,18,20,0,38
457,2017,Burkina Faso,Belgium,76,65,0,141
458,2017,Belarus,Belgium,41,45,0,86
459,2017,Brazil,Belgium,0,10,0,10
460,2017,Bosnia and Herzegovina,Belgium,50,40,0,90
461,2017,Bulgaria,Belgium,14,15,0,29
462,2017,Cambodia,Belgium,8,0,0,8
463,2017,Central African Rep.,Belgium,41,15,0,56
464,2017,Chad,Belgium,34,20,0,54
465,2017,China,Belgium,1197,105,0,1302
466,2017,Chile,Belgium,48,10,0,58
467,2017,Cameroon,Belgium,404,360,0,764
468,2017,Congo,Belgium,31,20,0,51
469,2017,Dem. Rep. of the Congo,Belgium,1015,665,0,1680
470,2017,Colombia,Belgium,33,80,0,113
471,2017,Cuba,Belgium,8,5,0,13
472,2017,Czechia,Belgium,6,5,0,11
473,2017,Djibouti,Belgium,267,105,0,372
474,2017,Dominican Rep.,Belgium,0,5,0,5
475,2017,Eritrea,Belgium,1000,350,0,1350
476,2017,Ethiopia,Belgium,121,70,0,191
477,2017,Gabon,Belgium,16,15,0,31
478,2017,Gambia,Belgium,15,45,0,60
479,2017,Palestinian,Belgium,117,535,0,652
480,2017,United Kingdom of Great Britain and Northern Ireland,Belgium,0,5,0,5
481,2017,Georgia,Belgium,49,260,0,309
482,2017,Ghana,Belgium,36,25,0,61
483,2017,Guinea-Bissau,Belgium,11,5,0,16
484,2017,Guatemala,Belgium,6,10,0,16
485,2017,Guinea,Belgium,2690,810,0,3500
486,2017,Haiti,Belgium,5,5,0,10
487,2017,Honduras,Belgium,0,20,0,20
488,2017,Croatia,Belgium,5,0,0,5
489,2017,Hungary,Belgium,49,0,0,49
490,2017,Cote d'Ivoire,Belgium,153,165,0,318
491,2017,India,Belgium,20,40,0,60
492,2017,Iran (Islamic Rep. of),Belgium,960,290,0,1250
493,2017,Iraq,Belgium,4000,2020,0,6020
494,2017,Israel,Belgium,13,10,0,23
495,2017,Jordan,Belgium,24,40,0,64
496,2017,Kazakhstan,Belgium,38,30,0,68
497,2017,Kenya,Belgium,22,5,0,27
498,2017,Kyrgyzstan,Belgium,64,40,0,104
499,2017,Dem. People's Rep. of Korea,Belgium,36,5,0,41
500,2017,Kuwait,Belgium,7,0,0,7
501,2017,Lao People's Dem. Rep.,Belgium,13,0,0,13
502,2017,Liberia,Belgium,15,10,0,25
503,2017,Libya,Belgium,60,45,0,105
504,2017,Lebanon,Belgium,99,155,0,254
505,2017,Sri Lanka,Belgium,394,100,0,494
506,2017,Lithuania,Belgium,7,0,0,7
507,2017,Madagascar,Belgium,5,5,0,10
508,2017,Mauritania,Belgium,206,135,0,341
509,2017,North Macedonia,Belgium,113,135,0,248
510,2017,Rep. of Moldova,Belgium,5,15,0,20
511,2017,Mexico,Belgium,0,5,0,5
512,2017,Mali,Belgium,61,55,0,116
513,2017,Mongolia,Belgium,0,5,0,5
514,2017,Morocco,Belgium,70,130,0,200
515,2017,Montenegro,Belgium,0,5,0,5
516,2017,Myanmar,Belgium,9,0,0,9
517,2017,Nepal,Belgium,13,20,0,33
518,2017,Niger,Belgium,91,60,0,151
519,2017,Nigeria,Belgium,43,70,0,113
520,2017,Pakistan,Belgium,222,155,0,377
521,2017,Peru,Belgium,0,5,0,5
522,2017,Philippines,Belgium,0,5,0,5
523,2017,Poland,Belgium,154,0,0,154
524,2017,Romania,Belgium,38,20,0,58
525,2017,South Africa,Belgium,5,5,0,10
526,2017,Russian Federation,Belgium,2558,825,0,3383
527,2017,Rwanda,Belgium,803,420,0,1223
528,2017,El Salvador,Belgium,7,205,0,212
529,2017,Saudi Arabia,Belgium,5,0,0,5
530,2017,Serbia and Kosovo: S/RES/1244 (1999),Belgium,155,310,0,465
531,2017,Senegal,Belgium,435,210,0,645
532,2017,Sierra Leone,Belgium,26,35,0,61
533,2017,Somalia,Belgium,1280,365,0,1645
534,2017,Viet Nam,Belgium,40,5,0,45
535,2017,Sudan,Belgium,174,75,0,249
536,2017,Suriname,Belgium,0,5,0,5
537,2017,South Sudan,Belgium,0,5,0,5
538,2017,Slovakia,Belgium,0,15,0,15
539,2017,Syrian Arab Rep.,Belgium,9080,1665,0,10745
540,2017,United Rep. of Tanzania,Belgium,50,25,0,75
541,2017,Tajikistan,Belgium,10,5,0,15
542,2017,Turkmenistan,Belgium,5,0,0,5
543,2017,Togo,Belgium,176,105,0,281
544,2017,Tunisia,Belgium,37,30,0,67
545,2017,Türkiye,Belgium,587,715,0,1302
546,2017,Uganda,Belgium,20,10,0,30
547,2017,Ukraine,Belgium,166,195,0,361
548,2017,United States of America,Belgium,0,5,0,5
549,2017,Uzbekistan,Belgium,32,15,0,47
550,2017,Venezuela (Bolivarian Republic of),Belgium,6,220,0,226
551,2017,Yemen,Belgium,24,5,0,29
552,2017,Zimbabwe,Belgium,0,5,0,5
553,2017,Stateless,Belgium,0,15,0,15
554,2017,Unknown ,Belgium,7503,445,0,7948
555,2017,Burundi,Benin,5,0,0,5
556,2017,Central African Rep.,Benin,848,132,0,980
557,2017,Chad,Benin,0,6,0,6
558,2017,Cameroon,Benin,0,10,0,10
559,2017,Congo,Benin,0,7,0,7
560,2017,Dem. Rep. of the Congo,Benin,7,24,0,31
561,2017,Eritrea,Benin,5,0,0,5
562,2017,Cote d'Ivoire,Benin,162,20,0,182
563,2017,Liberia,Benin,0,5,0,5
564,2017,Sri Lanka,Benin,7,0,0,7
565,2017,Mali,Benin,5,12,0,17
566,2017,Nigeria,Benin,0,5,0,5
567,2017,Pakistan,Benin,5,0,0,5
568,2017,Syrian Arab Rep.,Benin,7,5,0,12
569,2017,Togo,Benin,0,28,0,28
570,2017,Türkiye,Benin,5,0,0,5
571,2017,Yemen,Benin,0,8,0,8
572,2017,Dem. Rep. of the Congo,Bangladesh,0,5,0,5
573,2017,Myanmar,Bangladesh,932204,0,0,932204
574,2017,Somalia,Bangladesh,5,5,0,10
575,2017,Türkiye,Bangladesh,0,105,0,105
576,2017,Stateless,Bangladesh,0,0,0,0
577,2017,Cuba,Bahamas,8,10,0,18
578,2017,Haiti,Bahamas,0,5,0,5
579,2017,Burundi,Burkina Faso,30,0,0,30
580,2017,Burkina Faso,Burkina Faso,0,0,2350,0
581,2017,Central African Rep.,Burkina Faso,167,43,0,210
582,2017,Chad,Burkina Faso,82,0,0,82
583,2017,Cameroon,Burkina Faso,6,0,0,6
584,2017,Congo,Burkina Faso,26,0,0,26
585,2017,Dem. Rep. of the Congo,Burkina Faso,33,0,0,33
586,2017,Cote d'Ivoire,Burkina Faso,5,0,0,5
587,2017,Mali,Burkina Faso,23766,0,0,23766
588,2017,Rwanda,Burkina Faso,23,0,0,23
589,2017,Togo,Burkina Faso,14,0,0,14
590,2017,Afghanistan,Belarus,209,0,0,209
591,2017,Egypt,Belarus,5,0,0,5
592,2017,Armenia,Belarus,5,0,0,5
593,2017,Azerbaijan,Belarus,5,0,0,5
594,2017,Bangladesh,Belarus,0,5,0,5
595,2017,Ethiopia,Belarus,5,0,0,5
596,2017,Palestinian,Belarus,5,0,0,5
597,2017,Georgia,Belarus,59,0,0,59
598,2017,Iran (Islamic Rep. of),Belarus,5,0,0,5
599,2017,Iraq,Belarus,13,8,0,21
600,2017,Libya,Belarus,9,0,0,9
601,2017,Syrian Arab Rep.,Belarus,87,0,0,87
602,2017,Tajikistan,Belarus,12,0,0,12
603,2017,Türkiye,Belarus,0,5,0,5
604,2017,Ukraine,Belarus,1694,255,0,1949
605,2017,Yemen,Belarus,42,0,0,42
606,2017,Stateless,Belarus,0,0,0,0
607,2017,Chile,Bolivia (Plurinational State of),8,0,0,8
608,2017,Colombia,Bolivia (Plurinational State of),213,21,0,234
609,2017,Cuba,Bolivia (Plurinational State of),9,0,0,9
610,2017,Ecuador,Bolivia (Plurinational State of),5,0,0,5
611,2017,Cote d'Ivoire,Bolivia (Plurinational State of),5,0,0,5
612,2017,Iraq,Bolivia (Plurinational State of),16,0,0,16
613,2017,Nigeria,Bolivia (Plurinational State of),0,5,0,5
614,2017,Pakistan,Bolivia (Plurinational State of),5,0,0,5
615,2017,Peru,Bolivia (Plurinational State of),515,0,0,515
616,2017,Russian Federation,Bolivia (Plurinational State of),5,0,0,5
617,2017,Syrian Arab Rep.,Bolivia (Plurinational State of),21,8,0,29
618,2017,Angola,Botswana,0,0,0,0
619,2017,Burundi,Botswana,46,5,0,51
620,2017,Dem. Rep. of the Congo,Botswana,84,22,0,106
621,2017,Eritrea,Botswana,10,0,0,10
622,2017,Ethiopia,Botswana,5,0,0,5
623,2017,Kenya,Botswana,5,0,0,5
624,2017,Namibia,Botswana,923,11,0,934
625,2017,Rwanda,Botswana,20,0,0,20
626,2017,Somalia,Botswana,314,9,0,323
627,2017,Sudan,Botswana,12,0,0,12
628,2017,Uganda,Botswana,21,0,0,21
629,2017,Zimbabwe,Botswana,676,18,0,694
630,2017,Afghanistan,Brazil,99,165,0,264
631,2017,Albania,Brazil,0,6,0,6
632,2017,Algeria,Brazil,7,18,0,25
633,2017,Angola,Brazil,1112,4717,0,5829
634,2017,Egypt,Brazil,32,274,0,306
635,2017,Argentina,Brazil,11,44,0,55
636,2017,Armenia,Brazil,5,5,0,10
637,2017,Burundi,Brazil,39,25,0,64
638,2017,Belgium,Brazil,0,5,0,5
639,2017,Benin,Brazil,0,212,0,212
640,2017,Bangladesh,Brazil,10,4017,0,4027
641,2017,Bhutan,Brazil,30,35,0,65
642,2017,Burkina Faso,Brazil,5,189,0,194
643,2017,Bolivia (Plurinational State of),Brazil,153,382,0,535
644,2017,Bosnia and Herzegovina,Brazil,5,0,0,5
645,2017,Bulgaria,Brazil,0,5,0,5
646,2017,Canada,Brazil,0,5,0,5
647,2017,Central African Rep.,Brazil,5,6,0,11
648,2017,China,Brazil,5,2252,0,2257
649,2017,Chile,Brazil,21,16,0,37
650,2017,Cameroon,Brazil,56,332,0,388
651,2017,Congo,Brazil,20,0,0,20
652,2017,Dem. Rep. of the Congo,Brazil,1368,2816,0,4184
653,2017,Colombia,Brazil,1291,1417,0,2708
654,2017,Costa Rica,Brazil,0,6,0,6
655,2017,Cuba,Brazil,153,4630,0,4783
656,2017,Cabo Verde,Brazil,0,153,0,153
657,2017,Czechia,Brazil,0,5,0,5
658,2017,Denmark,Brazil,0,11,0,11
659,2017,Djibouti,Brazil,0,5,0,5
660,2017,Dominica,Brazil,0,6,0,6
661,2017,Dominican Rep.,Brazil,5,1171,0,1176
662,2017,Ecuador,Brazil,57,66,0,123
663,2017,Equatorial Guinea,Brazil,0,5,0,5
664,2017,Eritrea,Brazil,25,48,0,73
665,2017,Ethiopia,Brazil,26,64,0,90
666,2017,French Guiana,Brazil,0,6,0,6
667,2017,Fiji,Brazil,0,5,0,5
668,2017,France,Brazil,0,25,0,25
669,2017,Gambia,Brazil,6,392,0,398
670,2017,Palestinian,Brazil,490,350,0,840
671,2017,United Kingdom of Great Britain and Northern Ireland,Brazil,0,5,0,5
672,2017,Georgia,Brazil,10,0,0,10
673,2017,Germany,Brazil,0,8,0,8
674,2017,Ghana,Brazil,33,2305,0,2338
675,2017,Guinea-Bissau,Brazil,19,1560,0,1579
676,2017,Greece,Brazil,0,5,0,5
677,2017,Guatemala,Brazil,0,11,0,11
678,2017,Guinea,Brazil,86,869,0,955
679,2017,Guyana,Brazil,0,32,0,32
680,2017,Haiti,Brazil,8,9433,0,9441
681,2017,Honduras,Brazil,0,8,0,8
682,2017,Croatia,Brazil,5,0,0,5
683,2017,Cote d'Ivoire,Brazil,48,164,0,212
684,2017,India,Brazil,0,366,0,366
685,2017,Indonesia,Brazil,0,5,0,5
686,2017,Iran (Islamic Rep. of),Brazil,60,138,0,198
687,2017,Iraq,Brazil,287,342,0,629
688,2017,Israel,Brazil,0,30,0,30
689,2017,Italy,Brazil,0,15,0,15
690,2017,Jamaica,Brazil,0,7,0,7
691,2017,Jordan,Brazil,8,80,0,88
692,2017,Kenya,Brazil,0,73,0,73
693,2017,Rep. of Korea,Brazil,0,48,0,48
694,2017,Kuwait,Brazil,0,6,0,6
695,2017,Liberia,Brazil,259,27,0,286
696,2017,Libya,Brazil,5,35,0,40
697,2017,Lebanon,Brazil,406,1738,0,2144
698,2017,Lesotho,Brazil,0,5,0,5
699,2017,Sri Lanka,Brazil,18,17,0,35
700,2017,Lithuania,Brazil,0,5,0,5
701,2017,"China, Macao SAR",Brazil,0,5,0,5
702,2017,Mauritania,Brazil,0,137,0,137
703,2017,North Macedonia,Brazil,6,0,0,6
704,2017,Mexico,Brazil,6,23,0,29
705,2017,Mali,Brazil,74,415,0,489
706,2017,Malaysia,Brazil,0,5,0,5
707,2017,Morocco,Brazil,8,331,0,339
708,2017,Mozambique,Brazil,0,62,0,62
709,2017,Malta,Brazil,0,5,0,5
710,2017,Myanmar,Brazil,0,5,0,5
711,2017,Namibia,Brazil,0,34,0,34
712,2017,Nepal,Brazil,6,143,0,149
713,2017,Niger,Brazil,0,6,0,6
714,2017,Nicaragua,Brazil,0,6,0,6
715,2017,Nigeria,Brazil,119,3102,0,3221
716,2017,Norway,Brazil,0,6,0,6
717,2017,Pakistan,Brazil,260,1660,0,1920
718,2017,Panama,Brazil,0,5,0,5
719,2017,Paraguay,Brazil,8,59,0,67
720,2017,Peru,Brazil,45,81,0,126
721,2017,Philippines,Brazil,0,257,0,257
722,2017,Poland,Brazil,0,6,0,6
723,2017,Portugal,Brazil,0,60,0,60
724,2017,Romania,Brazil,0,13,0,13
725,2017,South Africa,Brazil,5,359,0,364
726,2017,Russian Federation,Brazil,13,20,0,33
727,2017,Rwanda,Brazil,18,5,0,23
728,2017,El Salvador,Brazil,13,24,0,37
729,2017,Saudi Arabia,Brazil,0,11,0,11
730,2017,Serbia and Kosovo: S/RES/1244 (1999),Brazil,92,5,0,97
731,2017,Senegal,Brazil,14,8633,0,8647
732,2017,Sierra Leone,Brazil,152,406,0,558
733,2017,Somalia,Brazil,47,473,0,520
734,2017,Spain,Brazil,0,40,0,40
735,2017,Viet Nam,Brazil,5,5,0,10
736,2017,Sao Tome and Principe,Brazil,0,23,0,23
737,2017,Sudan,Brazil,71,104,0,175
738,2017,Suriname,Brazil,0,10,0,10
739,2017,Sweden,Brazil,0,5,0,5
740,2017,Syrian Arab Rep.,Brazil,2905,4522,0,7427
741,2017,United Rep. of Tanzania,Brazil,7,96,0,103
742,2017,Thailand,Brazil,0,31,0,31
743,2017,Togo,Brazil,30,554,0,584
744,2017,Tunisia,Brazil,0,67,0,67
745,2017,Türkiye,Brazil,5,153,0,158
746,2017,Uganda,Brazil,5,18,0,23
747,2017,Ukraine,Brazil,10,65,0,75
748,2017,Uruguay,Brazil,0,19,0,19
749,2017,United States of America,Brazil,0,32,0,32
750,2017,Vanuatu,Brazil,0,8,0,8
751,2017,Venezuela (Bolivarian Republic of),Brazil,30,22315,0,22345
752,2017,Yemen,Brazil,0,35,0,35
753,2017,Zambia,Brazil,0,5,0,5
754,2017,Zimbabwe,Brazil,5,9,0,14
755,2017,Stateless,Brazil,13,0,0,13
756,2017,Unknown ,Brazil,0,33,0,33
757,2017,Stateless,Brunei Darussalam,0,0,0,0
758,2017,Afghanistan,Bosnia and Herzegovina,0,9,0,9
759,2017,Algeria,Bosnia and Herzegovina,0,72,0,72
760,2017,Bosnia and Herzegovina,Bosnia and Herzegovina,0,0,98574,0
761,2017,Palestinian,Bosnia and Herzegovina,5,5,0,10
762,2017,Croatia,Bosnia and Herzegovina,5120,0,0,5120
763,2017,Iran (Islamic Rep. of),Bosnia and Herzegovina,0,5,0,5
764,2017,Iraq,Bosnia and Herzegovina,5,0,0,5
765,2017,Libya,Bosnia and Herzegovina,0,21,0,21
766,2017,North Macedonia,Bosnia and Herzegovina,5,0,0,5
767,2017,Morocco,Bosnia and Herzegovina,0,22,0,22
768,2017,Nepal,Bosnia and Herzegovina,0,5,0,5
769,2017,Pakistan,Bosnia and Herzegovina,0,29,0,29
770,2017,Russian Federation,Bosnia and Herzegovina,0,12,0,12
771,2017,Serbia and Kosovo: S/RES/1244 (1999),Bosnia and Herzegovina,69,0,0,69
772,2017,Syrian Arab Rep.,Bosnia and Herzegovina,15,13,0,28
773,2017,Türkiye,Bosnia and Herzegovina,5,30,0,35
774,2017,Stateless,Bosnia and Herzegovina,0,0,0,0
775,2017,Afghanistan,Bulgaria,169,752,0,921
776,2017,Algeria,Bulgaria,0,23,0,23
777,2017,Egypt,Bulgaria,8,9,0,17
778,2017,Armenia,Bulgaria,15,13,0,28
779,2017,Bangladesh,Bulgaria,8,18,0,26
780,2017,China,Bulgaria,0,15,0,15
781,2017,Cameroon,Bulgaria,0,5,0,5
782,2017,Congo,Bulgaria,8,0,0,8
783,2017,Dem. Rep. of the Congo,Bulgaria,0,7,0,7
784,2017,Eritrea,Bulgaria,5,10,0,15
785,2017,Ethiopia,Bulgaria,13,0,0,13
786,2017,Ghana,Bulgaria,0,8,0,8
787,2017,Cote d'Ivoire,Bulgaria,5,5,0,10
788,2017,India,Bulgaria,5,5,0,10
789,2017,Iran (Islamic Rep. of),Bulgaria,60,116,0,176
790,2017,Iraq,Bulgaria,1221,1046,0,2267
791,2017,Jordan,Bulgaria,7,0,0,7
792,2017,Kazakhstan,Bulgaria,0,5,0,5
793,2017,Kyrgyzstan,Bulgaria,0,7,0,7
794,2017,Lebanon,Bulgaria,23,5,0,28
795,2017,Sri Lanka,Bulgaria,0,5,0,5
796,2017,Mali,Bulgaria,5,7,0,12
797,2017,Morocco,Bulgaria,5,0,0,5
798,2017,Nigeria,Bulgaria,0,6,0,6
799,2017,Pakistan,Bulgaria,12,99,0,111
800,2017,Russian Federation,Bulgaria,0,20,0,20
801,2017,Somalia,Bulgaria,50,6,0,56
802,2017,Sudan,Bulgaria,16,0,0,16
803,2017,Syrian Arab Rep.,Bulgaria,16549,407,0,16956
804,2017,Tunisia,Bulgaria,0,5,0,5
805,2017,Türkiye,Bulgaria,12,20,0,32
806,2017,Ukraine,Bulgaria,0,50,0,50
807,2017,Yemen,Bulgaria,11,0,0,11
808,2017,Stateless,Bulgaria,959,38,0,997
809,2017,Guatemala,Belize,0,447,0,447
810,2017,Honduras,Belize,0,601,0,601
811,2017,Nicaragua,Belize,0,5,0,5
812,2017,Peru,Belize,0,5,0,5
813,2017,El Salvador,Belize,0,2052,0,2052
814,2017,Unknown ,Belize,0,10,0,10
815,2017,Sri Lanka,Cambodia,5,0,0,5
816,2017,Myanmar,Cambodia,19,5,0,24
817,2017,Pakistan,Cambodia,5,0,0,5
818,2017,Viet Nam,Cambodia,32,31,0,63
819,2017,Thailand,Cambodia,0,8,0,8
820,2017,Afghanistan,Canada,3356,717,0,4073
821,2017,Albania,Canada,853,261,0,1114
822,2017,Algeria,Canada,390,240,0,630
823,2017,Angola,Canada,99,267,0,366
824,2017,Antigua and Barbuda,Canada,94,43,0,137
825,2017,Egypt,Canada,1329,734,0,2063
826,2017,Argentina,Canada,26,21,0,47
827,2017,Armenia,Canada,85,16,0,101
828,2017,Australia,Canada,0,5,0,5
829,2017,Austria,Canada,0,9,0,9
830,2017,Azerbaijan,Canada,297,424,0,721
831,2017,Bahrain,Canada,46,17,0,63
832,2017,Barbados,Canada,167,55,0,222
833,2017,Burundi,Canada,2022,591,0,2613
834,2017,Belgium,Canada,14,13,0,27
835,2017,Benin,Canada,54,23,0,77
836,2017,Bangladesh,Canada,905,578,0,1483
837,2017,Bahamas,Canada,194,169,0,363
838,2017,Bhutan,Canada,7,0,0,7
839,2017,Burkina Faso,Canada,95,52,0,147
840,2017,Belarus,Canada,95,20,0,115
841,2017,Bolivia (Plurinational State of),Canada,50,0,0,50
842,2017,Botswana,Canada,255,29,0,284
843,2017,Brazil,Canada,64,378,0,442
844,2017,Bosnia and Herzegovina,Canada,35,9,0,44
845,2017,Bulgaria,Canada,135,27,0,162
846,2017,Belize,Canada,16,7,0,23
847,2017,Cambodia,Canada,71,22,0,93
848,2017,Central African Rep.,Canada,70,11,0,81
849,2017,Chad,Canada,427,303,0,730
850,2017,China,Canada,7180,2216,0,9396
851,2017,Chile,Canada,52,97,0,149
852,2017,Cameroon,Canada,1039,297,0,1336
853,2017,Congo,Canada,281,89,0,370
854,2017,Dem. Rep. of the Congo,Canada,1816,668,0,2484
855,2017,Comoros,Canada,5,0,0,5
856,2017,Colombia,Canada,8049,1567,0,9616
857,2017,Costa Rica,Canada,15,12,0,27
858,2017,Cuba,Canada,836,100,0,936
859,2017,Cyprus,Canada,0,11,0,11
860,2017,Czechia,Canada,420,275,0,695
861,2017,Denmark,Canada,0,5,0,5
862,2017,Djibouti,Canada,801,477,0,1278
863,2017,Dominica,Canada,5,10,0,15
864,2017,Dominican Rep.,Canada,124,67,0,191
865,2017,Ecuador,Canada,59,29,0,88
866,2017,Equatorial Guinea,Canada,13,7,0,20
867,2017,Eritrea,Canada,2131,865,0,2996
868,2017,Estonia,Canada,5,0,0,5
869,2017,Ethiopia,Canada,1631,633,0,2264
870,2017,Fiji,Canada,60,10,0,70
871,2017,Finland,Canada,0,5,0,5
872,2017,France,Canada,10,23,0,33
873,2017,Gabon,Canada,36,11,0,47
874,2017,Gambia,Canada,82,56,0,138
875,2017,Palestinian,Canada,777,626,0,1403
876,2017,United Kingdom of Great Britain and Northern Ireland,Canada,11,0,0,11
877,2017,Georgia,Canada,276,297,0,573
878,2017,Germany,Canada,0,16,0,16
879,2017,Ghana,Canada,298,277,0,575
880,2017,Guinea-Bissau,Canada,9,5,0,14
881,2017,Greece,Canada,14,29,0,43
882,2017,Grenada,Canada,64,11,0,75
883,2017,Guatemala,Canada,554,225,0,779
884,2017,Guinea,Canada,442,132,0,574
885,2017,Guyana,Canada,148,102,0,250
886,2017,Haiti,Canada,6874,7097,0,13971
887,2017,"China, Hong Kong SAR",Canada,6,21,0,27
888,2017,Honduras,Canada,934,280,0,1214
889,2017,Croatia,Canada,204,219,0,423
890,2017,Hungary,Canada,2912,1463,0,4375
891,2017,Cote d'Ivoire,Canada,253,90,0,343
892,2017,India,Canada,1281,1767,0,3048
893,2017,Indonesia,Canada,119,56,0,175
894,2017,Ireland,Canada,0,10,0,10
895,2017,Iran (Islamic Rep. of),Canada,2197,647,0,2844
896,2017,Iraq,Canada,2792,890,0,3682
897,2017,Israel,Canada,181,110,0,291
898,2017,Italy,Canada,0,55,0,55
899,2017,Jamaica,Canada,893,238,0,1131
900,2017,Jordan,Canada,353,295,0,648
901,2017,Japan,Canada,0,10,0,10
902,2017,Kazakhstan,Canada,126,70,0,196
903,2017,Kenya,Canada,463,155,0,618
904,2017,Kyrgyzstan,Canada,61,24,0,85
905,2017,Rep. of Korea,Canada,102,33,0,135
906,2017,Dem. People's Rep. of Korea,Canada,484,409,0,893
907,2017,Kuwait,Canada,86,9,0,95
908,2017,Lao People's Dem. Rep.,Canada,5,0,0,5
909,2017,Liberia,Canada,91,30,0,121
910,2017,Libya,Canada,1118,405,0,1523
911,2017,Saint Lucia,Canada,967,141,0,1108
912,2017,Lebanon,Canada,838,402,0,1240
913,2017,Sri Lanka,Canada,4195,868,0,5063
914,2017,Lithuania,Canada,20,19,0,39
915,2017,Latvia,Canada,75,8,0,83
916,2017,Madagascar,Canada,16,10,0,26
917,2017,Mauritania,Canada,151,59,0,210
918,2017,North Macedonia,Canada,43,8,0,51
919,2017,Rep. of Moldova,Canada,121,21,0,142
920,2017,Mexico,Canada,3846,1408,0,5254
921,2017,Mali,Canada,142,92,0,234
922,2017,Malaysia,Canada,32,15,0,47
923,2017,Malawi,Canada,16,17,0,33
924,2017,Mongolia,Canada,143,36,0,179
925,2017,Morocco,Canada,151,59,0,210
926,2017,Montenegro,Canada,19,10,0,29
927,2017,Mauritius,Canada,5,8,0,13
928,2017,Myanmar,Canada,60,5,0,65
929,2017,Namibia,Canada,360,54,0,414
930,2017,Nepal,Canada,557,188,0,745
931,2017,Netherlands,Canada,5,18,0,23
932,2017,Niger,Canada,57,29,0,86
933,2017,Nicaragua,Canada,82,19,0,101
934,2017,Nigeria,Canada,4800,5632,0,10432
935,2017,Norway,Canada,0,5,0,5
936,2017,Oman,Canada,9,0,0,9
937,2017,Pakistan,Canada,4971,1991,0,6962
938,2017,Panama,Canada,16,23,0,39
939,2017,Paraguay,Canada,21,0,0,21
940,2017,Peru,Canada,252,108,0,360
941,2017,Philippines,Canada,96,64,0,160
942,2017,Papua New Guinea,Canada,5,0,0,5
943,2017,Poland,Canada,125,109,0,234
944,2017,Portugal,Canada,0,12,0,12
945,2017,Qatar,Canada,12,0,0,12
946,2017,Romania,Canada,193,228,0,421
947,2017,South Africa,Canada,58,111,0,169
948,2017,Russian Federation,Canada,877,202,0,1079
949,2017,Rwanda,Canada,1013,197,0,1210
950,2017,El Salvador,Canada,1354,629,0,1983
951,2017,Saudi Arabia,Canada,277,176,0,453
952,2017,Serbia and Kosovo: S/RES/1244 (1999),Canada,288,34,0,322
953,2017,Senegal,Canada,238,60,0,298
954,2017,Seychelles,Canada,5,0,0,5
955,2017,Singapore,Canada,15,5,0,20
956,2017,Sierra Leone,Canada,72,27,0,99
957,2017,Solomon Islands,Canada,28,0,0,28
958,2017,Somalia,Canada,3035,948,0,3983
959,2017,Spain,Canada,6,37,0,43
960,2017,Viet Nam,Canada,44,38,0,82
961,2017,Saint Kitts and Nevis,Canada,40,11,0,51
962,2017,Sudan,Canada,802,609,0,1411
963,2017,Suriname,Canada,8,0,0,8
964,2017,South Sudan,Canada,12,0,0,12
965,2017,Slovakia,Canada,696,664,0,1360
966,2017,Slovenia,Canada,5,9,0,14
967,2017,Eswatini,Canada,141,14,0,155
968,2017,Syrian Arab Rep.,Canada,3095,807,0,3902
969,2017,United Rep. of Tanzania,Canada,147,74,0,221
970,2017,Turks and Caicos Islands,Canada,0,5,0,5
971,2017,Thailand,Canada,17,8,0,25
972,2017,Tajikistan,Canada,44,11,0,55
973,2017,Turkmenistan,Canada,13,8,0,21
974,2017,Togo,Canada,110,47,0,157
975,2017,Trinidad and Tobago,Canada,135,26,0,161
976,2017,Tunisia,Canada,189,67,0,256
977,2017,Türkiye,Canada,2833,1778,0,4611
978,2017,United Arab Emirates,Canada,35,11,0,46
979,2017,Uganda,Canada,541,189,0,730
980,2017,Ukraine,Canada,1126,432,0,1558
981,2017,Uruguay,Canada,7,5,0,12
982,2017,United States of America,Canada,48,1939,0,1987
983,2017,Uzbekistan,Canada,172,69,0,241
984,2017,Saint Vincent and the Grenadines,Canada,1253,109,0,1362
985,2017,Venezuela (Bolivarian Republic of),Canada,1345,1059,0,2404
986,2017,Yemen,Canada,648,694,0,1342
987,2017,Zambia,Canada,28,13,0,41
988,2017,Zimbabwe,Canada,1146,142,0,1288
989,2017,Stateless,Canada,307,207,0,514
990,2017,Unknown ,Canada,85,48,0,133
991,2017,Angola,Central African Rep.,14,0,0,14
992,2017,Burundi,Central African Rep.,24,0,0,24
993,2017,Central African Rep.,Central African Rep.,0,0,688700,0
994,2017,Chad,Central African Rep.,3184,42,0,3226
995,2017,Cameroon,Central African Rep.,5,6,0,11
996,2017,Congo,Central African Rep.,13,8,0,21
997,2017,Dem. Rep. of the Congo,Central African Rep.,4025,472,0,4497
998,2017,Guinea,Central African Rep.,7,0,0,7
999,2017,Cote d'Ivoire,Central African Rep.,9,0,0,9
1000,2017,Liberia,Central African Rep.,5,5,0,10
1001,2017,Rwanda,Central African Rep.,184,11,0,195
1002,2017,Sudan,Central African Rep.,502,12,0,514
1003,2017,South Sudan,Central African Rep.,2049,9,0,2058
1004,2017,Togo,Central African Rep.,0,6,0,6
1005,2017,Türkiye,Central African Rep.,7,0,0,7
1006,2017,Uganda,Central African Rep.,5,0,0,5
1007,2017,Cuba,Cayman Islands,24,28,0,52
1008,2017,Mexico,Cayman Islands,5,0,0,5
1009,2017,Burundi,Chad,5,0,0,5
1010,2017,Central African Rep.,Chad,76653,469,0,77122
1011,2017,Chad,Chad,0,0,99983,0
1012,2017,Cameroon,Chad,11,5,0,16
1013,2017,Congo,Chad,9,5,0,14
1014,2017,Dem. Rep. of the Congo,Chad,316,51,0,367
1015,2017,Eritrea,Chad,6,6,0,12
1016,2017,Ethiopia,Chad,13,14,0,27
1017,2017,Cote d'Ivoire,Chad,5,0,0,5
1018,2017,Iran (Islamic Rep. of),Chad,5,0,0,5
1019,2017,Libya,Chad,9,5,0,14
1020,2017,Mali,Chad,0,0,0,0
1021,2017,Niger,Chad,495,0,0,495
1022,2017,Nigeria,Chad,9541,5,0,9546
1023,2017,Rwanda,Chad,17,0,0,17
1024,2017,Somalia,Chad,10,0,0,10
1025,2017,Sudan,Chad,324327,62,0,324389
1026,2017,South Sudan,Chad,8,0,0,8
1027,2017,Syrian Arab Rep.,Chad,39,29,0,68
1028,2017,Türkiye,Chad,6,0,0,6
1029,2017,Yemen,Chad,0,9,0,9
1030,2017,Unknown ,Chad,0,0,0,0
1031,2017,Afghanistan,China,8,18,0,26
1032,2017,Burundi,China,5,5,0,10
1033,2017,Benin,China,0,5,0,5
1034,2017,Cameroon,China,0,103,0,103
1035,2017,Dem. Rep. of the Congo,China,5,16,0,21
1036,2017,Eritrea,China,0,5,0,5
1037,2017,Gambia,China,0,10,0,10
1038,2017,Palestinian,China,9,6,0,15
1039,2017,Ghana,China,5,38,0,43
1040,2017,Guinea,China,0,11,0,11
1041,2017,Cote d'Ivoire,China,0,12,0,12
1042,2017,Iraq,China,12,19,0,31
1043,2017,Kenya,China,0,6,0,6
1044,2017,Liberia,China,0,125,0,125
1045,2017,Mozambique,China,0,14,0,14
1046,2017,Nigeria,China,0,54,0,54
1047,2017,Pakistan,China,18,15,0,33
1048,2017,Rwanda,China,0,8,0,8
1049,2017,Sierra Leone,China,0,18,0,18
1050,2017,Somalia,China,91,19,0,110
1051,2017,Viet Nam,China,321502,0,0,321502
1052,2017,Syrian Arab Rep.,China,42,32,0,74
1053,2017,Türkiye,China,0,15,0,15
1054,2017,Uganda,China,5,38,0,43
1055,2017,Yemen,China,7,15,0,22
1056,2017,Zimbabwe,China,5,84,0,89
1057,2017,Afghanistan,Chile,13,12,0,25
1058,2017,Angola,Chile,0,8,0,8
1059,2017,Egypt,Chile,0,5,0,5
1060,2017,Bangladesh,Chile,0,5,0,5
1061,2017,Bolivia (Plurinational State of),Chile,0,21,0,21
1062,2017,Congo,Chile,8,5,0,13
1063,2017,Dem. Rep. of the Congo,Chile,6,0,0,6
1064,2017,Colombia,Chile,1117,4765,0,5882
1065,2017,Costa Rica,Chile,5,0,0,5
1066,2017,Cuba,Chile,18,1649,0,1667
1067,2017,Dominican Rep.,Chile,0,150,0,150
1068,2017,Ecuador,Chile,23,31,0,54
1069,2017,Palestinian,Chile,11,16,0,27
1070,2017,Ghana,Chile,0,9,0,9
1071,2017,Haiti,Chile,0,32,0,32
1072,2017,Honduras,Chile,0,5,0,5
1073,2017,Iraq,Chile,0,5,0,5
1074,2017,Kenya,Chile,5,0,0,5
1075,2017,Rep. of Korea,Chile,0,5,0,5
1076,2017,Sri Lanka,Chile,5,0,0,5
1077,2017,Mexico,Chile,0,5,0,5
1078,2017,Pakistan,Chile,0,7,0,7
1079,2017,Peru,Chile,113,22,0,135
1080,2017,Russian Federation,Chile,0,12,0,12
1081,2017,El Salvador,Chile,9,20,0,29
1082,2017,Senegal,Chile,5,5,0,10
1083,2017,Syrian Arab Rep.,Chile,85,42,0,127
1084,2017,Türkiye,Chile,5,30,0,35
1085,2017,United States of America,Chile,0,5,0,5
1086,2017,Venezuela (Bolivarian Republic of),Chile,0,1586,0,1586
1087,2017,Yemen,Chile,0,5,0,5
1088,2017,Unknown ,Chile,433,0,0,433
1089,2017,Angola,Cameroon,5,0,0,5
1090,2017,Burundi,Cameroon,60,27,0,87
1091,2017,Burkina Faso,Cameroon,0,7,0,7
1092,2017,Central African Rep.,Cameroon,248843,4744,0,253587
1093,2017,Chad,Cameroon,1521,326,0,1847
1094,2017,Cameroon,Cameroon,0,0,221695,0
1095,2017,Congo,Cameroon,51,18,0,69
1096,2017,Dem. Rep. of the Congo,Cameroon,523,144,0,667
1097,2017,Gabon,Cameroon,0,5,0,5
1098,2017,Gambia,Cameroon,0,5,0,5
1099,2017,Guinea-Bissau,Cameroon,0,7,0,7
1100,2017,Guinea,Cameroon,11,100,0,111
1101,2017,Cote d'Ivoire,Cameroon,68,79,0,147
1102,2017,Iran (Islamic Rep. of),Cameroon,5,0,0,5
1103,2017,Liberia,Cameroon,9,0,0,9
1104,2017,Mauritania,Cameroon,5,5,0,10
1105,2017,Mali,Cameroon,0,53,0,53
1106,2017,Morocco,Cameroon,7,0,0,7
1107,2017,Niger,Cameroon,0,5,0,5
1108,2017,Nigeria,Cameroon,85319,6,0,85325
1109,2017,Rwanda,Cameroon,832,172,0,1004
1110,2017,Senegal,Cameroon,0,11,0,11
1111,2017,Sudan,Cameroon,79,27,0,106
1112,2017,South Sudan,Cameroon,12,0,0,12
1113,2017,Syrian Arab Rep.,Cameroon,15,9,0,24
1114,2017,Togo,Cameroon,17,0,0,17
1115,2017,Türkiye,Cameroon,0,15,0,15
1116,2017,Algeria,Congo,0,5,0,5
1117,2017,Angola,Congo,318,77,0,395
1118,2017,Burundi,Congo,98,14,0,112
1119,2017,Central African Rep.,Congo,26403,4388,0,30791
1120,2017,Chad,Congo,37,28,0,65
1121,2017,Cameroon,Congo,5,10,0,15
1122,2017,Congo,Congo,0,0,107828,0
1123,2017,Dem. Rep. of the Congo,Congo,12316,1872,0,14188
1124,2017,Guinea,Congo,0,8,0,8
1125,2017,Cote d'Ivoire,Congo,5,30,0,35
1126,2017,Liberia,Congo,0,7,0,7
1127,2017,Mauritania,Congo,0,60,0,60
1128,2017,Mali,Congo,6,12,0,18
1129,2017,Nigeria,Congo,6,0,0,6
1130,2017,Rwanda,Congo,9275,516,0,9791
1131,2017,Sierra Leone,Congo,5,0,0,5
1132,2017,Sudan,Congo,26,35,0,61
1133,2017,South Sudan,Congo,0,13,0,13
1134,2017,Syrian Arab Rep.,Congo,9,12,0,21
1135,2017,Türkiye,Congo,0,5,0,5
1136,2017,Angola,Dem. Rep. of the Congo,494,13,0,507
1137,2017,Burundi,Dem. Rep. of the Congo,44450,225,0,44675
1138,2017,Central African Rep.,Dem. Rep. of the Congo,181917,180,0,182097
1139,2017,Chad,Dem. Rep. of the Congo,5,16,0,21
1140,2017,Cameroon,Dem. Rep. of the Congo,0,17,0,17
1141,2017,Congo,Dem. Rep. of the Congo,661,29,0,690
1142,2017,Dem. Rep. of the Congo,Dem. Rep. of the Congo,0,0,4351376,0
1143,2017,Eritrea,Dem. Rep. of the Congo,5,0,0,5
1144,2017,Cote d'Ivoire,Dem. Rep. of the Congo,7,7,0,14
1145,2017,Kenya,Dem. Rep. of the Congo,0,5,0,5
1146,2017,Liberia,Dem. Rep. of the Congo,5,19,0,24
1147,2017,Mali,Dem. Rep. of the Congo,0,15,0,15
1148,2017,Nepal,Dem. Rep. of the Congo,0,5,0,5
1149,2017,Nigeria,Dem. Rep. of the Congo,0,5,0,5
1150,2017,Rwanda,Dem. Rep. of the Congo,220377,181,0,220558
1151,2017,Somalia,Dem. Rep. of the Congo,14,48,0,62
1152,2017,Sudan,Dem. Rep. of the Congo,151,0,0,151
1153,2017,South Sudan,Dem. Rep. of the Congo,88970,17,0,88987
1154,2017,Syrian Arab Rep.,Dem. Rep. of the Congo,8,20,0,28
1155,2017,Uganda,Dem. Rep. of the Congo,25,5,0,30
1156,2017,Afghanistan,Colombia,8,0,0,8
1157,2017,Bolivia (Plurinational State of),Colombia,5,0,0,5
1158,2017,Colombia,Colombia,0,0,7677609,0
1159,2017,Cuba,Colombia,71,25,0,96
1160,2017,Ecuador,Colombia,9,0,0,9
1161,2017,Eritrea,Colombia,5,0,0,5
1162,2017,Ethiopia,Colombia,17,0,0,17
1163,2017,Honduras,Colombia,5,0,0,5
1164,2017,Hungary,Colombia,7,0,0,7
1165,2017,Iraq,Colombia,9,0,0,9
1166,2017,Nicaragua,Colombia,14,0,0,14
1167,2017,Pakistan,Colombia,0,5,0,5
1168,2017,Romania,Colombia,7,0,0,7
1169,2017,El Salvador,Colombia,11,0,0,11
1170,2017,Serbia and Kosovo: S/RES/1244 (1999),Colombia,7,0,0,7
1171,2017,Sierra Leone,Colombia,5,0,0,5
1172,2017,Somalia,Colombia,11,0,0,11
1173,2017,Syrian Arab Rep.,Colombia,8,5,0,13
1174,2017,Türkiye,Colombia,0,14,0,14
1175,2017,Venezuela (Bolivarian Republic of),Colombia,61,469,0,530
1176,2017,Yemen,Colombia,0,7,0,7
1177,2017,Stateless,Colombia,0,0,0,0
1178,2017,Argentina,Costa Rica,0,5,0,5
1179,2017,Bangladesh,Costa Rica,0,16,0,16
1180,2017,Brazil,Costa Rica,0,5,0,5
1181,2017,Canada,Costa Rica,0,5,0,5
1182,2017,Cameroon,Costa Rica,0,19,0,19
1183,2017,Congo,Costa Rica,0,45,0,45
1184,2017,Dem. Rep. of the Congo,Costa Rica,5,16,0,21
1185,2017,Colombia,Costa Rica,2340,657,0,2997
1186,2017,Cuba,Costa Rica,379,213,0,592
1187,2017,Ecuador,Costa Rica,0,9,0,9
1188,2017,Eritrea,Costa Rica,0,5,0,5
1189,2017,Gambia,Costa Rica,0,5,0,5
1190,2017,Germany,Costa Rica,0,5,0,5
1191,2017,Ghana,Costa Rica,0,74,0,74
1192,2017,Guatemala,Costa Rica,26,19,0,45
1193,2017,Guinea,Costa Rica,0,5,0,5
1194,2017,Haiti,Costa Rica,12,72,0,84
1195,2017,Honduras,Costa Rica,144,296,0,440
1196,2017,Cote d'Ivoire,Costa Rica,0,5,0,5
1197,2017,India,Costa Rica,5,0,0,5
1198,2017,Iran (Islamic Rep. of),Costa Rica,5,0,0,5
1199,2017,Israel,Costa Rica,0,5,0,5
1200,2017,Mexico,Costa Rica,6,10,0,16
1201,2017,Nepal,Costa Rica,0,107,0,107
1202,2017,Niger,Costa Rica,0,7,0,7
1203,2017,Nicaragua,Costa Rica,461,73,0,534
1204,2017,Nigeria,Costa Rica,19,5,0,24
1205,2017,Pakistan,Costa Rica,0,11,0,11
1206,2017,Panama,Costa Rica,5,5,0,10
1207,2017,Peru,Costa Rica,15,0,0,15
1208,2017,Russian Federation,Costa Rica,19,5,0,24
1209,2017,El Salvador,Costa Rica,667,2037,0,2704
1210,2017,Senegal,Costa Rica,0,6,0,6
1211,2017,Somalia,Costa Rica,7,7,0,14
1212,2017,Spain,Costa Rica,0,6,0,6
1213,2017,Syrian Arab Rep.,Costa Rica,9,9,0,18
1214,2017,Ukraine,Costa Rica,17,0,0,17
1215,2017,United States of America,Costa Rica,0,15,0,15
1216,2017,Venezuela (Bolivarian Republic of),Costa Rica,338,3438,0,3776
1217,2017,Zimbabwe,Costa Rica,0,5,0,5
1218,2017,Stateless,Costa Rica,0,0,0,0
1219,2017,Unknown ,Costa Rica,0,201,0,201
1220,2017,Afghanistan,Cuba,45,0,0,45
1221,2017,Eritrea,Cuba,20,0,0,20
1222,2017,Ethiopia,Cuba,5,5,0,10
1223,2017,Palestinian,Cuba,6,0,0,6
1224,2017,Iran (Islamic Rep. of),Cuba,26,10,0,36
1225,2017,Iraq,Cuba,5,0,0,5
1226,2017,Syrian Arab Rep.,Cuba,43,0,0,43
1227,2017,Western Sahara,Cuba,176,0,0,176
1228,2017,Yemen,Cuba,17,0,0,17
1229,2017,Stateless,Cabo Verde,0,0,0,0
1230,2017,Afghanistan,Cyprus,12,5,0,17
1231,2017,Algeria,Cyprus,8,0,0,8
1232,2017,Egypt,Cyprus,98,438,0,536
1233,2017,Armenia,Cyprus,26,20,0,46
1234,2017,Bangladesh,Cyprus,5,274,0,279
1235,2017,Bosnia and Herzegovina,Cyprus,15,0,0,15
1236,2017,China,Cyprus,5,5,0,10
1237,2017,Cameroon,Cyprus,32,185,0,217
1238,2017,Congo,Cyprus,5,32,0,37
1239,2017,Dem. Rep. of the Congo,Cyprus,17,36,0,53
1240,2017,Cuba,Cyprus,0,5,0,5
1241,2017,Eritrea,Cyprus,53,0,0,53
1242,2017,Ethiopia,Cyprus,5,18,0,23
1243,2017,Gambia,Cyprus,0,39,0,39
1244,2017,Palestinian,Cyprus,1964,214,0,2178
1245,2017,Georgia,Cyprus,85,102,0,187
1246,2017,Ghana,Cyprus,0,5,0,5
1247,2017,Guinea,Cyprus,5,9,0,14
1248,2017,Cote d'Ivoire,Cyprus,5,18,0,23
1249,2017,India,Cyprus,7,408,0,415
1250,2017,Iran (Islamic Rep. of),Cyprus,523,131,0,654
1251,2017,Iraq,Cyprus,854,216,0,1070
1252,2017,Jordan,Cyprus,37,45,0,82
1253,2017,Kazakhstan,Cyprus,5,0,0,5
1254,2017,Kyrgyzstan,Cyprus,5,0,0,5
1255,2017,Lebanon,Cyprus,48,31,0,79
1256,2017,Sri Lanka,Cyprus,25,172,0,197
1257,2017,Rep. of Moldova,Cyprus,18,5,0,23
1258,2017,Mali,Cyprus,0,5,0,5
1259,2017,Morocco,Cyprus,0,5,0,5
1260,2017,Nepal,Cyprus,0,102,0,102
1261,2017,Nigeria,Cyprus,9,82,0,91
1262,2017,Pakistan,Cyprus,17,208,0,225
1263,2017,Philippines,Cyprus,12,105,0,117
1264,2017,Russian Federation,Cyprus,76,28,0,104
1265,2017,Rwanda,Cyprus,5,0,0,5
1266,2017,Serbia and Kosovo: S/RES/1244 (1999),Cyprus,59,5,0,64
1267,2017,Senegal,Cyprus,0,5,0,5
1268,2017,Sierra Leone,Cyprus,24,0,0,24
1269,2017,Somalia,Cyprus,148,113,0,261
1270,2017,Viet Nam,Cyprus,0,330,0,330
1271,2017,Sudan,Cyprus,10,5,0,15
1272,2017,Syrian Arab Rep.,Cyprus,5274,1585,0,6859
1273,2017,Tunisia,Cyprus,0,5,0,5
1274,2017,Türkiye,Cyprus,193,78,0,271
1275,2017,Ukraine,Cyprus,30,110,0,140
1276,2017,Uzbekistan,Cyprus,5,5,0,10
1277,2017,Yemen,Cyprus,10,13,0,23
1278,2017,Zimbabwe,Cyprus,0,5,0,5
1279,2017,Stateless,Cyprus,56,0,0,56
1280,2017,Unknown ,Cyprus,0,9,0,9
1281,2017,Afghanistan,Czechia,234,5,0,239
1282,2017,Albania,Czechia,6,0,0,6
1283,2017,Algeria,Czechia,0,5,0,5
1284,2017,Angola,Czechia,19,0,0,19
1285,2017,Armenia,Czechia,69,81,0,150
1286,2017,Azerbaijan,Czechia,31,73,0,104
1287,2017,Belarus,Czechia,364,11,0,375
1288,2017,Bosnia and Herzegovina,Czechia,13,0,0,13
1289,2017,Bulgaria,Czechia,16,0,0,16
1290,2017,China,Czechia,13,81,0,94
1291,2017,Cameroon,Czechia,6,5,0,11
1292,2017,Congo,Czechia,5,0,0,5
1293,2017,Dem. Rep. of the Congo,Czechia,21,5,0,26
1294,2017,Cuba,Czechia,228,43,0,271
1295,2017,Ecuador,Czechia,5,0,0,5
1296,2017,Eritrea,Czechia,17,0,0,17
1297,2017,Ethiopia,Czechia,10,0,0,10
1298,2017,Georgia,Czechia,34,40,0,74
1299,2017,Ghana,Czechia,11,0,0,11
1300,2017,Guinea,Czechia,7,0,0,7
1301,2017,India,Czechia,5,0,0,5
1302,2017,Iran (Islamic Rep. of),Czechia,26,0,0,26
1303,2017,Iraq,Czechia,199,35,0,234
1304,2017,Kazakhstan,Czechia,234,13,0,247
1305,2017,Kyrgyzstan,Czechia,21,6,0,27
1306,2017,Liberia,Czechia,5,0,0,5
1307,2017,Libya,Czechia,9,8,0,17
1308,2017,Lebanon,Czechia,5,0,0,5
1309,2017,Sri Lanka,Czechia,14,5,0,19
1310,2017,Rep. of Moldova,Czechia,25,13,0,38
1311,2017,Mongolia,Czechia,5,5,0,10
1312,2017,Morocco,Czechia,5,0,0,5
1313,2017,Myanmar,Czechia,160,5,0,165
1314,2017,Nigeria,Czechia,13,9,0,22
1315,2017,Pakistan,Czechia,20,8,0,28
1316,2017,Romania,Czechia,81,0,0,81
1317,2017,South Africa,Czechia,5,0,0,5
1318,2017,Russian Federation,Czechia,319,33,0,352
1319,2017,Saudi Arabia,Czechia,5,0,0,5
1320,2017,Serbia and Kosovo: S/RES/1244 (1999),Czechia,9,0,0,9
1321,2017,Sierra Leone,Czechia,5,0,0,5
1322,2017,Somalia,Czechia,22,0,0,22
1323,2017,Viet Nam,Czechia,70,44,0,114
1324,2017,Sudan,Czechia,17,0,0,17
1325,2017,Syrian Arab Rep.,Czechia,365,38,0,403
1326,2017,Tajikistan,Czechia,5,0,0,5
1327,2017,Turkmenistan,Czechia,5,0,0,5
1328,2017,Togo,Czechia,6,0,0,6
1329,2017,Tunisia,Czechia,0,6,0,6
1330,2017,Türkiye,Czechia,8,18,0,26
1331,2017,Uganda,Czechia,5,0,0,5
1332,2017,Ukraine,Czechia,444,186,0,630
1333,2017,Uzbekistan,Czechia,99,9,0,108
1334,2017,Venezuela (Bolivarian Republic of),Czechia,5,0,0,5
1335,2017,Stateless,Czechia,201,9,0,210
1336,2017,Unknown ,Czechia,109,0,0,109
1337,2017,Afghanistan,Denmark,2668,769,0,3437
1338,2017,Albania,Denmark,5,10,0,15
1339,2017,Algeria,Denmark,5,17,0,22
1340,2017,Egypt,Denmark,16,8,0,24
1341,2017,Armenia,Denmark,70,47,0,117
1342,2017,Azerbaijan,Denmark,50,29,0,79
1343,2017,Burundi,Denmark,5,5,0,10
1344,2017,Bangladesh,Denmark,20,10,0,30
1345,2017,Bhutan,Denmark,5,0,0,5
1346,2017,Belarus,Denmark,5,25,0,30
1347,2017,Bosnia and Herzegovina,Denmark,5,0,0,5
1348,2017,China,Denmark,17,5,0,22
1349,2017,Cameroon,Denmark,6,13,0,19
1350,2017,Congo,Denmark,5,0,0,5
1351,2017,Dem. Rep. of the Congo,Denmark,87,17,0,104
1352,2017,Colombia,Denmark,5,10,0,15
1353,2017,Eritrea,Denmark,4006,188,0,4194
1354,2017,Ethiopia,Denmark,94,44,0,138
1355,2017,Gambia,Denmark,5,11,0,16
1356,2017,Palestinian,Denmark,24,0,0,24
1357,2017,Georgia,Denmark,5,59,0,64
1358,2017,Ghana,Denmark,5,12,0,17
1359,2017,Guinea-Bissau,Denmark,5,0,0,5
1360,2017,Guinea,Denmark,0,16,0,16
1361,2017,Cote d'Ivoire,Denmark,14,0,0,14
1362,2017,India,Denmark,5,5,0,10
1363,2017,Indonesia,Denmark,0,6,0,6
1364,2017,Iran (Islamic Rep. of),Denmark,3107,841,0,3948
1365,2017,Iraq,Denmark,661,421,0,1082
1366,2017,Jordan,Denmark,5,7,0,12
1367,2017,Kenya,Denmark,6,11,0,17
1368,2017,Kyrgyzstan,Denmark,5,0,0,5
1369,2017,Dem. People's Rep. of Korea,Denmark,9,0,0,9
1370,2017,Kuwait,Denmark,0,95,0,95
1371,2017,Libya,Denmark,11,23,0,34
1372,2017,Lebanon,Denmark,26,30,0,56
1373,2017,Sri Lanka,Denmark,71,19,0,90
1374,2017,North Macedonia,Denmark,0,5,0,5
1375,2017,Rep. of Moldova,Denmark,0,12,0,12
1376,2017,Morocco,Denmark,8,64,0,72
1377,2017,Myanmar,Denmark,45,5,0,50
1378,2017,Nepal,Denmark,7,0,0,7
1379,2017,Nigeria,Denmark,12,45,0,57
1380,2017,Pakistan,Denmark,58,22,0,80
1381,2017,Russian Federation,Denmark,1029,27,0,1056
1382,2017,Rwanda,Denmark,20,0,0,20
1383,2017,El Salvador,Denmark,5,5,0,10
1384,2017,Serbia and Kosovo: S/RES/1244 (1999),Denmark,5,9,0,14
1385,2017,Sierra Leone,Denmark,0,5,0,5
1386,2017,Somalia,Denmark,1292,128,0,1420
1387,2017,Sudan,Denmark,77,8,0,85
1388,2017,Syrian Arab Rep.,Denmark,19221,285,0,19506
1389,2017,Thailand,Denmark,5,0,0,5
1390,2017,Tajikistan,Denmark,5,0,0,5
1391,2017,Tunisia,Denmark,0,7,0,7
1392,2017,Türkiye,Denmark,5,21,0,26
1393,2017,Uganda,Denmark,75,30,0,105
1394,2017,Ukraine,Denmark,26,43,0,69
1395,2017,United States of America,Denmark,0,5,0,5
1396,2017,Uzbekistan,Denmark,11,5,0,16
1397,2017,Venezuela (Bolivarian Republic of),Denmark,0,12,0,12
1398,2017,Yemen,Denmark,5,5,0,10
1399,2017,Zimbabwe,Denmark,13,0,0,13
1400,2017,Stateless,Denmark,2676,722,0,3398
1401,2017,Unknown ,Denmark,30,6,0,36
1402,2017,Eritrea,Djibouti,406,787,0,1193
1403,2017,Ethiopia,Djibouti,527,8504,0,9031
1404,2017,Iraq,Djibouti,14,5,0,19
1405,2017,Kenya,Djibouti,10,0,0,10
1406,2017,Philippines,Djibouti,5,0,0,5
1407,2017,Somalia,Djibouti,13108,56,0,13164
1408,2017,Sudan,Djibouti,6,0,0,6
1409,2017,South Sudan,Djibouti,0,5,0,5
1410,2017,Syrian Arab Rep.,Djibouti,9,0,0,9
1411,2017,Yemen,Djibouti,3468,0,0,3468
1412,2017,Afghanistan,Dominican Rep.,5,7,0,12
1413,2017,Colombia,Dominican Rep.,0,14,0,14
1414,2017,Cuba,Dominican Rep.,0,33,0,33
1415,2017,Ecuador,Dominican Rep.,5,0,0,5
1416,2017,Haiti,Dominican Rep.,574,730,0,1304
1417,2017,Honduras,Dominican Rep.,0,5,0,5
1418,2017,Iraq,Dominican Rep.,5,0,0,5
1419,2017,Syrian Arab Rep.,Dominican Rep.,0,6,0,6
1420,2017,Türkiye,Dominican Rep.,0,5,0,5
1421,2017,Ukraine,Dominican Rep.,5,0,0,5
1422,2017,Venezuela (Bolivarian Republic of),Dominican Rep.,0,50,0,50
1423,2017,Afghanistan,Ecuador,94,63,0,157
1424,2017,Albania,Ecuador,6,0,0,6
1425,2017,Angola,Ecuador,0,26,0,26
1426,2017,Egypt,Ecuador,0,8,0,8
1427,2017,Bangladesh,Ecuador,0,12,0,12
1428,2017,Brazil,Ecuador,5,6,0,11
1429,2017,Canada,Ecuador,0,5,0,5
1430,2017,China,Ecuador,12,0,0,12
1431,2017,Chile,Ecuador,5,6,0,11
1432,2017,Cameroon,Ecuador,0,9,0,9
1433,2017,Congo,Ecuador,5,0,0,5
1434,2017,Dem. Rep. of the Congo,Ecuador,0,14,0,14
1435,2017,Colombia,Ecuador,46616,10310,0,56926
1436,2017,Cuba,Ecuador,212,53,0,265
1437,2017,Dominican Rep.,Ecuador,5,9,0,14
1438,2017,Eritrea,Ecuador,11,0,0,11
1439,2017,Ethiopia,Ecuador,5,0,0,5
1440,2017,Gambia,Ecuador,0,5,0,5
1441,2017,Palestinian,Ecuador,7,5,0,12
1442,2017,Ghana,Ecuador,5,5,0,10
1443,2017,Guinea,Ecuador,9,0,0,9
1444,2017,Haiti,Ecuador,21,7,0,28
1445,2017,India,Ecuador,0,7,0,7
1446,2017,Iran (Islamic Rep. of),Ecuador,23,43,0,66
1447,2017,Iraq,Ecuador,35,33,0,68
1448,2017,Liberia,Ecuador,5,0,0,5
1449,2017,Libya,Ecuador,0,8,0,8
1450,2017,Lebanon,Ecuador,5,5,0,10
1451,2017,Sri Lanka,Ecuador,14,6,0,20
1452,2017,North Macedonia,Ecuador,14,0,0,14
1453,2017,Mexico,Ecuador,0,5,0,5
1454,2017,Mali,Ecuador,5,0,0,5
1455,2017,Morocco,Ecuador,5,0,0,5
1456,2017,Nepal,Ecuador,5,0,0,5
1457,2017,Nigeria,Ecuador,23,13,0,36
1458,2017,Pakistan,Ecuador,25,11,0,36
1459,2017,Peru,Ecuador,80,89,0,169
1460,2017,Philippines,Ecuador,0,6,0,6
1461,2017,Russian Federation,Ecuador,30,0,0,30
1462,2017,El Salvador,Ecuador,0,18,0,18
1463,2017,Saudi Arabia,Ecuador,5,0,0,5
1464,2017,Somalia,Ecuador,7,0,0,7
1465,2017,Spain,Ecuador,5,0,0,5
1466,2017,Viet Nam,Ecuador,5,0,0,5
1467,2017,Sudan,Ecuador,5,0,0,5
1468,2017,Syrian Arab Rep.,Ecuador,39,115,0,154
1469,2017,Turkmenistan,Ecuador,0,8,0,8
1470,2017,Türkiye,Ecuador,0,5,0,5
1471,2017,Ukraine,Ecuador,0,14,0,14
1472,2017,United States of America,Ecuador,6,0,0,6
1473,2017,Uzbekistan,Ecuador,5,0,0,5
1474,2017,Venezuela (Bolivarian Republic of),Ecuador,5,862,0,867
1475,2017,Western Sahara,Ecuador,5,0,0,5
1476,2017,Yemen,Ecuador,0,104,0,104
1477,2017,Zimbabwe,Ecuador,5,0,0,5
1478,2017,Unknown ,Ecuador,45026,0,0,45026
1479,2017,Eritrea,Eritrea,0,0,0,0
1480,2017,Ethiopia,Eritrea,30,0,0,30
1481,2017,Somalia,Eritrea,2286,0,0,2286
1482,2017,Sudan,Eritrea,67,0,0,67
1483,2017,South Sudan,Eritrea,9,0,0,9
1484,2017,Afghanistan,Estonia,23,0,0,23
1485,2017,Albania,Estonia,0,5,0,5
1486,2017,Bangladesh,Estonia,5,0,0,5
1487,2017,Belarus,Estonia,7,5,0,12
1488,2017,Eritrea,Estonia,5,0,0,5
1489,2017,Palestinian,Estonia,5,0,0,5
1490,2017,Georgia,Estonia,7,0,0,7
1491,2017,Iran (Islamic Rep. of),Estonia,0,5,0,5
1492,2017,Iraq,Estonia,32,6,0,38
1493,2017,Sri Lanka,Estonia,12,0,0,12
1494,2017,Pakistan,Estonia,5,0,0,5
1495,2017,Russian Federation,Estonia,26,9,0,35
1496,2017,Serbia and Kosovo: S/RES/1244 (1999),Estonia,5,0,0,5
1497,2017,Somalia,Estonia,5,0,0,5
1498,2017,Sudan,Estonia,24,0,0,24
1499,2017,Syrian Arab Rep.,Estonia,151,0,0,151
1500,2017,Türkiye,Estonia,5,0,0,5
1501,2017,Ukraine,Estonia,88,0,0,88
1502,2017,Venezuela (Bolivarian Republic of),Estonia,0,6,0,6
1503,2017,Stateless,Estonia,0,0,0,0
1504,2017,Egypt,Ethiopia,5,0,0,5
1505,2017,Burundi,Ethiopia,58,74,0,132
1506,2017,Dem. Rep. of the Congo,Ethiopia,530,523,0,1053
1507,2017,Cuba,Ethiopia,5,0,0,5
1508,2017,Djibouti,Ethiopia,76,8,0,84
1509,2017,Eritrea,Ethiopia,164605,216,0,164821
1510,2017,Ethiopia,Ethiopia,0,0,1078429,0
1511,2017,Cote d'Ivoire,Ethiopia,5,0,0,5
1512,2017,Iraq,Ethiopia,10,0,0,10
1513,2017,Kenya,Ethiopia,3459,429,0,3888
1514,2017,Rwanda,Ethiopia,10,6,0,16
1515,2017,Somalia,Ethiopia,253779,83,0,253862
1516,2017,Sudan,Ethiopia,43892,497,0,44389
1517,2017,South Sudan,Ethiopia,421373,494,0,421867
1518,2017,Syrian Arab Rep.,Ethiopia,9,67,0,76
1519,2017,Uganda,Ethiopia,18,5,0,23
1520,2017,Yemen,Ethiopia,1578,191,0,1769
1521,2017,Afghanistan,Fiji,7,5,0,12
1522,2017,Pakistan,Fiji,0,5,0,5
1523,2017,Afghanistan,Finland,2571,320,0,2891
1524,2017,Albania,Finland,5,5,0,10
1525,2017,Algeria,Finland,17,10,0,27
1526,2017,Angola,Finland,139,15,0,154
1527,2017,Egypt,Finland,13,12,0,25
1528,2017,Azerbaijan,Finland,43,9,0,52
1529,2017,Burundi,Finland,5,0,0,5
1530,2017,Bangladesh,Finland,22,10,0,32
1531,2017,Burkina Faso,Finland,5,5,0,10
1532,2017,Belarus,Finland,13,10,0,23
1533,2017,Brazil,Finland,5,0,0,5
1534,2017,Bosnia and Herzegovina,Finland,5,0,0,5
1535,2017,Bulgaria,Finland,0,5,0,5
1536,2017,Cambodia,Finland,5,0,0,5
1537,2017,Central African Rep.,Finland,5,0,0,5
1538,2017,China,Finland,90,66,0,156
1539,2017,Cameroon,Finland,90,29,0,119
1540,2017,Congo,Finland,10,0,0,10
1541,2017,Dem. Rep. of the Congo,Finland,158,14,0,172
1542,2017,Cuba,Finland,5,0,0,5
1543,2017,Dominican Rep.,Finland,5,0,0,5
1544,2017,Ecuador,Finland,5,0,0,5
1545,2017,Eritrea,Finland,564,276,0,840
1546,2017,Ethiopia,Finland,144,30,0,174
1547,2017,Gambia,Finland,29,13,0,42
1548,2017,Georgia,Finland,5,45,0,50
1549,2017,Ghana,Finland,52,10,0,62
1550,2017,Guatemala,Finland,5,0,0,5
1551,2017,Guinea,Finland,21,0,0,21
1552,2017,Honduras,Finland,11,0,0,11
1553,2017,Croatia,Finland,10,0,0,10
1554,2017,Cote d'Ivoire,Finland,13,0,0,13
1555,2017,India,Finland,8,9,0,17
1556,2017,Indonesia,Finland,0,10,0,10
1557,2017,Iran (Islamic Rep. of),Finland,877,82,0,959
1558,2017,Iraq,Finland,7849,1057,0,8906
1559,2017,Kazakhstan,Finland,13,0,0,13
1560,2017,Kenya,Finland,13,0,0,13
1561,2017,Kyrgyzstan,Finland,19,0,0,19
1562,2017,Liberia,Finland,5,0,0,5
1563,2017,Libya,Finland,27,5,0,32
1564,2017,Lebanon,Finland,14,0,0,14
1565,2017,Sri Lanka,Finland,107,19,0,126
1566,2017,Mauritania,Finland,5,0,0,5
1567,2017,North Macedonia,Finland,0,5,0,5
1568,2017,Rep. of Moldova,Finland,6,0,0,6
1569,2017,Mali,Finland,6,0,0,6
1570,2017,Morocco,Finland,37,15,0,52
1571,2017,Myanmar,Finland,30,0,0,30
1572,2017,Nigeria,Finland,161,58,0,219
1573,2017,Pakistan,Finland,66,38,0,104
1574,2017,Russian Federation,Finland,761,332,0,1093
1575,2017,Rwanda,Finland,24,12,0,36
1576,2017,El Salvador,Finland,10,0,0,10
1577,2017,Serbia and Kosovo: S/RES/1244 (1999),Finland,96,6,0,102
1578,2017,Senegal,Finland,5,0,0,5
1579,2017,Sierra Leone,Finland,6,0,0,6
1580,2017,Somalia,Finland,3257,188,0,3445
1581,2017,Viet Nam,Finland,5,0,0,5
1582,2017,Sudan,Finland,38,7,0,45
1583,2017,South Sudan,Finland,5,0,0,5
1584,2017,Syrian Arab Rep.,Finland,2370,132,0,2502
1585,2017,United Rep. of Tanzania,Finland,5,0,0,5
1586,2017,Tajikistan,Finland,0,5,0,5
1587,2017,Togo,Finland,5,0,0,5
1588,2017,Tunisia,Finland,5,0,0,5
1589,2017,Türkiye,Finland,145,92,0,237
1590,2017,Uganda,Finland,27,8,0,35
1591,2017,Ukraine,Finland,10,21,0,31
1592,2017,Uzbekistan,Finland,6,0,0,6
1593,2017,Venezuela (Bolivarian Republic of),Finland,5,11,0,16
1594,2017,Yemen,Finland,139,49,0,188
1595,2017,Zambia,Finland,0,5,0,5
1596,2017,Stateless,Finland,392,23,0,415
1597,2017,Unknown ,Finland,164,28,0,192
1598,2017,Afghanistan,France,13425,4314,0,17739
1599,2017,Albania,France,4349,4229,0,8578
1600,2017,Algeria,France,1654,1424,0,3078
1601,2017,Angola,France,3428,734,0,4162
1602,2017,Egypt,France,886,302,0,1188
1603,2017,Argentina,France,5,0,0,5
1604,2017,Armenia,France,4113,1432,0,5545
1605,2017,Azerbaijan,France,2916,306,0,3222
1606,2017,Bahrain,France,6,0,0,6
1607,2017,Burundi,France,607,195,0,802
1608,2017,Benin,France,36,26,0,62
1609,2017,Bangladesh,France,5160,2451,0,7611
1610,2017,Bhutan,France,117,8,0,125
1611,2017,Burkina Faso,France,193,69,0,262
1612,2017,Belarus,France,514,10,0,524
1613,2017,Bolivia (Plurinational State of),France,36,0,0,36
1614,2017,Brazil,France,12,0,0,12
1615,2017,Bosnia and Herzegovina,France,4085,383,0,4468
1616,2017,Bulgaria,France,71,0,0,71
1617,2017,Cambodia,France,11361,13,0,11374
1618,2017,Central African Rep.,France,2642,790,0,3432
1619,2017,Chad,France,1392,613,0,2005
1620,2017,China,France,4541,900,0,5441
1621,2017,Chile,France,67,0,0,67
1622,2017,Cameroon,France,1041,535,0,1576
1623,2017,Congo,France,3317,961,0,4278
1624,2017,Dem. Rep. of the Congo,France,15697,2850,0,18547
1625,2017,Comoros,France,575,250,0,825
1626,2017,Colombia,France,488,128,0,616
1627,2017,Cuba,France,167,9,0,176
1628,2017,Czechia,France,27,0,0,27
1629,2017,Djibouti,France,256,46,0,302
1630,2017,Dominican Rep.,France,49,241,0,290
1631,2017,Ecuador,France,26,0,0,26
1632,2017,Equatorial Guinea,France,32,5,0,37
1633,2017,Eritrea,France,3768,840,0,4608
1634,2017,Estonia,France,7,0,0,7
1635,2017,Ethiopia,France,1109,554,0,1663
1636,2017,Gabon,France,82,371,0,453
1637,2017,Gambia,France,252,80,0,332
1638,2017,Palestinian,France,813,199,0,1012
1639,2017,Georgia,France,3083,1394,0,4477
1640,2017,Germany,France,6,0,0,6
1641,2017,Ghana,France,516,16,0,532
1642,2017,Guinea-Bissau,France,896,44,0,940
1643,2017,Guatemala,France,14,0,0,14
1644,2017,Guinea,France,7788,3178,0,10966
1645,2017,Guyana,France,16,0,0,16
1646,2017,Haiti,France,3497,3282,0,6779
1647,2017,Honduras,France,6,0,0,6
1648,2017,Croatia,France,62,0,0,62
1649,2017,Hungary,France,65,0,0,65
1650,2017,Cote d'Ivoire,France,3263,2928,0,6191
1651,2017,India,France,213,35,0,248
1652,2017,Indonesia,France,6,0,0,6
1653,2017,Iran (Islamic Rep. of),France,2580,415,0,2995
1654,2017,Iraq,France,7265,946,0,8211
1655,2017,Israel,France,7,0,0,7
1656,2017,Jamaica,France,14,0,0,14
1657,2017,Jordan,France,27,0,0,27
1658,2017,Kazakhstan,France,553,42,0,595
1659,2017,Kenya,France,107,17,0,124
1660,2017,Kyrgyzstan,France,306,10,0,316
1661,2017,Dem. People's Rep. of Korea,France,5,7,0,12
1662,2017,Kuwait,France,77,0,0,77
1663,2017,Lao People's Dem. Rep.,France,6721,0,0,6721
1664,2017,Liberia,France,232,24,0,256
1665,2017,Libya,France,540,519,0,1059
1666,2017,Lebanon,France,135,30,0,165
1667,2017,Sri Lanka,France,24110,1463,0,25573
1668,2017,Lithuania,France,11,0,0,11
1669,2017,Latvia,France,38,0,0,38
1670,2017,Madagascar,France,221,35,0,256
1671,2017,Mauritania,France,5320,526,0,5846
1672,2017,North Macedonia,France,340,492,0,832
1673,2017,Rep. of Moldova,France,322,6,0,328
1674,2017,Mexico,France,23,0,0,23
1675,2017,Mali,France,4381,1030,0,5411
1676,2017,Malaysia,France,9,0,0,9
1677,2017,Mongolia,France,422,48,0,470
1678,2017,Morocco,France,473,359,0,832
1679,2017,Mozambique,France,9,6,0,15
1680,2017,Montenegro,France,86,46,0,132
1681,2017,Mauritius,France,16,8,0,24
1682,2017,Myanmar,France,316,30,0,346
1683,2017,Nepal,France,129,67,0,196
1684,2017,Niger,France,64,44,0,108
1685,2017,Nigeria,France,2101,1857,0,3958
1686,2017,Pakistan,France,1399,1279,0,2678
1687,2017,Paraguay,France,6,0,0,6
1688,2017,Peru,France,298,9,0,307
1689,2017,Poland,France,140,0,0,140
1690,2017,Romania,France,151,0,0,151
1691,2017,South Africa,France,32,0,0,32
1692,2017,Russian Federation,France,15634,1731,0,17365
1693,2017,Rwanda,France,2807,342,0,3149
1694,2017,El Salvador,France,38,5,0,43
1695,2017,Saudi Arabia,France,12,0,0,12
1696,2017,Serbia and Kosovo: S/RES/1244 (1999),France,13376,2294,0,15670
1697,2017,Senegal,France,1094,802,0,1896
1698,2017,Sierra Leone,France,541,70,0,611
1699,2017,Somalia,France,2964,1217,0,4181
1700,2017,Viet Nam,France,7911,18,0,7929
1701,2017,Sao Tome and Principe,France,5,0,0,5
1702,2017,Sudan,France,11337,3832,0,15169
1703,2017,Suriname,France,0,5,0,5
1704,2017,South Sudan,France,27,0,0,27
1705,2017,Slovakia,France,116,0,0,116
1706,2017,Syrian Arab Rep.,France,12520,2394,0,14914
1707,2017,United Rep. of Tanzania,France,8,5,0,13
1708,2017,Thailand,France,6,0,0,6
1709,2017,Tajikistan,France,48,5,0,53
1710,2017,Turkmenistan,France,21,0,0,21
1711,2017,Togo,France,719,184,0,903
1712,2017,Tunisia,France,293,43,0,336
1713,2017,Türkiye,France,10727,1083,0,11810
1714,2017,Uganda,France,120,5,0,125
1715,2017,Ukraine,France,1605,439,0,2044
1716,2017,United States of America,France,0,5,0,5
1717,2017,Uzbekistan,France,212,6,0,218
1718,2017,Venezuela (Bolivarian Republic of),France,123,189,0,312
1719,2017,Western Sahara,France,512,1104,0,1616
1720,2017,Yemen,France,218,11,0,229
1721,2017,Zimbabwe,France,44,0,0,44
1722,2017,Stateless,France,0,0,0,0
1723,2017,Unknown ,France,86381,1866,0,88247
1724,2017,Burundi,Gabon,8,0,0,8
1725,2017,Central African Rep.,Gabon,38,0,0,38
1726,2017,Chad,Gabon,570,0,0,570
1727,2017,Cameroon,Gabon,5,0,0,5
1728,2017,Congo,Gabon,86,0,0,86
1729,2017,Dem. Rep. of the Congo,Gabon,74,5,0,79
1730,2017,Equatorial Guinea,Gabon,5,0,0,5
1731,2017,Mauritania,Gabon,8,0,0,8
1732,2017,Sao Tome and Principe,Gabon,26,0,0,26
1733,2017,Sudan,Gabon,5,0,0,5
1734,2017,South Sudan,Gabon,5,0,0,5
1735,2017,Togo,Gabon,15,0,0,15
1736,2017,Congo,Gambia,9,0,0,9
1737,2017,Dem. Rep. of the Congo,Gambia,59,0,0,59
1738,2017,Guinea-Bissau,Gambia,12,0,0,12
1739,2017,Cote d'Ivoire,Gambia,188,0,0,188
1740,2017,Liberia,Gambia,67,0,0,67
1741,2017,Senegal,Gambia,7557,5,0,7562
1742,2017,Sierra Leone,Gambia,119,0,0,119
1743,2017,Somalia,Gambia,5,0,0,5
1744,2017,Togo,Gambia,23,0,0,23
1745,2017,Afghanistan,United Kingdom of Great Britain and Northern Ireland,9858,2347,0,12205
1746,2017,Albania,United Kingdom of Great Britain and Northern Ireland,2423,2991,0,5414
1747,2017,Algeria,United Kingdom of Great Britain and Northern Ireland,323,201,0,524
1748,2017,Angola,United Kingdom of Great Britain and Northern Ireland,195,60,0,255
1749,2017,Antigua and Barbuda,United Kingdom of Great Britain and Northern Ireland,0,5,0,5
1750,2017,Egypt,United Kingdom of Great Britain and Northern Ireland,651,406,0,1057
1751,2017,Argentina,United Kingdom of Great Britain and Northern Ireland,0,5,0,5
1752,2017,Armenia,United Kingdom of Great Britain and Northern Ireland,50,40,0,90
1753,2017,Australia,United Kingdom of Great Britain and Northern Ireland,5,5,0,10
1754,2017,Azerbaijan,United Kingdom of Great Britain and Northern Ireland,79,58,0,137
1755,2017,Bahrain,United Kingdom of Great Britain and Northern Ireland,154,18,0,172
1756,2017,Barbados,United Kingdom of Great Britain and Northern Ireland,5,11,0,16
1757,2017,Burundi,United Kingdom of Great Britain and Northern Ireland,48,23,0,71
1758,2017,Benin,United Kingdom of Great Britain and Northern Ireland,6,14,0,20
1759,2017,Bangladesh,United Kingdom of Great Britain and Northern Ireland,1170,1686,0,2856
1760,2017,Bahamas,United Kingdom of Great Britain and Northern Ireland,5,0,0,5
1761,2017,Bhutan,United Kingdom of Great Britain and Northern Ireland,86,0,0,86
1762,2017,Burkina Faso,United Kingdom of Great Britain and Northern Ireland,5,8,0,13
1763,2017,Belarus,United Kingdom of Great Britain and Northern Ireland,160,24,0,184
1764,2017,Bolivia (Plurinational State of),United Kingdom of Great Britain and Northern Ireland,15,7,0,22
1765,2017,Botswana,United Kingdom of Great Britain and Northern Ireland,19,24,0,43
1766,2017,Brazil,United Kingdom of Great Britain and Northern Ireland,13,36,0,49
1767,2017,Bosnia and Herzegovina,United Kingdom of Great Britain and Northern Ireland,27,5,0,32
1768,2017,Belize,United Kingdom of Great Britain and Northern Ireland,5,0,0,5
1769,2017,Canada,United Kingdom of Great Britain and Northern Ireland,9,7,0,16
1770,2017,Central African Rep.,United Kingdom of Great Britain and Northern Ireland,9,0,0,9
1771,2017,Chad,United Kingdom of Great Britain and Northern Ireland,41,9,0,50
1772,2017,China,United Kingdom of Great Britain and Northern Ireland,1571,773,0,2344
1773,2017,Cameroon,United Kingdom of Great Britain and Northern Ireland,534,209,0,743
1774,2017,Congo,United Kingdom of Great Britain and Northern Ireland,130,36,0,166
1775,2017,Dem. Rep. of the Congo,United Kingdom of Great Britain and Northern Ireland,1103,241,0,1344
1776,2017,Comoros,United Kingdom of Great Britain and Northern Ireland,5,8,0,13
1777,2017,Colombia,United Kingdom of Great Britain and Northern Ireland,40,25,0,65
1778,2017,Cuba,United Kingdom of Great Britain and Northern Ireland,13,0,0,13
1779,2017,Cabo Verde,United Kingdom of Great Britain and Northern Ireland,5,0,0,5
1780,2017,Djibouti,United Kingdom of Great Britain and Northern Ireland,5,5,0,10
1781,2017,Dominica,United Kingdom of Great Britain and Northern Ireland,11,5,0,16
1782,2017,Ecuador,United Kingdom of Great Britain and Northern Ireland,14,5,0,19
1783,2017,Eritrea,United Kingdom of Great Britain and Northern Ireland,13590,950,0,14540
1784,2017,Ethiopia,United Kingdom of Great Britain and Northern Ireland,1387,494,0,1881
1785,2017,Fiji,United Kingdom of Great Britain and Northern Ireland,8,0,0,8
1786,2017,Gambia,United Kingdom of Great Britain and Northern Ireland,1312,136,0,1448
1787,2017,Palestinian,United Kingdom of Great Britain and Northern Ireland,486,238,0,724
1788,2017,Georgia,United Kingdom of Great Britain and Northern Ireland,48,74,0,122
1789,2017,Ghana,United Kingdom of Great Britain and Northern Ireland,278,233,0,511
1790,2017,Guinea-Bissau,United Kingdom of Great Britain and Northern Ireland,7,0,0,7
1791,2017,Greece,United Kingdom of Great Britain and Northern Ireland,5,0,0,5
1792,2017,Grenada,United Kingdom of Great Britain and Northern Ireland,15,15,0,30
1793,2017,Guatemala,United Kingdom of Great Britain and Northern Ireland,5,10,0,15
1794,2017,Guinea,United Kingdom of Great Britain and Northern Ireland,263,48,0,311
1795,2017,Guyana,United Kingdom of Great Britain and Northern Ireland,16,6,0,22
1796,2017,Haiti,United Kingdom of Great Britain and Northern Ireland,0,8,0,8
1797,2017,"China, Hong Kong SAR",United Kingdom of Great Britain and Northern Ireland,0,9,0,9
1798,2017,Honduras,United Kingdom of Great Britain and Northern Ireland,34,6,0,40
1799,2017,Croatia,United Kingdom of Great Britain and Northern Ireland,0,5,0,5
1800,2017,Cote d'Ivoire,United Kingdom of Great Britain and Northern Ireland,220,61,0,281
1801,2017,India,United Kingdom of Great Britain and Northern Ireland,351,1231,0,1582
1802,2017,Indonesia,United Kingdom of Great Britain and Northern Ireland,16,32,0,48
1803,2017,Iran (Islamic Rep. of),United Kingdom of Great Britain and Northern Ireland,16085,2187,0,18272
1804,2017,Iraq,United Kingdom of Great Britain and Northern Ireland,4192,2868,0,7060
1805,2017,Israel,United Kingdom of Great Britain and Northern Ireland,10,6,0,16
1806,2017,Italy,United Kingdom of Great Britain and Northern Ireland,0,5,0,5
1807,2017,Jamaica,United Kingdom of Great Britain and Northern Ireland,358,160,0,518
1808,2017,Jordan,United Kingdom of Great Britain and Northern Ireland,54,39,0,93
1809,2017,Kazakhstan,United Kingdom of Great Britain and Northern Ireland,13,26,0,39
1810,2017,Kenya,United Kingdom of Great Britain and Northern Ireland,277,125,0,402
1811,2017,Kyrgyzstan,United Kingdom of Great Britain and Northern Ireland,28,11,0,39
1812,2017,Rep. of Korea,United Kingdom of Great Britain and Northern Ireland,7,9,0,16
1813,2017,Dem. People's Rep. of Korea,United Kingdom of Great Britain and Northern Ireland,362,36,0,398
1814,2017,Kuwait,United Kingdom of Great Britain and Northern Ireland,542,159,0,701
1815,2017,Liberia,United Kingdom of Great Britain and Northern Ireland,34,5,0,39
1816,2017,Libya,United Kingdom of Great Britain and Northern Ireland,1753,990,0,2743
1817,2017,Saint Lucia,United Kingdom of Great Britain and Northern Ireland,19,16,0,35
1818,2017,Lebanon,United Kingdom of Great Britain and Northern Ireland,150,92,0,242
1819,2017,Lesotho,United Kingdom of Great Britain and Northern Ireland,0,5,0,5
1820,2017,Sri Lanka,United Kingdom of Great Britain and Northern Ireland,5804,1401,0,7205
1821,2017,Lithuania,United Kingdom of Great Britain and Northern Ireland,0,7,0,7
1822,2017,Mauritania,United Kingdom of Great Britain and Northern Ireland,5,0,0,5
1823,2017,North Macedonia,United Kingdom of Great Britain and Northern Ireland,21,5,0,26
1824,2017,Rep. of Moldova,United Kingdom of Great Britain and Northern Ireland,18,0,0,18
1825,2017,Maldives,United Kingdom of Great Britain and Northern Ireland,30,7,0,37
1826,2017,Mexico,United Kingdom of Great Britain and Northern Ireland,9,29,0,38
1827,2017,Mali,United Kingdom of Great Britain and Northern Ireland,24,8,0,32
1828,2017,Malaysia,United Kingdom of Great Britain and Northern Ireland,126,98,0,224
1829,2017,Malawi,United Kingdom of Great Britain and Northern Ireland,319,102,0,421
1830,2017,Mongolia,United Kingdom of Great Britain and Northern Ireland,77,28,0,105
1831,2017,Morocco,United Kingdom of Great Britain and Northern Ireland,167,115,0,282
1832,2017,Mozambique,United Kingdom of Great Britain and Northern Ireland,5,6,0,11
1833,2017,Mauritius,United Kingdom of Great Britain and Northern Ireland,43,61,0,104
1834,2017,Myanmar,United Kingdom of Great Britain and Northern Ireland,836,90,0,926
1835,2017,Namibia,United Kingdom of Great Britain and Northern Ireland,30,101,0,131
1836,2017,Nepal,United Kingdom of Great Britain and Northern Ireland,24,135,0,159
1837,2017,Niger,United Kingdom of Great Britain and Northern Ireland,6,0,0,6
1838,2017,Nigeria,United Kingdom of Great Britain and Northern Ireland,2205,1749,0,3954
1839,2017,Norway,United Kingdom of Great Britain and Northern Ireland,5,0,0,5
1840,2017,Oman,United Kingdom of Great Britain and Northern Ireland,11,11,0,22
1841,2017,Pakistan,United Kingdom of Great Britain and Northern Ireland,7207,2758,0,9965
1842,2017,Philippines,United Kingdom of Great Britain and Northern Ireland,18,72,0,90
1843,2017,Poland,United Kingdom of Great Britain and Northern Ireland,0,5,0,5
1844,2017,Qatar,United Kingdom of Great Britain and Northern Ireland,6,0,0,6
1845,2017,Romania,United Kingdom of Great Britain and Northern Ireland,5,0,0,5
1846,2017,South Africa,United Kingdom of Great Britain and Northern Ireland,168,86,0,254
1847,2017,Russian Federation,United Kingdom of Great Britain and Northern Ireland,484,167,0,651
1848,2017,Rwanda,United Kingdom of Great Britain and Northern Ireland,111,28,0,139
1849,2017,El Salvador,United Kingdom of Great Britain and Northern Ireland,81,45,0,126
1850,2017,Saudi Arabia,United Kingdom of Great Britain and Northern Ireland,129,55,0,184
1851,2017,Serbia and Kosovo: S/RES/1244 (1999),United Kingdom of Great Britain and Northern Ireland,105,46,0,151
1852,2017,Senegal,United Kingdom of Great Britain and Northern Ireland,79,52,0,131
1853,2017,Seychelles,United Kingdom of Great Britain and Northern Ireland,0,5,0,5
1854,2017,Singapore,United Kingdom of Great Britain and Northern Ireland,5,14,0,19
1855,2017,Sierra Leone,United Kingdom of Great Britain and Northern Ireland,292,81,0,373
1856,2017,Somalia,United Kingdom of Great Britain and Northern Ireland,4670,347,0,5017
1857,2017,Viet Nam,United Kingdom of Great Britain and Northern Ireland,1015,1199,0,2214
1858,2017,Saint Kitts and Nevis,United Kingdom of Great Britain and Northern Ireland,6,7,0,13
1859,2017,Sudan,United Kingdom of Great Britain and Northern Ireland,8132,1415,0,9547
1860,2017,South Sudan,United Kingdom of Great Britain and Northern Ireland,32,27,0,59
1861,2017,Eswatini,United Kingdom of Great Britain and Northern Ireland,57,7,0,64
1862,2017,Syrian Arab Rep.,United Kingdom of Great Britain and Northern Ireland,9100,574,0,9674
1863,2017,United Rep. of Tanzania,United Kingdom of Great Britain and Northern Ireland,82,39,0,121
1864,2017,Thailand,United Kingdom of Great Britain and Northern Ireland,29,38,0,67
1865,2017,Tajikistan,United Kingdom of Great Britain and Northern Ireland,12,0,0,12
1866,2017,Turkmenistan,United Kingdom of Great Britain and Northern Ireland,11,5,0,16
1867,2017,Timor-Leste,United Kingdom of Great Britain and Northern Ireland,0,5,0,5
1868,2017,Togo,United Kingdom of Great Britain and Northern Ireland,17,7,0,24
1869,2017,Trinidad and Tobago,United Kingdom of Great Britain and Northern Ireland,64,32,0,96
1870,2017,Tunisia,United Kingdom of Great Britain and Northern Ireland,39,37,0,76
1871,2017,Türkiye,United Kingdom of Great Britain and Northern Ireland,864,700,0,1564
1872,2017,United Arab Emirates,United Kingdom of Great Britain and Northern Ireland,18,5,0,23
1873,2017,Uganda,United Kingdom of Great Britain and Northern Ireland,1156,163,0,1319
1874,2017,Ukraine,United Kingdom of Great Britain and Northern Ireland,110,137,0,247
1875,2017,United States of America,United Kingdom of Great Britain and Northern Ireland,42,52,0,94
1876,2017,Uzbekistan,United Kingdom of Great Britain and Northern Ireland,69,37,0,106
1877,2017,Saint Vincent and the Grenadines,United Kingdom of Great Britain and Northern Ireland,17,10,0,27
1878,2017,Venezuela (Bolivarian Republic of),United Kingdom of Great Britain and Northern Ireland,31,23,0,54
1879,2017,Western Sahara,United Kingdom of Great Britain and Northern Ireland,11,0,0,11
1880,2017,Yemen,United Kingdom of Great Britain and Northern Ireland,453,124,0,577
1881,2017,Zambia,United Kingdom of Great Britain and Northern Ireland,71,26,0,97
1882,2017,Zimbabwe,United Kingdom of Great Britain and Northern Ireland,8236,287,0,8523
1883,2017,Stateless,United Kingdom of Great Britain and Northern Ireland,2179,399,0,2578
1884,2017,Unknown ,United Kingdom of Great Britain and Northern Ireland,6126,7693,0,13819
1885,2017,Afghanistan,Georgia,5,16,0,21
1886,2017,Egypt,Georgia,19,70,0,89
1887,2017,Azerbaijan,Georgia,6,9,0,15
1888,2017,Bangladesh,Georgia,0,23,0,23
1889,2017,Cameroon,Georgia,0,5,0,5
1890,2017,Congo,Georgia,0,6,0,6
1891,2017,Eritrea,Georgia,0,69,0,69
1892,2017,Georgia,Georgia,0,0,278103,0
1893,2017,Ghana,Georgia,0,5,0,5
1894,2017,India,Georgia,0,12,0,12
1895,2017,Iran (Islamic Rep. of),Georgia,34,37,0,71
1896,2017,Iraq,Georgia,630,28,0,658
1897,2017,Lebanon,Georgia,6,0,0,6
1898,2017,Sri Lanka,Georgia,0,5,0,5
1899,2017,Nigeria,Georgia,0,19,0,19
1900,2017,Pakistan,Georgia,10,40,0,50
1901,2017,Russian Federation,Georgia,259,30,0,289
1902,2017,Saudi Arabia,Georgia,0,5,0,5
1903,2017,Somalia,Georgia,0,24,0,24
1904,2017,Sudan,Georgia,6,5,0,11
1905,2017,Syrian Arab Rep.,Georgia,445,9,0,454
1906,2017,Tajikistan,Georgia,5,0,0,5
1907,2017,Türkiye,Georgia,0,41,0,41
1908,2017,Ukraine,Georgia,654,5,0,659
1909,2017,Yemen,Georgia,5,50,0,55
1910,2017,Stateless,Georgia,0,12,0,12
1911,2017,Unknown ,Georgia,5,5,0,10
1912,2017,Afghanistan,Germany,104385,87321,0,191706
1913,2017,Albania,Germany,983,4838,0,5821
1914,2017,Algeria,Germany,524,1748,0,2272
1915,2017,Angola,Germany,803,318,0,1121
1916,2017,Egypt,Germany,1798,3038,0,4836
1917,2017,Argentina,Germany,14,0,0,14
1918,2017,Armenia,Germany,2038,9030,0,11068
1919,2017,Australia,Germany,5,0,0,5
1920,2017,Austria,Germany,5,0,0,5
1921,2017,Azerbaijan,Germany,3313,6788,0,10101
1922,2017,Bahrain,Germany,73,18,0,91
1923,2017,Burundi,Germany,90,44,0,134
1924,2017,Belgium,Germany,6,0,0,6
1925,2017,Benin,Germany,73,270,0,343
1926,2017,Bangladesh,Germany,589,2393,0,2982
1927,2017,Bhutan,Germany,21,15,0,36
1928,2017,Burkina Faso,Germany,72,223,0,295
1929,2017,Belarus,Germany,179,359,0,538
1930,2017,Bolivia (Plurinational State of),Germany,8,0,0,8
1931,2017,Botswana,Germany,5,0,0,5
1932,2017,Brazil,Germany,32,14,0,46
1933,2017,Bosnia and Herzegovina,Germany,1478,963,0,2441
1934,2017,Bulgaria,Germany,82,15,0,97
1935,2017,Cambodia,Germany,27,25,0,52
1936,2017,Canada,Germany,24,5,0,29
1937,2017,Central African Rep.,Germany,32,79,0,111
1938,2017,Chad,Germany,83,295,0,378
1939,2017,China,Germany,1588,1186,0,2774
1940,2017,Chile,Germany,178,0,0,178
1941,2017,Cameroon,Germany,594,2667,0,3261
1942,2017,Congo,Germany,249,119,0,368
1943,2017,Dem. Rep. of the Congo,Germany,1594,718,0,2312
1944,2017,Comoros,Germany,0,18,0,18
1945,2017,Colombia,Germany,67,103,0,170
1946,2017,Cuba,Germany,97,113,0,210
1947,2017,Czechia,Germany,777,0,0,777
1948,2017,Djibouti,Germany,24,18,0,42
1949,2017,Dominican Rep.,Germany,9,5,0,14
1950,2017,Ecuador,Germany,12,5,0,17
1951,2017,Equatorial Guinea,Germany,22,8,0,30
1952,2017,Eritrea,Germany,49253,6905,0,56158
1953,2017,Estonia,Germany,5,0,0,5
1954,2017,Ethiopia,Germany,4230,7192,0,11422
1955,2017,France,Germany,15,0,0,15
1956,2017,Gabon,Germany,8,33,0,41
1957,2017,Gambia,Germany,558,8839,0,9397
1958,2017,United Kingdom of Great Britain and Northern Ireland,Germany,18,5,0,23
1959,2017,Georgia,Germany,502,4673,0,5175
1960,2017,Ghana,Germany,462,2218,0,2680
1961,2017,Guinea-Bissau,Germany,75,296,0,371
1962,2017,Greece,Germany,48,0,0,48
1963,2017,Guatemala,Germany,5,5,0,10
1964,2017,Guinea,Germany,1663,5783,0,7446
1965,2017,Haiti,Germany,16,10,0,26
1966,2017,Honduras,Germany,49,9,0,58
1967,2017,Croatia,Germany,311,5,0,316
1968,2017,Hungary,Germany,259,5,0,264
1969,2017,Iceland,Germany,5,0,0,5
1970,2017,Cote d'Ivoire,Germany,339,2143,0,2482
1971,2017,India,Germany,351,1711,0,2062
1972,2017,Indonesia,Germany,12,17,0,29
1973,2017,Iran (Islamic Rep. of),Germany,38262,17876,0,56138
1974,2017,Iraq,Germany,130640,45672,0,176312
1975,2017,Israel,Germany,33,38,0,71
1976,2017,Italy,Germany,17,33,0,50
1977,2017,Jamaica,Germany,46,63,0,109
1978,2017,Jordan,Germany,318,389,0,707
1979,2017,Japan,Germany,28,0,0,28
1980,2017,Kazakhstan,Germany,95,217,0,312
1981,2017,Kenya,Germany,180,470,0,650
1982,2017,Kyrgyzstan,Germany,165,273,0,438
1983,2017,Rep. of Korea,Germany,45,13,0,58
1984,2017,Dem. People's Rep. of Korea,Germany,92,75,0,167
1985,2017,Kuwait,Germany,31,41,0,72
1986,2017,Lao People's Dem. Rep.,Germany,44,0,0,44
1987,2017,Liberia,Germany,73,301,0,374
1988,2017,Libya,Germany,1379,1692,0,3071
1989,2017,Lebanon,Germany,1390,4148,0,5538
1990,2017,Sri Lanka,Germany,3863,1608,0,5471
1991,2017,Lithuania,Germany,5,0,0,5
1992,2017,Latvia,Germany,12,11,0,23
1993,2017,Madagascar,Germany,0,5,0,5
1994,2017,Mauritania,Germany,33,120,0,153
1995,2017,North Macedonia,Germany,605,2872,0,3477
1996,2017,Rep. of Moldova,Germany,86,445,0,531
1997,2017,Mexico,Germany,13,5,0,18
1998,2017,Mali,Germany,216,1258,0,1474
1999,2017,Malaysia,Germany,10,21,0,31
2000,2017,Malawi,Germany,5,5,0,10
2001,2017,Mongolia,Germany,103,990,0,1093
2002,2017,Morocco,Germany,576,1691,0,2267
2003,2017,Mozambique,Germany,11,27,0,38
2004,2017,Montenegro,Germany,283,436,0,719
2005,2017,Mauritius,Germany,5,5,0,10
2006,2017,Myanmar,Germany,831,134,0,965
2007,2017,Namibia,Germany,0,5,0,5
2008,2017,Nepal,Germany,50,142,0,192
2009,2017,Netherlands,Germany,21,5,0,26
2010,2017,Niger,Germany,44,194,0,238
2011,2017,Nigeria,Germany,3971,19817,0,23788
2012,2017,Norway,Germany,5,0,0,5
2013,2017,New Zealand,Germany,8,0,0,8
2014,2017,Oman,Germany,9,6,0,15
2015,2017,Pakistan,Germany,6572,17952,0,24524
2016,2017,Peru,Germany,38,0,0,38
2017,2017,Philippines,Germany,28,41,0,69
2018,2017,Poland,Germany,666,0,0,666
2019,2017,Portugal,Germany,6,0,0,6
2020,2017,Romania,Germany,163,5,0,168
2021,2017,South Africa,Germany,17,34,0,51
2022,2017,Russian Federation,Germany,6960,19253,0,26213
2023,2017,Rwanda,Germany,207,119,0,326
2024,2017,El Salvador,Germany,11,40,0,51
2025,2017,Saudi Arabia,Germany,105,42,0,147
2026,2017,Serbia and Kosovo: S/RES/1244 (1999),Germany,9232,6947,0,16179
2027,2017,Senegal,Germany,130,704,0,834
2028,2017,Singapore,Germany,7,0,0,7
2029,2017,Sierra Leone,Germany,563,1592,0,2155
2030,2017,Solomon Islands,Germany,8,0,0,8
2031,2017,Somalia,Germany,19508,10344,0,29852
2032,2017,Spain,Germany,17,39,0,56
2033,2017,Viet Nam,Germany,1279,252,0,1531
2034,2017,Sudan,Germany,1974,2290,0,4264
2035,2017,South Sudan,Germany,59,106,0,165
2036,2017,Slovakia,Germany,85,0,0,85
2037,2017,Slovenia,Germany,7,0,0,7
2038,2017,Eswatini,Germany,5,0,0,5
2039,2017,Sweden,Germany,6,0,0,6
2040,2017,Syrian Arab Rep.,Germany,496674,70833,0,567507
2041,2017,United Rep. of Tanzania,Germany,34,151,0,185
2042,2017,Thailand,Germany,26,10,0,36
2043,2017,Tajikistan,Germany,490,2443,0,2933
2044,2017,Turkmenistan,Germany,50,243,0,293
2045,2017,Togo,Germany,1081,947,0,2028
2046,2017,Tunisia,Germany,160,592,0,752
2047,2017,Türkiye,Germany,21120,10761,0,31881
2048,2017,United Arab Emirates,Germany,27,5,0,32
2049,2017,Uganda,Germany,160,292,0,452
2050,2017,Ukraine,Germany,631,3963,0,4594
2051,2017,United States of America,Germany,141,22,0,163
2052,2017,Uzbekistan,Germany,101,132,0,233
2053,2017,Saint Vincent and the Grenadines,Germany,5,0,0,5
2054,2017,Venezuela (Bolivarian Republic of),Germany,80,207,0,287
2055,2017,Yemen,Germany,1171,682,0,1853
2056,2017,Zambia,Germany,7,14,0,21
2057,2017,Zimbabwe,Germany,154,267,0,421
2058,2017,Stateless,Germany,8574,2616,0,11190
2059,2017,Unknown ,Germany,28278,11614,0,39892
2060,2017,Egypt,Ghana,0,16,0,16
2061,2017,Burundi,Ghana,10,15,0,25
2062,2017,Benin,Ghana,5,0,0,5
2063,2017,Central African Rep.,Ghana,107,73,0,180
2064,2017,Chad,Ghana,30,8,0,38
2065,2017,Cameroon,Ghana,6,5,0,11
2066,2017,Congo,Ghana,5,12,0,17
2067,2017,Dem. Rep. of the Congo,Ghana,41,47,0,88
2068,2017,Eritrea,Ghana,13,130,0,143
2069,2017,Ethiopia,Ghana,6,5,0,11
2070,2017,Palestinian,Ghana,13,5,0,18
2071,2017,Cote d'Ivoire,Ghana,6687,388,0,7075
2072,2017,Iraq,Ghana,11,0,0,11
2073,2017,Liberia,Ghana,1209,0,0,1209
2074,2017,Libya,Ghana,0,8,0,8
2075,2017,Lebanon,Ghana,7,0,0,7
2076,2017,Mali,Ghana,0,5,0,5
2077,2017,Nigeria,Ghana,9,14,0,23
2078,2017,Pakistan,Ghana,26,9,0,35
2079,2017,Rwanda,Ghana,36,0,0,36
2080,2017,Sierra Leone,Ghana,87,5,0,92
2081,2017,Somalia,Ghana,62,17,0,79
2082,2017,Sudan,Ghana,299,303,0,602
2083,2017,South Sudan,Ghana,6,0,0,6
2084,2017,Syrian Arab Rep.,Ghana,39,150,0,189
2085,2017,Togo,Ghana,3425,83,0,3508
2086,2017,Uganda,Ghana,5,0,0,5
2087,2017,Uzbekistan,Ghana,9,0,0,9
2088,2017,Yemen,Ghana,0,5,0,5
2089,2017,Burundi,Guinea-Bissau,11,0,0,11
2090,2017,Congo,Guinea-Bissau,5,0,0,5
2091,2017,Dem. Rep. of the Congo,Guinea-Bissau,5,0,0,5
2092,2017,Gambia,Guinea-Bissau,6,0,0,6
2093,2017,Guinea,Guinea-Bissau,10,0,0,10
2094,2017,Cote d'Ivoire,Guinea-Bissau,15,6,0,21
2095,2017,Liberia,Guinea-Bissau,5,0,0,5
2096,2017,Nigeria,Guinea-Bissau,5,0,0,5
2097,2017,Senegal,Guinea-Bissau,10061,0,0,10061
2098,2017,Sierra Leone,Guinea-Bissau,12,5,0,17
2099,2017,Unknown ,Guinea-Bissau,1072,0,0,1072
2100,2017,Afghanistan,Greece,4751,6922,0,11673
2101,2017,Albania,Greece,150,2209,0,2359
2102,2017,Algeria,Greece,62,328,0,390
2103,2017,Angola,Greece,5,11,0,16
2104,2017,Egypt,Greece,191,685,0,876
2105,2017,Armenia,Greece,11,99,0,110
2106,2017,Azerbaijan,Greece,5,0,0,5
2107,2017,Burundi,Greece,18,14,0,32
2108,2017,Bangladesh,Greece,244,1618,0,1862
2109,2017,Burkina Faso,Greece,14,20,0,34
2110,2017,Belarus,Greece,5,5,0,10
2111,2017,Botswana,Greece,0,5,0,5
2112,2017,Bosnia and Herzegovina,Greece,0,5,0,5
2113,2017,Central African Rep.,Greece,9,5,0,14
2114,2017,China,Greece,56,341,0,397
2115,2017,Cameroon,Greece,151,290,0,441
2116,2017,Congo,Greece,61,70,0,131
2117,2017,Dem. Rep. of the Congo,Greece,304,797,0,1101
2118,2017,Comoros,Greece,5,8,0,13
2119,2017,Cuba,Greece,0,7,0,7
2120,2017,Dominican Rep.,Greece,7,30,0,37
2121,2017,Equatorial Guinea,Greece,0,8,0,8
2122,2017,Eritrea,Greece,864,191,0,1055
2123,2017,Ethiopia,Greece,296,202,0,498
2124,2017,Gabon,Greece,0,5,0,5
2125,2017,Gambia,Greece,25,22,0,47
2126,2017,Palestinian,Greece,606,622,0,1228
2127,2017,Georgia,Greece,266,985,0,1251
2128,2017,Ghana,Greece,49,74,0,123
2129,2017,Guinea,Greece,63,106,0,169
2130,2017,Haiti,Greece,5,19,0,24
2131,2017,Cote d'Ivoire,Greece,68,53,0,121
2132,2017,India,Greece,27,158,0,185
2133,2017,Indonesia,Greece,12,34,0,46
2134,2017,Iran (Islamic Rep. of),Greece,1059,1140,0,2199
2135,2017,Iraq,Greece,4473,5436,0,9909
2136,2017,Jordan,Greece,8,26,0,34
2137,2017,Kazakhstan,Greece,5,5,0,10
2138,2017,Kenya,Greece,28,8,0,36
2139,2017,Kuwait,Greece,42,210,0,252
2140,2017,Libya,Greece,29,13,0,42
2141,2017,Lebanon,Greece,30,80,0,110
2142,2017,Sri Lanka,Greece,40,58,0,98
2143,2017,Mauritania,Greece,49,8,0,57
2144,2017,North Macedonia,Greece,0,5,0,5
2145,2017,Rep. of Moldova,Greece,11,40,0,51
2146,2017,Mali,Greece,39,61,0,100
2147,2017,Morocco,Greece,107,275,0,382
2148,2017,Myanmar,Greece,30,61,0,91
2149,2017,Nepal,Greece,5,63,0,68
2150,2017,Niger,Greece,5,5,0,10
2151,2017,Nigeria,Greece,265,238,0,503
2152,2017,Pakistan,Greece,726,7705,0,8431
2153,2017,Philippines,Greece,7,6,0,13
2154,2017,Russian Federation,Greece,11,33,0,44
2155,2017,Rwanda,Greece,8,0,0,8
2156,2017,El Salvador,Greece,7,6,0,13
2157,2017,Saudi Arabia,Greece,5,5,0,10
2158,2017,Serbia and Kosovo: S/RES/1244 (1999),Greece,22,10,0,32
2159,2017,Senegal,Greece,49,49,0,98
2160,2017,Sierra Leone,Greece,32,42,0,74
2161,2017,Somalia,Greece,335,194,0,529
2162,2017,Viet Nam,Greece,7,14,0,21
2163,2017,Sudan,Greece,398,72,0,470
2164,2017,South Sudan,Greece,7,12,0,19
2165,2017,Syrian Arab Rep.,Greece,13714,9605,0,23319
2166,2017,United Rep. of Tanzania,Greece,13,11,0,24
2167,2017,Togo,Greece,6,16,0,22
2168,2017,Tunisia,Greece,16,55,0,71
2169,2017,Türkiye,Greece,199,1670,0,1869
2170,2017,Uganda,Greece,21,22,0,43
2171,2017,Ukraine,Greece,134,99,0,233
2172,2017,United States of America,Greece,0,5,0,5
2173,2017,Uzbekistan,Greece,14,0,0,14
2174,2017,Venezuela (Bolivarian Republic of),Greece,0,27,0,27
2175,2017,Western Sahara,Greece,0,6,0,6
2176,2017,Yemen,Greece,158,108,0,266
2177,2017,Zimbabwe,Greece,5,11,0,16
2178,2017,Stateless,Greece,335,242,0,577
2179,2017,Unknown ,Greece,8204,483,0,8687
2180,2017,Colombia,Guatemala,8,0,0,8
2181,2017,Honduras,Guatemala,36,8,0,44
2182,2017,Nicaragua,Guatemala,100,0,0,100
2183,2017,El Salvador,Guatemala,206,12,0,218
2184,2017,Venezuela (Bolivarian Republic of),Guatemala,10,8,0,18
2185,2017,Unknown ,Guatemala,0,0,0,0
2186,2017,Burundi,Guinea,5,0,0,5
2187,2017,Central African Rep.,Guinea,37,0,0,37
2188,2017,Dem. Rep. of the Congo,Guinea,30,19,0,49
2189,2017,Cote d'Ivoire,Guinea,4539,33,0,4572
2190,2017,Liberia,Guinea,298,34,0,332
2191,2017,Sri Lanka,Guinea,8,0,0,8
2192,2017,Mali,Guinea,6,0,0,6
2193,2017,Nigeria,Guinea,7,0,0,7
2194,2017,Rwanda,Guinea,10,0,0,10
2195,2017,Sierra Leone,Guinea,202,22,0,224
2196,2017,Somalia,Guinea,6,0,0,6
2197,2017,Togo,Guinea,8,0,0,8
2198,2017,Dem. Rep. of the Congo,Guyana,7,0,0,7
2199,2017,Pakistan,Guyana,5,0,0,5
2200,2017,Rwanda,Guyana,5,0,0,5
2201,2017,Ethiopia,Haiti,5,0,0,5
2202,2017,Stateless,Haiti,0,0,0,0
2203,2017,Egypt,"China, Hong Kong SAR",5,0,0,5
2204,2017,Indonesia,"China, Hong Kong SAR",5,0,0,5
2205,2017,Sri Lanka,"China, Hong Kong SAR",21,0,0,21
2206,2017,Pakistan,"China, Hong Kong SAR",8,0,0,8
2207,2017,Rwanda,"China, Hong Kong SAR",20,5,0,25
2208,2017,Somalia,"China, Hong Kong SAR",21,0,0,21
2209,2017,Yemen,"China, Hong Kong SAR",5,0,0,5
2210,2017,Honduras,Honduras,0,0,174000,0
2211,2017,Iran (Islamic Rep. of),Honduras,5,0,0,5
2212,2017,Nicaragua,Honduras,6,0,0,6
2213,2017,El Salvador,Honduras,11,11,0,22
2214,2017,Venezuela (Bolivarian Republic of),Honduras,5,0,0,5
2215,2017,Afghanistan,Croatia,45,93,0,138
2216,2017,Albania,Croatia,0,5,0,5
2217,2017,Algeria,Croatia,0,20,0,20
2218,2017,Egypt,Croatia,5,9,0,14
2219,2017,Azerbaijan,Croatia,5,0,0,5
2220,2017,Bangladesh,Croatia,0,15,0,15
2221,2017,Belarus,Croatia,5,0,0,5
2222,2017,Bosnia and Herzegovina,Croatia,37,0,0,37
2223,2017,Congo,Croatia,5,0,0,5
2224,2017,Cuba,Croatia,0,5,0,5
2225,2017,Eritrea,Croatia,19,0,0,19
2226,2017,Palestinian,Croatia,5,5,0,10
2227,2017,Georgia,Croatia,5,0,0,5
2228,2017,Croatia,Croatia,0,0,0,0
2229,2017,India,Croatia,0,7,0,7
2230,2017,Iran (Islamic Rep. of),Croatia,14,52,0,66
2231,2017,Iraq,Croatia,62,31,0,93
2232,2017,Kazakhstan,Croatia,5,0,0,5
2233,2017,Libya,Croatia,5,9,0,14
2234,2017,Mauritania,Croatia,5,0,0,5
2235,2017,Morocco,Croatia,0,7,0,7
2236,2017,Nigeria,Croatia,10,5,0,15
2237,2017,Pakistan,Croatia,5,32,0,37
2238,2017,Russian Federation,Croatia,14,5,0,19
2239,2017,Somalia,Croatia,22,0,0,22
2240,2017,Sudan,Croatia,5,0,0,5
2241,2017,Syrian Arab Rep.,Croatia,194,77,0,271
2242,2017,Tunisia,Croatia,0,15,0,15
2243,2017,Türkiye,Croatia,16,9,0,25
2244,2017,Uganda,Croatia,5,0,0,5
2245,2017,Ukraine,Croatia,5,0,0,5
2246,2017,Uzbekistan,Croatia,5,0,0,5
2247,2017,Yemen,Croatia,5,0,0,5
2248,2017,Stateless,Croatia,0,0,0,0
2249,2017,Unknown ,Croatia,0,5,0,5
2250,2017,Afghanistan,Hungary,1412,241,0,1653
2251,2017,Algeria,Hungary,15,5,0,20
2252,2017,Angola,Hungary,5,0,0,5
2253,2017,Egypt,Hungary,13,0,0,13
2254,2017,Armenia,Hungary,47,0,0,47
2255,2017,Azerbaijan,Hungary,16,0,0,16
2256,2017,Bangladesh,Hungary,9,0,0,9
2257,2017,China,Hungary,5,0,0,5
2258,2017,Cameroon,Hungary,35,9,0,44
2259,2017,Congo,Hungary,13,0,0,13
2260,2017,Dem. Rep. of the Congo,Hungary,21,0,0,21
2261,2017,Cuba,Hungary,80,0,0,80
2262,2017,Eritrea,Hungary,48,5,0,53
2263,2017,Ethiopia,Hungary,33,6,0,39
2264,2017,Palestinian,Hungary,87,7,0,94
2265,2017,Georgia,Hungary,62,5,0,67
2266,2017,Germany,Hungary,0,5,0,5
2267,2017,Ghana,Hungary,7,0,0,7
2268,2017,Guinea,Hungary,5,0,0,5
2269,2017,Cote d'Ivoire,Hungary,15,0,0,15
2270,2017,India,Hungary,5,0,0,5
2271,2017,Iran (Islamic Rep. of),Hungary,142,46,0,188
2272,2017,Iraq,Hungary,598,121,0,719
2273,2017,Libya,Hungary,6,0,0,6
2274,2017,Lebanon,Hungary,7,0,0,7
2275,2017,Sri Lanka,Hungary,12,0,0,12
2276,2017,Rep. of Moldova,Hungary,5,0,0,5
2277,2017,Mali,Hungary,5,5,0,10
2278,2017,Myanmar,Hungary,5,0,0,5
2279,2017,Nepal,Hungary,11,0,0,11
2280,2017,Nigeria,Hungary,54,5,0,59
2281,2017,Pakistan,Hungary,55,32,0,87
2282,2017,Russian Federation,Hungary,36,5,0,41
2283,2017,Serbia and Kosovo: S/RES/1244 (1999),Hungary,56,47,0,103
2284,2017,Sierra Leone,Hungary,5,0,0,5
2285,2017,Somalia,Hungary,651,0,0,651
2286,2017,Sudan,Hungary,68,0,0,68
2287,2017,Syrian Arab Rep.,Hungary,925,108,0,1033
2288,2017,Tunisia,Hungary,8,0,0,8
2289,2017,Türkiye,Hungary,34,5,0,39
2290,2017,Uganda,Hungary,6,0,0,6
2291,2017,Ukraine,Hungary,19,0,0,19
2292,2017,Uzbekistan,Hungary,7,0,0,7
2293,2017,Yemen,Hungary,17,0,0,17
2294,2017,Zimbabwe,Hungary,5,0,0,5
2295,2017,Stateless,Hungary,76,0,0,76
2296,2017,Unknown ,Hungary,925,9,0,934
2297,2017,Afghanistan,Iceland,44,10,0,54
2298,2017,Albania,Iceland,6,20,0,26
2299,2017,Algeria,Iceland,0,6,0,6
2300,2017,Azerbaijan,Iceland,0,5,0,5
2301,2017,Bangladesh,Iceland,0,5,0,5
2302,2017,Bosnia and Herzegovina,Iceland,0,6,0,6
2303,2017,China,Iceland,5,0,0,5
2304,2017,Eritrea,Iceland,11,0,0,11
2305,2017,Palestinian,Iceland,10,8,0,18
2306,2017,Georgia,Iceland,5,68,0,73
2307,2017,Ghana,Iceland,0,5,0,5
2308,2017,Iran (Islamic Rep. of),Iceland,33,15,0,48
2309,2017,Iraq,Iceland,70,64,0,134
2310,2017,Kazakhstan,Iceland,5,0,0,5
2311,2017,Kenya,Iceland,5,0,0,5
2312,2017,Libya,Iceland,5,5,0,10
2313,2017,Sri Lanka,Iceland,5,0,0,5
2314,2017,North Macedonia,Iceland,5,10,0,15
2315,2017,Mongolia,Iceland,0,5,0,5
2316,2017,Morocco,Iceland,5,8,0,13
2317,2017,Nigeria,Iceland,6,5,0,11
2318,2017,Pakistan,Iceland,11,12,0,23
2319,2017,Russian Federation,Iceland,11,5,0,16
2320,2017,El Salvador,Iceland,8,5,0,13
2321,2017,Serbia and Kosovo: S/RES/1244 (1999),Iceland,5,15,0,20
2322,2017,Senegal,Iceland,0,5,0,5
2323,2017,Somalia,Iceland,13,19,0,32
2324,2017,South Sudan,Iceland,0,5,0,5
2325,2017,Syrian Arab Rep.,Iceland,58,5,0,63
2326,2017,Ukraine,Iceland,15,6,0,21
2327,2017,Yemen,Iceland,0,5,0,5
2328,2017,Stateless,Iceland,8,0,0,8
2329,2017,Unknown ,Iceland,12,0,0,12
2330,2017,Burundi,Cote d'Ivoire,34,0,0,34
2331,2017,Benin,Cote d'Ivoire,0,5,0,5
2332,2017,Burkina Faso,Cote d'Ivoire,0,6,0,6
2333,2017,Cambodia,Cote d'Ivoire,5,0,0,5
2334,2017,Central African Rep.,Cote d'Ivoire,332,118,0,450
2335,2017,Chad,Cote d'Ivoire,0,5,0,5
2336,2017,Cameroon,Cote d'Ivoire,0,5,0,5
2337,2017,Congo,Cote d'Ivoire,51,9,0,60
2338,2017,Dem. Rep. of the Congo,Cote d'Ivoire,112,41,0,153
2339,2017,Eritrea,Cote d'Ivoire,0,5,0,5
2340,2017,Ethiopia,Cote d'Ivoire,0,5,0,5
2341,2017,Palestinian,Cote d'Ivoire,0,5,0,5
2342,2017,Guinea,Cote d'Ivoire,0,11,0,11
2343,2017,Cote d'Ivoire,Cote d'Ivoire,0,0,0,0
2344,2017,Liberia,Cote d'Ivoire,907,75,0,982
2345,2017,Mauritania,Cote d'Ivoire,0,5,0,5
2346,2017,Mali,Cote d'Ivoire,5,19,0,24
2347,2017,Nigeria,Cote d'Ivoire,5,18,0,23
2348,2017,Rwanda,Cote d'Ivoire,47,5,0,52
2349,2017,Somalia,Cote d'Ivoire,0,5,0,5
2350,2017,Viet Nam,Cote d'Ivoire,5,0,0,5
2351,2017,Sudan,Cote d'Ivoire,9,0,0,9
2352,2017,Syrian Arab Rep.,Cote d'Ivoire,12,9,0,21
2353,2017,Togo,Cote d'Ivoire,15,17,0,32
2354,2017,Türkiye,Cote d'Ivoire,20,0,0,20
2355,2017,Stateless,Cote d'Ivoire,0,0,0,0
2356,2017,Afghanistan,India,7758,5743,0,13501
2357,2017,Burundi,India,0,5,0,5
2358,2017,China,India,108008,0,0,108008
2359,2017,Cameroon,India,0,19,0,19
2360,2017,Congo,India,0,11,0,11
2361,2017,Dem. Rep. of the Congo,India,49,42,0,91
2362,2017,Eritrea,India,29,6,0,35
2363,2017,Ethiopia,India,20,30,0,50
2364,2017,Palestinian,India,75,0,0,75
2365,2017,Cote d'Ivoire,India,5,7,0,12
2366,2017,Iran (Islamic Rep. of),India,57,12,0,69
2367,2017,Iraq,India,344,110,0,454
2368,2017,Libya,India,0,6,0,6
2369,2017,Sri Lanka,India,61842,0,0,61842
2370,2017,Maldives,India,5,0,0,5
2371,2017,Myanmar,India,18089,3152,0,21241
2372,2017,Nigeria,India,0,8,0,8
2373,2017,Russian Federation,India,0,7,0,7
2374,2017,Rwanda,India,5,0,0,5
2375,2017,Saudi Arabia,India,5,0,0,5
2376,2017,Somalia,India,664,269,0,933
2377,2017,Sudan,India,89,41,0,130
2378,2017,South Sudan,India,6,73,0,79
2379,2017,Syrian Arab Rep.,India,87,17,0,104
2380,2017,Tajikistan,India,0,5,0,5
2381,2017,Uganda,India,0,5,0,5
2382,2017,Ukraine,India,0,6,0,6
2383,2017,Yemen,India,5,934,0,939
2384,2017,Afghanistan,Indonesia,5477,2082,0,7559
2385,2017,Algeria,Indonesia,0,14,0,14
2386,2017,Angola,Indonesia,0,7,0,7
2387,2017,Egypt,Indonesia,14,15,0,29
2388,2017,Bangladesh,Indonesia,0,28,0,28
2389,2017,China,Indonesia,9,10,0,19
2390,2017,Cameroon,Indonesia,0,61,0,61
2391,2017,Dem. Rep. of the Congo,Indonesia,5,14,0,19
2392,2017,Eritrea,Indonesia,32,25,0,57
2393,2017,Ethiopia,Indonesia,143,100,0,243
2394,2017,Palestinian,Indonesia,388,45,0,433
2395,2017,Cote d'Ivoire,Indonesia,0,13,0,13
2396,2017,India,Indonesia,0,7,0,7
2397,2017,Iran (Islamic Rep. of),Indonesia,239,123,0,362
2398,2017,Iraq,Indonesia,560,323,0,883
2399,2017,Kuwait,Indonesia,11,0,0,11
2400,2017,Libya,Indonesia,6,9,0,15
2401,2017,Sri Lanka,Indonesia,389,144,0,533
2402,2017,Mali,Indonesia,0,5,0,5
2403,2017,Myanmar,Indonesia,766,49,0,815
2404,2017,Nigeria,Indonesia,0,24,0,24
2405,2017,Pakistan,Indonesia,372,27,0,399
2406,2017,Senegal,Indonesia,0,5,0,5
2407,2017,Sierra Leone,Indonesia,0,10,0,10
2408,2017,Somalia,Indonesia,976,543,0,1519
2409,2017,Viet Nam,Indonesia,18,0,0,18
2410,2017,Sudan,Indonesia,266,143,0,409
2411,2017,Syrian Arab Rep.,Indonesia,35,27,0,62
2412,2017,Türkiye,Indonesia,0,38,0,38
2413,2017,Yemen,Indonesia,76,125,0,201
2414,2017,Afghanistan,Ireland,230,180,0,410
2415,2017,Albania,Ireland,78,635,0,713
2416,2017,Algeria,Ireland,189,197,0,386
2417,2017,Angola,Ireland,236,20,0,256
2418,2017,Egypt,Ireland,29,39,0,68
2419,2017,Armenia,Ireland,11,9,0,20
2420,2017,Azerbaijan,Ireland,15,0,0,15
2421,2017,Bahrain,Ireland,0,6,0,6
2422,2017,Burundi,Ireland,25,11,0,36
2423,2017,Benin,Ireland,5,0,0,5
2424,2017,Bangladesh,Ireland,30,280,0,310
2425,2017,Bhutan,Ireland,10,0,0,10
2426,2017,Belarus,Ireland,43,7,0,50
2427,2017,Bolivia (Plurinational State of),Ireland,7,11,0,18
2428,2017,Botswana,Ireland,0,18,0,18
2429,2017,Brazil,Ireland,0,57,0,57
2430,2017,Bosnia and Herzegovina,Ireland,14,0,0,14
2431,2017,Central African Rep.,Ireland,9,0,0,9
2432,2017,Chad,Ireland,5,0,0,5
2433,2017,China,Ireland,54,65,0,119
2434,2017,Cameroon,Ireland,85,33,0,118
2435,2017,Congo,Ireland,186,5,0,191
2436,2017,Dem. Rep. of the Congo,Ireland,396,244,0,640
2437,2017,Cuba,Ireland,22,5,0,27
2438,2017,Eritrea,Ireland,48,8,0,56
2439,2017,Ethiopia,Ireland,42,10,0,52
2440,2017,Gambia,Ireland,5,5,0,10
2441,2017,Palestinian,Ireland,94,26,0,120
2442,2017,Georgia,Ireland,70,367,0,437
2443,2017,Ghana,Ireland,26,47,0,73
2444,2017,Guatemala,Ireland,0,5,0,5
2445,2017,Guinea,Ireland,17,0,0,17
2446,2017,Guyana,Ireland,0,5,0,5
2447,2017,Honduras,Ireland,5,0,0,5
2448,2017,Cote d'Ivoire,Ireland,19,5,0,24
2449,2017,India,Ireland,5,98,0,103
2450,2017,Iran (Islamic Rep. of),Ireland,135,26,0,161
2451,2017,Iraq,Ireland,491,96,0,587
2452,2017,Israel,Ireland,5,5,0,10
2453,2017,Jordan,Ireland,7,5,0,12
2454,2017,Kazakhstan,Ireland,35,0,0,35
2455,2017,Kenya,Ireland,56,6,0,62
2456,2017,Kyrgyzstan,Ireland,5,9,0,14
2457,2017,Dem. People's Rep. of Korea,Ireland,5,5,0,10
2458,2017,Kuwait,Ireland,46,26,0,72
2459,2017,Liberia,Ireland,23,5,0,28
2460,2017,Libya,Ireland,255,74,0,329
2461,2017,Lebanon,Ireland,13,5,0,18
2462,2017,Sri Lanka,Ireland,20,11,0,31
2463,2017,Mauritania,Ireland,5,0,0,5
2464,2017,Rep. of Moldova,Ireland,105,8,0,113
2465,2017,Mexico,Ireland,0,6,0,6
2466,2017,Mali,Ireland,8,0,0,8
2467,2017,Malaysia,Ireland,5,16,0,21
2468,2017,Malawi,Ireland,51,177,0,228
2469,2017,Mongolia,Ireland,5,11,0,16
2470,2017,Morocco,Ireland,8,25,0,33
2471,2017,Mozambique,Ireland,6,0,0,6
2472,2017,Montenegro,Ireland,6,0,0,6
2473,2017,Mauritius,Ireland,7,39,0,46
2474,2017,Myanmar,Ireland,9,10,0,19
2475,2017,Nepal,Ireland,0,17,0,17
2476,2017,Niger,Ireland,5,0,0,5
2477,2017,Nigeria,Ireland,421,504,0,925
2478,2017,Pakistan,Ireland,172,940,0,1112
2479,2017,Philippines,Ireland,0,5,0,5
2480,2017,South Africa,Ireland,51,228,0,279
2481,2017,Russian Federation,Ireland,159,31,0,190
2482,2017,Rwanda,Ireland,66,0,0,66
2483,2017,Saudi Arabia,Ireland,10,6,0,16
2484,2017,Serbia and Kosovo: S/RES/1244 (1999),Ireland,200,24,0,224
2485,2017,Senegal,Ireland,0,7,0,7
2486,2017,Sierra Leone,Ireland,53,34,0,87
2487,2017,Somalia,Ireland,480,41,0,521
2488,2017,Viet Nam,Ireland,7,5,0,12
2489,2017,Sudan,Ireland,188,32,0,220
2490,2017,Eswatini,Ireland,15,13,0,28
2491,2017,Syrian Arab Rep.,Ireland,718,138,0,856
2492,2017,United Rep. of Tanzania,Ireland,9,0,0,9
2493,2017,Tajikistan,Ireland,12,0,0,12
2494,2017,Togo,Ireland,37,5,0,42
2495,2017,Tunisia,Ireland,0,14,0,14
2496,2017,Türkiye,Ireland,14,5,0,19
2497,2017,Uganda,Ireland,42,12,0,54
2498,2017,Ukraine,Ireland,110,66,0,176
2499,2017,United States of America,Ireland,0,8,0,8
2500,2017,Uzbekistan,Ireland,24,0,0,24
2501,2017,Venezuela (Bolivarian Republic of),Ireland,11,42,0,53
2502,2017,Yemen,Ireland,5,9,0,14
2503,2017,Zambia,Ireland,5,6,0,11
2504,2017,Zimbabwe,Ireland,252,513,0,765
2505,2017,Stateless,Ireland,7,0,0,7
2506,2017,Unknown ,Ireland,0,323,0,323
2507,2017,Afghanistan,Iran (Islamic Rep. of),951142,0,0,951142
2508,2017,Iraq,Iran (Islamic Rep. of),28268,0,0,28268
2509,2017,Kuwait,Iran (Islamic Rep. of),8,0,0,8
2510,2017,Myanmar,Iran (Islamic Rep. of),0,84,0,84
2511,2017,Pakistan,Iran (Islamic Rep. of),10,0,0,10
2512,2017,Uzbekistan,Iran (Islamic Rep. of),7,0,0,7
2513,2017,Afghanistan,Iraq,11,107,0,118
2514,2017,Egypt,Iraq,0,23,0,23
2515,2017,Bahrain,Iraq,0,39,0,39
2516,2017,Eritrea,Iraq,5,0,0,5
2517,2017,Ethiopia,Iraq,0,5,0,5
2518,2017,Palestinian,Iraq,7865,136,0,8001
2519,2017,Indonesia,Iraq,0,5,0,5
2520,2017,Iran (Islamic Rep. of),Iraq,7143,6317,0,13460
2521,2017,Iraq,Iraq,0,0,2615988,0
2522,2017,Jordan,Iraq,9,5,0,14
2523,2017,Kyrgyzstan,Iraq,0,6,0,6
2524,2017,Kuwait,Iraq,0,131,0,131
2525,2017,Lebanon,Iraq,0,5,0,5
2526,2017,Morocco,Iraq,0,5,0,5
2527,2017,Pakistan,Iraq,0,45,0,45
2528,2017,Saudi Arabia,Iraq,0,8,0,8
2529,2017,Somalia,Iraq,0,8,0,8
2530,2017,Sudan,Iraq,64,890,0,954
2531,2017,South Sudan,Iraq,0,14,0,14
2532,2017,Syrian Arab Rep.,Iraq,247057,0,0,247057
2533,2017,Tunisia,Iraq,0,6,0,6
2534,2017,Türkiye,Iraq,15514,5191,0,20705
2535,2017,Uzbekistan,Iraq,0,5,0,5
2536,2017,Yemen,Iraq,0,84,0,84
2537,2017,Stateless,Iraq,0,0,0,0
2538,2017,Egypt,Israel,0,12,0,12
2539,2017,Armenia,Israel,0,29,0,29
2540,2017,Azerbaijan,Israel,0,13,0,13
2541,2017,Belarus,Israel,0,117,0,117
2542,2017,Botswana,Israel,0,5,0,5
2543,2017,Central African Rep.,Israel,0,10,0,10
2544,2017,Chad,Israel,0,8,0,8
2545,2017,China,Israel,0,53,0,53
2546,2017,Cameroon,Israel,0,20,0,20
2547,2017,Congo,Israel,0,28,0,28
2548,2017,Dem. Rep. of the Congo,Israel,209,189,0,398
2549,2017,Colombia,Israel,0,23,0,23
2550,2017,Eritrea,Israel,22010,4553,0,26563
2551,2017,Ethiopia,Israel,89,897,0,986
2552,2017,Georgia,Israel,0,3472,0,3472
2553,2017,Ghana,Israel,0,403,0,403
2554,2017,Guinea,Israel,0,32,0,32
2555,2017,Cote d'Ivoire,Israel,5,23,0,28
2556,2017,India,Israel,0,439,0,439
2557,2017,Iran (Islamic Rep. of),Israel,6,5,0,11
2558,2017,Iraq,Israel,10,0,0,10
2559,2017,Kazakhstan,Israel,0,31,0,31
2560,2017,Kenya,Israel,0,44,0,44
2561,2017,Kyrgyzstan,Israel,0,17,0,17
2562,2017,Dem. People's Rep. of Korea,Israel,5,0,0,5
2563,2017,Lesotho,Israel,0,5,0,5
2564,2017,Sri Lanka,Israel,0,566,0,566
2565,2017,Rep. of Moldova,Israel,0,426,0,426
2566,2017,Mali,Israel,0,6,0,6
2567,2017,Malawi,Israel,0,12,0,12
2568,2017,Mongolia,Israel,0,83,0,83
2569,2017,Myanmar,Israel,0,38,0,38
2570,2017,Nepal,Israel,0,8,0,8
2571,2017,Nigeria,Israel,5,725,0,730
2572,2017,Romania,Israel,0,29,0,29
2573,2017,South Africa,Israel,0,249,0,249
2574,2017,Russian Federation,Israel,0,805,0,805
2575,2017,Sierra Leone,Israel,5,23,0,28
2576,2017,Somalia,Israel,0,13,0,13
2577,2017,Sudan,Israel,3187,4437,0,7624
2578,2017,South Sudan,Israel,126,98,0,224
2579,2017,Türkiye,Israel,0,50,0,50
2580,2017,Uganda,Israel,0,26,0,26
2581,2017,Ukraine,Israel,0,11507,0,11507
2582,2017,Uzbekistan,Israel,0,130,0,130
2583,2017,Zimbabwe,Israel,0,5,0,5
2584,2017,Stateless,Israel,0,0,0,0
2585,2017,Unknown ,Israel,0,40,0,40
2586,2017,Afghanistan,Italy,17171,322,0,17493
2587,2017,Albania,Italy,538,800,0,1338
2588,2017,Algeria,Italy,186,169,0,355
2589,2017,Angola,Italy,35,28,0,63
2590,2017,Egypt,Italy,1995,968,0,2963
2591,2017,Argentina,Italy,5,13,0,18
2592,2017,Armenia,Italy,289,261,0,550
2593,2017,Azerbaijan,Italy,62,15,0,77
2594,2017,Bahrain,Italy,5,0,0,5
2595,2017,Burundi,Italy,19,10,0,29
2596,2017,Benin,Italy,228,261,0,489
2597,2017,Bangladesh,Italy,5671,18209,0,23880
2598,2017,Bahamas,Italy,0,5,0,5
2599,2017,Burkina Faso,Italy,1014,1431,0,2445
2600,2017,Belarus,Italy,34,36,0,70
2601,2017,Bolivia (Plurinational State of),Italy,13,5,0,18
2602,2017,Brazil,Italy,100,117,0,217
2603,2017,Bosnia and Herzegovina,Italy,618,121,0,739
2604,2017,Cambodia,Italy,5,0,0,5
2605,2017,Central African Rep.,Italy,90,78,0,168
2606,2017,Chad,Italy,448,172,0,620
2607,2017,China,Italy,166,746,0,912
2608,2017,Chile,Italy,8,9,0,17
2609,2017,Cameroon,Italy,1348,2996,0,4344
2610,2017,Congo,Italy,425,139,0,564
2611,2017,Dem. Rep. of the Congo,Italy,556,144,0,700
2612,2017,Comoros,Italy,0,38,0,38
2613,2017,Colombia,Italy,353,330,0,683
2614,2017,Costa Rica,Italy,0,7,0,7
2615,2017,Cuba,Italy,195,154,0,349
2616,2017,Cabo Verde,Italy,0,5,0,5
2617,2017,Dominica,Italy,0,5,0,5
2618,2017,Dominican Rep.,Italy,17,14,0,31
2619,2017,Ecuador,Italy,31,13,0,44
2620,2017,Equatorial Guinea,Italy,14,6,0,20
2621,2017,Eritrea,Italy,7940,18570,0,26510
2622,2017,Ethiopia,Italy,1309,260,0,1569
2623,2017,Gabon,Italy,29,36,0,65
2624,2017,Gambia,Italy,10273,10570,0,20843
2625,2017,Palestinian,Italy,954,234,0,1188
2626,2017,Georgia,Italy,329,975,0,1304
2627,2017,Ghana,Italy,4861,7121,0,11982
2628,2017,Guinea-Bissau,Italy,709,1127,0,1836
2629,2017,Guatemala,Italy,6,7,0,13
2630,2017,Guinea,Italy,3387,11176,0,14563
2631,2017,Haiti,Italy,9,0,0,9
2632,2017,Honduras,Italy,42,168,0,210
2633,2017,Croatia,Italy,18,0,0,18
2634,2017,Cote d'Ivoire,Italy,6412,11429,0,17841
2635,2017,India,Italy,205,837,0,1042
2636,2017,Indonesia,Italy,0,5,0,5
2637,2017,Iran (Islamic Rep. of),Italy,1828,236,0,2064
2638,2017,Iraq,Italy,5359,1565,0,6924
2639,2017,Israel,Italy,7,0,0,7
2640,2017,Jamaica,Italy,5,0,0,5
2641,2017,Jordan,Italy,27,17,0,44
2642,2017,Kazakhstan,Italy,8,17,0,25
2643,2017,Kenya,Italy,138,41,0,179
2644,2017,Kyrgyzstan,Italy,25,165,0,190
2645,2017,Rep. of Korea,Italy,5,0,0,5
2646,2017,Kuwait,Italy,5,5,0,10
2647,2017,Liberia,Italy,320,502,0,822
2648,2017,Libya,Italy,837,604,0,1441
2649,2017,Lebanon,Italy,313,61,0,374
2650,2017,Lesotho,Italy,0,5,0,5
2651,2017,Sri Lanka,Italy,517,598,0,1115
2652,2017,Madagascar,Italy,18,7,0,25
2653,2017,Mauritania,Italy,342,48,0,390
2654,2017,North Macedonia,Italy,56,66,0,122
2655,2017,Rep. of Moldova,Italy,100,38,0,138
2656,2017,Mexico,Italy,5,5,0,10
2657,2017,Mali,Italy,13206,10722,0,23928
2658,2017,Malaysia,Italy,0,5,0,5
2659,2017,Malawi,Italy,5,0,0,5
2660,2017,Mongolia,Italy,5,0,0,5
2661,2017,Morocco,Italy,746,1901,0,2647
2662,2017,Mozambique,Italy,5,0,0,5
2663,2017,Montenegro,Italy,81,14,0,95
2664,2017,Mauritius,Italy,16,0,0,16
2665,2017,Myanmar,Italy,34,35,0,69
2666,2017,Namibia,Italy,5,0,0,5
2667,2017,Nepal,Italy,95,156,0,251
2668,2017,Niger,Italy,431,860,0,1291
2669,2017,Nicaragua,Italy,14,6,0,20
2670,2017,Nigeria,Italy,18026,37967,0,55993
2671,2017,Norway,Italy,0,5,0,5
2672,2017,Pakistan,Italy,15966,11864,0,27830
2673,2017,Paraguay,Italy,5,9,0,14
2674,2017,Peru,Italy,70,218,0,288
2675,2017,Philippines,Italy,29,137,0,166
2676,2017,Palau,Italy,0,5,0,5
2677,2017,South Africa,Italy,8,0,0,8
2678,2017,Russian Federation,Italy,208,261,0,469
2679,2017,Rwanda,Italy,13,9,0,22
2680,2017,El Salvador,Italy,674,2848,0,3522
2681,2017,Saudi Arabia,Italy,7,13,0,20
2682,2017,Serbia and Kosovo: S/RES/1244 (1999),Italy,1128,1308,0,2436
2683,2017,Senegal,Italy,6197,11442,0,17639
2684,2017,Sierra Leone,Italy,539,1699,0,2238
2685,2017,Somalia,Italy,15641,1258,0,16899
2686,2017,Viet Nam,Italy,7,0,0,7
2687,2017,Sudan,Italy,1665,546,0,2211
2688,2017,South Sudan,Italy,61,41,0,102
2689,2017,Eswatini,Italy,8,0,0,8
2690,2017,Syrian Arab Rep.,Italy,3618,1696,0,5314
2691,2017,United Rep. of Tanzania,Italy,26,9,0,35
2692,2017,Thailand,Italy,0,8,0,8
2693,2017,Tajikistan,Italy,8,18,0,26
2694,2017,Turkmenistan,Italy,5,0,0,5
2695,2017,Timor-Leste,Italy,5,0,0,5
2696,2017,Togo,Italy,963,1039,0,2002
2697,2017,Tunisia,Italy,601,548,0,1149
2698,2017,Türkiye,Italy,2456,396,0,2852
2699,2017,United Arab Emirates,Italy,0,5,0,5
2700,2017,Uganda,Italy,67,17,0,84
2701,2017,Ukraine,Italy,4947,4453,0,9400
2702,2017,Uruguay,Italy,0,8,0,8
2703,2017,United States of America,Italy,5,5,0,10
2704,2017,Uzbekistan,Italy,6,11,0,17
2705,2017,Venezuela (Bolivarian Republic of),Italy,177,915,0,1092
2706,2017,Western Sahara,Italy,5,0,0,5
2707,2017,Yemen,Italy,113,42,0,155
2708,2017,Zimbabwe,Italy,24,11,0,35
2709,2017,Stateless,Italy,19,13,0,32
2710,2017,Unknown ,Italy,1353,0,0,1353
2711,2017,Cuba,Jamaica,0,8,0,8
2712,2017,Haiti,Jamaica,8,0,0,8
2713,2017,Syrian Arab Rep.,Jamaica,5,0,0,5
2714,2017,Afghanistan,Jordan,8,9,0,17
2715,2017,Algeria,Jordan,5,7,0,12
2716,2017,Egypt,Jordan,79,564,0,643
2717,2017,Bangladesh,Jordan,0,8,0,8
2718,2017,Burkina Faso,Jordan,0,5,0,5
2719,2017,Bosnia and Herzegovina,Jordan,10,0,0,10
2720,2017,Chad,Jordan,0,21,0,21
2721,2017,Eritrea,Jordan,25,16,0,41
2722,2017,Ethiopia,Jordan,8,42,0,50
2723,2017,Ghana,Jordan,0,6,0,6
2724,2017,India,Jordan,0,7,0,7
2725,2017,Indonesia,Jordan,0,5,0,5
2726,2017,Iran (Islamic Rep. of),Jordan,7,5,0,12
2727,2017,Iraq,Jordan,34037,31885,0,65922
2728,2017,Kenya,Jordan,0,25,0,25
2729,2017,Libya,Jordan,27,183,0,210
2730,2017,Lebanon,Jordan,6,105,0,111
2731,2017,Sri Lanka,Jordan,5,8,0,13
2732,2017,Morocco,Jordan,0,13,0,13
2733,2017,Nigeria,Jordan,0,13,0,13
2734,2017,Pakistan,Jordan,5,18,0,23
2735,2017,Philippines,Jordan,0,6,0,6
2736,2017,South Africa,Jordan,0,5,0,5
2737,2017,Russian Federation,Jordan,25,20,0,45
2738,2017,Saudi Arabia,Jordan,0,8,0,8
2739,2017,Serbia and Kosovo: S/RES/1244 (1999),Jordan,0,5,0,5
2740,2017,Senegal,Jordan,0,5,0,5
2741,2017,Somalia,Jordan,645,164,0,809
2742,2017,Sudan,Jordan,2567,1469,0,4036
2743,2017,Suriname,Jordan,0,7,0,7
2744,2017,South Sudan,Jordan,12,5,0,17
2745,2017,Syrian Arab Rep.,Jordan,653031,0,0,653031
2746,2017,Tajikistan,Jordan,0,5,0,5
2747,2017,Tunisia,Jordan,8,20,0,28
2748,2017,Türkiye,Jordan,0,8,0,8
2749,2017,Ukraine,Jordan,0,17,0,17
2750,2017,Yemen,Jordan,494,8951,0,9445
2751,2017,Stateless,Jordan,11,169,0,180
2752,2017,Afghanistan,Japan,51,0,0,51
2753,2017,Burundi,Japan,8,0,0,8
2754,2017,Bangladesh,Japan,27,1049,0,1076
2755,2017,Cambodia,Japan,0,1085,0,1085
2756,2017,China,Japan,69,535,0,604
2757,2017,Cameroon,Japan,17,218,0,235
2758,2017,Dem. Rep. of the Congo,Japan,7,0,0,7
2759,2017,Ethiopia,Japan,23,0,0,23
2760,2017,Ghana,Japan,0,330,0,330
2761,2017,India,Japan,0,1257,0,1257
2762,2017,Indonesia,Japan,0,2613,0,2613
2763,2017,Iran (Islamic Rep. of),Japan,17,307,0,324
2764,2017,Iraq,Japan,13,0,0,13
2765,2017,Sri Lanka,Japan,59,3549,0,3608
2766,2017,Mongolia,Japan,0,70,0,70
2767,2017,Myanmar,Japan,1469,2241,0,3710
2768,2017,Nepal,Japan,0,4520,0,4520
2769,2017,Nigeria,Japan,0,328,0,328
2770,2017,Pakistan,Japan,34,1017,0,1051
2771,2017,Philippines,Japan,0,5298,0,5298
2772,2017,Senegal,Japan,0,141,0,141
2773,2017,Somalia,Japan,5,0,0,5
2774,2017,Viet Nam,Japan,0,2490,0,2490
2775,2017,Sudan,Japan,15,0,0,15
2776,2017,Syrian Arab Rep.,Japan,66,0,0,66
2777,2017,Thailand,Japan,0,52,0,52
2778,2017,Tunisia,Japan,0,155,0,155
2779,2017,Türkiye,Japan,39,2949,0,2988
2780,2017,Uganda,Japan,0,160,0,160
2781,2017,Stateless,Japan,9,0,0,9
2782,2017,Unknown ,Japan,261,840,0,1101
2783,2017,Afghanistan,Kazakhstan,561,164,0,725
2784,2017,China,Kazakhstan,6,6,0,12
2785,2017,Syrian Arab Rep.,Kazakhstan,17,23,0,40
2786,2017,Türkiye,Kazakhstan,0,14,0,14
2787,2017,Uzbekistan,Kazakhstan,18,0,0,18
2788,2017,Stateless,Kazakhstan,0,0,0,0
2789,2017,Afghanistan,Kenya,8,5,0,13
2790,2017,Angola,Kenya,0,6,0,6
2791,2017,Burundi,Kenya,1902,10926,0,12828
2792,2017,Central African Rep.,Kenya,0,6,0,6
2793,2017,Cameroon,Kenya,0,17,0,17
2794,2017,Congo,Kenya,26,109,0,135
2795,2017,Dem. Rep. of the Congo,Kenya,13941,21769,0,35710
2796,2017,Eritrea,Kenya,702,639,0,1341
2797,2017,Ethiopia,Kenya,17873,10007,0,27880
2798,2017,Cote d'Ivoire,Kenya,0,9,0,9
2799,2017,India,Kenya,0,5,0,5
2800,2017,Iraq,Kenya,5,0,0,5
2801,2017,Liberia,Kenya,0,5,0,5
2802,2017,Sri Lanka,Kenya,9,0,0,9
2803,2017,Mozambique,Kenya,7,0,0,7
2804,2017,Nigeria,Kenya,5,14,0,19
2805,2017,Pakistan,Kenya,9,0,0,9
2806,2017,Rwanda,Kenya,576,1066,0,1642
2807,2017,Sierra Leone,Kenya,5,0,0,5
2808,2017,Somalia,Kenya,281692,2654,0,284346
2809,2017,Sudan,Kenya,2922,7086,0,10008
2810,2017,South Sudan,Kenya,111510,102,0,111612
2811,2017,Syrian Arab Rep.,Kenya,0,7,0,7
2812,2017,United Rep. of Tanzania,Kenya,9,28,0,37
2813,2017,Türkiye,Kenya,0,12,0,12
2814,2017,Uganda,Kenya,626,1856,0,2482
2815,2017,Yemen,Kenya,68,157,0,225
2816,2017,Zimbabwe,Kenya,0,14,0,14
2817,2017,Stateless,Kenya,0,0,0,0
2818,2017,Afghanistan,Kyrgyzstan,236,46,0,282
2819,2017,Iraq,Kyrgyzstan,0,5,0,5
2820,2017,Syrian Arab Rep.,Kyrgyzstan,69,12,0,81
2821,2017,Tajikistan,Kyrgyzstan,0,5,0,5
2822,2017,Türkiye,Kyrgyzstan,0,13,0,13
2823,2017,Ukraine,Kyrgyzstan,17,9,0,26
2824,2017,Uzbekistan,Kyrgyzstan,12,17,0,29
2825,2017,Stateless,Kyrgyzstan,0,0,0,0
2826,2017,Afghanistan,Rep. of Korea,37,7,0,44
2827,2017,Algeria,Rep. of Korea,5,47,0,52
2828,2017,Angola,Rep. of Korea,5,30,0,35
2829,2017,Egypt,Rep. of Korea,19,635,0,654
2830,2017,Burundi,Rep. of Korea,18,10,0,28
2831,2017,Bangladesh,Rep. of Korea,98,413,0,511
2832,2017,Burkina Faso,Rep. of Korea,0,18,0,18
2833,2017,Bosnia and Herzegovina,Rep. of Korea,0,5,0,5
2834,2017,Cambodia,Rep. of Korea,0,11,0,11
2835,2017,China,Rep. of Korea,39,1119,0,1158
2836,2017,Cameroon,Rep. of Korea,18,135,0,153
2837,2017,Dem. Rep. of the Congo,Rep. of Korea,49,17,0,66
2838,2017,Ecuador,Rep. of Korea,0,5,0,5
2839,2017,Eritrea,Rep. of Korea,5,5,0,10
2840,2017,Ethiopia,Rep. of Korea,130,121,0,251
2841,2017,Gabon,Rep. of Korea,0,5,0,5
2842,2017,Gambia,Rep. of Korea,0,51,0,51
2843,2017,Palestinian,Rep. of Korea,5,0,0,5
2844,2017,Ghana,Rep. of Korea,6,145,0,151
2845,2017,Guinea-Bissau,Rep. of Korea,0,7,0,7
2846,2017,Guinea,Rep. of Korea,0,85,0,85
2847,2017,Haiti,Rep. of Korea,0,5,0,5
2848,2017,Cote d'Ivoire,Rep. of Korea,30,28,0,58
2849,2017,India,Rep. of Korea,0,720,0,720
2850,2017,Indonesia,Rep. of Korea,0,9,0,9
2851,2017,Iran (Islamic Rep. of),Rep. of Korea,48,54,0,102
2852,2017,Iraq,Rep. of Korea,27,23,0,50
2853,2017,Jordan,Rep. of Korea,0,16,0,16
2854,2017,Kazakhstan,Rep. of Korea,5,1152,0,1157
2855,2017,Kenya,Rep. of Korea,5,26,0,31
2856,2017,Kyrgyzstan,Rep. of Korea,0,83,0,83
2857,2017,Liberia,Rep. of Korea,9,176,0,185
2858,2017,Libya,Rep. of Korea,5,6,0,11
2859,2017,Sri Lanka,Rep. of Korea,8,115,0,123
2860,2017,Mali,Rep. of Korea,6,64,0,70
2861,2017,Malaysia,Rep. of Korea,0,451,0,451
2862,2017,Mongolia,Rep. of Korea,0,159,0,159
2863,2017,Morocco,Rep. of Korea,5,144,0,149
2864,2017,Mozambique,Rep. of Korea,0,7,0,7
2865,2017,Mauritius,Rep. of Korea,0,5,0,5
2866,2017,Myanmar,Rep. of Korea,292,12,0,304
2867,2017,Nepal,Rep. of Korea,5,135,0,140
2868,2017,Nigeria,Rep. of Korea,10,431,0,441
2869,2017,Pakistan,Rep. of Korea,86,805,0,891
2870,2017,Philippines,Rep. of Korea,0,255,0,255
2871,2017,South Africa,Rep. of Korea,0,111,0,111
2872,2017,Russian Federation,Rep. of Korea,13,618,0,631
2873,2017,Rwanda,Rep. of Korea,0,5,0,5
2874,2017,Senegal,Rep. of Korea,0,168,0,168
2875,2017,Sierra Leone,Rep. of Korea,0,5,0,5
2876,2017,Somalia,Rep. of Korea,5,0,0,5
2877,2017,Viet Nam,Rep. of Korea,0,42,0,42
2878,2017,Sudan,Rep. of Korea,12,36,0,48
2879,2017,Syrian Arab Rep.,Rep. of Korea,1122,68,0,1190
2880,2017,United Rep. of Tanzania,Rep. of Korea,5,36,0,41
2881,2017,Thailand,Rep. of Korea,5,278,0,283
2882,2017,Tajikistan,Rep. of Korea,0,13,0,13
2883,2017,Togo,Rep. of Korea,0,8,0,8
2884,2017,Tunisia,Rep. of Korea,0,26,0,26
2885,2017,Türkiye,Rep. of Korea,0,47,0,47
2886,2017,Uganda,Rep. of Korea,31,75,0,106
2887,2017,Ukraine,Rep. of Korea,12,18,0,30
2888,2017,Uzbekistan,Rep. of Korea,8,40,0,48
2889,2017,Venezuela (Bolivarian Republic of),Rep. of Korea,0,5,0,5
2890,2017,Yemen,Rep. of Korea,50,201,0,251
2891,2017,Zimbabwe,Rep. of Korea,0,7,0,7
2892,2017,Stateless,Rep. of Korea,0,0,0,0
2893,2017,Egypt,Kuwait,0,18,0,18
2894,2017,Djibouti,Kuwait,0,5,0,5
2895,2017,Eritrea,Kuwait,0,24,0,24
2896,2017,Ethiopia,Kuwait,0,11,0,11
2897,2017,Palestinian,Kuwait,0,5,0,5
2898,2017,Iran (Islamic Rep. of),Kuwait,9,83,0,92
2899,2017,Iraq,Kuwait,328,285,0,613
2900,2017,Jordan,Kuwait,0,6,0,6
2901,2017,Lebanon,Kuwait,0,5,0,5
2902,2017,Sri Lanka,Kuwait,0,6,0,6
2903,2017,Pakistan,Kuwait,0,12,0,12
2904,2017,Philippines,Kuwait,0,5,0,5
2905,2017,Somalia,Kuwait,227,419,0,646
2906,2017,Sudan,Kuwait,0,19,0,19
2907,2017,Syrian Arab Rep.,Kuwait,44,31,0,75
2908,2017,Ukraine,Kuwait,0,5,0,5
2909,2017,Yemen,Kuwait,5,9,0,14
2910,2017,Stateless,Kuwait,0,0,0,0
2911,2017,Dem. Rep. of the Congo,Liberia,10,0,0,10
2912,2017,Cote d'Ivoire,Liberia,11063,0,0,11063
2913,2017,Iraq,Liberia,0,5,0,5
2914,2017,Mali,Liberia,19,0,0,19
2915,2017,Nigeria,Liberia,0,9,0,9
2916,2017,Rwanda,Liberia,0,5,0,5
2917,2017,Sierra Leone,Liberia,0,0,0,0
2918,2017,Sudan,Liberia,5,0,0,5
2919,2017,Syrian Arab Rep.,Liberia,7,6,0,13
2920,2017,Togo,Liberia,5,0,0,5
2921,2017,Türkiye,Liberia,0,5,0,5
2922,2017,Afghanistan,Libya,0,11,0,11
2923,2017,Algeria,Libya,5,0,0,5
2924,2017,Egypt,Libya,5,0,0,5
2925,2017,Chad,Libya,20,56,0,76
2926,2017,Dem. Rep. of the Congo,Libya,14,11,0,25
2927,2017,Eritrea,Libya,471,4661,0,5132
2928,2017,Ethiopia,Libya,24,744,0,768
2929,2017,Palestinian,Libya,5303,1676,0,6979
2930,2017,Iraq,Libya,2459,652,0,3111
2931,2017,Liberia,Libya,22,0,0,22
2932,2017,Libya,Libya,0,0,180937,0
2933,2017,Morocco,Libya,0,5,0,5
2934,2017,Somalia,Libya,143,2253,0,2396
2935,2017,Sudan,Libya,629,3660,0,4289
2936,2017,South Sudan,Libya,0,5,0,5
2937,2017,Syrian Arab Rep.,Libya,257,21890,0,22147
2938,2017,Yemen,Libya,0,26,0,26
2939,2017,Afghanistan,Lebanon,22,6,0,28
2940,2017,Algeria,Lebanon,0,5,0,5
2941,2017,Egypt,Lebanon,66,166,0,232
2942,2017,Armenia,Lebanon,0,0,0,0
2943,2017,Bahrain,Lebanon,27,10,0,37
2944,2017,Benin,Lebanon,0,5,0,5
2945,2017,Bangladesh,Lebanon,0,30,0,30
2946,2017,Cameroon,Lebanon,0,14,0,14
2947,2017,Dem. Rep. of the Congo,Lebanon,5,5,0,10
2948,2017,Eritrea,Lebanon,20,39,0,59
2949,2017,Ethiopia,Lebanon,30,396,0,426
2950,2017,Gambia,Lebanon,0,5,0,5
2951,2017,Palestinian,Lebanon,0,5,0,5
2952,2017,Hungary,Lebanon,0,0,0,0
2953,2017,Cote d'Ivoire,Lebanon,0,7,0,7
2954,2017,India,Lebanon,0,5,0,5
2955,2017,Iran (Islamic Rep. of),Lebanon,33,17,0,50
2956,2017,Iraq,Lebanon,5695,13612,0,19307
2957,2017,Jordan,Lebanon,32,48,0,80
2958,2017,Kenya,Lebanon,0,13,0,13
2959,2017,Libya,Lebanon,12,10,0,22
2960,2017,Sri Lanka,Lebanon,0,0,0,0
2961,2017,Madagascar,Lebanon,0,0,0,0
2962,2017,Mauritania,Lebanon,0,5,0,5
2963,2017,Morocco,Lebanon,0,0,0,0
2964,2017,Nigeria,Lebanon,0,19,0,19
2965,2017,Pakistan,Lebanon,0,16,0,16
2966,2017,Philippines,Lebanon,0,29,0,29
2967,2017,Saudi Arabia,Lebanon,10,8,0,18
2968,2017,Somalia,Lebanon,19,5,0,24
2969,2017,Sudan,Lebanon,705,716,0,1421
2970,2017,South Sudan,Lebanon,39,0,0,39
2971,2017,Syrian Arab Rep.,Lebanon,992127,10,0,992137
2972,2017,Tunisia,Lebanon,11,0,0,11
2973,2017,Türkiye,Lebanon,8,7,0,15
2974,2017,Ukraine,Lebanon,0,5,0,5
2975,2017,United States of America,Lebanon,0,0,0,0
2976,2017,Yemen,Lebanon,15,103,0,118
2977,2017,Dem. Rep. of the Congo,Lesotho,27,28,0,55
2978,2017,Eritrea,Lesotho,5,0,0,5
2979,2017,Ethiopia,Lesotho,12,0,0,12
2980,2017,Uganda,Lesotho,6,0,0,6
2981,2017,Zimbabwe,Lesotho,5,0,0,5
2982,2017,Afghanistan,Liechtenstein,5,0,0,5
2983,2017,Albania,Liechtenstein,0,6,0,6
2984,2017,Armenia,Liechtenstein,8,0,0,8
2985,2017,China,Liechtenstein,27,5,0,32
2986,2017,Eritrea,Liechtenstein,11,0,0,11
2987,2017,Georgia,Liechtenstein,0,5,0,5
2988,2017,Iran (Islamic Rep. of),Liechtenstein,5,5,0,10
2989,2017,Iraq,Liechtenstein,7,5,0,12
2990,2017,North Macedonia,Liechtenstein,0,7,0,7
2991,2017,Serbia and Kosovo: S/RES/1244 (1999),Liechtenstein,36,36,0,72
2992,2017,Somalia,Liechtenstein,28,5,0,33
2993,2017,Syrian Arab Rep.,Liechtenstein,32,0,0,32
2994,2017,Ukraine,Liechtenstein,5,5,0,10
2995,2017,Afghanistan,Sri Lanka,133,58,0,191
2996,2017,Palestinian,Sri Lanka,10,0,0,10
2997,2017,Iran (Islamic Rep. of),Sri Lanka,8,11,0,19
2998,2017,Sri Lanka,Sri Lanka,0,0,39322,0
2999,2017,Maldives,Sri Lanka,8,5,0,13
3000,2017,Myanmar,Sri Lanka,35,0,0,35
3001,2017,Nepal,Sri Lanka,0,5,0,5
3002,2017,Nigeria,Sri Lanka,0,5,0,5
3003,2017,Pakistan,Sri Lanka,600,536,0,1136
3004,2017,Syrian Arab Rep.,Sri Lanka,14,0,0,14
3005,2017,Yemen,Sri Lanka,12,9,0,21
3006,2017,Afghanistan,Lithuania,212,9,0,221
3007,2017,Armenia,Lithuania,5,19,0,24
3008,2017,Azerbaijan,Lithuania,12,5,0,17
3009,2017,Belarus,Lithuania,35,18,0,53
3010,2017,Cameroon,Lithuania,5,0,0,5
3011,2017,Cuba,Lithuania,5,0,0,5
3012,2017,Eritrea,Lithuania,38,0,0,38
3013,2017,Ethiopia,Lithuania,5,0,0,5
3014,2017,Georgia,Lithuania,5,0,0,5
3015,2017,Iran (Islamic Rep. of),Lithuania,6,0,0,6
3016,2017,Iraq,Lithuania,57,0,0,57
3017,2017,Kyrgyzstan,Lithuania,0,7,0,7
3018,2017,Sri Lanka,Lithuania,10,13,0,23
3019,2017,Nigeria,Lithuania,5,0,0,5
3020,2017,Pakistan,Lithuania,5,6,0,11
3021,2017,Russian Federation,Lithuania,636,60,0,696
3022,2017,Somalia,Lithuania,22,0,0,22
3023,2017,Syrian Arab Rep.,Lithuania,362,52,0,414
3024,2017,Tajikistan,Lithuania,24,34,0,58
3025,2017,Türkiye,Lithuania,14,5,0,19
3026,2017,Ukraine,Lithuania,63,21,0,84
3027,2017,Uzbekistan,Lithuania,16,0,0,16
3028,2017,Stateless,Lithuania,35,0,0,35
3029,2017,Afghanistan,Luxembourg,43,70,0,113
3030,2017,Albania,Luxembourg,82,65,0,147
3031,2017,Algeria,Luxembourg,0,50,0,50
3032,2017,Angola,Luxembourg,15,0,0,15
3033,2017,Egypt,Luxembourg,5,10,0,15
3034,2017,Armenia,Luxembourg,6,0,0,6
3035,2017,Azerbaijan,Luxembourg,15,5,0,20
3036,2017,Benin,Luxembourg,0,5,0,5
3037,2017,Bhutan,Luxembourg,5,0,0,5
3038,2017,Belarus,Luxembourg,7,10,0,17
3039,2017,Bosnia and Herzegovina,Luxembourg,7,15,0,22
3040,2017,China,Luxembourg,5,0,0,5
3041,2017,Cameroon,Luxembourg,12,10,0,22
3042,2017,Congo,Luxembourg,5,0,0,5
3043,2017,Dem. Rep. of the Congo,Luxembourg,38,20,0,58
3044,2017,Eritrea,Luxembourg,79,245,0,324
3045,2017,Ethiopia,Luxembourg,43,25,0,68
3046,2017,Gabon,Luxembourg,5,5,0,10
3047,2017,Gambia,Luxembourg,6,5,0,11
3048,2017,Georgia,Luxembourg,0,40,0,40
3049,2017,Ghana,Luxembourg,0,5,0,5
3050,2017,Guinea,Luxembourg,10,20,0,30
3051,2017,Cote d'Ivoire,Luxembourg,6,10,0,16
3052,2017,India,Luxembourg,0,5,0,5
3053,2017,Iran (Islamic Rep. of),Luxembourg,148,55,0,203
3054,2017,Iraq,Luxembourg,280,200,0,480
3055,2017,Jordan,Luxembourg,0,5,0,5
3056,2017,Dem. People's Rep. of Korea,Luxembourg,12,0,0,12
3057,2017,Libya,Luxembourg,5,10,0,15
3058,2017,Lebanon,Luxembourg,0,5,0,5
3059,2017,Sri Lanka,Luxembourg,5,0,0,5
3060,2017,North Macedonia,Luxembourg,0,10,0,10
3061,2017,Rep. of Moldova,Luxembourg,0,5,0,5
3062,2017,Mexico,Luxembourg,5,0,0,5
3063,2017,Mali,Luxembourg,0,5,0,5
3064,2017,Morocco,Luxembourg,0,55,0,55
3065,2017,Montenegro,Luxembourg,18,10,0,28
3066,2017,Nigeria,Luxembourg,10,15,0,25
3067,2017,Peru,Luxembourg,5,0,0,5
3068,2017,Russian Federation,Luxembourg,33,10,0,43
3069,2017,Rwanda,Luxembourg,19,0,0,19
3070,2017,Serbia and Kosovo: S/RES/1244 (1999),Luxembourg,265,80,0,345
3071,2017,Senegal,Luxembourg,0,5,0,5
3072,2017,Somalia,Luxembourg,44,15,0,59
3073,2017,Sudan,Luxembourg,0,25,0,25
3074,2017,Syrian Arab Rep.,Luxembourg,686,225,0,911
3075,2017,Tajikistan,Luxembourg,0,5,0,5
3076,2017,Turkmenistan,Luxembourg,5,0,0,5
3077,2017,Togo,Luxembourg,5,5,0,10
3078,2017,Tunisia,Luxembourg,5,45,0,50
3079,2017,Türkiye,Luxembourg,24,30,0,54
3080,2017,Ukraine,Luxembourg,6,40,0,46
3081,2017,Yemen,Luxembourg,0,5,0,5
3082,2017,Stateless,Luxembourg,46,0,0,46
3083,2017,Unknown ,Luxembourg,0,10,0,10
3084,2017,Afghanistan,Latvia,58,8,0,66
3085,2017,Egypt,Latvia,5,0,0,5
3086,2017,Azerbaijan,Latvia,6,0,0,6
3087,2017,Belarus,Latvia,7,0,0,7
3088,2017,Eritrea,Latvia,30,0,0,30
3089,2017,Palestinian,Latvia,5,0,0,5
3090,2017,Iran (Islamic Rep. of),Latvia,23,0,0,23
3091,2017,Iraq,Latvia,34,0,0,34
3092,2017,Kazakhstan,Latvia,5,11,0,16
3093,2017,Kyrgyzstan,Latvia,10,0,0,10
3094,2017,Lebanon,Latvia,5,0,0,5
3095,2017,Sri Lanka,Latvia,5,0,0,5
3096,2017,Pakistan,Latvia,5,0,0,5
3097,2017,Russian Federation,Latvia,24,19,0,43
3098,2017,Somalia,Latvia,7,0,0,7
3099,2017,Viet Nam,Latvia,0,6,0,6
3100,2017,Syrian Arab Rep.,Latvia,393,0,0,393
3101,2017,Tajikistan,Latvia,5,5,0,10
3102,2017,Türkiye,Latvia,14,0,0,14
3103,2017,Uzbekistan,Latvia,12,5,0,17
3104,2017,Stateless,Latvia,0,0,0,0
3105,2017,India,"China, Macao SAR",0,5,0,5
3106,2017,Afghanistan,Madagascar,5,0,0,5
3107,2017,Dem. Rep. of the Congo,Madagascar,0,9,0,9
3108,2017,Pakistan,Madagascar,12,0,0,12
3109,2017,Somalia,Madagascar,0,5,0,5
3110,2017,Türkiye,Madagascar,0,20,0,20
3111,2017,Yemen,Madagascar,22,23,0,45
3112,2017,Afghanistan,Mauritania,0,7,0,7
3113,2017,Algeria,Mauritania,0,13,0,13
3114,2017,Egypt,Mauritania,0,5,0,5
3115,2017,Burundi,Mauritania,5,0,0,5
3116,2017,Benin,Mauritania,0,6,0,6
3117,2017,Central African Rep.,Mauritania,555,70,0,625
3118,2017,Chad,Mauritania,5,0,0,5
3119,2017,Cameroon,Mauritania,5,47,0,52
3120,2017,Congo,Mauritania,9,6,0,15
3121,2017,Dem. Rep. of the Congo,Mauritania,47,22,0,69
3122,2017,Ethiopia,Mauritania,6,0,0,6
3123,2017,Gabon,Mauritania,0,5,0,5
3124,2017,Gambia,Mauritania,0,5,0,5
3125,2017,Palestinian,Mauritania,40,26,0,66
3126,2017,Guinea,Mauritania,8,45,0,53
3127,2017,Cote d'Ivoire,Mauritania,269,64,0,333
3128,2017,Iraq,Mauritania,38,5,0,43
3129,2017,Libya,Mauritania,0,5,0,5
3130,2017,Lebanon,Mauritania,0,5,0,5
3131,2017,Mali,Mauritania,49829,29,0,49858
3132,2017,Nigeria,Mauritania,17,70,0,87
3133,2017,Senegal,Mauritania,70,54,0,124
3134,2017,Sierra Leone,Mauritania,0,21,0,21
3135,2017,Somalia,Mauritania,5,5,0,10
3136,2017,Sudan,Mauritania,12,26,0,38
3137,2017,South Sudan,Mauritania,0,5,0,5
3138,2017,Syrian Arab Rep.,Mauritania,464,112,0,576
3139,2017,Togo,Mauritania,30,17,0,47
3140,2017,Türkiye,Mauritania,0,71,0,71
3141,2017,Ukraine,Mauritania,5,0,0,5
3142,2017,Western Sahara,Mauritania,26000,0,0,26000
3143,2017,Yemen,Mauritania,5,0,0,5
3144,2017,Afghanistan,North Macedonia,5,0,0,5
3145,2017,Algeria,North Macedonia,0,5,0,5
3146,2017,Iraq,North Macedonia,0,5,0,5
3147,2017,Serbia and Kosovo: S/RES/1244 (1999),North Macedonia,394,0,0,394
3148,2017,Syrian Arab Rep.,North Macedonia,15,5,0,20
3149,2017,Türkiye,North Macedonia,0,11,0,11
3150,2017,Stateless,North Macedonia,0,0,0,0
3151,2017,Unknown ,Monaco,25,0,0,25
3152,2017,Afghanistan,Rep. of Moldova,18,7,0,25
3153,2017,Egypt,Rep. of Moldova,5,0,0,5
3154,2017,Armenia,Rep. of Moldova,19,0,0,19
3155,2017,Azerbaijan,Rep. of Moldova,5,0,0,5
3156,2017,Palestinian,Rep. of Moldova,5,0,0,5
3157,2017,Georgia,Rep. of Moldova,0,5,0,5
3158,2017,Iran (Islamic Rep. of),Rep. of Moldova,5,0,0,5
3159,2017,Iraq,Rep. of Moldova,24,0,0,24
3160,2017,Kyrgyzstan,Rep. of Moldova,11,5,0,16
3161,2017,Russian Federation,Rep. of Moldova,5,0,0,5
3162,2017,Sudan,Rep. of Moldova,9,0,0,9
3163,2017,Syrian Arab Rep.,Rep. of Moldova,204,18,0,222
3164,2017,Tajikistan,Rep. of Moldova,7,0,0,7
3165,2017,Türkiye,Rep. of Moldova,0,10,0,10
3166,2017,Ukraine,Rep. of Moldova,60,16,0,76
3167,2017,Uzbekistan,Rep. of Moldova,9,0,0,9
3168,2017,Yemen,Rep. of Moldova,5,0,0,5
3169,2017,Stateless,Rep. of Moldova,0,0,0,0
3170,2017,Afghanistan,Mexico,0,6,0,6
3171,2017,Albania,Mexico,8,8,0,16
3172,2017,Angola,Mexico,5,0,0,5
3173,2017,Egypt,Mexico,5,0,0,5
3174,2017,Bangladesh,Mexico,5,10,0,15
3175,2017,Belize,Mexico,0,5,0,5
3176,2017,Canada,Mexico,0,5,0,5
3177,2017,China,Mexico,5,5,0,10
3178,2017,Cameroon,Mexico,18,68,0,86
3179,2017,Congo,Mexico,19,10,0,29
3180,2017,Dem. Rep. of the Congo,Mexico,68,10,0,78
3181,2017,Colombia,Mexico,284,137,0,421
3182,2017,Costa Rica,Mexico,0,5,0,5
3183,2017,Cuba,Mexico,69,244,0,313
3184,2017,Dominican Rep.,Mexico,9,10,0,19
3185,2017,Ecuador,Mexico,0,18,0,18
3186,2017,Eritrea,Mexico,7,0,0,7
3187,2017,Ethiopia,Mexico,7,0,0,7
3188,2017,Palestinian,Mexico,5,0,0,5
3189,2017,Ghana,Mexico,7,38,0,45
3190,2017,Guatemala,Mexico,627,429,0,1056
3191,2017,Guinea,Mexico,0,10,0,10
3192,2017,Haiti,Mexico,179,429,0,608
3193,2017,Honduras,Mexico,2895,2983,0,5878
3194,2017,Cote d'Ivoire,Mexico,5,0,0,5
3195,2017,India,Mexico,11,114,0,125
3196,2017,Iran (Islamic Rep. of),Mexico,36,0,0,36
3197,2017,Iraq,Mexico,42,6,0,48
3198,2017,Italy,Mexico,0,5,0,5
3199,2017,Sri Lanka,Mexico,19,10,0,29
3200,2017,Myanmar,Mexico,0,5,0,5
3201,2017,Nepal,Mexico,0,5,0,5
3202,2017,Nicaragua,Mexico,28,57,0,85
3203,2017,Nigeria,Mexico,25,41,0,66
3204,2017,Pakistan,Mexico,7,9,0,16
3205,2017,Panama,Mexico,0,5,0,5
3206,2017,Peru,Mexico,11,0,0,11
3207,2017,Romania,Mexico,7,0,0,7
3208,2017,Russian Federation,Mexico,19,11,0,30
3209,2017,El Salvador,Mexico,3332,2418,0,5750
3210,2017,Sierra Leone,Mexico,0,5,0,5
3211,2017,Somalia,Mexico,0,12,0,12
3212,2017,Syrian Arab Rep.,Mexico,23,0,0,23
3213,2017,Togo,Mexico,0,5,0,5
3214,2017,Türkiye,Mexico,7,0,0,7
3215,2017,Uganda,Mexico,0,5,0,5
3216,2017,Ukraine,Mexico,9,0,0,9
3217,2017,Uruguay,Mexico,0,5,0,5
3218,2017,United States of America,Mexico,0,16,0,16
3219,2017,Uzbekistan,Mexico,0,5,0,5
3220,2017,Venezuela (Bolivarian Republic of),Mexico,1185,3183,0,4368
3221,2017,Yemen,Mexico,5,5,0,10
3222,2017,Stateless,Mexico,0,0,0,0
3223,2017,Burundi,Mali,7,5,0,12
3224,2017,Central African Rep.,Mali,809,458,0,1267
3225,2017,Congo,Mali,24,5,0,29
3226,2017,Dem. Rep. of the Congo,Mali,233,36,0,269
3227,2017,Cote d'Ivoire,Mali,614,44,0,658
3228,2017,Mauritania,Mali,15319,0,0,15319
3229,2017,Mali,Mali,0,0,38172,0
3230,2017,Pakistan,Mali,0,6,0,6
3231,2017,Rwanda,Mali,7,0,0,7
3232,2017,Syrian Arab Rep.,Mali,9,0,0,9
3233,2017,Togo,Mali,14,0,0,14
3234,2017,Afghanistan,Malaysia,389,798,0,1187
3235,2017,Algeria,Malaysia,0,5,0,5
3236,2017,Egypt,Malaysia,5,19,0,24
3237,2017,Bangladesh,Malaysia,27,15,0,42
3238,2017,Cambodia,Malaysia,71,0,0,71
3239,2017,Central African Rep.,Malaysia,0,6,0,6
3240,2017,China,Malaysia,15,15,0,30
3241,2017,Dem. Rep. of the Congo,Malaysia,0,6,0,6
3242,2017,Eritrea,Malaysia,5,11,0,16
3243,2017,Ethiopia,Malaysia,8,5,0,13
3244,2017,Palestinian,Malaysia,236,482,0,718
3245,2017,United Kingdom of Great Britain and Northern Ireland,Malaysia,5,0,0,5
3246,2017,Guinea,Malaysia,0,13,0,13
3247,2017,Cote d'Ivoire,Malaysia,5,0,0,5
3248,2017,India,Malaysia,0,7,0,7
3249,2017,Indonesia,Malaysia,883,15,0,898
3250,2017,Iran (Islamic Rep. of),Malaysia,187,200,0,387
3251,2017,Iraq,Malaysia,452,966,0,1418
3252,2017,Jordan,Malaysia,5,5,0,10
3253,2017,Liberia,Malaysia,10,13,0,23
3254,2017,Libya,Malaysia,0,25,0,25
3255,2017,Lebanon,Malaysia,5,0,0,5
3256,2017,Sri Lanka,Malaysia,974,1065,0,2039
3257,2017,Mali,Malaysia,5,11,0,16
3258,2017,Myanmar,Malaysia,98041,33656,0,131697
3259,2017,Nepal,Malaysia,10,0,0,10
3260,2017,Nigeria,Malaysia,5,13,0,18
3261,2017,Pakistan,Malaysia,1090,4269,0,5359
3262,2017,Philippines,Malaysia,20,0,0,20
3263,2017,Russian Federation,Malaysia,5,5,0,10
3264,2017,Sierra Leone,Malaysia,5,21,0,26
3265,2017,Somalia,Malaysia,816,1422,0,2238
3266,2017,Sudan,Malaysia,68,163,0,231
3267,2017,South Sudan,Malaysia,5,8,0,13
3268,2017,Syrian Arab Rep.,Malaysia,372,1937,0,2309
3269,2017,Thailand,Malaysia,24,5,0,29
3270,2017,Togo,Malaysia,0,5,0,5
3271,2017,Türkiye,Malaysia,0,6,0,6
3272,2017,United Arab Emirates,Malaysia,0,5,0,5
3273,2017,Uganda,Malaysia,0,11,0,11
3274,2017,United States of America,Malaysia,8,0,0,8
3275,2017,Uzbekistan,Malaysia,0,14,0,14
3276,2017,Yemen,Malaysia,76,2287,0,2363
3277,2017,Zimbabwe,Malaysia,5,0,0,5
3278,2017,Stateless,Malaysia,0,0,0,0
3279,2017,Burundi,Malawi,1649,5490,0,7139
3280,2017,Dem. Rep. of the Congo,Malawi,5334,13726,0,19060
3281,2017,Ethiopia,Malawi,5,29,0,34
3282,2017,Cote d'Ivoire,Malawi,0,5,0,5
3283,2017,Mozambique,Malawi,0,3367,0,3367
3284,2017,Rwanda,Malawi,1943,3307,0,5250
3285,2017,Somalia,Malawi,46,43,0,89
3286,2017,United Rep. of Tanzania,Malawi,0,5,0,5
3287,2017,Uganda,Malawi,0,8,0,8
3288,2017,Zimbabwe,Malawi,0,7,0,7
3289,2017,Afghanistan,Mongolia,5,0,0,5
3290,2017,China,Mongolia,0,5,0,5
3291,2017,Mongolia,Mongolia,0,0,0,0
3292,2017,Stateless,Mongolia,0,0,0,0
3293,2017,Afghanistan,Morocco,5,0,0,5
3294,2017,Algeria,Morocco,5,5,0,10
3295,2017,Egypt,Morocco,0,5,0,5
3296,2017,Benin,Morocco,0,5,0,5
3297,2017,Burkina Faso,Morocco,0,13,0,13
3298,2017,Central African Rep.,Morocco,243,56,0,299
3299,2017,Chad,Morocco,5,6,0,11
3300,2017,Cameroon,Morocco,79,535,0,614
3301,2017,Congo,Morocco,16,62,0,78
3302,2017,Dem. Rep. of the Congo,Morocco,178,140,0,318
3303,2017,Gambia,Morocco,5,7,0,12
3304,2017,Palestinian,Morocco,71,27,0,98
3305,2017,Guinea-Bissau,Morocco,0,9,0,9
3306,2017,Guinea,Morocco,31,503,0,534
3307,2017,Cote d'Ivoire,Morocco,311,262,0,573
3308,2017,Iraq,Morocco,150,9,0,159
3309,2017,Liberia,Morocco,5,25,0,30
3310,2017,Libya,Morocco,32,5,0,37
3311,2017,Lebanon,Morocco,0,17,0,17
3312,2017,Mauritania,Morocco,0,5,0,5
3313,2017,Mali,Morocco,16,79,0,95
3314,2017,Niger,Morocco,5,0,0,5
3315,2017,Nigeria,Morocco,9,63,0,72
3316,2017,Pakistan,Morocco,5,7,0,12
3317,2017,Senegal,Morocco,57,104,0,161
3318,2017,Sierra Leone,Morocco,0,38,0,38
3319,2017,Somalia,Morocco,0,5,0,5
3320,2017,Sudan,Morocco,5,10,0,15
3321,2017,Syrian Arab Rep.,Morocco,2953,0,0,2953
3322,2017,Togo,Morocco,0,9,0,9
3323,2017,Türkiye,Morocco,0,39,0,39
3324,2017,Yemen,Morocco,517,0,0,517
3325,2017,Burundi,Mozambique,982,6770,0,7752
3326,2017,Central African Rep.,Mozambique,0,5,0,5
3327,2017,Congo,Mozambique,12,14,0,26
3328,2017,Dem. Rep. of the Congo,Mozambique,2940,6859,0,9799
3329,2017,Ethiopia,Mozambique,5,8,0,13
3330,2017,Guinea,Mozambique,0,5,0,5
3331,2017,Cote d'Ivoire,Mozambique,0,15,0,15
3332,2017,Kenya,Mozambique,0,5,0,5
3333,2017,Mozambique,Mozambique,0,0,15128,0
3334,2017,Rwanda,Mozambique,766,2638,0,3404
3335,2017,Somalia,Mozambique,159,2444,0,2603
3336,2017,Sudan,Mozambique,5,17,0,22
3337,2017,Uganda,Mozambique,7,15,0,22
3338,2017,Afghanistan,Malta,0,6,0,6
3339,2017,Egypt,Malta,74,16,0,90
3340,2017,Bangladesh,Malta,8,0,0,8
3341,2017,Burkina Faso,Malta,0,5,0,5
3342,2017,Belarus,Malta,9,0,0,9
3343,2017,Chad,Malta,6,0,0,6
3344,2017,China,Malta,15,0,0,15
3345,2017,Cameroon,Malta,9,0,0,9
3346,2017,Dem. Rep. of the Congo,Malta,5,0,0,5
3347,2017,Eritrea,Malta,782,122,0,904
3348,2017,Ethiopia,Malta,161,32,0,193
3349,2017,Gambia,Malta,23,6,0,29
3350,2017,Palestinian,Malta,68,13,0,81
3351,2017,Georgia,Malta,5,10,0,15
3352,2017,Ghana,Malta,5,0,0,5
3353,2017,Cote d'Ivoire,Malta,10,11,0,21
3354,2017,Iran (Islamic Rep. of),Malta,28,5,0,33
3355,2017,Iraq,Malta,72,45,0,117
3356,2017,Jordan,Malta,5,0,0,5
3357,2017,Liberia,Malta,6,5,0,11
3358,2017,Libya,Malta,2459,257,0,2716
3359,2017,Sri Lanka,Malta,7,0,0,7
3360,2017,North Macedonia,Malta,5,7,0,12
3361,2017,Mali,Malta,17,5,0,22
3362,2017,Morocco,Malta,27,5,0,32
3363,2017,Nigeria,Malta,107,34,0,141
3364,2017,Pakistan,Malta,51,15,0,66
3365,2017,Russian Federation,Malta,12,5,0,17
3366,2017,Serbia and Kosovo: S/RES/1244 (1999),Malta,7,5,0,12
3367,2017,Senegal,Malta,5,0,0,5
3368,2017,Sierra Leone,Malta,5,5,0,10
3369,2017,Somalia,Malta,1730,337,0,2067
3370,2017,Sudan,Malta,187,22,0,209
3371,2017,South Sudan,Malta,22,0,0,22
3372,2017,Syrian Arab Rep.,Malta,1289,252,0,1541
3373,2017,Togo,Malta,5,5,0,10
3374,2017,Tunisia,Malta,12,5,0,17
3375,2017,Türkiye,Malta,5,15,0,20
3376,2017,Ukraine,Malta,120,68,0,188
3377,2017,Venezuela (Bolivarian Republic of),Malta,5,31,0,36
3378,2017,Stateless,Malta,11,0,0,11
3379,2017,Unknown ,Malta,615,0,0,615
3380,2017,Algeria,Montenegro,0,81,0,81
3381,2017,Belarus,Montenegro,5,0,0,5
3382,2017,Bosnia and Herzegovina,Montenegro,29,0,0,29
3383,2017,Cuba,Montenegro,7,5,0,12
3384,2017,Croatia,Montenegro,14,0,0,14
3385,2017,Iran (Islamic Rep. of),Montenegro,0,5,0,5
3386,2017,Morocco,Montenegro,0,23,0,23
3387,2017,Pakistan,Montenegro,0,7,0,7
3388,2017,Serbia and Kosovo: S/RES/1244 (1999),Montenegro,729,0,0,729
3389,2017,Syrian Arab Rep.,Montenegro,0,47,0,47
3390,2017,Tunisia,Montenegro,0,5,0,5
3391,2017,Yemen,Montenegro,10,0,0,10
3392,2017,Stateless,Montenegro,0,0,0,0
3393,2017,Unknown ,Montenegro,0,0,0,0
3394,2017,Syrian Arab Rep.,Mauritius,5,0,0,5
3395,2017,Myanmar,Myanmar,0,0,353108,0
3396,2017,Stateless,Myanmar,0,0,0,0
3397,2017,Burundi,Namibia,275,154,0,429
3398,2017,Cameroon,Namibia,6,5,0,11
3399,2017,Congo,Namibia,5,0,0,5
3400,2017,Dem. Rep. of the Congo,Namibia,1666,1565,0,3231
3401,2017,Ethiopia,Namibia,7,0,0,7
3402,2017,Kenya,Namibia,0,5,0,5
3403,2017,Nigeria,Namibia,0,9,0,9
3404,2017,Rwanda,Namibia,145,36,0,181
3405,2017,Somalia,Namibia,9,6,0,15
3406,2017,Sudan,Namibia,0,6,0,6
3407,2017,United Rep. of Tanzania,Namibia,0,5,0,5
3408,2017,Uganda,Namibia,5,10,0,15
3409,2017,Zimbabwe,Namibia,64,88,0,152
3410,2017,Afghanistan,Nepal,57,0,0,57
3411,2017,Bangladesh,Nepal,12,0,0,12
3412,2017,Bhutan,Nepal,7422,0,0,7422
3413,2017,India,Nepal,0,0,0,0
3414,2017,Iran (Islamic Rep. of),Nepal,5,0,0,5
3415,2017,Sri Lanka,Nepal,20,5,0,25
3416,2017,Myanmar,Nepal,190,124,0,314
3417,2017,Nepal,Nepal,0,0,0,0
3418,2017,Pakistan,Nepal,228,14,0,242
3419,2017,Somalia,Nepal,24,5,0,29
3420,2017,Tibetan,Nepal,13509,0,0,13509
3421,2017,Afghanistan,Netherlands,6205,413,0,6618
3422,2017,Albania,Netherlands,8,15,0,23
3423,2017,Algeria,Netherlands,18,192,0,210
3424,2017,Angola,Netherlands,58,5,0,63
3425,2017,Egypt,Netherlands,218,107,0,325
3426,2017,Argentina,Netherlands,5,0,0,5
3427,2017,Armenia,Netherlands,416,79,0,495
3428,2017,Azerbaijan,Netherlands,253,78,0,331
3429,2017,Bahrain,Netherlands,0,5,0,5
3430,2017,Burundi,Netherlands,236,30,0,266
3431,2017,Benin,Netherlands,6,0,0,6
3432,2017,Bangladesh,Netherlands,40,5,0,45
3433,2017,Bhutan,Netherlands,185,0,0,185
3434,2017,Burkina Faso,Netherlands,14,0,0,14
3435,2017,Belarus,Netherlands,61,52,0,113
3436,2017,Bosnia and Herzegovina,Netherlands,5,0,0,5
3437,2017,Cambodia,Netherlands,17,0,0,17
3438,2017,Central African Rep.,Netherlands,7,0,0,7
3439,2017,Chad,Netherlands,5,6,0,11
3440,2017,China,Netherlands,1153,54,0,1207
3441,2017,Cameroon,Netherlands,80,20,0,100
3442,2017,Congo,Netherlands,484,27,0,511
3443,2017,Dem. Rep. of the Congo,Netherlands,271,0,0,271
3444,2017,Colombia,Netherlands,45,14,0,59
3445,2017,Cuba,Netherlands,14,177,0,191
3446,2017,Ecuador,Netherlands,8,0,0,8
3447,2017,Eritrea,Netherlands,14713,295,0,15008
3448,2017,Ethiopia,Netherlands,597,70,0,667
3449,2017,Gambia,Netherlands,38,68,0,106
3450,2017,Palestinian,Netherlands,168,26,0,194
3451,2017,Georgia,Netherlands,44,36,0,80
3452,2017,Ghana,Netherlands,6,11,0,17
3453,2017,Guinea-Bissau,Netherlands,0,7,0,7
3454,2017,Guinea,Netherlands,719,102,0,821
3455,2017,Honduras,Netherlands,7,0,0,7
3456,2017,Cote d'Ivoire,Netherlands,314,13,0,327
3457,2017,India,Netherlands,6,5,0,11
3458,2017,Iran (Islamic Rep. of),Netherlands,4757,518,0,5275
3459,2017,Iraq,Netherlands,11369,398,0,11767
3460,2017,Jamaica,Netherlands,182,0,0,182
3461,2017,Jordan,Netherlands,18,11,0,29
3462,2017,Kazakhstan,Netherlands,41,0,0,41
3463,2017,Kenya,Netherlands,39,0,0,39
3464,2017,Kyrgyzstan,Netherlands,21,0,0,21
3465,2017,Dem. People's Rep. of Korea,Netherlands,48,0,0,48
3466,2017,Kuwait,Netherlands,5,0,0,5
3467,2017,Lao People's Dem. Rep.,Netherlands,33,0,0,33
3468,2017,Liberia,Netherlands,78,7,0,85
3469,2017,Libya,Netherlands,295,123,0,418
3470,2017,Lebanon,Netherlands,33,28,0,61
3471,2017,Sri Lanka,Netherlands,689,23,0,712
3472,2017,Mauritania,Netherlands,7,5,0,12
3473,2017,Rep. of Moldova,Netherlands,5,70,0,75
3474,2017,Mali,Netherlands,16,12,0,28
3475,2017,Malaysia,Netherlands,7,0,0,7
3476,2017,Malawi,Netherlands,5,0,0,5
3477,2017,Mongolia,Netherlands,40,0,0,40
3478,2017,Morocco,Netherlands,44,180,0,224
3479,2017,Myanmar,Netherlands,732,7,0,739
3480,2017,Namibia,Netherlands,5,0,0,5
3481,2017,Nepal,Netherlands,294,0,0,294
3482,2017,Niger,Netherlands,6,0,0,6
3483,2017,Nigeria,Netherlands,303,124,0,427
3484,2017,Pakistan,Netherlands,428,96,0,524
3485,2017,Peru,Netherlands,9,0,0,9
3486,2017,Russian Federation,Netherlands,274,99,0,373
3487,2017,Rwanda,Netherlands,67,0,0,67
3488,2017,Saudi Arabia,Netherlands,13,0,0,13
3489,2017,Serbia and Kosovo: S/RES/1244 (1999),Netherlands,30,0,0,30
3490,2017,Senegal,Netherlands,30,19,0,49
3491,2017,Sierra Leone,Netherlands,516,38,0,554
3492,2017,Somalia,Netherlands,15478,76,0,15554
3493,2017,Viet Nam,Netherlands,5,5,0,10
3494,2017,Sudan,Netherlands,790,116,0,906
3495,2017,Syrian Arab Rep.,Netherlands,30851,668,0,31519
3496,2017,United Rep. of Tanzania,Netherlands,6,0,0,6
3497,2017,Tajikistan,Netherlands,34,14,0,48
3498,2017,Turkmenistan,Netherlands,5,0,0,5
3499,2017,Togo,Netherlands,37,5,0,42
3500,2017,Trinidad and Tobago,Netherlands,56,18,0,74
3501,2017,Tunisia,Netherlands,18,30,0,48
3502,2017,Türkiye,Netherlands,520,295,0,815
3503,2017,Uganda,Netherlands,526,53,0,579
3504,2017,Ukraine,Netherlands,23,32,0,55
3505,2017,Uzbekistan,Netherlands,64,0,0,64
3506,2017,Venezuela (Bolivarian Republic of),Netherlands,0,46,0,46
3507,2017,Yemen,Netherlands,250,42,0,292
3508,2017,Zambia,Netherlands,8,0,0,8
3509,2017,Zimbabwe,Netherlands,36,0,0,36
3510,2017,Stateless,Netherlands,5423,34,0,5457
3511,2017,Unknown ,Netherlands,2850,714,0,3564
3512,2017,Central African Rep.,Niger,65,31,0,96
3513,2017,Chad,Niger,165,0,0,165
3514,2017,Cameroon,Niger,5,6,0,11
3515,2017,Congo,Niger,5,0,0,5
3516,2017,Dem. Rep. of the Congo,Niger,75,11,0,86
3517,2017,Eritrea,Niger,0,132,0,132
3518,2017,Ethiopia,Niger,0,5,0,5
3519,2017,Cote d'Ivoire,Niger,51,5,0,56
3520,2017,Iraq,Niger,6,0,0,6
3521,2017,Libya,Niger,6,7,0,13
3522,2017,Mali,Niger,56838,0,0,56838
3523,2017,Niger,Niger,0,0,129015,0
3524,2017,Nigeria,Niger,108470,10,0,108480
3525,2017,Rwanda,Niger,18,0,0,18
3526,2017,Somalia,Niger,9,66,0,75
3527,2017,Sudan,Niger,9,0,0,9
3528,2017,Syrian Arab Rep.,Niger,7,0,0,7
3529,2017,Togo,Niger,0,5,0,5
3530,2017,Colombia,Nicaragua,6,0,0,6
3531,2017,Cuba,Nicaragua,15,0,0,15
3532,2017,Guatemala,Nicaragua,10,5,0,15
3533,2017,Honduras,Nicaragua,74,48,0,122
3534,2017,El Salvador,Nicaragua,217,354,0,571
3535,2017,Afghanistan,Nigeria,5,0,0,5
3536,2017,Central African Rep.,Nigeria,403,186,0,589
3537,2017,Chad,Nigeria,87,21,0,108
3538,2017,Cameroon,Nigeria,95,8050,0,8145
3539,2017,Congo,Nigeria,5,5,0,10
3540,2017,Dem. Rep. of the Congo,Nigeria,599,216,0,815
3541,2017,Eritrea,Nigeria,25,9,0,34
3542,2017,Ethiopia,Nigeria,6,0,0,6
3543,2017,Palestinian,Nigeria,8,0,0,8
3544,2017,Ghana,Nigeria,5,8,0,13
3545,2017,Guinea-Bissau,Nigeria,5,0,0,5
3546,2017,Guinea,Nigeria,17,5,0,22
3547,2017,Cote d'Ivoire,Nigeria,122,18,0,140
3548,2017,Liberia,Nigeria,9,5,0,14
3549,2017,Lebanon,Nigeria,0,5,0,5
3550,2017,Mali,Nigeria,137,35,0,172
3551,2017,Nigeria,Nigeria,0,0,1704080,0
3552,2017,Sierra Leone,Nigeria,21,0,0,21
3553,2017,Sudan,Nigeria,48,5,0,53
3554,2017,Syrian Arab Rep.,Nigeria,154,60,0,214
3555,2017,Togo,Nigeria,20,22,0,42
3556,2017,Türkiye,Nigeria,139,0,0,139
3557,2017,Afghanistan,Norway,6490,616,0,7106
3558,2017,Albania,Norway,27,12,0,39
3559,2017,Algeria,Norway,12,0,0,12
3560,2017,Angola,Norway,35,0,0,35
3561,2017,Egypt,Norway,58,7,0,65
3562,2017,Azerbaijan,Norway,46,0,0,46
3563,2017,Burundi,Norway,74,5,0,79
3564,2017,Bangladesh,Norway,10,12,0,22
3565,2017,Bhutan,Norway,5,0,0,5
3566,2017,Burkina Faso,Norway,5,0,0,5
3567,2017,Belarus,Norway,6,0,0,6
3568,2017,Bosnia and Herzegovina,Norway,7,0,0,7
3569,2017,Bulgaria,Norway,13,0,0,13
3570,2017,Central African Rep.,Norway,7,0,0,7
3571,2017,Chad,Norway,5,0,0,5
3572,2017,China,Norway,607,10,0,617
3573,2017,Cameroon,Norway,26,5,0,31
3574,2017,Congo,Norway,7,0,0,7
3575,2017,Dem. Rep. of the Congo,Norway,212,15,0,227
3576,2017,Colombia,Norway,17,0,0,17
3577,2017,Cuba,Norway,7,5,0,12
3578,2017,Eritrea,Norway,15456,442,0,15898
3579,2017,Ethiopia,Norway,2125,224,0,2349
3580,2017,Gambia,Norway,15,0,0,15
3581,2017,Georgia,Norway,5,5,0,10
3582,2017,Ghana,Norway,8,0,0,8
3583,2017,Guinea-Bissau,Norway,5,0,0,5
3584,2017,Guatemala,Norway,7,0,0,7
3585,2017,Guinea,Norway,54,0,0,54
3586,2017,Honduras,Norway,5,0,0,5
3587,2017,Cote d'Ivoire,Norway,23,0,0,23
3588,2017,India,Norway,5,0,0,5
3589,2017,Iran (Islamic Rep. of),Norway,2036,310,0,2346
3590,2017,Iraq,Norway,2564,265,0,2829
3591,2017,Israel,Norway,11,0,0,11
3592,2017,Jordan,Norway,9,5,0,14
3593,2017,Kazakhstan,Norway,13,0,0,13
3594,2017,Kenya,Norway,9,0,0,9
3595,2017,Kyrgyzstan,Norway,19,0,0,19
3596,2017,Dem. People's Rep. of Korea,Norway,5,0,0,5
3597,2017,Kuwait,Norway,8,0,0,8
3598,2017,Liberia,Norway,16,0,0,16
3599,2017,Libya,Norway,62,6,0,68
3600,2017,Lebanon,Norway,34,10,0,44
3601,2017,Sri Lanka,Norway,218,14,0,232
3602,2017,Rep. of Moldova,Norway,5,5,0,10
3603,2017,Mali,Norway,8,0,0,8
3604,2017,Mongolia,Norway,5,7,0,12
3605,2017,Morocco,Norway,29,13,0,42
3606,2017,Montenegro,Norway,5,0,0,5
3607,2017,Myanmar,Norway,130,5,0,135
3608,2017,Nepal,Norway,10,0,0,10
3609,2017,Nigeria,Norway,178,33,0,211
3610,2017,Pakistan,Norway,99,18,0,117
3611,2017,Philippines,Norway,6,5,0,11
3612,2017,Romania,Norway,5,0,0,5
3613,2017,Russian Federation,Norway,998,19,0,1017
3614,2017,Rwanda,Norway,45,0,0,45
3615,2017,Saudi Arabia,Norway,5,5,0,10
3616,2017,Serbia and Kosovo: S/RES/1244 (1999),Norway,139,0,0,139
3617,2017,Sierra Leone,Norway,15,0,0,15
3618,2017,Somalia,Norway,7527,118,0,7645
3619,2017,Viet Nam,Norway,45,0,0,45
3620,2017,Sudan,Norway,1961,16,0,1977
3621,2017,South Sudan,Norway,13,5,0,18
3622,2017,Syrian Arab Rep.,Norway,13349,447,0,13796
3623,2017,United Rep. of Tanzania,Norway,5,0,0,5
3624,2017,Tajikistan,Norway,11,5,0,16
3625,2017,Turkmenistan,Norway,8,0,0,8
3626,2017,Togo,Norway,5,0,0,5
3627,2017,Tunisia,Norway,5,7,0,12
3628,2017,Türkiye,Norway,200,95,0,295
3629,2017,Uganda,Norway,119,5,0,124
3630,2017,Ukraine,Norway,9,0,0,9
3631,2017,United States of America,Norway,5,0,0,5
3632,2017,Uzbekistan,Norway,240,10,0,250
3633,2017,Venezuela (Bolivarian Republic of),Norway,0,10,0,10
3634,2017,Yemen,Norway,231,14,0,245
3635,2017,Zimbabwe,Norway,14,0,0,14
3636,2017,Stateless,Norway,3367,142,0,3509
3637,2017,Unknown ,Norway,46,0,0,46
3638,2017,Afghanistan,Nauru,81,0,0,81
3639,2017,Bangladesh,Nauru,9,33,0,42
3640,2017,India,Nauru,11,8,0,19
3641,2017,Indonesia,Nauru,5,0,0,5
3642,2017,Iran (Islamic Rep. of),Nauru,316,26,0,342
3643,2017,Iraq,Nauru,43,0,0,43
3644,2017,Kuwait,Nauru,5,0,0,5
3645,2017,Lebanon,Nauru,14,0,0,14
3646,2017,Sri Lanka,Nauru,101,28,0,129
3647,2017,Malaysia,Nauru,5,0,0,5
3648,2017,Myanmar,Nauru,115,0,0,115
3649,2017,Nepal,Nauru,5,9,0,14
3650,2017,Pakistan,Nauru,120,22,0,142
3651,2017,Somalia,Nauru,56,0,0,56
3652,2017,Sudan,Nauru,13,0,0,13
3653,2017,Stateless,Nauru,65,0,0,65
3654,2017,Afghanistan,New Zealand,42,20,0,62
3655,2017,Algeria,New Zealand,6,0,0,6
3656,2017,Egypt,New Zealand,28,5,0,33
3657,2017,Bahrain,New Zealand,24,0,0,24
3658,2017,Bangladesh,New Zealand,7,19,0,26
3659,2017,China,New Zealand,153,68,0,221
3660,2017,Chile,New Zealand,5,0,0,5
3661,2017,Cameroon,New Zealand,5,0,0,5
3662,2017,Congo,New Zealand,5,0,0,5
3663,2017,Dem. Rep. of the Congo,New Zealand,5,0,0,5
3664,2017,Colombia,New Zealand,24,6,0,30
3665,2017,Czechia,New Zealand,17,0,0,17
3666,2017,Eritrea,New Zealand,7,0,0,7
3667,2017,Ethiopia,New Zealand,9,7,0,16
3668,2017,Fiji,New Zealand,29,5,0,34
3669,2017,Palestinian,New Zealand,15,0,0,15
3670,2017,Hungary,New Zealand,8,0,0,8
3671,2017,India,New Zealand,6,25,0,31
3672,2017,Indonesia,New Zealand,5,0,0,5
3673,2017,Iran (Islamic Rep. of),New Zealand,159,11,0,170
3674,2017,Iraq,New Zealand,132,5,0,137
3675,2017,Jordan,New Zealand,8,9,0,17
3676,2017,Kuwait,New Zealand,7,0,0,7
3677,2017,Libya,New Zealand,22,0,0,22
3678,2017,Sri Lanka,New Zealand,81,16,0,97
3679,2017,Madagascar,New Zealand,5,0,0,5
3680,2017,Maldives,New Zealand,5,0,0,5
3681,2017,Mexico,New Zealand,5,0,0,5
3682,2017,Malaysia,New Zealand,5,5,0,10
3683,2017,Myanmar,New Zealand,12,5,0,17
3684,2017,Nepal,New Zealand,5,0,0,5
3685,2017,Pakistan,New Zealand,57,12,0,69
3686,2017,Philippines,New Zealand,0,7,0,7
3687,2017,Papua New Guinea,New Zealand,5,0,0,5
3688,2017,South Africa,New Zealand,10,0,0,10
3689,2017,Russian Federation,New Zealand,6,15,0,21
3690,2017,El Salvador,New Zealand,5,0,0,5
3691,2017,Saudi Arabia,New Zealand,59,5,0,64
3692,2017,Somalia,New Zealand,17,0,0,17
3693,2017,Viet Nam,New Zealand,8,0,0,8
3694,2017,Sudan,New Zealand,7,0,0,7
3695,2017,Syrian Arab Rep.,New Zealand,65,5,0,70
3696,2017,Türkiye,New Zealand,43,22,0,65
3697,2017,Uganda,New Zealand,5,0,0,5
3698,2017,Ukraine,New Zealand,0,5,0,5
3699,2017,Venezuela (Bolivarian Republic of),New Zealand,0,5,0,5
3700,2017,Yemen,New Zealand,5,0,0,5
3701,2017,Zimbabwe,New Zealand,32,0,0,32
3702,2017,Unknown ,New Zealand,295,109,0,404
3703,2017,Iraq,Oman,301,387,0,688
3704,2017,Sudan,Oman,0,5,0,5
3705,2017,Syrian Arab Rep.,Oman,7,6,0,13
3706,2017,Afghanistan,Pakistan,1392610,3241,0,1395851
3707,2017,Algeria,Pakistan,17,0,0,17
3708,2017,Palestinian,Pakistan,22,0,0,22
3709,2017,Iran (Islamic Rep. of),Pakistan,48,7,0,55
3710,2017,Iraq,Pakistan,21,7,0,28
3711,2017,Myanmar,Pakistan,21,0,0,21
3712,2017,Pakistan,Pakistan,0,0,174354,0
3713,2017,Russian Federation,Pakistan,7,0,0,7
3714,2017,Somalia,Pakistan,232,0,0,232
3715,2017,Syrian Arab Rep.,Pakistan,29,0,0,29
3716,2017,Tajikistan,Pakistan,6,0,0,6
3717,2017,Türkiye,Pakistan,6,224,0,230
3718,2017,Yemen,Pakistan,113,8,0,121
3719,2017,Afghanistan,Panama,5,6,0,11
3720,2017,Angola,Panama,0,7,0,7
3721,2017,Armenia,Panama,0,7,0,7
3722,2017,Bangladesh,Panama,0,18,0,18
3723,2017,Belarus,Panama,7,5,0,12
3724,2017,Brazil,Panama,0,5,0,5
3725,2017,Bosnia and Herzegovina,Panama,5,0,0,5
3726,2017,Cameroon,Panama,8,7,0,15
3727,2017,Dem. Rep. of the Congo,Panama,5,0,0,5
3728,2017,Colombia,Panama,1660,1506,0,3166
3729,2017,Cuba,Panama,120,89,0,209
3730,2017,Dominican Rep.,Panama,5,29,0,34
3731,2017,Ecuador,Panama,0,5,0,5
3732,2017,Eritrea,Panama,0,39,0,39
3733,2017,Guatemala,Panama,12,8,0,20
3734,2017,Haiti,Panama,19,0,0,19
3735,2017,Honduras,Panama,0,28,0,28
3736,2017,Croatia,Panama,5,0,0,5
3737,2017,Cote d'Ivoire,Panama,0,5,0,5
3738,2017,Iran (Islamic Rep. of),Panama,5,0,0,5
3739,2017,Italy,Panama,0,5,0,5
3740,2017,Jamaica,Panama,0,6,0,6
3741,2017,Kenya,Panama,0,7,0,7
3742,2017,Liberia,Panama,5,0,0,5
3743,2017,Mexico,Panama,5,0,0,5
3744,2017,Nepal,Panama,0,16,0,16
3745,2017,Nicaragua,Panama,173,630,0,803
3746,2017,Nigeria,Panama,10,36,0,46
3747,2017,Peru,Panama,23,5,0,28
3748,2017,El Salvador,Panama,302,1014,0,1316
3749,2017,Sierra Leone,Panama,5,0,0,5
3750,2017,Somalia,Panama,0,103,0,103
3751,2017,Sudan,Panama,5,0,0,5
3752,2017,Syrian Arab Rep.,Panama,0,11,0,11
3753,2017,Ukraine,Panama,0,5,0,5
3754,2017,Venezuela (Bolivarian Republic of),Panama,33,3687,0,3720
3755,2017,Bolivia (Plurinational State of),Paraguay,17,0,0,17
3756,2017,Colombia,Paraguay,35,0,0,35
3757,2017,Cuba,Paraguay,65,14,0,79
3758,2017,Iraq,Paraguay,6,0,0,6
3759,2017,Lebanon,Paraguay,0,5,0,5
3760,2017,Nigeria,Paraguay,0,5,0,5
3761,2017,Russian Federation,Paraguay,8,0,0,8
3762,2017,El Salvador,Paraguay,0,6,0,6
3763,2017,Viet Nam,Paraguay,6,0,0,6
3764,2017,Syrian Arab Rep.,Paraguay,53,26,0,79
3765,2017,Türkiye,Paraguay,5,0,0,5
3766,2017,Venezuela (Bolivarian Republic of),Paraguay,5,13,0,18
3767,2017,Bangladesh,Peru,20,8,0,28
3768,2017,Bolivia (Plurinational State of),Peru,9,5,0,14
3769,2017,Bosnia and Herzegovina,Peru,5,0,0,5
3770,2017,China,Peru,0,7,0,7
3771,2017,Cameroon,Peru,5,5,0,10
3772,2017,Congo,Peru,0,5,0,5
3773,2017,Dem. Rep. of the Congo,Peru,5,0,0,5
3774,2017,Colombia,Peru,604,376,0,980
3775,2017,Cuba,Peru,577,962,0,1539
3776,2017,Dominican Rep.,Peru,13,10,0,23
3777,2017,Ecuador,Peru,5,26,0,31
3778,2017,Ethiopia,Peru,5,0,0,5
3779,2017,Gambia,Peru,5,0,0,5
3780,2017,Palestinian,Peru,35,10,0,45
3781,2017,Ghana,Peru,5,6,0,11
3782,2017,Haiti,Peru,48,92,0,140
3783,2017,Hungary,Peru,6,0,0,6
3784,2017,India,Peru,6,0,0,6
3785,2017,Iran (Islamic Rep. of),Peru,10,5,0,15
3786,2017,Iraq,Peru,17,0,0,17
3787,2017,Sri Lanka,Peru,0,7,0,7
3788,2017,Nepal,Peru,0,5,0,5
3789,2017,Nigeria,Peru,16,9,0,25
3790,2017,Pakistan,Peru,0,13,0,13
3791,2017,Panama,Peru,0,5,0,5
3792,2017,Philippines,Peru,0,17,0,17
3793,2017,Poland,Peru,5,0,0,5
3794,2017,Portugal,Peru,0,5,0,5
3795,2017,Russian Federation,Peru,16,0,0,16
3796,2017,El Salvador,Peru,5,5,0,10
3797,2017,Serbia and Kosovo: S/RES/1244 (1999),Peru,64,0,0,64
3798,2017,Senegal,Peru,0,5,0,5
3799,2017,Spain,Peru,0,5,0,5
3800,2017,Syrian Arab Rep.,Peru,38,5,0,43
3801,2017,Türkiye,Peru,0,63,0,63
3802,2017,Ukraine,Peru,15,0,0,15
3803,2017,Venezuela (Bolivarian Republic of),Peru,249,36062,0,36311
3804,2017,Stateless,Peru,0,5,0,5
3805,2017,Afghanistan,Philippines,13,5,0,18
3806,2017,Burundi,Philippines,10,0,0,10
3807,2017,Bangladesh,Philippines,0,5,0,5
3808,2017,Cambodia,Philippines,5,12,0,17
3809,2017,China,Philippines,5,5,0,10
3810,2017,Cameroon,Philippines,0,14,0,14
3811,2017,Congo,Philippines,0,6,0,6
3812,2017,Dem. Rep. of the Congo,Philippines,5,0,0,5
3813,2017,Eritrea,Philippines,16,0,0,16
3814,2017,Ethiopia,Philippines,5,0,0,5
3815,2017,Palestinian,Philippines,48,9,0,57
3816,2017,Cote d'Ivoire,Philippines,18,15,0,33
3817,2017,Iran (Islamic Rep. of),Philippines,66,9,0,75
3818,2017,Iraq,Philippines,46,7,0,53
3819,2017,Liberia,Philippines,5,0,0,5
3820,2017,Lebanon,Philippines,0,5,0,5
3821,2017,Sri Lanka,Philippines,20,0,0,20
3822,2017,Myanmar,Philippines,10,0,0,10
3823,2017,Nigeria,Philippines,5,10,0,15
3824,2017,Pakistan,Philippines,77,25,0,102
3825,2017,Philippines,Philippines,0,0,311943,0
3826,2017,Rwanda,Philippines,19,0,0,19
3827,2017,Saudi Arabia,Philippines,5,5,0,10
3828,2017,Somalia,Philippines,25,6,0,31
3829,2017,Viet Nam,Philippines,15,0,0,15
3830,2017,Sudan,Philippines,5,5,0,10
3831,2017,Syrian Arab Rep.,Philippines,74,40,0,114
3832,2017,Türkiye,Philippines,10,11,0,21
3833,2017,Yemen,Philippines,0,10,0,10
3834,2017,Stateless,Philippines,5,0,0,5
3835,2017,Unknown ,Philippines,0,6,0,6
3836,2017,Afghanistan,Papua New Guinea,117,0,0,117
3837,2017,Bangladesh,Papua New Guinea,20,0,0,20
3838,2017,Indonesia,Papua New Guinea,9368,0,0,9368
3839,2017,Iran (Islamic Rep. of),Papua New Guinea,156,0,0,156
3840,2017,Iraq,Papua New Guinea,47,0,0,47
3841,2017,Sri Lanka,Papua New Guinea,21,0,0,21
3842,2017,Pakistan,Papua New Guinea,96,0,0,96
3843,2017,Somalia,Papua New Guinea,39,0,0,39
3844,2017,Sudan,Papua New Guinea,75,0,0,75
3845,2017,Stateless,Papua New Guinea,79,0,0,79
3846,2017,Afghanistan,Poland,99,7,0,106
3847,2017,Algeria,Poland,5,5,0,10
3848,2017,Egypt,Poland,56,5,0,61
3849,2017,Armenia,Poland,78,29,0,107
3850,2017,Azerbaijan,Poland,0,5,0,5
3851,2017,Bangladesh,Poland,7,0,0,7
3852,2017,Belarus,Poland,187,31,0,218
3853,2017,Central African Rep.,Poland,5,0,0,5
3854,2017,China,Poland,18,0,0,18
3855,2017,Cameroon,Poland,10,0,0,10
3856,2017,Congo,Poland,6,0,0,6
3857,2017,Dem. Rep. of the Congo,Poland,5,0,0,5
3858,2017,Cuba,Poland,17,0,0,17
3859,2017,Eritrea,Poland,30,0,0,30
3860,2017,Palestinian,Poland,16,0,0,16
3861,2017,Georgia,Poland,72,91,0,163
3862,2017,India,Poland,5,6,0,11
3863,2017,Iran (Islamic Rep. of),Poland,26,7,0,33
3864,2017,Iraq,Poland,229,13,0,242
3865,2017,Kazakhstan,Poland,52,10,0,62
3866,2017,Kenya,Poland,5,0,0,5
3867,2017,Kyrgyzstan,Poland,45,27,0,72
3868,2017,Libya,Poland,22,5,0,27
3869,2017,Sri Lanka,Poland,49,0,0,49
3870,2017,Rep. of Moldova,Poland,5,6,0,11
3871,2017,Mongolia,Poland,19,0,0,19
3872,2017,Nepal,Poland,7,0,0,7
3873,2017,Nigeria,Poland,10,5,0,15
3874,2017,Pakistan,Poland,18,20,0,38
3875,2017,Russian Federation,Poland,9950,2118,0,12068
3876,2017,Rwanda,Poland,5,0,0,5
3877,2017,Serbia and Kosovo: S/RES/1244 (1999),Poland,5,0,0,5
3878,2017,Senegal,Poland,5,0,0,5
3879,2017,Somalia,Poland,46,0,0,46
3880,2017,Viet Nam,Poland,15,13,0,28
3881,2017,Sudan,Poland,5,0,0,5
3882,2017,Syrian Arab Rep.,Poland,512,18,0,530
3883,2017,Tajikistan,Poland,49,82,0,131
3884,2017,Turkmenistan,Poland,32,0,0,32
3885,2017,Türkiye,Poland,17,28,0,45
3886,2017,Uganda,Poland,6,0,0,6
3887,2017,Ukraine,Poland,369,333,0,702
3888,2017,Uzbekistan,Poland,14,6,0,20
3889,2017,Yemen,Poland,5,0,0,5
3890,2017,Stateless,Poland,87,8,0,95
3891,2017,Afghanistan,Portugal,18,0,0,18
3892,2017,Angola,Portugal,0,15,0,15
3893,2017,Armenia,Portugal,5,0,0,5
3894,2017,Bangladesh,Portugal,5,0,0,5
3895,2017,Belarus,Portugal,17,0,0,17
3896,2017,Bosnia and Herzegovina,Portugal,11,0,0,11
3897,2017,Central African Rep.,Portugal,8,0,0,8
3898,2017,Cameroon,Portugal,13,0,0,13
3899,2017,Congo,Portugal,7,0,0,7
3900,2017,Dem. Rep. of the Congo,Portugal,63,5,0,68
3901,2017,Colombia,Portugal,71,0,0,71
3902,2017,Cuba,Portugal,6,0,0,6
3903,2017,Eritrea,Portugal,140,0,0,140
3904,2017,Gambia,Portugal,5,0,0,5
3905,2017,Palestinian,Portugal,5,0,0,5
3906,2017,Georgia,Portugal,5,0,0,5
3907,2017,Ghana,Portugal,5,0,0,5
3908,2017,Guinea-Bissau,Portugal,13,0,0,13
3909,2017,Guinea,Portugal,103,15,0,118
3910,2017,Cote d'Ivoire,Portugal,33,0,0,33
3911,2017,Iran (Islamic Rep. of),Portugal,38,0,0,38
3912,2017,Iraq,Portugal,57,0,0,57
3913,2017,Kenya,Portugal,6,0,0,6
3914,2017,Libya,Portugal,14,0,0,14
3915,2017,Sri Lanka,Portugal,48,0,0,48
3916,2017,Mauritania,Portugal,5,0,0,5
3917,2017,Mali,Portugal,13,0,0,13
3918,2017,Morocco,Portugal,9,0,0,9
3919,2017,Nigeria,Portugal,27,0,0,27
3920,2017,Pakistan,Portugal,60,0,0,60
3921,2017,Russian Federation,Portugal,18,5,0,23
3922,2017,Rwanda,Portugal,5,0,0,5
3923,2017,Senegal,Portugal,7,0,0,7
3924,2017,Sierra Leone,Portugal,27,5,0,32
3925,2017,Somalia,Portugal,51,0,0,51
3926,2017,Sudan,Portugal,5,0,0,5
3927,2017,Syrian Arab Rep.,Portugal,307,0,0,307
3928,2017,Togo,Portugal,6,0,0,6
3929,2017,Türkiye,Portugal,5,0,0,5
3930,2017,Uganda,Portugal,5,0,0,5
3931,2017,Ukraine,Portugal,373,0,0,373
3932,2017,Stateless,Portugal,0,0,0,0
3933,2017,Egypt,Qatar,9,0,0,9
3934,2017,Eritrea,Qatar,0,5,0,5
3935,2017,Iraq,Qatar,137,103,0,240
3936,2017,Somalia,Qatar,8,0,0,8
3937,2017,Sudan,Qatar,0,15,0,15
3938,2017,Syrian Arab Rep.,Qatar,34,0,0,34
3939,2017,Stateless,Qatar,0,0,0,0
3940,2017,Afghanistan,Romania,152,111,0,263
3941,2017,Algeria,Romania,5,0,0,5
3942,2017,Angola,Romania,5,0,0,5
3943,2017,Egypt,Romania,19,0,0,19
3944,2017,Burundi,Romania,6,0,0,6
3945,2017,Bangladesh,Romania,5,5,0,10
3946,2017,Central African Rep.,Romania,10,0,0,10
3947,2017,China,Romania,0,5,0,5
3948,2017,Cameroon,Romania,24,0,0,24
3949,2017,Congo,Romania,7,0,0,7
3950,2017,Dem. Rep. of the Congo,Romania,23,5,0,28
3951,2017,Cuba,Romania,0,5,0,5
3952,2017,Eritrea,Romania,53,0,0,53
3953,2017,Ethiopia,Romania,5,0,0,5
3954,2017,Gambia,Romania,5,0,0,5
3955,2017,Palestinian,Romania,42,16,0,58
3956,2017,Georgia,Romania,5,0,0,5
3957,2017,Guinea,Romania,7,0,0,7
3958,2017,Cote d'Ivoire,Romania,5,0,0,5
3959,2017,India,Romania,0,10,0,10
3960,2017,Iran (Islamic Rep. of),Romania,66,89,0,155
3961,2017,Iraq,Romania,806,994,0,1800
3962,2017,Jordan,Romania,7,0,0,7
3963,2017,Liberia,Romania,5,0,0,5
3964,2017,Libya,Romania,6,0,0,6
3965,2017,Lebanon,Romania,6,0,0,6
3966,2017,Sri Lanka,Romania,0,7,0,7
3967,2017,Myanmar,Romania,29,0,0,29
3968,2017,Nigeria,Romania,5,0,0,5
3969,2017,Pakistan,Romania,40,46,0,86
3970,2017,Rwanda,Romania,8,0,0,8
3971,2017,Serbia and Kosovo: S/RES/1244 (1999),Romania,0,5,0,5
3972,2017,Sierra Leone,Romania,5,0,0,5
3973,2017,Somalia,Romania,43,11,0,54
3974,2017,Sudan,Romania,15,0,0,15
3975,2017,Syrian Arab Rep.,Romania,2282,167,0,2449
3976,2017,Türkiye,Romania,25,27,0,52
3977,2017,Ukraine,Romania,37,5,0,42
3978,2017,Yemen,Romania,27,0,0,27
3979,2017,Zimbabwe,Romania,8,0,0,8
3980,2017,Stateless,Romania,113,6,0,119
3981,2017,Algeria,South Africa,0,12,0,12
3982,2017,Angola,South Africa,25,0,0,25
3983,2017,Burundi,South Africa,3000,5865,0,8865
3984,2017,Bangladesh,South Africa,319,26366,0,26685
3985,2017,China,South Africa,0,171,0,171
3986,2017,Cameroon,South Africa,392,1691,0,2083
3987,2017,Congo,South Africa,5261,8800,0,14061
3988,2017,Dem. Rep. of the Congo,South Africa,26043,32537,0,58580
3989,2017,Eritrea,South Africa,1924,704,0,2628
3990,2017,Ethiopia,South Africa,17562,49487,0,67049
3991,2017,Palestinian,South Africa,38,0,0,38
3992,2017,Ghana,South Africa,0,2601,0,2601
3993,2017,Cote d'Ivoire,South Africa,41,0,0,41
3994,2017,India,South Africa,0,4459,0,4459
3995,2017,Kenya,South Africa,155,1097,0,1252
3996,2017,Liberia,South Africa,60,0,0,60
3997,2017,Malawi,South Africa,0,2761,0,2761
3998,2017,Mozambique,South Africa,0,987,0,987
3999,2017,Niger,South Africa,0,894,0,894
4000,2017,Nigeria,South Africa,0,8877,0,8877
4001,2017,Pakistan,South Africa,0,9993,0,9993
4002,2017,Rwanda,South Africa,1295,902,0,2197
4003,2017,Senegal,South Africa,0,834,0,834
4004,2017,Somalia,South Africa,26977,4014,0,30991
4005,2017,Sudan,South Africa,112,0,0,112
4006,2017,Syrian Arab Rep.,South Africa,45,0,0,45
4007,2017,United Rep. of Tanzania,South Africa,37,664,0,701
4008,2017,Uganda,South Africa,549,4586,0,5135
4009,2017,Zambia,South Africa,64,0,0,64
4010,2017,Zimbabwe,South Africa,4558,19290,0,23848
4011,2017,Unknown ,South Africa,237,3741,0,3978
4012,2017,Afghanistan,Russian Federation,661,167,0,828
4013,2017,Azerbaijan,Russian Federation,15,5,0,20
4014,2017,Bangladesh,Russian Federation,5,0,0,5
4015,2017,Belarus,Russian Federation,0,9,0,9
4016,2017,Bosnia and Herzegovina,Russian Federation,5,0,0,5
4017,2017,Dem. Rep. of the Congo,Russian Federation,5,6,0,11
4018,2017,Palestinian,Russian Federation,9,0,0,9
4019,2017,Georgia,Russian Federation,198,12,0,210
4020,2017,Germany,Russian Federation,10,5,0,15
4021,2017,Cote d'Ivoire,Russian Federation,5,5,0,10
4022,2017,Iran (Islamic Rep. of),Russian Federation,6,0,0,6
4023,2017,Iraq,Russian Federation,24,8,0,32
4024,2017,Kazakhstan,Russian Federation,5,6,0,11
4025,2017,Kyrgyzstan,Russian Federation,25,10,0,35
4026,2017,Dem. People's Rep. of Korea,Russian Federation,77,10,0,87
4027,2017,Lebanon,Russian Federation,6,0,0,6
4028,2017,Lithuania,Russian Federation,5,0,0,5
4029,2017,Latvia,Russian Federation,5,0,0,5
4030,2017,Rep. of Moldova,Russian Federation,21,7,0,28
4031,2017,Nigeria,Russian Federation,5,0,0,5
4032,2017,Pakistan,Russian Federation,5,5,0,10
4033,2017,Sudan,Russian Federation,6,5,0,11
4034,2017,Syrian Arab Rep.,Russian Federation,1130,303,0,1433
4035,2017,Tajikistan,Russian Federation,23,15,0,38
4036,2017,Turkmenistan,Russian Federation,5,5,0,10
4037,2017,Türkiye,Russian Federation,5,0,0,5
4038,2017,Ukraine,Russian Federation,123600,1512,0,125112
4039,2017,United States of America,Russian Federation,5,0,0,5
4040,2017,Uzbekistan,Russian Federation,79,32,0,111
4041,2017,Yemen,Russian Federation,54,24,0,78
4042,2017,Stateless,Russian Federation,17,5,0,22
4043,2017,Unknown ,Russian Federation,0,12,0,12
4044,2017,Angola,Rwanda,5,0,0,5
4045,2017,Burundi,Rwanda,88209,116,0,88325
4046,2017,Chad,Rwanda,7,0,0,7
4047,2017,Dem. Rep. of the Congo,Rwanda,82750,314,0,83064
4048,2017,Eritrea,Rwanda,5,8,0,13
4049,2017,Ethiopia,Rwanda,5,0,0,5
4050,2017,Rwanda,Rwanda,0,0,0,0
4051,2017,Somalia,Rwanda,5,0,0,5
4052,2017,Uganda,Rwanda,5,0,0,5
4053,2017,Colombia,El Salvador,5,0,0,5
4054,2017,Honduras,El Salvador,14,5,0,19
4055,2017,Iraq,El Salvador,5,0,0,5
4056,2017,Mexico,El Salvador,5,0,0,5
4057,2017,Nicaragua,El Salvador,6,0,0,6
4058,2017,El Salvador,El Salvador,0,0,71500,0
4059,2017,Syrian Arab Rep.,El Salvador,5,0,0,5
4060,2017,Chad,Saudi Arabia,9,0,0,9
4061,2017,China,Saudi Arabia,14,5,0,19
4062,2017,Eritrea,Saudi Arabia,32,5,0,37
4063,2017,Palestinian,Saudi Arabia,9,0,0,9
4064,2017,Iraq,Saudi Arabia,32,28,0,60
4065,2017,Liberia,Saudi Arabia,7,0,0,7
4066,2017,Somalia,Saudi Arabia,16,0,0,16
4067,2017,Sudan,Saudi Arabia,5,5,0,10
4068,2017,Syrian Arab Rep.,Saudi Arabia,14,34,0,48
4069,2017,Tunisia,Saudi Arabia,6,0,0,6
4070,2017,Yemen,Saudi Arabia,9,5,0,14
4071,2017,Stateless,Saudi Arabia,0,0,0,0
4072,2017,Afghanistan,Serbia and Kosovo: S/RES/1244 (1999),2182,49,0,2231
4073,2017,Bosnia and Herzegovina,Serbia and Kosovo: S/RES/1244 (1999),8765,0,0,8765
4074,2017,Congo,Serbia and Kosovo: S/RES/1244 (1999),0,7,0,7
4075,2017,Cuba,Serbia and Kosovo: S/RES/1244 (1999),5,5,0,10
4076,2017,Ethiopia,Serbia and Kosovo: S/RES/1244 (1999),5,0,0,5
4077,2017,Ghana,Serbia and Kosovo: S/RES/1244 (1999),0,5,0,5
4078,2017,Croatia,Serbia and Kosovo: S/RES/1244 (1999),19043,0,0,19043
4079,2017,Iran (Islamic Rep. of),Serbia and Kosovo: S/RES/1244 (1999),376,16,0,392
4080,2017,Iraq,Serbia and Kosovo: S/RES/1244 (1999),513,0,0,513
4081,2017,Libya,Serbia and Kosovo: S/RES/1244 (1999),32,0,0,32
4082,2017,Nigeria,Serbia and Kosovo: S/RES/1244 (1999),0,11,0,11
4083,2017,Pakistan,Serbia and Kosovo: S/RES/1244 (1999),0,19,0,19
4084,2017,Serbia and Kosovo: S/RES/1244 (1999),Serbia and Kosovo: S/RES/1244 (1999),0,0,217453,0
4085,2017,Somalia,Serbia and Kosovo: S/RES/1244 (1999),5,17,0,22
4086,2017,Sudan,Serbia and Kosovo: S/RES/1244 (1999),5,0,0,5
4087,2017,Syrian Arab Rep.,Serbia and Kosovo: S/RES/1244 (1999),73,0,0,73
4088,2017,Türkiye,Serbia and Kosovo: S/RES/1244 (1999),0,7,0,7
4089,2017,Ukraine,Serbia and Kosovo: S/RES/1244 (1999),15,0,0,15
4090,2017,Stateless,Serbia and Kosovo: S/RES/1244 (1999),0,0,0,0
4091,2017,Unknown ,Serbia and Kosovo: S/RES/1244 (1999),1186,5,0,1191
4092,2017,Algeria,Senegal,9,10,0,19
4093,2017,Angola,Senegal,0,12,0,12
4094,2017,Burundi,Senegal,55,25,0,80
4095,2017,Benin,Senegal,0,6,0,6
4096,2017,Burkina Faso,Senegal,0,5,0,5
4097,2017,Central African Rep.,Senegal,289,441,0,730
4098,2017,Chad,Senegal,18,55,0,73
4099,2017,Cameroon,Senegal,12,42,0,54
4100,2017,Congo,Senegal,19,275,0,294
4101,2017,Dem. Rep. of the Congo,Senegal,30,336,0,366
4102,2017,Ethiopia,Senegal,0,5,0,5
4103,2017,France,Senegal,0,5,0,5
4104,2017,Gambia,Senegal,44,342,0,386
4105,2017,Ghana,Senegal,0,32,0,32
4106,2017,Guinea-Bissau,Senegal,0,93,0,93
4107,2017,Guinea,Senegal,10,113,0,123
4108,2017,Haiti,Senegal,0,5,0,5
4109,2017,Cote d'Ivoire,Senegal,39,310,0,349
4110,2017,India,Senegal,0,5,0,5
4111,2017,Liberia,Senegal,61,391,0,452
4112,2017,Sri Lanka,Senegal,0,87,0,87
4113,2017,Mauritania,Senegal,13779,99,0,13878
4114,2017,Mali,Senegal,0,52,0,52
4115,2017,Niger,Senegal,0,5,0,5
4116,2017,Nigeria,Senegal,7,364,0,371
4117,2017,Rwanda,Senegal,274,11,0,285
4118,2017,Sierra Leone,Senegal,0,31,0,31
4119,2017,Somalia,Senegal,0,8,0,8
4120,2017,Syrian Arab Rep.,Senegal,0,21,0,21
4121,2017,United Rep. of Tanzania,Senegal,0,6,0,6
4122,2017,Togo,Senegal,0,88,0,88
4123,2017,Türkiye,Senegal,0,88,0,88
4124,2017,Cote d'Ivoire,Sierra Leone,17,0,0,17
4125,2017,Liberia,Sierra Leone,653,0,0,653
4126,2017,Sudan,Sierra Leone,8,0,0,8
4127,2017,Egypt,Somalia,0,16,0,16
4128,2017,Bangladesh,Somalia,6,0,0,6
4129,2017,Cameroon,Somalia,0,5,0,5
4130,2017,Dem. Rep. of the Congo,Somalia,0,5,0,5
4131,2017,Djibouti,Somalia,0,13,0,13
4132,2017,Eritrea,Somalia,49,37,0,86
4133,2017,Ethiopia,Somalia,3608,14456,0,18064
4134,2017,Palestinian,Somalia,15,0,0,15
4135,2017,Iraq,Somalia,5,0,0,5
4136,2017,Mozambique,Somalia,0,5,0,5
4137,2017,Nigeria,Somalia,0,5,0,5
4138,2017,Pakistan,Somalia,0,5,0,5
4139,2017,Somalia,Somalia,0,0,2116705,0
4140,2017,Sudan,Somalia,5,12,0,17
4141,2017,Syrian Arab Rep.,Somalia,172,5,0,177
4142,2017,United Rep. of Tanzania,Somalia,0,71,0,71
4143,2017,Yemen,Somalia,10705,71,0,10776
4144,2017,Afghanistan,Spain,287,148,0,435
4145,2017,Albania,Spain,0,47,0,47
4146,2017,Algeria,Spain,46,484,0,530
4147,2017,Angola,Spain,10,21,0,31
4148,2017,Egypt,Spain,14,21,0,35
4149,2017,Argentina,Spain,0,11,0,11
4150,2017,Armenia,Spain,23,173,0,196
4151,2017,Azerbaijan,Spain,32,36,0,68
4152,2017,Burundi,Spain,5,0,0,5
4153,2017,Benin,Spain,5,7,0,12
4154,2017,Bangladesh,Spain,20,167,0,187
4155,2017,Burkina Faso,Spain,0,20,0,20
4156,2017,Belarus,Spain,15,25,0,40
4157,2017,Bolivia (Plurinational State of),Spain,9,11,0,20
4158,2017,Brazil,Spain,0,47,0,47
4159,2017,Bosnia and Herzegovina,Spain,0,5,0,5
4160,2017,Bulgaria,Spain,0,5,0,5
4161,2017,Central African Rep.,Spain,42,148,0,190
4162,2017,China,Spain,21,402,0,423
4163,2017,Chile,Spain,0,14,0,14
4164,2017,Cameroon,Spain,47,839,0,886
4165,2017,Congo,Spain,10,211,0,221
4166,2017,Dem. Rep. of the Congo,Spain,74,248,0,322
4167,2017,Colombia,Spain,179,2483,0,2662
4168,2017,Costa Rica,Spain,0,13,0,13
4169,2017,Cuba,Spain,894,191,0,1085
4170,2017,Dominican Rep.,Spain,0,184,0,184
4171,2017,Ecuador,Spain,0,20,0,20
4172,2017,Equatorial Guinea,Spain,32,42,0,74
4173,2017,Eritrea,Spain,213,53,0,266
4174,2017,Ethiopia,Spain,60,12,0,72
4175,2017,Gabon,Spain,0,5,0,5
4176,2017,Gambia,Spain,12,140,0,152
4177,2017,Palestinian,Spain,862,1315,0,2177
4178,2017,Georgia,Spain,7,254,0,261
4179,2017,Ghana,Spain,0,52,0,52
4180,2017,Guinea-Bissau,Spain,0,16,0,16
4181,2017,Guatemala,Spain,12,87,0,99
4182,2017,Guinea,Spain,6,469,0,475
4183,2017,Haiti,Spain,21,5,0,26
4184,2017,Honduras,Spain,35,1373,0,1408
4185,2017,Cote d'Ivoire,Spain,193,402,0,595
4186,2017,India,Spain,6,40,0,46
4187,2017,Iran (Islamic Rep. of),Spain,88,63,0,151
4188,2017,Iraq,Spain,319,197,0,516
4189,2017,Jamaica,Spain,0,15,0,15
4190,2017,Jordan,Spain,29,15,0,44
4191,2017,Kazakhstan,Spain,10,10,0,20
4192,2017,Kenya,Spain,0,6,0,6
4193,2017,Kyrgyzstan,Spain,6,11,0,17
4194,2017,Liberia,Spain,6,16,0,22
4195,2017,Libya,Spain,24,50,0,74
4196,2017,Lebanon,Spain,25,109,0,134
4197,2017,Sri Lanka,Spain,100,51,0,151
4198,2017,Mauritania,Spain,0,37,0,37
4199,2017,North Macedonia,Spain,0,8,0,8
4200,2017,Rep. of Moldova,Spain,0,21,0,21
4201,2017,Mexico,Spain,16,56,0,72
4202,2017,Mali,Spain,30,211,0,241
4203,2017,Mongolia,Spain,0,8,0,8
4204,2017,Morocco,Spain,112,402,0,514
4205,2017,Mozambique,Spain,0,5,0,5
4206,2017,Myanmar,Spain,5,5,0,10
4207,2017,Niger,Spain,0,8,0,8
4208,2017,Nicaragua,Spain,11,47,0,58
4209,2017,Nigeria,Spain,47,623,0,670
4210,2017,Pakistan,Spain,365,342,0,707
4211,2017,Panama,Spain,0,6,0,6
4212,2017,Paraguay,Spain,0,21,0,21
4213,2017,Peru,Spain,0,133,0,133
4214,2017,South Africa,Spain,0,5,0,5
4215,2017,Russian Federation,Spain,139,446,0,585
4216,2017,Rwanda,Spain,0,5,0,5
4217,2017,El Salvador,Spain,7,1501,0,1508
4218,2017,Serbia and Kosovo: S/RES/1244 (1999),Spain,0,20,0,20
4219,2017,Senegal,Spain,6,155,0,161
4220,2017,Sierra Leone,Spain,11,35,0,46
4221,2017,Somalia,Spain,601,165,0,766
4222,2017,Viet Nam,Spain,0,30,0,30
4223,2017,Sudan,Spain,54,48,0,102
4224,2017,South Sudan,Spain,0,5,0,5
4225,2017,Syrian Arab Rep.,Spain,11752,2255,0,14007
4226,2017,Tajikistan,Spain,5,0,0,5
4227,2017,Turkmenistan,Spain,0,5,0,5
4228,2017,Togo,Spain,14,10,0,24
4229,2017,Tunisia,Spain,0,14,0,14
4230,2017,Türkiye,Spain,10,91,0,101
4231,2017,Uganda,Spain,0,5,0,5
4232,2017,Ukraine,Spain,368,4466,0,4834
4233,2017,Uruguay,Spain,0,13,0,13
4234,2017,United States of America,Spain,0,26,0,26
4235,2017,Uzbekistan,Spain,10,9,0,19
4236,2017,Venezuela (Bolivarian Republic of),Spain,44,12465,0,12509
4237,2017,Western Sahara,Spain,17,127,0,144
4238,2017,Yemen,Spain,21,210,0,231
4239,2017,Stateless,Spain,24,5,0,29
4240,2017,Tibetan,Spain,5,7,0,12
4241,2017,Unknown ,Spain,68,21,0,89
4242,2017,Stateless,Viet Nam,0,0,0,0
4243,2017,Cuba,Saint Kitts and Nevis,0,5,0,5
4244,2017,Afghanistan,Sudan,0,0,0,0
4245,2017,Egypt,Sudan,7,25,0,32
4246,2017,Burundi,Sudan,15,10,0,25
4247,2017,Central African Rep.,Sudan,2277,10,0,2287
4248,2017,Chad,Sudan,7458,5,0,7463
4249,2017,Cameroon,Sudan,7,0,0,7
4250,2017,Congo,Sudan,0,6,0,6
4251,2017,Dem. Rep. of the Congo,Sudan,59,752,0,811
4252,2017,Eritrea,Sudan,108243,4901,0,113144
4253,2017,Ethiopia,Sudan,4273,9204,0,13477
4254,2017,Palestinian,Sudan,59,76,0,135
4255,2017,India,Sudan,0,5,0,5
4256,2017,Iraq,Sudan,16,23,0,39
4257,2017,Kuwait,Sudan,0,0,0,0
4258,2017,Nigeria,Sudan,0,10,0,10
4259,2017,Somalia,Sudan,208,146,0,354
4260,2017,Sudan,Sudan,0,0,1997022,0
4261,2017,South Sudan,Sudan,772715,0,0,772715
4262,2017,Syrian Arab Rep.,Sudan,11240,439,0,11679
4263,2017,Uganda,Sudan,5,0,0,5
4264,2017,Yemen,Sudan,0,2561,0,2561
4265,2017,Unknown ,Sudan,8,39,0,47
4266,2017,Cuba,Suriname,29,62,0,91
4267,2017,Dominican Rep.,Suriname,0,5,0,5
4268,2017,Jamaica,Suriname,5,0,0,5
4269,2017,Burundi,South Sudan,5,274,0,279
4270,2017,Central African Rep.,South Sudan,1869,0,0,1869
4271,2017,Dem. Rep. of the Congo,South Sudan,14961,0,0,14961
4272,2017,Eritrea,South Sudan,32,1344,0,1376
4273,2017,Ethiopia,South Sudan,4555,241,0,4796
4274,2017,Somalia,South Sudan,0,28,0,28
4275,2017,Sudan,South Sudan,261983,8,0,261991
4276,2017,South Sudan,South Sudan,0,0,1903953,0
4277,2017,Afghanistan,Slovakia,246,0,0,246
4278,2017,Angola,Slovakia,24,0,0,24
4279,2017,Egypt,Slovakia,5,0,0,5
4280,2017,Armenia,Slovakia,34,0,0,34
4281,2017,Burundi,Slovakia,5,0,0,5
4282,2017,Bosnia and Herzegovina,Slovakia,36,0,0,36
4283,2017,Bulgaria,Slovakia,8,0,0,8
4284,2017,Cambodia,Slovakia,5,0,0,5
4285,2017,China,Slovakia,5,0,0,5
4286,2017,Cameroon,Slovakia,7,0,0,7
4287,2017,Dem. Rep. of the Congo,Slovakia,16,0,0,16
4288,2017,Cuba,Slovakia,40,0,0,40
4289,2017,Palestinian,Slovakia,7,0,0,7
4290,2017,Iran (Islamic Rep. of),Slovakia,28,0,0,28
4291,2017,Iraq,Slovakia,209,0,0,209
4292,2017,Liberia,Slovakia,5,0,0,5
4293,2017,Pakistan,Slovakia,6,0,0,6
4294,2017,Romania,Slovakia,37,0,0,37
4295,2017,Russian Federation,Slovakia,37,0,0,37
4296,2017,Serbia and Kosovo: S/RES/1244 (1999),Slovakia,46,0,0,46
4297,2017,Somalia,Slovakia,31,0,0,31
4298,2017,Viet Nam,Slovakia,16,0,0,16
4299,2017,Sudan,Slovakia,0,0,0,0
4300,2017,Syrian Arab Rep.,Slovakia,17,0,0,17
4301,2017,Uganda,Slovakia,5,0,0,5
4302,2017,Ukraine,Slovakia,23,0,0,23
4303,2017,Uzbekistan,Slovakia,5,0,0,5
4304,2017,Stateless,Slovakia,9,0,0,9
4305,2017,Unknown ,Slovakia,0,26,0,26
4306,2017,Afghanistan,Slovenia,41,41,0,82
4307,2017,Algeria,Slovenia,0,58,0,58
4308,2017,Bosnia and Herzegovina,Slovenia,8,5,0,13
4309,2017,Cameroon,Slovenia,5,0,0,5
4310,2017,Dem. Rep. of the Congo,Slovenia,8,0,0,8
4311,2017,Eritrea,Slovenia,56,11,0,67
4312,2017,Palestinian,Slovenia,11,5,0,16
4313,2017,Iran (Islamic Rep. of),Slovenia,60,18,0,78
4314,2017,Iraq,Slovenia,39,5,0,44
4315,2017,Kazakhstan,Slovenia,19,0,0,19
4316,2017,Libya,Slovenia,0,8,0,8
4317,2017,Morocco,Slovenia,0,12,0,12
4318,2017,Pakistan,Slovenia,0,32,0,32
4319,2017,Russian Federation,Slovenia,15,0,0,15
4320,2017,Serbia and Kosovo: S/RES/1244 (1999),Slovenia,65,15,0,80
4321,2017,Sierra Leone,Slovenia,5,0,0,5
4322,2017,Somalia,Slovenia,48,0,0,48
4323,2017,Viet Nam,Slovenia,0,5,0,5
4324,2017,Sudan,Slovenia,6,0,0,6
4325,2017,Syrian Arab Rep.,Slovenia,215,9,0,224
4326,2017,Türkiye,Slovenia,0,40,0,40
4327,2017,Ukraine,Slovenia,5,0,0,5
4328,2017,Yemen,Slovenia,5,0,0,5
4329,2017,Stateless,Slovenia,0,0,0,0
4330,2017,Angola,Eswatini,11,0,0,11
4331,2017,Burundi,Eswatini,160,84,0,244
4332,2017,Congo,Eswatini,5,45,0,50
4333,2017,Dem. Rep. of the Congo,Eswatini,355,148,0,503
4334,2017,Ethiopia,Eswatini,5,36,0,41
4335,2017,Guinea,Eswatini,5,0,0,5
4336,2017,Kenya,Eswatini,5,0,0,5
4337,2017,Sri Lanka,Eswatini,5,0,0,5
4338,2017,Rwanda,Eswatini,153,91,0,244
4339,2017,Somalia,Eswatini,73,140,0,213
4340,2017,Uganda,Eswatini,6,0,0,6
4341,2017,Zimbabwe,Eswatini,7,0,0,7
4342,2017,Afghanistan,Sweden,25645,17812,0,43457
4343,2017,Albania,Sweden,329,384,0,713
4344,2017,Algeria,Sweden,66,121,0,187
4345,2017,Angola,Sweden,38,29,0,67
4346,2017,Egypt,Sweden,347,384,0,731
4347,2017,Armenia,Sweden,474,281,0,755
4348,2017,Azerbaijan,Sweden,685,380,0,1065
4349,2017,Bahrain,Sweden,15,5,0,20
4350,2017,Burundi,Sweden,200,103,0,303
4351,2017,Benin,Sweden,5,5,0,10
4352,2017,Bangladesh,Sweden,229,312,0,541
4353,2017,Bhutan,Sweden,8,0,0,8
4354,2017,Burkina Faso,Sweden,5,6,0,11
4355,2017,Belarus,Sweden,134,154,0,288
4356,2017,Bolivia (Plurinational State of),Sweden,64,37,0,101
4357,2017,Brazil,Sweden,8,14,0,22
4358,2017,Bosnia and Herzegovina,Sweden,160,98,0,258
4359,2017,Bulgaria,Sweden,16,0,0,16
4360,2017,Chad,Sweden,19,6,0,25
4361,2017,China,Sweden,282,66,0,348
4362,2017,Chile,Sweden,19,18,0,37
4363,2017,Cameroon,Sweden,152,101,0,253
4364,2017,Congo,Sweden,50,27,0,77
4365,2017,Dem. Rep. of the Congo,Sweden,324,73,0,397
4366,2017,Comoros,Sweden,5,0,0,5
4367,2017,Colombia,Sweden,30,152,0,182
4368,2017,Cuba,Sweden,60,65,0,125
4369,2017,Djibouti,Sweden,21,33,0,54
4370,2017,Ecuador,Sweden,8,17,0,25
4371,2017,Equatorial Guinea,Sweden,0,5,0,5
4372,2017,Eritrea,Sweden,27153,931,0,28084
4373,2017,Ethiopia,Sweden,2005,1022,0,3027
4374,2017,France,Sweden,5,0,0,5
4375,2017,Gambia,Sweden,147,154,0,301
4376,2017,Palestinian,Sweden,983,442,0,1425
4377,2017,United Kingdom of Great Britain and Northern Ireland,Sweden,7,5,0,12
4378,2017,Georgia,Sweden,133,622,0,755
4379,2017,Germany,Sweden,5,0,0,5
4380,2017,Ghana,Sweden,56,66,0,122
4381,2017,Guinea-Bissau,Sweden,7,5,0,12
4382,2017,Greece,Sweden,18,0,0,18
4383,2017,Guatemala,Sweden,9,5,0,14
4384,2017,Guinea,Sweden,80,42,0,122
4385,2017,Honduras,Sweden,11,23,0,34
4386,2017,Croatia,Sweden,0,5,0,5
4387,2017,Hungary,Sweden,5,5,0,10
4388,2017,Cote d'Ivoire,Sweden,61,25,0,86
4389,2017,India,Sweden,29,64,0,93
4390,2017,Indonesia,Sweden,15,0,0,15
4391,2017,Iran (Islamic Rep. of),Sweden,5867,3116,0,8983
4392,2017,Iraq,Sweden,15524,7856,0,23380
4393,2017,Israel,Sweden,33,12,0,45
4394,2017,Italy,Sweden,5,5,0,10
4395,2017,Jordan,Sweden,344,290,0,634
4396,2017,Kazakhstan,Sweden,266,154,0,420
4397,2017,Kenya,Sweden,93,78,0,171
4398,2017,Kyrgyzstan,Sweden,177,137,0,314
4399,2017,Rep. of Korea,Sweden,6,0,0,6
4400,2017,Dem. People's Rep. of Korea,Sweden,5,10,0,15
4401,2017,Kuwait,Sweden,23,59,0,82
4402,2017,Liberia,Sweden,13,13,0,26
4403,2017,Libya,Sweden,404,167,0,571
4404,2017,Lebanon,Sweden,534,571,0,1105
4405,2017,Sri Lanka,Sweden,48,41,0,89
4406,2017,Lithuania,Sweden,5,7,0,12
4407,2017,Latvia,Sweden,8,0,0,8
4408,2017,Mauritania,Sweden,12,5,0,17
4409,2017,North Macedonia,Sweden,55,88,0,143
4410,2017,Rep. of Moldova,Sweden,8,5,0,13
4411,2017,Mexico,Sweden,0,5,0,5
4412,2017,Mali,Sweden,24,11,0,35
4413,2017,Malaysia,Sweden,8,5,0,13
4414,2017,Mongolia,Sweden,315,359,0,674
4415,2017,Morocco,Sweden,230,368,0,598
4416,2017,Montenegro,Sweden,40,31,0,71
4417,2017,Myanmar,Sweden,16,5,0,21
4418,2017,Nepal,Sweden,19,12,0,31
4419,2017,Niger,Sweden,5,0,0,5
4420,2017,Nicaragua,Sweden,9,59,0,68
4421,2017,Nigeria,Sweden,510,515,0,1025
4422,2017,Norway,Sweden,5,0,0,5
4423,2017,Pakistan,Sweden,461,433,0,894
4424,2017,Peru,Sweden,11,66,0,77
4425,2017,Philippines,Sweden,7,26,0,33
4426,2017,Poland,Sweden,5,0,0,5
4427,2017,Romania,Sweden,63,0,0,63
4428,2017,South Africa,Sweden,0,14,0,14
4429,2017,Russian Federation,Sweden,1628,635,0,2263
4430,2017,Rwanda,Sweden,38,36,0,74
4431,2017,El Salvador,Sweden,78,159,0,237
4432,2017,Saudi Arabia,Sweden,46,22,0,68
4433,2017,Serbia and Kosovo: S/RES/1244 (1999),Sweden,1455,389,0,1844
4434,2017,Senegal,Sweden,45,25,0,70
4435,2017,Sierra Leone,Sweden,69,34,0,103
4436,2017,Somalia,Sweden,21973,2326,0,24299
4437,2017,Viet Nam,Sweden,68,29,0,97
4438,2017,Sudan,Sweden,841,241,0,1082
4439,2017,South Sudan,Sweden,5,5,0,10
4440,2017,Slovakia,Sweden,6,0,0,6
4441,2017,Syrian Arab Rep.,Sweden,103614,3531,0,107145
4442,2017,United Rep. of Tanzania,Sweden,40,52,0,92
4443,2017,Thailand,Sweden,8,17,0,25
4444,2017,Tajikistan,Sweden,58,65,0,123
4445,2017,Turkmenistan,Sweden,13,10,0,23
4446,2017,Togo,Sweden,7,0,0,7
4447,2017,Tunisia,Sweden,55,98,0,153
4448,2017,Türkiye,Sweden,270,1342,0,1612
4449,2017,United Arab Emirates,Sweden,5,0,0,5
4450,2017,Uganda,Sweden,669,98,0,767
4451,2017,Ukraine,Sweden,208,387,0,595
4452,2017,United States of America,Sweden,20,6,0,26
4453,2017,Uzbekistan,Sweden,616,455,0,1071
4454,2017,Venezuela (Bolivarian Republic of),Sweden,6,91,0,97
4455,2017,Yemen,Sweden,1099,186,0,1285
4456,2017,Zambia,Sweden,11,5,0,16
4457,2017,Zimbabwe,Sweden,24,11,0,35
4458,2017,Stateless,Sweden,22072,1837,0,23909
4459,2017,Unknown ,Sweden,622,869,0,1491
4460,2017,Afghanistan,Switzerland,8151,5620,0,13771
4461,2017,Albania,Switzerland,86,54,0,140
4462,2017,Algeria,Switzerland,160,148,0,308
4463,2017,Angola,Switzerland,774,42,0,816
4464,2017,Egypt,Switzerland,106,34,0,140
4465,2017,Armenia,Switzerland,132,104,0,236
4466,2017,Azerbaijan,Switzerland,80,85,0,165
4467,2017,Bahrain,Switzerland,5,0,0,5
4468,2017,Burundi,Switzerland,84,33,0,117
4469,2017,Benin,Switzerland,22,5,0,27
4470,2017,Bangladesh,Switzerland,62,19,0,81
4471,2017,Burkina Faso,Switzerland,19,7,0,26
4472,2017,Belarus,Switzerland,43,21,0,64
4473,2017,Brazil,Switzerland,14,5,0,19
4474,2017,Bosnia and Herzegovina,Switzerland,2026,23,0,2049
4475,2017,Bulgaria,Switzerland,9,8,0,17
4476,2017,Cambodia,Switzerland,322,0,0,322
4477,2017,Central African Rep.,Switzerland,13,6,0,19
4478,2017,Chad,Switzerland,49,11,0,60
4479,2017,China,Switzerland,2973,413,0,3386
4480,2017,Chile,Switzerland,12,0,0,12
4481,2017,Cameroon,Switzerland,188,69,0,257
4482,2017,Congo,Switzerland,67,5,0,72
4483,2017,Dem. Rep. of the Congo,Switzerland,1288,143,0,1431
4484,2017,Colombia,Switzerland,254,39,0,293
4485,2017,Cuba,Switzerland,40,5,0,45
4486,2017,Czechia,Switzerland,7,0,0,7
4487,2017,Djibouti,Switzerland,14,7,0,21
4488,2017,Ecuador,Switzerland,7,0,0,7
4489,2017,Eritrea,Switzerland,30935,4526,0,35461
4490,2017,Ethiopia,Switzerland,1418,671,0,2089
4491,2017,Gambia,Switzerland,46,50,0,96
4492,2017,Georgia,Switzerland,142,254,0,396
4493,2017,Ghana,Switzerland,17,20,0,37
4494,2017,Guinea-Bissau,Switzerland,60,16,0,76
4495,2017,Guatemala,Switzerland,6,0,0,6
4496,2017,Guinea,Switzerland,154,150,0,304
4497,2017,Croatia,Switzerland,33,0,0,33
4498,2017,Hungary,Switzerland,7,0,0,7
4499,2017,Cote d'Ivoire,Switzerland,169,69,0,238
4500,2017,India,Switzerland,39,7,0,46
4501,2017,Indonesia,Switzerland,0,5,0,5
4502,2017,Iran (Islamic Rep. of),Switzerland,1637,905,0,2542
4503,2017,Iraq,Switzerland,4015,1394,0,5409
4504,2017,Israel,Switzerland,5,0,0,5
4505,2017,Italy,Switzerland,5,0,0,5
4506,2017,Jordan,Switzerland,57,10,0,67
4507,2017,Kazakhstan,Switzerland,12,9,0,21
4508,2017,Kenya,Switzerland,43,0,0,43
4509,2017,Kyrgyzstan,Switzerland,18,7,0,25
4510,2017,Kuwait,Switzerland,0,8,0,8
4511,2017,Lao People's Dem. Rep.,Switzerland,127,0,0,127
4512,2017,Liberia,Switzerland,44,9,0,53
4513,2017,Libya,Switzerland,297,71,0,368
4514,2017,Lebanon,Switzerland,41,24,0,65
4515,2017,Sri Lanka,Switzerland,5581,1833,0,7414
4516,2017,Madagascar,Switzerland,5,0,0,5
4517,2017,Mauritania,Switzerland,6,7,0,13
4518,2017,North Macedonia,Switzerland,188,39,0,227
4519,2017,Rep. of Moldova,Switzerland,7,10,0,17
4520,2017,Mali,Switzerland,29,25,0,54
4521,2017,Mongolia,Switzerland,118,54,0,172
4522,2017,Morocco,Switzerland,62,101,0,163
4523,2017,Montenegro,Switzerland,45,7,0,52
4524,2017,Myanmar,Switzerland,40,0,0,40
4525,2017,Nepal,Switzerland,19,11,0,30
4526,2017,Niger,Switzerland,11,5,0,16
4527,2017,Nigeria,Switzerland,185,139,0,324
4528,2017,Pakistan,Switzerland,150,241,0,391
4529,2017,Paraguay,Switzerland,5,0,0,5
4530,2017,Peru,Switzerland,8,0,0,8
4531,2017,Philippines,Switzerland,6,6,0,12
4532,2017,Poland,Switzerland,5,0,0,5
4533,2017,Portugal,Switzerland,5,0,0,5
4534,2017,Romania,Switzerland,20,0,0,20
4535,2017,South Africa,Switzerland,14,5,0,19
4536,2017,Russian Federation,Switzerland,734,127,0,861
4537,2017,Rwanda,Switzerland,140,5,0,145
4538,2017,El Salvador,Switzerland,5,10,0,15
4539,2017,Saudi Arabia,Switzerland,5,13,0,18
4540,2017,Serbia and Kosovo: S/RES/1244 (1999),Switzerland,2777,159,0,2936
4541,2017,Senegal,Switzerland,42,31,0,73
4542,2017,Sierra Leone,Switzerland,34,13,0,47
4543,2017,Somalia,Switzerland,4574,874,0,5448
4544,2017,Viet Nam,Switzerland,996,0,0,996
4545,2017,Sudan,Switzerland,277,123,0,400
4546,2017,South Sudan,Switzerland,7,5,0,12
4547,2017,Syrian Arab Rep.,Switzerland,13639,3192,0,16831
4548,2017,United Rep. of Tanzania,Switzerland,15,0,0,15
4549,2017,Tajikistan,Switzerland,11,8,0,19
4550,2017,Turkmenistan,Switzerland,5,0,0,5
4551,2017,Togo,Switzerland,669,22,0,691
4552,2017,Tunisia,Switzerland,273,67,0,340
4553,2017,Türkiye,Switzerland,3440,932,0,4372
4554,2017,Uganda,Switzerland,40,18,0,58
4555,2017,Ukraine,Switzerland,42,84,0,126
4556,2017,Uzbekistan,Switzerland,50,12,0,62
4557,2017,Venezuela (Bolivarian Republic of),Switzerland,5,19,0,24
4558,2017,Western Sahara,Switzerland,7,5,0,12
4559,2017,Yemen,Switzerland,339,47,0,386
4560,2017,Zimbabwe,Switzerland,15,5,0,20
4561,2017,Stateless,Switzerland,519,11,0,530
4562,2017,Unknown ,Switzerland,1527,352,0,1879
4563,2017,Afghanistan,Syrian Arab Rep.,1221,32,0,1253
4564,2017,Algeria,Syrian Arab Rep.,5,0,0,5
4565,2017,Egypt,Syrian Arab Rep.,35,12,0,47
4566,2017,Bahrain,Syrian Arab Rep.,0,5,0,5
4567,2017,Burkina Faso,Syrian Arab Rep.,0,5,0,5
4568,2017,Chad,Syrian Arab Rep.,8,5,0,13
4569,2017,Eritrea,Syrian Arab Rep.,23,5,0,28
4570,2017,Ethiopia,Syrian Arab Rep.,19,0,0,19
4571,2017,Guinea,Syrian Arab Rep.,51,5,0,56
4572,2017,Cote d'Ivoire,Syrian Arab Rep.,5,0,0,5
4573,2017,Iran (Islamic Rep. of),Syrian Arab Rep.,45,30,0,75
4574,2017,Iraq,Syrian Arab Rep.,16325,17673,0,33998
4575,2017,Jordan,Syrian Arab Rep.,25,13,0,38
4576,2017,Kuwait,Syrian Arab Rep.,5,0,0,5
4577,2017,Libya,Syrian Arab Rep.,14,0,0,14
4578,2017,Lebanon,Syrian Arab Rep.,24,0,0,24
4579,2017,Sri Lanka,Syrian Arab Rep.,0,5,0,5
4580,2017,Morocco,Syrian Arab Rep.,6,0,0,6
4581,2017,Pakistan,Syrian Arab Rep.,173,26,0,199
4582,2017,Saudi Arabia,Syrian Arab Rep.,11,0,0,11
4583,2017,Sierra Leone,Syrian Arab Rep.,19,0,0,19
4584,2017,Somalia,Syrian Arab Rep.,404,0,0,404
4585,2017,Sudan,Syrian Arab Rep.,762,89,0,851
4586,2017,South Sudan,Syrian Arab Rep.,110,0,0,110
4587,2017,Syrian Arab Rep.,Syrian Arab Rep.,0,0,6150005,0
4588,2017,United Rep. of Tanzania,Syrian Arab Rep.,0,5,0,5
4589,2017,Tunisia,Syrian Arab Rep.,5,5,0,10
4590,2017,Türkiye,Syrian Arab Rep.,7,9,0,16
4591,2017,Yemen,Syrian Arab Rep.,123,169,0,292
4592,2017,Stateless,Syrian Arab Rep.,0,5,0,5
4593,2017,Burundi,United Rep. of Tanzania,251227,24455,0,275682
4594,2017,Dem. Rep. of the Congo,United Rep. of Tanzania,56906,19548,0,76454
4595,2017,Somalia,United Rep. of Tanzania,150,0,0,150
4596,2017,Unknown ,United Rep. of Tanzania,245,169,0,414
4597,2017,Cuba,Turks and Caicos Islands,5,0,0,5
4598,2017,Afghanistan,Thailand,88,5,0,93
4599,2017,Egypt,Thailand,16,13,0,29
4600,2017,Bangladesh,Thailand,0,5,0,5
4601,2017,Cambodia,Thailand,166,167,0,333
4602,2017,China,Thailand,179,27,0,206
4603,2017,Dem. Rep. of the Congo,Thailand,33,8,0,41
4604,2017,Eritrea,Thailand,8,0,0,8
4605,2017,Ethiopia,Thailand,13,25,0,38
4606,2017,Palestinian,Thailand,413,16,0,429
4607,2017,Guinea,Thailand,0,5,0,5
4608,2017,Cote d'Ivoire,Thailand,16,0,0,16
4609,2017,Iran (Islamic Rep. of),Thailand,57,77,0,134
4610,2017,Iraq,Thailand,305,26,0,331
4611,2017,Jordan,Thailand,5,0,0,5
4612,2017,Lao People's Dem. Rep.,Thailand,0,12,0,12
4613,2017,Sri Lanka,Thailand,156,55,0,211
4614,2017,Myanmar,Thailand,99982,254,0,100236
4615,2017,Nepal,Thailand,11,0,0,11
4616,2017,Nigeria,Thailand,0,5,0,5
4617,2017,Pakistan,Thailand,2075,722,0,2797
4618,2017,Russian Federation,Thailand,5,5,0,10
4619,2017,Somalia,Thailand,223,134,0,357
4620,2017,Viet Nam,Thailand,450,471,0,921
4621,2017,Sudan,Thailand,14,0,0,14
4622,2017,Syrian Arab Rep.,Thailand,327,9,0,336
4623,2017,United Rep. of Tanzania,Thailand,5,0,0,5
4624,2017,Togo,Thailand,5,0,0,5
4625,2017,Ukraine,Thailand,5,0,0,5
4626,2017,Uzbekistan,Thailand,0,5,0,5
4627,2017,Yemen,Thailand,40,0,0,40
4628,2017,Zimbabwe,Thailand,8,0,0,8
4629,2017,Stateless,Thailand,0,0,0,0
4630,2017,Afghanistan,Tajikistan,2516,440,0,2956
4631,2017,Iran (Islamic Rep. of),Tajikistan,5,0,0,5
4632,2017,Stateless,Tajikistan,0,0,0,0
4633,2017,Afghanistan,Turkmenistan,14,0,0,14
4634,2017,Azerbaijan,Turkmenistan,8,0,0,8
4635,2017,Stateless,Turkmenistan,0,0,0,0
4636,2017,Burundi,Togo,5,0,0,5
4637,2017,Burkina Faso,Togo,0,5,0,5
4638,2017,Central African Rep.,Togo,349,172,0,521
4639,2017,Chad,Togo,18,9,0,27
4640,2017,Cameroon,Togo,0,8,0,8
4641,2017,Congo,Togo,27,12,0,39
4642,2017,Dem. Rep. of the Congo,Togo,99,79,0,178
4643,2017,Ghana,Togo,9695,0,0,9695
4644,2017,Cote d'Ivoire,Togo,1991,349,0,2340
4645,2017,Iraq,Togo,5,0,0,5
4646,2017,Lebanon,Togo,0,13,0,13
4647,2017,Sri Lanka,Togo,0,6,0,6
4648,2017,Mali,Togo,91,41,0,132
4649,2017,Nigeria,Togo,8,13,0,21
4650,2017,Rwanda,Togo,137,5,0,142
4651,2017,Sudan,Togo,0,5,0,5
4652,2017,Syrian Arab Rep.,Togo,0,9,0,9
4653,2017,Türkiye,Togo,0,18,0,18
4654,2017,Bangladesh,Trinidad and Tobago,10,56,0,66
4655,2017,Colombia,Trinidad and Tobago,14,13,0,27
4656,2017,Cuba,Trinidad and Tobago,108,728,0,836
4657,2017,Dominican Rep.,Trinidad and Tobago,0,5,0,5
4658,2017,Guyana,Trinidad and Tobago,5,5,0,10
4659,2017,Jamaica,Trinidad and Tobago,19,12,0,31
4660,2017,Sri Lanka,Trinidad and Tobago,5,0,0,5
4661,2017,Mexico,Trinidad and Tobago,6,0,0,6
4662,2017,Nigeria,Trinidad and Tobago,0,5,0,5
4663,2017,Pakistan,Trinidad and Tobago,10,11,0,21
4664,2017,Syrian Arab Rep.,Trinidad and Tobago,53,32,0,85
4665,2017,Trinidad and Tobago,Trinidad and Tobago,0,0,0,0
4666,2017,Saint Vincent and the Grenadines,Trinidad and Tobago,5,0,0,5
4667,2017,Venezuela (Bolivarian Republic of),Trinidad and Tobago,47,1108,0,1155
4668,2017,Algeria,Tunisia,7,0,0,7
4669,2017,Central African Rep.,Tunisia,5,0,0,5
4670,2017,Cameroon,Tunisia,5,0,0,5
4671,2017,Eritrea,Tunisia,5,0,0,5
4672,2017,Ethiopia,Tunisia,5,0,0,5
4673,2017,Palestinian,Tunisia,29,0,0,29
4674,2017,Cote d'Ivoire,Tunisia,5,0,0,5
4675,2017,Iran (Islamic Rep. of),Tunisia,6,0,0,6
4676,2017,Iraq,Tunisia,15,0,0,15
4677,2017,Rwanda,Tunisia,6,0,0,6
4678,2017,Somalia,Tunisia,9,0,0,9
4679,2017,Sudan,Tunisia,26,0,0,26
4680,2017,Syrian Arab Rep.,Tunisia,603,0,0,603
4681,2017,Türkiye,Tunisia,0,15,0,15
4682,2017,Yemen,Tunisia,0,21,0,21
4683,2017,Afghanistan,Türkiye,5603,157810,0,163413
4684,2017,Algeria,Türkiye,5,23,0,28
4685,2017,Angola,Türkiye,5,0,0,5
4686,2017,Egypt,Türkiye,51,253,0,304
4687,2017,Azerbaijan,Türkiye,5,0,0,5
4688,2017,Burundi,Türkiye,6,28,0,34
4689,2017,Bangladesh,Türkiye,0,161,0,161
4690,2017,Central African Rep.,Türkiye,0,15,0,15
4691,2017,China,Türkiye,13,383,0,396
4692,2017,Cameroon,Türkiye,11,70,0,81
4693,2017,Congo,Türkiye,6,113,0,119
4694,2017,Dem. Rep. of the Congo,Türkiye,51,416,0,467
4695,2017,Djibouti,Türkiye,0,6,0,6
4696,2017,Eritrea,Türkiye,75,99,0,174
4697,2017,Ethiopia,Türkiye,95,215,0,310
4698,2017,Gabon,Türkiye,0,9,0,9
4699,2017,Gambia,Türkiye,0,11,0,11
4700,2017,Palestinian,Türkiye,1147,646,0,1793
4701,2017,Ghana,Türkiye,0,12,0,12
4702,2017,Guinea,Türkiye,12,10,0,22
4703,2017,Cote d'Ivoire,Türkiye,15,18,0,33
4704,2017,India,Türkiye,0,5,0,5
4705,2017,Iran (Islamic Rep. of),Türkiye,8308,25615,0,33923
4706,2017,Iraq,Türkiye,37319,115657,0,152976
4707,2017,Jordan,Türkiye,35,72,0,107
4708,2017,Kazakhstan,Türkiye,0,40,0,40
4709,2017,Kenya,Türkiye,0,5,0,5
4710,2017,Kyrgyzstan,Türkiye,190,100,0,290
4711,2017,Kuwait,Türkiye,0,5,0,5
4712,2017,Liberia,Türkiye,5,5,0,10
4713,2017,Libya,Türkiye,23,63,0,86
4714,2017,Lebanon,Türkiye,13,33,0,46
4715,2017,Sri Lanka,Türkiye,15,6,0,21
4716,2017,Mauritania,Türkiye,8,0,0,8
4717,2017,Mali,Türkiye,0,24,0,24
4718,2017,Malaysia,Türkiye,0,5,0,5
4719,2017,Mongolia,Türkiye,0,80,0,80
4720,2017,Morocco,Türkiye,31,78,0,109
4721,2017,Myanmar,Türkiye,0,15,0,15
4722,2017,Nepal,Türkiye,0,5,0,5
4723,2017,Niger,Türkiye,0,5,0,5
4724,2017,Nigeria,Türkiye,11,79,0,90
4725,2017,Pakistan,Türkiye,56,1634,0,1690
4726,2017,Philippines,Türkiye,5,5,0,10
4727,2017,Russian Federation,Türkiye,5,0,0,5
4728,2017,Rwanda,Türkiye,0,5,0,5
4729,2017,Saudi Arabia,Türkiye,5,5,0,10
4730,2017,Senegal,Türkiye,5,17,0,22
4731,2017,Sierra Leone,Türkiye,5,13,0,18
4732,2017,Somalia,Türkiye,2219,2144,0,4363
4733,2017,Sudan,Türkiye,274,114,0,388
4734,2017,South Sudan,Türkiye,5,5,0,10
4735,2017,Syrian Arab Rep.,Türkiye,3424237,162,0,3424399
4736,2017,Tajikistan,Türkiye,8,262,0,270
4737,2017,Turkmenistan,Türkiye,6,591,0,597
4738,2017,Togo,Türkiye,0,5,0,5
4739,2017,Tunisia,Türkiye,14,31,0,45
4740,2017,United Arab Emirates,Türkiye,6,21,0,27
4741,2017,Uganda,Türkiye,24,487,0,511
4742,2017,Uzbekistan,Türkiye,51,615,0,666
4743,2017,Yemen,Türkiye,161,423,0,584
4744,2017,Zimbabwe,Türkiye,0,39,0,39
4745,2017,Stateless,Türkiye,206,65,0,271
4746,2017,Afghanistan,United Arab Emirates,5,14,0,19
4747,2017,Ethiopia,United Arab Emirates,8,0,0,8
4748,2017,Palestinian,United Arab Emirates,5,143,0,148
4749,2017,Iran (Islamic Rep. of),United Arab Emirates,5,7,0,12
4750,2017,Iraq,United Arab Emirates,697,482,0,1179
4751,2017,Liberia,United Arab Emirates,0,5,0,5
4752,2017,Libya,United Arab Emirates,0,5,0,5
4753,2017,Lebanon,United Arab Emirates,6,0,0,6
4754,2017,Morocco,United Arab Emirates,0,0,0,0
4755,2017,Pakistan,United Arab Emirates,0,5,0,5
4756,2017,Philippines,United Arab Emirates,0,0,0,0
4757,2017,Saudi Arabia,United Arab Emirates,5,0,0,5
4758,2017,Somalia,United Arab Emirates,17,0,0,17
4759,2017,Sudan,United Arab Emirates,8,12,0,20
4760,2017,Syrian Arab Rep.,United Arab Emirates,128,1185,0,1313
4761,2017,Yemen,United Arab Emirates,0,24,0,24
4762,2017,Burundi,Uganda,38245,2389,0,40634
4763,2017,Central African Rep.,Uganda,21,5,0,26
4764,2017,Chad,Uganda,5,0,0,5
4765,2017,Dem. Rep. of the Congo,Uganda,226192,16214,0,242406
4766,2017,Eritrea,Uganda,4566,10026,0,14592
4767,2017,Ethiopia,Uganda,1944,1289,0,3233
4768,2017,Palestinian,Uganda,0,7,0,7
4769,2017,Kenya,Uganda,193,25,0,218
4770,2017,Mali,Uganda,0,5,0,5
4771,2017,Pakistan,Uganda,224,267,0,491
4772,2017,Rwanda,Uganda,14282,978,0,15260
4773,2017,Senegal,Uganda,5,0,0,5
4774,2017,Somalia,Uganda,25011,12182,0,37193
4775,2017,Sudan,Uganda,2355,745,0,3100
4776,2017,South Sudan,Uganda,1037412,486,0,1037898
4777,2017,Syrian Arab Rep.,Uganda,7,12,0,19
4778,2017,Uganda,Uganda,0,0,0,0
4779,2017,Yemen,Uganda,33,5,0,38
4780,2017,Afghanistan,Ukraine,1410,2808,0,4218
4781,2017,Algeria,Ukraine,0,15,0,15
4782,2017,Angola,Ukraine,26,9,0,35
4783,2017,Egypt,Ukraine,5,21,0,26
4784,2017,Armenia,Ukraine,192,28,0,220
4785,2017,Azerbaijan,Ukraine,149,46,0,195
4786,2017,Burundi,Ukraine,6,7,0,13
4787,2017,Bangladesh,Ukraine,0,140,0,140
4788,2017,Belarus,Ukraine,26,39,0,65
4789,2017,Cambodia,Ukraine,0,5,0,5
4790,2017,Chad,Ukraine,7,5,0,12
4791,2017,China,Ukraine,0,11,0,11
4792,2017,Cameroon,Ukraine,5,93,0,98
4793,2017,Congo,Ukraine,20,34,0,54
4794,2017,Dem. Rep. of the Congo,Ukraine,68,123,0,191
4795,2017,Cuba,Ukraine,0,11,0,11
4796,2017,Eritrea,Ukraine,16,24,0,40
4797,2017,Ethiopia,Ukraine,20,29,0,49
4798,2017,Palestinian,Ukraine,37,164,0,201
4799,2017,Georgia,Ukraine,48,100,0,148
4800,2017,Ghana,Ukraine,0,5,0,5
4801,2017,Guinea,Ukraine,7,117,0,124
4802,2017,Cote d'Ivoire,Ukraine,0,30,0,30
4803,2017,India,Ukraine,0,36,0,36
4804,2017,Iran (Islamic Rep. of),Ukraine,58,103,0,161
4805,2017,Iraq,Ukraine,91,264,0,355
4806,2017,Jordan,Ukraine,5,24,0,29
4807,2017,Kazakhstan,Ukraine,11,10,0,21
4808,2017,Kenya,Ukraine,0,6,0,6
4809,2017,Kyrgyzstan,Ukraine,12,142,0,154
4810,2017,Liberia,Ukraine,0,16,0,16
4811,2017,Libya,Ukraine,0,19,0,19
4812,2017,Lebanon,Ukraine,9,23,0,32
4813,2017,Sri Lanka,Ukraine,8,64,0,72
4814,2017,Rep. of Moldova,Ukraine,0,6,0,6
4815,2017,Mali,Ukraine,0,5,0,5
4816,2017,Myanmar,Ukraine,0,10,0,10
4817,2017,Nepal,Ukraine,0,19,0,19
4818,2017,Nigeria,Ukraine,5,68,0,73
4819,2017,Pakistan,Ukraine,9,191,0,200
4820,2017,Russian Federation,Ukraine,150,186,0,336
4821,2017,Rwanda,Ukraine,5,0,0,5
4822,2017,Serbia and Kosovo: S/RES/1244 (1999),Ukraine,5,0,0,5
4823,2017,Sierra Leone,Ukraine,5,7,0,12
4824,2017,Somalia,Ukraine,132,306,0,438
4825,2017,Viet Nam,Ukraine,0,35,0,35
4826,2017,Sudan,Ukraine,60,106,0,166
4827,2017,Syrian Arab Rep.,Ukraine,483,520,0,1003
4828,2017,Tajikistan,Ukraine,16,38,0,54
4829,2017,Turkmenistan,Ukraine,5,5,0,10
4830,2017,Togo,Ukraine,0,5,0,5
4831,2017,Tunisia,Ukraine,0,10,0,10
4832,2017,Türkiye,Ukraine,14,40,0,54
4833,2017,Uganda,Ukraine,0,5,0,5
4834,2017,Ukraine,Ukraine,0,0,1800000,0
4835,2017,Uzbekistan,Ukraine,60,60,0,120
4836,2017,Western Sahara,Ukraine,0,5,0,5
4837,2017,Yemen,Ukraine,5,6,0,11
4838,2017,Stateless,Ukraine,51,6,0,57
4839,2017,Angola,Uruguay,0,20,0,20
4840,2017,Bolivia (Plurinational State of),Uruguay,5,0,0,5
4841,2017,Brazil,Uruguay,0,7,0,7
4842,2017,Cameroon,Uruguay,8,0,0,8
4843,2017,Congo,Uruguay,5,0,0,5
4844,2017,Colombia,Uruguay,141,23,0,164
4845,2017,Cuba,Uruguay,12,1968,0,1980
4846,2017,Dominican Rep.,Uruguay,0,5,0,5
4847,2017,Ecuador,Uruguay,7,0,0,7
4848,2017,France,Uruguay,0,5,0,5
4849,2017,Libya,Uruguay,5,0,0,5
4850,2017,Latvia,Uruguay,5,0,0,5
4851,2017,Mexico,Uruguay,5,0,0,5
4852,2017,Morocco,Uruguay,0,5,0,5
4853,2017,Nigeria,Uruguay,13,12,0,25
4854,2017,Paraguay,Uruguay,5,0,0,5
4855,2017,Peru,Uruguay,6,0,0,6
4856,2017,Russian Federation,Uruguay,12,0,0,12
4857,2017,El Salvador,Uruguay,18,0,0,18
4858,2017,Senegal,Uruguay,0,5,0,5
4859,2017,Somalia,Uruguay,5,0,0,5
4860,2017,Syrian Arab Rep.,Uruguay,61,0,0,61
4861,2017,Türkiye,Uruguay,5,6,0,11
4862,2017,Ukraine,Uruguay,11,0,0,11
4863,2017,Venezuela (Bolivarian Republic of),Uruguay,5,33,0,38
4864,2017,Afghanistan,United States of America,1564,810,0,2374
4865,2017,Albania,United States of America,1527,1636,0,3163
4866,2017,Algeria,United States of America,131,274,0,405
4867,2017,Angola,United States of America,157,1143,0,1300
4868,2017,Antigua and Barbuda,United States of America,5,10,0,15
4869,2017,Egypt,United States of America,11926,4599,0,16525
4870,2017,Argentina,United States of America,55,232,0,287
4871,2017,Armenia,United States of America,1663,2032,0,3695
4872,2017,Austria,United States of America,5,12,0,17
4873,2017,Azerbaijan,United States of America,298,875,0,1173
4874,2017,Bahrain,United States of America,45,29,0,74
4875,2017,Barbados,United States of America,0,10,0,10
4876,2017,Burundi,United States of America,747,693,0,1440
4877,2017,Belgium,United States of America,32,19,0,51
4878,2017,Benin,United States of America,97,186,0,283
4879,2017,Bangladesh,United States of America,1248,6225,0,7473
4880,2017,Bahamas,United States of America,179,61,0,240
4881,2017,Bhutan,United States of America,43,323,0,366
4882,2017,Burkina Faso,United States of America,1163,3388,0,4551
4883,2017,Belarus,United States of America,1537,1769,0,3306
4884,2017,Bolivia (Plurinational State of),United States of America,113,381,0,494
4885,2017,Botswana,United States of America,0,9,0,9
4886,2017,Brazil,United States of America,593,6052,0,6645
4887,2017,Bosnia and Herzegovina,United States of America,101,157,0,258
4888,2017,Bulgaria,United States of America,352,230,0,582
4889,2017,Belize,United States of America,43,194,0,237
4890,2017,Cambodia,United States of America,139,46,0,185
4891,2017,Canada,United States of America,42,40,0,82
4892,2017,Central African Rep.,United States of America,210,116,0,326
4893,2017,Cayman Islands,United States of America,6,0,0,6
4894,2017,Chad,United States of America,335,218,0,553
4895,2017,China,United States of America,74476,68414,0,142890
4896,2017,Chile,United States of America,27,161,0,188
4897,2017,Cameroon,United States of America,3992,4056,0,8048
4898,2017,Congo,United States of America,1331,1516,0,2847
4899,2017,Dem. Rep. of the Congo,United States of America,939,1324,0,2263
4900,2017,Comoros,United States of America,5,0,0,5
4901,2017,Colombia,United States of America,4264,7002,0,11266
4902,2017,Costa Rica,United States of America,170,443,0,613
4903,2017,Cuba,United States of America,431,1008,0,1439
4904,2017,Cabo Verde,United States of America,0,23,0,23
4905,2017,Czechia,United States of America,18,22,0,40
4906,2017,Denmark,United States of America,0,5,0,5
4907,2017,Djibouti,United States of America,282,535,0,817
4908,2017,Dominica,United States of America,10,32,0,42
4909,2017,Dominican Rep.,United States of America,179,936,0,1115
4910,2017,Ecuador,United States of America,948,17082,0,18030
4911,2017,Equatorial Guinea,United States of America,9,24,0,33
4912,2017,Eritrea,United States of America,5145,1697,0,6842
4913,2017,Estonia,United States of America,266,36,0,302
4914,2017,Ethiopia,United States of America,9987,5506,0,15493
4915,2017,French Guiana,United States of America,0,5,0,5
4916,2017,Fiji,United States of America,231,196,0,427
4917,2017,Finland,United States of America,5,0,0,5
4918,2017,France,United States of America,24,70,0,94
4919,2017,Gabon,United States of America,40,181,0,221
4920,2017,Gambia,United States of America,1503,903,0,2406
4921,2017,Palestinian,United States of America,5,57,0,62
4922,2017,United Kingdom of Great Britain and Northern Ireland,United States of America,39,108,0,147
4923,2017,Georgia,United States of America,382,1469,0,1851
4924,2017,Germany,United States of America,40,125,0,165
4925,2017,Ghana,United States of America,399,983,0,1382
4926,2017,Guinea-Bissau,United States of America,24,19,0,43
4927,2017,Greece,United States of America,15,48,0,63
4928,2017,Grenada,United States of America,24,36,0,60
4929,2017,Guatemala,United States of America,14971,71443,0,86414
4930,2017,Guinea,United States of America,2305,1223,0,3528
4931,2017,Guyana,United States of America,75,332,0,407
4932,2017,Haiti,United States of America,17055,15184,0,32239
4933,2017,"China, Hong Kong SAR",United States of America,0,17,0,17
4934,2017,Honduras,United States of America,10107,53905,0,64012
4935,2017,Croatia,United States of America,34,34,0,68
4936,2017,Hungary,United States of America,18,173,0,191
4937,2017,Cote d'Ivoire,United States of America,1263,1092,0,2355
4938,2017,India,United States of America,4836,23395,0,28231
4939,2017,Indonesia,United States of America,1834,1792,0,3626
4940,2017,Ireland,United States of America,0,30,0,30
4941,2017,Iran (Islamic Rep. of),United States of America,5536,3266,0,8802
4942,2017,Iraq,United States of America,6130,3869,0,9999
4943,2017,Israel,United States of America,138,437,0,575
4944,2017,Italy,United States of America,20,145,0,165
4945,2017,Jamaica,United States of America,697,915,0,1612
4946,2017,Jordan,United States of America,428,1820,0,2248
4947,2017,Japan,United States of America,6,78,0,84
4948,2017,Kazakhstan,United States of America,707,1558,0,2265
4949,2017,Kenya,United States of America,2087,2905,0,4992
4950,2017,Kyrgyzstan,United States of America,1270,1407,0,2677
4951,2017,Rep. of Korea,United States of America,29,166,0,195
4952,2017,Dem. People's Rep. of Korea,United States of America,12,25,0,37
4953,2017,Kuwait,United States of America,130,185,0,315
4954,2017,Lao People's Dem. Rep.,United States of America,108,174,0,282
4955,2017,Liberia,United States of America,1179,956,0,2135
4956,2017,Libya,United States of America,280,1041,0,1321
4957,2017,Saint Lucia,United States of America,9,21,0,30
4958,2017,Lebanon,United States of America,378,699,0,1077
4959,2017,Lesotho,United States of America,6,0,0,6
4960,2017,Sri Lanka,United States of America,1270,1545,0,2815
4961,2017,Lithuania,United States of America,20,51,0,71
4962,2017,Latvia,United States of America,19,86,0,105
4963,2017,"China, Macao SAR",United States of America,0,5,0,5
4964,2017,Madagascar,United States of America,17,5,0,22
4965,2017,Mauritania,United States of America,944,858,0,1802
4966,2017,North Macedonia,United States of America,108,163,0,271
4967,2017,Monaco,United States of America,5,0,0,5
4968,2017,Rep. of Moldova,United States of America,1400,2204,0,3604
4969,2017,Maldives,United States of America,6,5,0,11
4970,2017,Mexico,United States of America,7709,83501,0,91210
4971,2017,Marshall Islands,United States of America,7,0,0,7
4972,2017,Mali,United States of America,1191,611,0,1802
4973,2017,Malaysia,United States of America,93,313,0,406
4974,2017,Malawi,United States of America,33,71,0,104
4975,2017,Mongolia,United States of America,766,1882,0,2648
4976,2017,Morocco,United States of America,114,198,0,312
4977,2017,Mozambique,United States of America,0,31,0,31
4978,2017,Montenegro,United States of America,109,206,0,315
4979,2017,Mauritius,United States of America,31,44,0,75
4980,2017,Myanmar,United States of America,1623,779,0,2402
4981,2017,Namibia,United States of America,45,6,0,51
4982,2017,Nepal,United States of America,6907,6872,0,13779
4983,2017,Netherlands,United States of America,13,41,0,54
4984,2017,Niger,United States of America,138,262,0,400
4985,2017,Nicaragua,United States of America,563,1815,0,2378
4986,2017,Nigeria,United States of America,1154,5486,0,6640
4987,2017,Niue,United States of America,19,5,0,24
4988,2017,Oman,United States of America,5,5,0,10
4989,2017,Pakistan,United States of America,3308,5173,0,8481
4990,2017,Panama,United States of America,15,77,0,92
4991,2017,Paraguay,United States of America,19,76,0,95
4992,2017,Peru,United States of America,528,2709,0,3237
4993,2017,Philippines,United States of America,145,1414,0,1559
4994,2017,Poland,United States of America,23,659,0,682
4995,2017,Portugal,United States of America,5,88,0,93
4996,2017,Qatar,United States of America,13,34,0,47
4997,2017,Romania,United States of America,371,2950,0,3321
4998,2017,South Africa,United States of America,40,294,0,334
4999,2017,Russian Federation,United States of America,5463,7980,0,13443
5000,2017,Rwanda,United States of America,1079,674,0,1753
5001,2017,El Salvador,United States of America,18763,91429,0,110192
5002,2017,Saudi Arabia,United States of America,391,752,0,1143
5003,2017,Serbia and Kosovo: S/RES/1244 (1999),United States of America,1039,606,0,1645
5004,2017,Senegal,United States of America,388,620,0,1008
5005,2017,Seychelles,United States of America,5,0,0,5
5006,2017,Singapore,United States of America,15,30,0,45
5007,2017,Sierra Leone,United States of America,523,290,0,813
5008,2017,Somalia,United States of America,2297,550,0,2847
5009,2017,Spain,United States of America,11,65,0,76
5010,2017,Viet Nam,United States of America,256,444,0,700
5011,2017,Saint Kitts and Nevis,United States of America,5,0,0,5
5012,2017,Sudan,United States of America,1382,903,0,2285
5013,2017,Suriname,United States of America,9,17,0,26
5014,2017,South Sudan,United States of America,7,28,0,35
5015,2017,Slovakia,United States of America,10,15,0,25
5016,2017,Slovenia,United States of America,5,5,0,10
5017,2017,Eswatini,United States of America,5,6,0,11
5018,2017,Sweden,United States of America,8,8,0,16
5019,2017,Switzerland,United States of America,5,10,0,15
5020,2017,Syrian Arab Rep.,United States of America,7282,3358,0,10640
5021,2017,United Rep. of Tanzania,United States of America,133,154,0,287
5022,2017,Turks and Caicos Islands,United States of America,14,0,0,14
5023,2017,Thailand,United States of America,29,465,0,494
5024,2017,Tajikistan,United States of America,283,404,0,687
5025,2017,Turkmenistan,United States of America,159,235,0,394
5026,2017,Togo,United States of America,604,494,0,1098
5027,2017,Tonga,United States of America,0,10,0,10
5028,2017,Trinidad and Tobago,United States of America,55,227,0,282
5029,2017,Tunisia,United States of America,54,204,0,258
5030,2017,Türkiye,United States of America,428,2646,0,3074
5031,2017,United Arab Emirates,United States of America,39,150,0,189
5032,2017,Uganda,United States of America,1301,1821,0,3122
5033,2017,Ukraine,United States of America,1812,7574,0,9386
5034,2017,Uruguay,United States of America,5,118,0,123
5035,2017,Uzbekistan,United States of America,1210,1614,0,2824
5036,2017,Saint Vincent and the Grenadines,United States of America,31,17,0,48
5037,2017,Venezuela (Bolivarian Republic of),United States of America,5402,58811,0,64213
5038,2017,Yemen,United States of America,549,908,0,1457
5039,2017,Zambia,United States of America,44,66,0,110
5040,2017,Zimbabwe,United States of America,1049,768,0,1817
5041,2017,Stateless,United States of America,455,0,0,455
5042,2017,Guadeloupe,United States of America,0,37,0,37
5043,2017,Curacao ,United States of America,35,0,0,35
5044,2017,Unknown ,United States of America,4506,3604,0,8110
5045,2017,Afghanistan,Uzbekistan,20,0,0,20
5046,2017,Stateless,Uzbekistan,0,0,0,0
5047,2017,Afghanistan,Venezuela (Bolivarian Republic of),10,0,0,10
5048,2017,Chile,Venezuela (Bolivarian Republic of),10,0,0,10
5049,2017,Congo,Venezuela (Bolivarian Republic of),5,0,0,5
5050,2017,Colombia,Venezuela (Bolivarian Republic of),122677,904,0,123581
5051,2017,Palestinian,Venezuela (Bolivarian Republic of),7,0,0,7
5052,2017,Haiti,Venezuela (Bolivarian Republic of),7,0,0,7
5053,2017,Iraq,Venezuela (Bolivarian Republic of),18,0,0,18
5054,2017,Liberia,Venezuela (Bolivarian Republic of),9,0,0,9
5055,2017,Libya,Venezuela (Bolivarian Republic of),5,0,0,5
5056,2017,Lebanon,Venezuela (Bolivarian Republic of),12,0,0,12
5057,2017,Nigeria,Venezuela (Bolivarian Republic of),7,0,0,7
5058,2017,Peru,Venezuela (Bolivarian Republic of),5,0,0,5
5059,2017,Rwanda,Venezuela (Bolivarian Republic of),5,0,0,5
5060,2017,Sierra Leone,Venezuela (Bolivarian Republic of),5,0,0,5
5061,2017,Syrian Arab Rep.,Venezuela (Bolivarian Republic of),5,0,0,5
5062,2017,Türkiye,Venezuela (Bolivarian Republic of),6,0,0,6
5063,2017,Western Sahara,Venezuela (Bolivarian Republic of),11,0,0,11
5064,2017,Sri Lanka,Samoa,5,0,0,5
5065,2017,Egypt,Yemen,16,5,0,21
5066,2017,Dem. Rep. of the Congo,Yemen,5,0,0,5
5067,2017,Djibouti,Yemen,5,5,0,10
5068,2017,Eritrea,Yemen,1370,360,0,1730
5069,2017,Ethiopia,Yemen,6205,8317,0,14522
5070,2017,Palestinian,Yemen,625,162,0,787
5071,2017,Iran (Islamic Rep. of),Yemen,5,0,0,5
5072,2017,Iraq,Yemen,3351,28,0,3379
5073,2017,Jordan,Yemen,12,0,0,12
5074,2017,Lebanon,Yemen,0,6,0,6
5075,2017,Pakistan,Yemen,0,9,0,9
5076,2017,Somalia,Yemen,255894,0,0,255894
5077,2017,Viet Nam,Yemen,15,0,0,15
5078,2017,Sudan,Yemen,124,375,0,499
5079,2017,Syrian Arab Rep.,Yemen,3286,496,0,3782
5080,2017,United Rep. of Tanzania,Yemen,0,0,0,0
5081,2017,Yemen,Yemen,0,0,2014062,0
5082,2017,Angola,Zambia,0,0,0,0
5083,2017,Burundi,Zambia,3267,1134,0,4401
5084,2017,Congo,Zambia,0,5,0,5
5085,2017,Dem. Rep. of the Congo,Zambia,34928,2884,0,37812
5086,2017,Eritrea,Zambia,8,27,0,35
5087,2017,Ethiopia,Zambia,18,17,0,35
5088,2017,Palestinian,Zambia,10,0,0,10
5089,2017,Liberia,Zambia,6,0,0,6
5090,2017,South Africa,Zambia,7,0,0,7
5091,2017,Rwanda,Zambia,715,47,0,762
5092,2017,Sierra Leone,Zambia,0,5,0,5
5093,2017,Somalia,Zambia,2174,551,0,2725
5094,2017,Sudan,Zambia,24,0,0,24
5095,2017,Türkiye,Zambia,12,5,0,17
5096,2017,Uganda,Zambia,21,0,0,21
5097,2017,Zimbabwe,Zambia,5,0,0,5
5098,2017,Unknown ,Zambia,71,0,0,71
5099,2017,Egypt,Zimbabwe,5,0,0,5
5100,2017,Burundi,Zimbabwe,622,17,0,639
5101,2017,Congo,Zimbabwe,13,0,0,13
5102,2017,Dem. Rep. of the Congo,Zimbabwe,6296,245,0,6541
5103,2017,Eritrea,Zimbabwe,20,5,0,25
5104,2017,Ethiopia,Zimbabwe,68,14,0,82
5105,2017,Cote d'Ivoire,Zimbabwe,10,0,0,10
5106,2017,Kenya,Zimbabwe,0,8,0,8
5107,2017,Mozambique,Zimbabwe,0,8059,0,8059
5108,2017,South Africa,Zimbabwe,0,9,0,9
5109,2017,Rwanda,Zimbabwe,500,13,0,513
5110,2017,Somalia,Zimbabwe,19,8,0,27
5111,2017,Sudan,Zimbabwe,5,9,0,14
5112,2017,Uganda,Zimbabwe,8,5,0,13
5113,2017,Zambia,Zimbabwe,0,0,0,0
5114,2017,Zimbabwe,Zimbabwe,0,0,0,0
5115,2017,Venezuela (Bolivarian Republic of),Aruba,0,147,0,147
5116,2017,Colombia,Curacao ,45,68,0,113
5117,2017,Cuba,Curacao ,6,6,0,12
5118,2017,Venezuela (Bolivarian Republic of),Curacao ,23,655,0,678
5119,2017,Iran (Islamic Rep. of),Sint Maarten (Dutch part),5,0,0,5
