,Year,Country of origin,Country of asylum,Refugees under UNHCR's mandate,Asylum-seekers,IDPs of concern to UNHCR,International total
0,2017,Afghanistan,Afghanistan,0,0,1837079,0
1,2017,Iran (Islamic Rep. of),Afghanistan,34,5,0,39
2,2017,Pakistan,Afghanistan,75893,101,0,75994
3,2017,Tajikistan,Afghanistan,0,7,0,7
4,2017,Türkiye,Afghanistan,0,102,0,102
5,2017,Egypt,Albania,5,0,0,5
6,2017,China,Albania,12,0,0,12
7,2017,Dem. Rep. of the Congo,Albania,5,0,0,5
8,2017,Palestinian,Albania,5,0,0,5
9,2017,Iran (Islamic Rep. of),Albania,12,5,0,17
10,2017,Iraq,Albania,5,0,0,5
11,2017,Serbia and Kosovo: S/RES/1244 (1999),Albania,60,5,0,65
12,2017,Syrian Arab Rep.,Albania,5,22,0,27
13,2017,Türkiye,Albania,5,0,0,5
14,2017,Uzbekistan,Albania,5,0,0,5
15,2017,Venezuela (Bolivarian Republic of),Albania,5,0,0,5
17,2017,Central African Rep.,Algeria,43,27,0,70
18,2017,Chad,Algeria,0,5,0,5
19,2017,Cameroon,Algeria,16,31,0,47
20,2017,Congo,Algeria,0,5,0,5
21,2017,Dem. Rep. of the Congo,Algeria,47,76,0,123
22,2017,Palestinian,Algeria,4014,85,0,4099
23,2017,Guinea,Algeria,5,24,0,29
24,2017,Cote d'Ivoire,Algeria,39,53,0,92
25,2017,Iraq,Algeria,13,5,0,18
26,2017,Libya,Algeria,19,8,0,27
27,2017,Lebanon,Algeria,0,5,0,5
28,2017,Mali,Algeria,34,37,0,71
29,2017,Nigeria,Algeria,0,5,0,5
30,2017,Sudan,Algeria,0,6,0,6
31,2017,Syrian Arab Rep.,Algeria,8,5821,0,5829
32,2017,Togo,Algeria,5,0,0,5
33,2017,Tunisia,Algeria,0,5,0,5
34,2017,Western Sahara,Algeria,90000,0,0,90000
35,2017,Yemen,Algeria,5,155,0,160
36,2017,Burundi,Angola,9,94,0,103
37,2017,Central African Rep.,Angola,9,76,0,85
38,2017,Chad,Angola,184,780,0,964
39,2017,Congo,Angola,5,58,0,63
40,2017,Dem. Rep. of the Congo,Angola,38516,500,0,39016
41,2017,Eritrea,Angola,34,1767,0,1801
42,2017,Ethiopia,Angola,0,57,0,57
43,2017,Guinea-Bissau,Angola,0,268,0,268
44,2017,Guinea,Angola,107,9145,0,9252
45,2017,Cote d'Ivoire,Angola,510,5938,0,6448
46,2017,Liberia,Angola,155,478,0,633
47,2017,Mauritania,Angola,306,5403,0,5709
48,2017,Rwanda,Angola,273,67,0,340
49,2017,Sierra Leone,Angola,374,1497,0,1871
50,2017,Somalia,Angola,288,1731,0,2019
51,2017,Sudan,Angola,313,1670,0,1983
52,2017,United Rep. of Tanzania,Angola,5,0,0,5
53,2017,Uganda,Angola,6,6,0,12
54,2017,Western Sahara,Angola,18,596,0,614
55,2017,Zambia,Angola,7,0,0,7
56,2017,Afghanistan,Egypt,17,22,0,39
57,2017,Burundi,Egypt,24,31,0,55
58,2017,Benin,Egypt,0,5,0,5
59,2017,Bangladesh,Egypt,0,5,0,5
60,2017,Central African Rep.,Egypt,17,16,0,33
61,2017,Chad,Egypt,46,35,0,81
62,2017,China,Egypt,0,42,0,42
63,2017,Cameroon,Egypt,5,27,0,32
64,2017,Congo,Egypt,5,19,0,24
65,2017,Dem. Rep. of the Congo,Egypt,40,19,0,59
66,2017,Djibouti,Egypt,5,13,0,18
67,2017,Eritrea,Egypt,2727,9966,0,12693
68,2017,Ethiopia,Egypt,2676,11776,0,14452
69,2017,Palestinian,Egypt,70018,0,0,70018
70,2017,Ghana,Egypt,0,10,0,10
71,2017,Guinea,Egypt,5,15,0,20
72,2017,Cote d'Ivoire,Egypt,113,5,0,118
73,2017,India,Egypt,0,5,0,5
74,2017,Iraq,Egypt,4275,2388,0,6663
75,2017,Jordan,Egypt,0,13,0,13
76,2017,Kenya,Egypt,6,5,0,11
77,2017,Liberia,Egypt,0,13,0,13
78,2017,Mali,Egypt,9,5,0,14
79,2017,Myanmar,Egypt,5,0,0,5
80,2017,Niger,Egypt,0,5,0,5
81,2017,Nigeria,Egypt,17,335,0,352
82,2017,Russian Federation,Egypt,18,47,0,65
83,2017,Saudi Arabia,Egypt,0,6,0,6
84,2017,Sierra Leone,Egypt,5,10,0,15
85,2017,Somalia,Egypt,3252,3395,0,6647
86,2017,Sudan,Egypt,17298,18439,0,35737
87,2017,South Sudan,Egypt,5247,4828,0,10075
88,2017,Syrian Arab Rep.,Egypt,126688,0,0,126688
89,2017,Tajikistan,Egypt,12,29,0,41
90,2017,Turkmenistan,Egypt,5,0,0,5
91,2017,Türkiye,Egypt,0,387,0,387
92,2017,Uganda,Egypt,10,16,0,26
93,2017,Uzbekistan,Egypt,0,73,0,73
94,2017,Yemen,Egypt,85,4500,0,4585
95,2017,Zimbabwe,Egypt,12,47,0,59
98,2017,Afghanistan,Argentina,5,9,0,14
99,2017,Albania,Argentina,18,0,0,18
100,2017,Algeria,Argentina,30,5,0,35
101,2017,Angola,Argentina,14,11,0,25
102,2017,Egypt,Argentina,5,5,0,10
103,2017,Armenia,Argentina,78,180,0,258
104,2017,Burundi,Argentina,5,0,0,5
105,2017,Bangladesh,Argentina,5,57,0,62
106,2017,Bolivia (Plurinational State of),Argentina,5,5,0,10
107,2017,Brazil,Argentina,0,6,0,6
108,2017,Bosnia and Herzegovina,Argentina,6,0,0,6
109,2017,China,Argentina,0,60,0,60
110,2017,Chile,Argentina,33,5,0,38
111,2017,Cameroon,Argentina,6,31,0,37
112,2017,Dem. Rep. of the Congo,Argentina,22,23,0,45
113,2017,Colombia,Argentina,544,188,0,732
114,2017,Costa Rica,Argentina,5,0,0,5
115,2017,Cuba,Argentina,255,583,0,838
116,2017,Dominican Rep.,Argentina,0,283,0,283
117,2017,Ecuador,Argentina,17,5,0,22
118,2017,Ethiopia,Argentina,5,0,0,5
119,2017,Gambia,Argentina,0,10,0,10
120,2017,Palestinian,Argentina,10,9,0,19
121,2017,Georgia,Argentina,5,0,0,5
122,2017,Germany,Argentina,0,5,0,5
123,2017,Ghana,Argentina,38,117,0,155
124,2017,Guinea-Bissau,Argentina,8,5,0,13
125,2017,Guatemala,Argentina,0,5,0,5
126,2017,Guinea,Argentina,9,10,0,19
127,2017,Haiti,Argentina,66,593,0,659
128,2017,Honduras,Argentina,5,5,0,10
129,2017,Hungary,Argentina,0,5,0,5
130,2017,Cote d'Ivoire,Argentina,20,0,0,20
131,2017,India,Argentina,22,114,0,136
132,2017,Iran (Islamic Rep. of),Argentina,23,0,0,23
133,2017,Iraq,Argentina,22,6,0,28
134,2017,Jamaica,Argentina,0,9,0,9
135,2017,Kazakhstan,Argentina,18,5,0,23
136,2017,Kyrgyzstan,Argentina,5,0,0,5
137,2017,Liberia,Argentina,44,0,0,44
138,2017,Libya,Argentina,0,5,0,5
139,2017,Sri Lanka,Argentina,37,0,0,37
140,2017,Mauritania,Argentina,0,5,0,5
141,2017,North Macedonia,Argentina,9,0,0,9
142,2017,Mexico,Argentina,0,5,0,5
143,2017,Mali,Argentina,9,0,0,9
144,2017,Morocco,Argentina,0,11,0,11
145,2017,Nepal,Argentina,0,5,0,5
146,2017,Nigeria,Argentina,42,55,0,97
147,2017,Pakistan,Argentina,32,24,0,56
148,2017,Paraguay,Argentina,8,10,0,18
149,2017,Peru,Argentina,547,26,0,573
150,2017,Philippines,Argentina,0,5,0,5
151,2017,Romania,Argentina,51,0,0,51
152,2017,South Africa,Argentina,0,5,0,5
153,2017,Russian Federation,Argentina,65,75,0,140
154,2017,El Salvador,Argentina,22,24,0,46
155,2017,Senegal,Argentina,42,956,0,998
156,2017,Sierra Leone,Argentina,37,6,0,43
157,2017,Somalia,Argentina,5,0,0,5
158,2017,Spain,Argentina,0,5,0,5
159,2017,Viet Nam,Argentina,0,5,0,5
160,2017,Sudan,Argentina,5,0,0,5
161,2017,Syrian Arab Rep.,Argentina,370,84,0,454
162,2017,Türkiye,Argentina,11,0,0,11
163,2017,Ukraine,Argentina,94,159,0,253
164,2017,United States of America,Argentina,5,15,0,20
165,2017,Venezuela (Bolivarian Republic of),Argentina,0,183,0,183
166,2017,Yemen,Argentina,15,0,0,15
169,2017,Afghanistan,Armenia,0,5,0,5
170,2017,Azerbaijan,Armenia,2034,0,0,2034
171,2017,Palestinian,Armenia,6,0,0,6
172,2017,Georgia,Armenia,8,0,0,8
173,2017,Cote d'Ivoire,Armenia,6,0,0,6
174,2017,Iran (Islamic Rep. of),Armenia,31,19,0,50
175,2017,Iraq,Armenia,1061,5,0,1066
176,2017,Lebanon,Armenia,19,0,0,19
177,2017,Syrian Arab Rep.,Armenia,14680,12,0,14692
178,2017,Türkiye,Armenia,5,10,0,15
179,2017,Ukraine,Armenia,113,0,0,113
180,2017,Uzbekistan,Armenia,0,5,0,5
181,2017,Yemen,Armenia,5,6,0,11
183,2017,Afghanistan,Australia,10922,1795,0,12717
184,2017,Albania,Australia,59,84,0,143
185,2017,Algeria,Australia,10,17,0,27
186,2017,Andorra,Australia,0,5,0,5
187,2017,Angola,Australia,0,5,0,5
188,2017,Antigua and Barbuda,Australia,0,5,0,5
189,2017,Egypt,Australia,1560,230,0,1790
190,2017,Argentina,Australia,0,21,0,21
191,2017,Austria,Australia,0,5,0,5
192,2017,Azerbaijan,Australia,9,13,0,22
193,2017,Bahrain,Australia,97,20,0,117
194,2017,Burundi,Australia,50,35,0,85
195,2017,Bangladesh,Australia,434,857,0,1291
196,2017,Bhutan,Australia,5,19,0,24
197,2017,Belarus,Australia,7,6,0,13
198,2017,Botswana,Australia,0,5,0,5
199,2017,Brazil,Australia,5,27,0,32
200,2017,Brunei Darussalam,Australia,0,9,0,9
201,2017,Bosnia and Herzegovina,Australia,0,15,0,15
202,2017,Bulgaria,Australia,0,6,0,6
203,2017,Cambodia,Australia,31,192,0,223
204,2017,Canada,Australia,0,6,0,6
205,2017,Chad,Australia,5,5,0,10
206,2017,China,Australia,2543,8525,0,11068
207,2017,Chile,Australia,0,14,0,14
208,2017,Cameroon,Australia,42,40,0,82
209,2017,Congo,Australia,13,12,0,25
210,2017,Dem. Rep. of the Congo,Australia,48,61,0,109
211,2017,Colombia,Australia,116,102,0,218
212,2017,Cuba,Australia,0,6,0,6
213,2017,Cyprus,Australia,0,9,0,9
214,2017,Djibouti,Australia,5,5,0,10
215,2017,Dominica,Australia,0,5,0,5
216,2017,Ecuador,Australia,0,5,0,5
217,2017,Eritrea,Australia,138,26,0,164
218,2017,Estonia,Australia,0,6,0,6
219,2017,Ethiopia,Australia,282,267,0,549
220,2017,Fiji,Australia,406,462,0,868
221,2017,Finland,Australia,0,5,0,5
222,2017,France,Australia,0,12,0,12
223,2017,Gabon,Australia,0,5,0,5
224,2017,Gambia,Australia,8,5,0,13
225,2017,Palestinian,Australia,378,150,0,528
226,2017,United Kingdom of Great Britain and Northern Ireland,Australia,5,30,0,35
227,2017,Georgia,Australia,16,13,0,29
228,2017,Germany,Australia,5,10,0,15
229,2017,Ghana,Australia,32,91,0,123
230,2017,Greece,Australia,6,13,0,19
231,2017,Guatemala,Australia,0,5,0,5
232,2017,Guinea,Australia,12,11,0,23
233,2017,Haiti,Australia,0,5,0,5
234,2017,"China, Hong Kong SAR",Australia,5,57,0,62
235,2017,Honduras,Australia,5,6,0,11
236,2017,Hungary,Australia,0,5,0,5
237,2017,Cote d'Ivoire,Australia,5,5,0,10
238,2017,India,Australia,388,2300,0,2688
239,2017,Indonesia,Australia,205,775,0,980
240,2017,Ireland,Australia,0,12,0,12
241,2017,Iran (Islamic Rep. of),Australia,8077,5877,0,13954
242,2017,Iraq,Australia,4042,1563,0,5605
243,2017,Israel,Australia,15,32,0,47
244,2017,Italy,Australia,5,14,0,19
245,2017,Jamaica,Australia,5,5,0,10
246,2017,Jordan,Australia,149,113,0,262
247,2017,Japan,Australia,10,11,0,21
248,2017,Kazakhstan,Australia,7,5,0,12
249,2017,Kenya,Australia,117,81,0,198
250,2017,Kyrgyzstan,Australia,14,15,0,29
251,2017,Rep. of Korea,Australia,45,107,0,152
252,2017,Dem. People's Rep. of Korea,Australia,19,5,0,24
253,2017,Kuwait,Australia,54,5,0,59
254,2017,Lao People's Dem. Rep.,Australia,5,37,0,42
255,2017,Liberia,Australia,37,25,0,62
256,2017,Libya,Australia,992,133,0,1125
257,2017,Lebanon,Australia,548,668,0,1216
258,2017,Sri Lanka,Australia,4489,3258,0,7747
259,2017,Lithuania,Australia,0,6,0,6
260,2017,Madagascar,Australia,0,6,0,6
261,2017,Mauritania,Australia,0,5,0,5
262,2017,North Macedonia,Australia,5,28,0,33
263,2017,Rep. of Moldova,Australia,0,6,0,6
264,2017,Maldives,Australia,10,17,0,27
265,2017,Mexico,Australia,10,10,0,20
266,2017,Mali,Australia,0,6,0,6
267,2017,Malaysia,Australia,240,8539,0,8779
268,2017,Malawi,Australia,0,9,0,9
269,2017,Mongolia,Australia,27,51,0,78
270,2017,Morocco,Australia,12,10,0,22
271,2017,Mozambique,Australia,5,5,0,10
272,2017,Mauritius,Australia,7,59,0,66
273,2017,Myanmar,Australia,516,243,0,759
274,2017,Nepal,Australia,182,327,0,509
275,2017,Nicaragua,Australia,0,5,0,5
276,2017,Nigeria,Australia,187,305,0,492
277,2017,Norway,Australia,0,9,0,9
278,2017,New Zealand,Australia,26,27,0,53
279,2017,Oman,Australia,5,0,0,5
280,2017,Pakistan,Australia,4496,2351,0,6847
281,2017,Peru,Australia,9,21,0,30
282,2017,Philippines,Australia,51,287,0,338
283,2017,Papua New Guinea,Australia,396,372,0,768
284,2017,Poland,Australia,0,5,0,5
285,2017,Portugal,Australia,0,6,0,6
286,2017,Qatar,Australia,0,5,0,5
287,2017,Romania,Australia,9,11,0,20
288,2017,South Africa,Australia,36,88,0,124
289,2017,Russian Federation,Australia,55,33,0,88
290,2017,Rwanda,Australia,64,65,0,129
291,2017,El Salvador,Australia,10,19,0,29
292,2017,Saudi Arabia,Australia,94,97,0,191
293,2017,Serbia and Kosovo: S/RES/1244 (1999),Australia,5,25,0,30
294,2017,Senegal,Australia,0,5,0,5
295,2017,Singapore,Australia,6,6,0,12
296,2017,Sierra Leone,Australia,29,40,0,69
297,2017,Solomon Islands,Australia,21,106,0,127
298,2017,Somalia,Australia,139,257,0,396
299,2017,Viet Nam,Australia,200,1583,0,1783
300,2017,Sudan,Australia,239,303,0,542
301,2017,South Sudan,Australia,7,29,0,36
302,2017,Slovakia,Australia,0,5,0,5
303,2017,Sweden,Australia,0,5,0,5
304,2017,Syrian Arab Rep.,Australia,477,128,0,605
305,2017,United Rep. of Tanzania,Australia,14,14,0,28
306,2017,Thailand,Australia,15,413,0,428
307,2017,Timor-Leste,Australia,8,0,0,8
308,2017,Togo,Australia,5,5,0,10
309,2017,Tonga,Australia,34,96,0,130
310,2017,Tunisia,Australia,5,12,0,17
311,2017,Türkiye,Australia,476,441,0,917
312,2017,United Arab Emirates,Australia,7,5,0,12
313,2017,Uganda,Australia,65,45,0,110
314,2017,Ukraine,Australia,18,82,0,100
315,2017,Uruguay,Australia,0,6,0,6
316,2017,United States of America,Australia,20,35,0,55
317,2017,Uzbekistan,Australia,29,9,0,38
318,2017,Vanuatu,Australia,0,6,0,6
319,2017,Venezuela (Bolivarian Republic of),Australia,26,80,0,106
320,2017,Samoa,Australia,0,11,0,11
321,2017,Yemen,Australia,27,14,0,41
322,2017,Zambia,Australia,10,24,0,34
323,2017,Zimbabwe,Australia,986,117,0,1103
327,2017,Afghanistan,Austria,26939,24233,0,51172
328,2017,Albania,Austria,88,51,0,139
329,2017,Algeria,Austria,43,248,0,291
330,2017,Angola,Austria,82,13,0,95
331,2017,Egypt,Austria,185,257,0,442
332,2017,Armenia,Austria,692,673,0,1365
333,2017,Azerbaijan,Austria,323,214,0,537
334,2017,Burundi,Austria,16,7,0,23
335,2017,Benin,Austria,0,45,0,45
336,2017,Bangladesh,Austria,276,445,0,721
337,2017,Bhutan,Austria,5,0,0,5
338,2017,Burkina Faso,Austria,9,5,0,14
339,2017,Belarus,Austria,82,49,0,131
340,2017,Bolivia (Plurinational State of),Austria,11,0,0,11
341,2017,Bosnia and Herzegovina,Austria,117,31,0,148
342,2017,Chad,Austria,0,5,0,5
343,2017,China,Austria,559,331,0,890
344,2017,Cameroon,Austria,233,89,0,322
345,2017,Congo,Austria,131,15,0,146
346,2017,Dem. Rep. of the Congo,Austria,406,120,0,526
347,2017,Colombia,Austria,0,15,0,15
348,2017,Cuba,Austria,14,19,0,33
349,2017,Eritrea,Austria,303,89,0,392
350,2017,Estonia,Austria,5,0,0,5
351,2017,Ethiopia,Austria,188,145,0,333
352,2017,Gabon,Austria,0,5,0,5
353,2017,Gambia,Austria,134,219,0,353
354,2017,Georgia,Austria,555,734,0,1289
355,2017,Ghana,Austria,31,71,0,102
356,2017,Guinea-Bissau,Austria,5,13,0,18
357,2017,Guatemala,Austria,9,0,0,9
358,2017,Guinea,Austria,142,82,0,224
359,2017,Croatia,Austria,5,0,0,5
360,2017,Cote d'Ivoire,Austria,70,39,0,109
361,2017,India,Austria,63,600,0,663
362,2017,Iran (Islamic Rep. of),Austria,4565,3433,0,7998
363,2017,Iraq,Austria,7414,7805,0,15219
364,2017,Israel,Austria,11,6,0,17
365,2017,Jordan,Austria,62,38,0,100
366,2017,Kazakhstan,Austria,100,88,0,188
367,2017,Kenya,Austria,30,22,0,52
368,2017,Kyrgyzstan,Austria,244,51,0,295
369,2017,Kuwait,Austria,5,7,0,12
370,2017,Liberia,Austria,18,25,0,43
371,2017,Libya,Austria,80,146,0,226
372,2017,Lebanon,Austria,68,157,0,225
373,2017,Sri Lanka,Austria,67,47,0,114
374,2017,Madagascar,Austria,5,0,0,5
375,2017,Mauritania,Austria,5,6,0,11
376,2017,North Macedonia,Austria,75,85,0,160
377,2017,Rep. of Moldova,Austria,66,44,0,110
378,2017,Mali,Austria,11,23,0,34
379,2017,Mongolia,Austria,177,288,0,465
380,2017,Morocco,Austria,30,218,0,248
381,2017,Montenegro,Austria,12,5,0,17
382,2017,Myanmar,Austria,36,14,0,50
383,2017,Nepal,Austria,39,82,0,121
384,2017,Niger,Austria,0,5,0,5
385,2017,Nigeria,Austria,407,1659,0,2066
386,2017,Pakistan,Austria,270,1345,0,1615
387,2017,Philippines,Austria,10,18,0,28
388,2017,Romania,Austria,9,0,0,9
389,2017,South Africa,Austria,5,0,0,5
390,2017,Russian Federation,Austria,11301,2239,0,13540
391,2017,Rwanda,Austria,19,11,0,30
392,2017,Saudi Arabia,Austria,5,0,0,5
393,2017,Serbia and Kosovo: S/RES/1244 (1999),Austria,1216,397,0,1613
394,2017,Senegal,Austria,13,31,0,44
395,2017,Sierra Leone,Austria,26,43,0,69
396,2017,Somalia,Austria,5671,2418,0,8089
397,2017,Viet Nam,Austria,17,16,0,33
398,2017,Sudan,Austria,298,109,0,407
399,2017,South Sudan,Austria,5,12,0,17
400,2017,Syrian Arab Rep.,Austria,43888,3937,0,47825
401,2017,United Rep. of Tanzania,Austria,0,5,0,5
402,2017,Tajikistan,Austria,166,129,0,295
403,2017,Turkmenistan,Austria,7,0,0,7
404,2017,Togo,Austria,12,9,0,21
405,2017,Tunisia,Austria,7,94,0,101
406,2017,Türkiye,Austria,802,529,0,1331
407,2017,Uganda,Austria,23,21,0,44
408,2017,Ukraine,Austria,292,770,0,1062
409,2017,United States of America,Austria,5,0,0,5
410,2017,Uzbekistan,Austria,113,126,0,239
411,2017,Venezuela (Bolivarian Republic of),Austria,0,23,0,23
412,2017,Yemen,Austria,163,120,0,283
413,2017,Zambia,Austria,5,0,0,5
414,2017,Zimbabwe,Austria,22,5,0,27
417,2017,Afghanistan,Azerbaijan,587,70,0,657
418,2017,Azerbaijan,Azerbaijan,0,0,612785,0
419,2017,Palestinian,Azerbaijan,5,0,0,5
420,2017,Iran (Islamic Rep. of),Azerbaijan,56,0,0,56
421,2017,Iraq,Azerbaijan,8,0,0,8
422,2017,Sri Lanka,Azerbaijan,0,5,0,5
423,2017,Pakistan,Azerbaijan,16,8,0,24
424,2017,Russian Federation,Azerbaijan,419,28,0,447
425,2017,Syrian Arab Rep.,Azerbaijan,15,0,0,15
426,2017,Türkiye,Azerbaijan,0,8,0,8
427,2017,Ukraine,Azerbaijan,6,0,0,6
428,2017,Uzbekistan,Azerbaijan,0,5,0,5
429,2017,Yemen,Azerbaijan,8,0,0,8
431,2017,Egypt,Bahrain,0,5,0,5
432,2017,Iraq,Bahrain,246,95,0,341
433,2017,Jordan,Bahrain,0,6,0,6
434,2017,Yemen,Bahrain,9,5,0,14
435,2017,Angola,Burundi,0,5,0,5
436,2017,Burundi,Burundi,0,0,57258,0
437,2017,Benin,Burundi,0,0,0,0
438,2017,Central African Rep.,Burundi,0,6,0,6
439,2017,Dem. Rep. of the Congo,Burundi,61867,2737,0,64604
440,2017,Mali,Burundi,13,5,0,18
441,2017,Rwanda,Burundi,422,793,0,1215
442,2017,Somalia,Burundi,23,0,0,23
443,2017,United Rep. of Tanzania,Burundi,0,0,0,0
444,2017,Türkiye,Burundi,21,5,0,26
445,2017,Uganda,Burundi,7,0,0,7
447,2017,Afghanistan,Belgium,3201,3915,0,7116
448,2017,Albania,Belgium,534,385,0,919
449,2017,Algeria,Belgium,46,100,0,146
450,2017,Angola,Belgium,91,145,0,236
451,2017,Egypt,Belgium,50,75,0,125
452,2017,Armenia,Belgium,127,220,0,347
453,2017,Azerbaijan,Belgium,75,65,0,140
454,2017,Burundi,Belgium,454,355,0,809
455,2017,Benin,Belgium,30,35,0,65
456,2017,Bangladesh,Belgium,18,20,0,38
457,2017,Burkina Faso,Belgium,76,65,0,141
458,2017,Belarus,Belgium,41,45,0,86
459,2017,Brazil,Belgium,0,10,0,10
460,2017,Bosnia and Herzegovina,Belgium,50,40,0,90
461,2017,Bulgaria,Belgium,14,15,0,29
462,2017,Cambodia,Belgium,8,0,0,8
463,2017,Central African Rep.,Belgium,41,15,0,56
464,2017,Chad,Belgium,34,20,0,54
465,2017,China,Belgium,1197,105,0,1302
466,2017,Chile,Belgium,48,10,0,58
467,2017,Cameroon,Belgium,404,360,0,764
468,2017,Congo,Belgium,31,20,0,51
469,2017,Dem. Rep. of the Congo,Belgium,1015,665,0,1680
470,2017,Colombia,Belgium,33,80,0,113
471,2017,Cuba,Belgium,8,5,0,13
472,2017,Czechia,Belgium,6,5,0,11
473,2017,Djibouti,Belgium,267,105,0,372
474,2017,Dominican Rep.,Belgium,0,5,0,5
475,2017,Eritrea,Belgium,1000,350,0,1350
476,2017,Ethiopia,Belgium,121,70,0,191
477,2017,Gabon,Belgium,16,15,0,31
478,2017,Gambia,Belgium,15,45,0,60
479,2017,Palestinian,Belgium,117,535,0,652
480,2017,United Kingdom of Great Britain and Northern Ireland,Belgium,0,5,0,5
481,2017,Georgia,Belgium,49,260,0,309
482,2017,Ghana,Belgium,36,25,0,61
483,2017,Guinea-Bissau,Belgium,11,5,0,16
484,2017,Guatemala,Belgium,6,10,0,16
485,2017,Guinea,Belgium,2690,810,0,3500
486,2017,Haiti,Belgium,5,5,0,10
487,2017,Honduras,Belgium,0,20,0,20
488,2017,Croatia,Belgium,5,0,0,5
489,2017,Hungary,Belgium,49,0,0,49
490,2017,Cote d'Ivoire,Belgium,153,165,0,318
491,2017,India,Belgium,20,40,0,60
492,2017,Iran (Islamic Rep. of),Belgium,960,290,0,1250
493,2017,Iraq,Belgium,4000,2020,0,6020
494,2017,Israel,Belgium,13,10,0,23
495,2017,Jordan,Belgium,24,40,0,64
496,2017,Kazakhstan,Belgium,38,30,0,68
497,2017,Kenya,Belgium,22,5,0,27
498,2017,Kyrgyzstan,Belgium,64,40,0,104
499,2017,Dem. People's Rep. of Korea,Belgium,36,5,0,41
500,2017,Kuwait,Belgium,7,0,0,7
501,2017,Lao People's Dem. Rep.,Belgium,13,0,0,13
502,2017,Liberia,Belgium,15,10,0,25
503,2017,Libya,Belgium,60,45,0,105
504,2017,Lebanon,Belgium,99,155,0,254
505,2017,Sri Lanka,Belgium,394,100,0,494
506,2017,Lithuania,Belgium,7,0,0,7
507,2017,Madagascar,Belgium,5,5,0,10
508,2017,Mauritania,Belgium,206,135,0,341
509,2017,North Macedonia,Belgium,113,135,0,248
510,2017,Rep. of Moldova,Belgium,5,15,0,20
511,2017,Mexico,Belgium,0,5,0,5
512,2017,Mali,Belgium,61,55,0,116
513,2017,Mongolia,Belgium,0,5,0,5
514,2017,Morocco,Belgium,70,130,0,200
515,2017,Montenegro,Belgium,0,5,0,5
516,2017,Myanmar,Belgium,9,0,0,9
517,2017,Nepal,Belgium,13,20,0,33
518,2017,Niger,Belgium,91,60,0,151
519,2017,Nigeria,Belgium,43,70,0,113
520,2017,Pakistan,Belgium,222,155,0,377
521,2017,Peru,Belgium,0,5,0,5
522,2017,Philippines,Belgium,0,5,0,5
523,2017,Poland,Belgium,154,0,0,154
524,2017,Romania,Belgium,38,20,0,58
525,2017,South Africa,Belgium,5,5,0,10
526,2017,Russian Federation,Belgium,2558,825,0,3383
527,2017,Rwanda,Belgium,803,420,0,1223
528,2017,El Salvador,Belgium,7,205,0,212
529,2017,Saudi Arabia,Belgium,5,0,0,5
530,2017,Serbia and Kosovo: S/RES/1244 (1999),Belgium,155,310,0,465
531,2017,Senegal,Belgium,435,210,0,645
532,2017,Sierra Leone,Belgium,26,35,0,61
533,2017,Somalia,Belgium,1280,365,0,1645
534,2017,Viet Nam,Belgium,40,5,0,45
535,2017,Sudan,Belgium,174,75,0,249
536,2017,Suriname,Belgium,0,5,0,5
537,2017,South Sudan,Belgium,0,5,0,5
538,2017,Slovakia,Belgium,0,15,0,15
539,2017,Syrian Arab Rep.,Belgium,9080,1665,0,10745
540,2017,United Rep. of Tanzania,Belgium,50,25,0,75
541,2017,Tajikistan,Belgium,10,5,0,15
542,2017,Turkmenistan,Belgium,5,0,0,5
543,2017,Togo,Belgium,176,105,0,281
544,2017,Tunisia,Belgium,37,30,0,67
545,2017,Türkiye,Belgium,587,715,0,1302
546,2017,Uganda,Belgium,20,10,0,30
547,2017,Ukraine,Belgium,166,195,0,361
548,2017,United States of America,Belgium,0,5,0,5
549,2017,Uzbekistan,Belgium,32,15,0,47
550,2017,Venezuela (Bolivarian Republic of),Belgium,6,220,0,226
551,2017,Yemen,Belgium,24,5,0,29
552,2017,Zimbabwe,Belgium,0,5,0,5
555,2017,Burundi,Benin,5,0,0,5
556,2017,Central African Rep.,Benin,848,132,0,980
557,2017,Chad,Benin,0,6,0,6
558,2017,Cameroon,Benin,0,10,0,10
559,2017,Congo,Benin,0,7,0,7
560,2017,Dem. Rep. of the Congo,Benin,7,24,0,31
561,2017,Eritrea,Benin,5,0,0,5
562,2017,Cote d'Ivoire,Benin,162,20,0,182
563,2017,Liberia,Benin,0,5,0,5
564,2017,Sri Lanka,Benin,7,0,0,7
565,2017,Mali,Benin,5,12,0,17
566,2017,Nigeria,Benin,0,5,0,5
567,2017,Pakistan,Benin,5,0,0,5
568,2017,Syrian Arab Rep.,Benin,7,5,0,12
569,2017,Togo,Benin,0,28,0,28
570,2017,Türkiye,Benin,5,0,0,5
571,2017,Yemen,Benin,0,8,0,8
572,2017,Dem. Rep. of the Congo,Bangladesh,0,5,0,5
573,2017,Myanmar,Bangladesh,932204,0,0,932204
574,2017,Somalia,Bangladesh,5,5,0,10
575,2017,Türkiye,Bangladesh,0,105,0,105
577,2017,Cuba,Bahamas,8,10,0,18
578,2017,Haiti,Bahamas,0,5,0,5
579,2017,Burundi,Burkina Faso,30,0,0,30
580,2017,Burkina Faso,Burkina Faso,0,0,2350,0
581,2017,Central African Rep.,Burkina Faso,167,43,0,210
582,2017,Chad,Burkina Faso,82,0,0,82
583,2017,Cameroon,Burkina Faso,6,0,0,6
584,2017,Congo,Burkina Faso,26,0,0,26
585,2017,Dem. Rep. of the Congo,Burkina Faso,33,0,0,33
586,2017,Cote d'Ivoire,Burkina Faso,5,0,0,5
587,2017,Mali,Burkina Faso,23766,0,0,23766
588,2017,Rwanda,Burkina Faso,23,0,0,23
589,2017,Togo,Burkina Faso,14,0,0,14
590,2017,Afghanistan,Belarus,209,0,0,209
591,2017,Egypt,Belarus,5,0,0,5
592,2017,Armenia,Belarus,5,0,0,5
593,2017,Azerbaijan,Belarus,5,0,0,5
594,2017,Bangladesh,Belarus,0,5,0,5
595,2017,Ethiopia,Belarus,5,0,0,5
596,2017,Palestinian,Belarus,5,0,0,5
597,2017,Georgia,Belarus,59,0,0,59
598,2017,Iran (Islamic Rep. of),Belarus,5,0,0,5
599,2017,Iraq,Belarus,13,8,0,21
600,2017,Libya,Belarus,9,0,0,9
601,2017,Syrian Arab Rep.,Belarus,87,0,0,87
602,2017,Tajikistan,Belarus,12,0,0,12
603,2017,Türkiye,Belarus,0,5,0,5
604,2017,Ukraine,Belarus,1694,255,0,1949
605,2017,Yemen,Belarus,42,0,0,42
607,2017,Chile,Bolivia (Plurinational State of),8,0,0,8
608,2017,Colombia,Bolivia (Plurinational State of),213,21,0,234
609,2017,Cuba,Bolivia (Plurinational State of),9,0,0,9
610,2017,Ecuador,Bolivia (Plurinational State of),5,0,0,5
611,2017,Cote d'Ivoire,Bolivia (Plurinational State of),5,0,0,5
612,2017,Iraq,Bolivia (Plurinational State of),16,0,0,16
613,2017,Nigeria,Bolivia (Plurinational State of),0,5,0,5
614,2017,Pakistan,Bolivia (Plurinational State of),5,0,0,5
615,2017,Peru,Bolivia (Plurinational State of),515,0,0,515
616,2017,Russian Federation,Bolivia (Plurinational State of),5,0,0,5
617,2017,Syrian Arab Rep.,Bolivia (Plurinational State of),21,8,0,29
618,2017,Angola,Botswana,0,0,0,0
619,2017,Burundi,Botswana,46,5,0,51
620,2017,Dem. Rep. of the Congo,Botswana,84,22,0,106
621,2017,Eritrea,Botswana,10,0,0,10
622,2017,Ethiopia,Botswana,5,0,0,5
623,2017,Kenya,Botswana,5,0,0,5
624,2017,Namibia,Botswana,923,11,0,934
625,2017,Rwanda,Botswana,20,0,0,20
626,2017,Somalia,Botswana,314,9,0,323
627,2017,Sudan,Botswana,12,0,0,12
628,2017,Uganda,Botswana,21,0,0,21
629,2017,Zimbabwe,Botswana,676,18,0,694
630,2017,Afghanistan,Brazil,99,165,0,264
631,2017,Albania,Brazil,0,6,0,6
632,2017,Algeria,Brazil,7,18,0,25
633,2017,Angola,Brazil,1112,4717,0,5829
634,2017,Egypt,Brazil,32,274,0,306
635,2017,Argentina,Brazil,11,44,0,55
636,2017,Armenia,Brazil,5,5,0,10
637,2017,Burundi,Brazil,39,25,0,64
638,2017,Belgium,Brazil,0,5,0,5
639,2017,Benin,Brazil,0,212,0,212
640,2017,Bangladesh,Brazil,10,4017,0,4027
641,2017,Bhutan,Brazil,30,35,0,65
642,2017,Burkina Faso,Brazil,5,189,0,194
643,2017,Bolivia (Plurinational State of),Brazil,153,382,0,535
644,2017,Bosnia and Herzegovina,Brazil,5,0,0,5
645,2017,Bulgaria,Brazil,0,5,0,5
646,2017,Canada,Brazil,0,5,0,5
647,2017,Central African Rep.,Brazil,5,6,0,11
648,2017,China,Brazil,5,2252,0,2257
649,2017,Chile,Brazil,21,16,0,37
650,2017,Cameroon,Brazil,56,332,0,388
651,2017,Congo,Brazil,20,0,0,20
652,2017,Dem. Rep. of the Congo,Brazil,1368,2816,0,4184
653,2017,Colombia,Brazil,1291,1417,0,2708
654,2017,Costa Rica,Brazil,0,6,0,6
655,2017,Cuba,Brazil,153,4630,0,4783
656,2017,Cabo Verde,Brazil,0,153,0,153
657,2017,Czechia,Brazil,0,5,0,5
658,2017,Denmark,Brazil,0,11,0,11
659,2017,Djibouti,Brazil,0,5,0,5
660,2017,Dominica,Brazil,0,6,0,6
661,2017,Dominican Rep.,Brazil,5,1171,0,1176
662,2017,Ecuador,Brazil,57,66,0,123
663,2017,Equatorial Guinea,Brazil,0,5,0,5
664,2017,Eritrea,Brazil,25,48,0,73
665,2017,Ethiopia,Brazil,26,64,0,90
666,2017,French Guiana,Brazil,0,6,0,6
667,2017,Fiji,Brazil,0,5,0,5
668,2017,France,Brazil,0,25,0,25
669,2017,Gambia,Brazil,6,392,0,398
670,2017,Palestinian,Brazil,490,350,0,840
671,2017,United Kingdom of Great Britain and Northern Ireland,Brazil,0,5,0,5
672,2017,Georgia,Brazil,10,0,0,10
673,2017,Germany,Brazil,0,8,0,8
674,2017,Ghana,Brazil,33,2305,0,2338
675,2017,Guinea-Bissau,Brazil,19,1560,0,1579
676,2017,Greece,Brazil,0,5,0,5
677,2017,Guatemala,Brazil,0,11,0,11
678,2017,Guinea,Brazil,86,869,0,955
679,2017,Guyana,Brazil,0,32,0,32
680,2017,Haiti,Brazil,8,9433,0,9441
681,2017,Honduras,Brazil,0,8,0,8
682,2017,Croatia,Brazil,5,0,0,5
683,2017,Cote d'Ivoire,Brazil,48,164,0,212
684,2017,India,Brazil,0,366,0,366
685,2017,Indonesia,Brazil,0,5,0,5
686,2017,Iran (Islamic Rep. of),Brazil,60,138,0,198
687,2017,Iraq,Brazil,287,342,0,629
688,2017,Israel,Brazil,0,30,0,30
689,2017,Italy,Brazil,0,15,0,15
690,2017,Jamaica,Brazil,0,7,0,7
691,2017,Jordan,Brazil,8,80,0,88
692,2017,Kenya,Brazil,0,73,0,73
693,2017,Rep. of Korea,Brazil,0,48,0,48
694,2017,Kuwait,Brazil,0,6,0,6
695,2017,Liberia,Brazil,259,27,0,286
696,2017,Libya,Brazil,5,35,0,40
697,2017,Lebanon,Brazil,406,1738,0,2144
698,2017,Lesotho,Brazil,0,5,0,5
699,2017,Sri Lanka,Brazil,18,17,0,35
700,2017,Lithuania,Brazil,0,5,0,5
702,2017,Mauritania,Brazil,0,137,0,137
703,2017,North Macedonia,Brazil,6,0,0,6
704,2017,Mexico,Brazil,6,23,0,29
705,2017,Mali,Brazil,74,415,0,489
706,2017,Malaysia,Brazil,0,5,0,5
707,2017,Morocco,Brazil,8,331,0,339
708,2017,Mozambique,Brazil,0,62,0,62
709,2017,Malta,Brazil,0,5,0,5
710,2017,Myanmar,Brazil,0,5,0,5
711,2017,Namibia,Brazil,0,34,0,34
712,2017,Nepal,Brazil,6,143,0,149
713,2017,Niger,Brazil,0,6,0,6
714,2017,Nicaragua,Brazil,0,6,0,6
715,2017,Nigeria,Brazil,119,3102,0,3221
716,2017,Norway,Brazil,0,6,0,6
717,2017,Pakistan,Brazil,260,1660,0,1920
718,2017,Panama,Brazil,0,5,0,5
719,2017,Paraguay,Brazil,8,59,0,67
720,2017,Peru,Brazil,45,81,0,126
721,2017,Philippines,Brazil,0,257,0,257
722,2017,Poland,Brazil,0,6,0,6
723,2017,Portugal,Brazil,0,60,0,60
724,2017,Romania,Brazil,0,13,0,13
725,2017,South Africa,Brazil,5,359,0,364
726,2017,Russian Federation,Brazil,13,20,0,33
727,2017,Rwanda,Brazil,18,5,0,23
728,2017,El Salvador,Brazil,13,24,0,37
729,2017,Saudi Arabia,Brazil,0,11,0,11
730,2017,Serbia and Kosovo: S/RES/1244 (1999),Brazil,92,5,0,97
731,2017,Senegal,Brazil,14,8633,0,8647
732,2017,Sierra Leone,Brazil,152,406,0,558
733,2017,Somalia,Brazil,47,473,0,520
734,2017,Spain,Brazil,0,40,0,40
735,2017,Viet Nam,Brazil,5,5,0,10
736,2017,Sao Tome and Principe,Brazil,0,23,0,23
737,2017,Sudan,Brazil,71,104,0,175
738,2017,Suriname,Brazil,0,10,0,10
739,2017,Sweden,Brazil,0,5,0,5
740,2017,Syrian Arab Rep.,Brazil,2905,4522,0,7427
741,2017,United Rep. of Tanzania,Brazil,7,96,0,103
742,2017,Thailand,Brazil,0,31,0,31
743,2017,Togo,Brazil,30,554,0,584
744,2017,Tunisia,Brazil,0,67,0,67
745,2017,Türkiye,Brazil,5,153,0,158
746,2017,Uganda,Brazil,5,18,0,23
747,2017,Ukraine,Brazil,10,65,0,75
748,2017,Uruguay,Brazil,0,19,0,19
749,2017,United States of America,Brazil,0,32,0,32
750,2017,Vanuatu,Brazil,0,8,0,8
751,2017,Venezuela (Bolivarian Republic of),Brazil,30,22315,0,22345
752,2017,Yemen,Brazil,0,35,0,35
753,2017,Zambia,Brazil,0,5,0,5
754,2017,Zimbabwe,Brazil,5,9,0,14
758,2017,Afghanistan,Bosnia and Herzegovina,0,9,0,9
759,2017,Algeria,Bosnia and Herzegovina,0,72,0,72
760,2017,Bosnia and Herzegovina,Bosnia and Herzegovina,0,0,98574,0
761,2017,Palestinian,Bosnia and Herzegovina,5,5,0,10
762,2017,Croatia,Bosnia and Herzegovina,5120,0,0,5120
763,2017,Iran (Islamic Rep. of),Bosnia and Herzegovina,0,5,0,5
764,2017,Iraq,Bosnia and Herzegovina,5,0,0,5
765,2017,Libya,Bosnia and Herzegovina,0,21,0,21
766,2017,North Macedonia,Bosnia and Herzegovina,5,0,0,5
767,2017,Morocco,Bosnia and Herzegovina,0,22,0,22
768,2017,Nepal,Bosnia and Herzegovina,0,5,0,5
769,2017,Pakistan,Bosnia and Herzegovina,0,29,0,29
770,2017,Russian Federation,Bosnia and Herzegovina,0,12,0,12
771,2017,Serbia and Kosovo: S/RES/1244 (1999),Bosnia and Herzegovina,69,0,0,69
772,2017,Syrian Arab Rep.,Bosnia and Herzegovina,15,13,0,28
773,2017,Türkiye,Bosnia and Herzegovina,5,30,0,35
775,2017,Afghanistan,Bulgaria,169,752,0,921
776,2017,Algeria,Bulgaria,0,23,0,23
777,2017,Egypt,Bulgaria,8,9,0,17
778,2017,Armenia,Bulgaria,15,13,0,28
779,2017,Bangladesh,Bulgaria,8,18,0,26
780,2017,China,Bulgaria,0,15,0,15
781,2017,Cameroon,Bulgaria,0,5,0,5
782,2017,Congo,Bulgaria,8,0,0,8
783,2017,Dem. Rep. of the Congo,Bulgaria,0,7,0,7
784,2017,Eritrea,Bulgaria,5,10,0,15
785,2017,Ethiopia,Bulgaria,13,0,0,13
786,2017,Ghana,Bulgaria,0,8,0,8
787,2017,Cote d'Ivoire,Bulgaria,5,5,0,10
788,2017,India,Bulgaria,5,5,0,10
789,2017,Iran (Islamic Rep. of),Bulgaria,60,116,0,176
790,2017,Iraq,Bulgaria,1221,1046,0,2267
791,2017,Jordan,Bulgaria,7,0,0,7
792,2017,Kazakhstan,Bulgaria,0,5,0,5
793,2017,Kyrgyzstan,Bulgaria,0,7,0,7
794,2017,Lebanon,Bulgaria,23,5,0,28
795,2017,Sri Lanka,Bulgaria,0,5,0,5
796,2017,Mali,Bulgaria,5,7,0,12
797,2017,Morocco,Bulgaria,5,0,0,5
798,2017,Nigeria,Bulgaria,0,6,0,6
799,2017,Pakistan,Bulgaria,12,99,0,111
800,2017,Russian Federation,Bulgaria,0,20,0,20
801,2017,Somalia,Bulgaria,50,6,0,56
802,2017,Sudan,Bulgaria,16,0,0,16
803,2017,Syrian Arab Rep.,Bulgaria,16549,407,0,16956
804,2017,Tunisia,Bulgaria,0,5,0,5
805,2017,Türkiye,Bulgaria,12,20,0,32
806,2017,Ukraine,Bulgaria,0,50,0,50
807,2017,Yemen,Bulgaria,11,0,0,11
809,2017,Guatemala,Belize,0,447,0,447
810,2017,Honduras,Belize,0,601,0,601
811,2017,Nicaragua,Belize,0,5,0,5
812,2017,Peru,Belize,0,5,0,5
813,2017,El Salvador,Belize,0,2052,0,2052
815,2017,Sri Lanka,Cambodia,5,0,0,5
816,2017,Myanmar,Cambodia,19,5,0,24
817,2017,Pakistan,Cambodia,5,0,0,5
818,2017,Viet Nam,Cambodia,32,31,0,63
819,2017,Thailand,Cambodia,0,8,0,8
820,2017,Afghanistan,Canada,3356,717,0,4073
821,2017,Albania,Canada,853,261,0,1114
822,2017,Algeria,Canada,390,240,0,630
823,2017,Angola,Canada,99,267,0,366
824,2017,Antigua and Barbuda,Canada,94,43,0,137
825,2017,Egypt,Canada,1329,734,0,2063
826,2017,Argentina,Canada,26,21,0,47
827,2017,Armenia,Canada,85,16,0,101
828,2017,Australia,Canada,0,5,0,5
829,2017,Austria,Canada,0,9,0,9
830,2017,Azerbaijan,Canada,297,424,0,721
831,2017,Bahrain,Canada,46,17,0,63
832,2017,Barbados,Canada,167,55,0,222
833,2017,Burundi,Canada,2022,591,0,2613
834,2017,Belgium,Canada,14,13,0,27
835,2017,Benin,Canada,54,23,0,77
836,2017,Bangladesh,Canada,905,578,0,1483
837,2017,Bahamas,Canada,194,169,0,363
838,2017,Bhutan,Canada,7,0,0,7
839,2017,Burkina Faso,Canada,95,52,0,147
840,2017,Belarus,Canada,95,20,0,115
841,2017,Bolivia (Plurinational State of),Canada,50,0,0,50
842,2017,Botswana,Canada,255,29,0,284
843,2017,Brazil,Canada,64,378,0,442
844,2017,Bosnia and Herzegovina,Canada,35,9,0,44
845,2017,Bulgaria,Canada,135,27,0,162
846,2017,Belize,Canada,16,7,0,23
847,2017,Cambodia,Canada,71,22,0,93
848,2017,Central African Rep.,Canada,70,11,0,81
849,2017,Chad,Canada,427,303,0,730
850,2017,China,Canada,7180,2216,0,9396
851,2017,Chile,Canada,52,97,0,149
852,2017,Cameroon,Canada,1039,297,0,1336
853,2017,Congo,Canada,281,89,0,370
854,2017,Dem. Rep. of the Congo,Canada,1816,668,0,2484
855,2017,Comoros,Canada,5,0,0,5
856,2017,Colombia,Canada,8049,1567,0,9616
857,2017,Costa Rica,Canada,15,12,0,27
858,2017,Cuba,Canada,836,100,0,936
859,2017,Cyprus,Canada,0,11,0,11
860,2017,Czechia,Canada,420,275,0,695
861,2017,Denmark,Canada,0,5,0,5
862,2017,Djibouti,Canada,801,477,0,1278
863,2017,Dominica,Canada,5,10,0,15
864,2017,Dominican Rep.,Canada,124,67,0,191
865,2017,Ecuador,Canada,59,29,0,88
866,2017,Equatorial Guinea,Canada,13,7,0,20
867,2017,Eritrea,Canada,2131,865,0,2996
868,2017,Estonia,Canada,5,0,0,5
869,2017,Ethiopia,Canada,1631,633,0,2264
870,2017,Fiji,Canada,60,10,0,70
871,2017,Finland,Canada,0,5,0,5
872,2017,France,Canada,10,23,0,33
873,2017,Gabon,Canada,36,11,0,47
874,2017,Gambia,Canada,82,56,0,138
875,2017,Palestinian,Canada,777,626,0,1403
876,2017,United Kingdom of Great Britain and Northern Ireland,Canada,11,0,0,11
877,2017,Georgia,Canada,276,297,0,573
878,2017,Germany,Canada,0,16,0,16
879,2017,Ghana,Canada,298,277,0,575
880,2017,Guinea-Bissau,Canada,9,5,0,14
881,2017,Greece,Canada,14,29,0,43
882,2017,Grenada,Canada,64,11,0,75
883,2017,Guatemala,Canada,554,225,0,779
884,2017,Guinea,Canada,442,132,0,574
885,2017,Guyana,Canada,148,102,0,250
886,2017,Haiti,Canada,6874,7097,0,13971
887,2017,"China, Hong Kong SAR",Canada,6,21,0,27
888,2017,Honduras,Canada,934,280,0,1214
889,2017,Croatia,Canada,204,219,0,423
890,2017,Hungary,Canada,2912,1463,0,4375
891,2017,Cote d'Ivoire,Canada,253,90,0,343
892,2017,India,Canada,1281,1767,0,3048
893,2017,Indonesia,Canada,119,56,0,175
894,2017,Ireland,Canada,0,10,0,10
895,2017,Iran (Islamic Rep. of),Canada,2197,647,0,2844
896,2017,Iraq,Canada,2792,890,0,3682
897,2017,Israel,Canada,181,110,0,291
898,2017,Italy,Canada,0,55,0,55
899,2017,Jamaica,Canada,893,238,0,1131
900,2017,Jordan,Canada,353,295,0,648
901,2017,Japan,Canada,0,10,0,10
902,2017,Kazakhstan,Canada,126,70,0,196
903,2017,Kenya,Canada,463,155,0,618
904,2017,Kyrgyzstan,Canada,61,24,0,85
905,2017,Rep. of Korea,Canada,102,33,0,135
906,2017,Dem. People's Rep. of Korea,Canada,484,409,0,893
907,2017,Kuwait,Canada,86,9,0,95
908,2017,Lao People's Dem. Rep.,Canada,5,0,0,5
909,2017,Liberia,Canada,91,30,0,121
910,2017,Libya,Canada,1118,405,0,1523
911,2017,Saint Lucia,Canada,967,141,0,1108
912,2017,Lebanon,Canada,838,402,0,1240
913,2017,Sri Lanka,Canada,4195,868,0,5063
914,2017,Lithuania,Canada,20,19,0,39
915,2017,Latvia,Canada,75,8,0,83
916,2017,Madagascar,Canada,16,10,0,26
917,2017,Mauritania,Canada,151,59,0,210
918,2017,North Macedonia,Canada,43,8,0,51
919,2017,Rep. of Moldova,Canada,121,21,0,142
920,2017,Mexico,Canada,3846,1408,0,5254
921,2017,Mali,Canada,142,92,0,234
922,2017,Malaysia,Canada,32,15,0,47
923,2017,Malawi,Canada,16,17,0,33
924,2017,Mongolia,Canada,143,36,0,179
925,2017,Morocco,Canada,151,59,0,210
926,2017,Montenegro,Canada,19,10,0,29
927,2017,Mauritius,Canada,5,8,0,13
928,2017,Myanmar,Canada,60,5,0,65
929,2017,Namibia,Canada,360,54,0,414
930,2017,Nepal,Canada,557,188,0,745
931,2017,Netherlands,Canada,5,18,0,23
932,2017,Niger,Canada,57,29,0,86
933,2017,Nicaragua,Canada,82,19,0,101
934,2017,Nigeria,Canada,4800,5632,0,10432
935,2017,Norway,Canada,0,5,0,5
936,2017,Oman,Canada,9,0,0,9
937,2017,Pakistan,Canada,4971,1991,0,6962
938,2017,Panama,Canada,16,23,0,39
939,2017,Paraguay,Canada,21,0,0,21
940,2017,Peru,Canada,252,108,0,360
941,2017,Philippines,Canada,96,64,0,160
942,2017,Papua New Guinea,Canada,5,0,0,5
943,2017,Poland,Canada,125,109,0,234
944,2017,Portugal,Canada,0,12,0,12
945,2017,Qatar,Canada,12,0,0,12
946,2017,Romania,Canada,193,228,0,421
947,2017,South Africa,Canada,58,111,0,169
948,2017,Russian Federation,Canada,877,202,0,1079
949,2017,Rwanda,Canada,1013,197,0,1210
950,2017,El Salvador,Canada,1354,629,0,1983
951,2017,Saudi Arabia,Canada,277,176,0,453
952,2017,Serbia and Kosovo: S/RES/1244 (1999),Canada,288,34,0,322
953,2017,Senegal,Canada,238,60,0,298
954,2017,Seychelles,Canada,5,0,0,5
955,2017,Singapore,Canada,15,5,0,20
956,2017,Sierra Leone,Canada,72,27,0,99
957,2017,Solomon Islands,Canada,28,0,0,28
958,2017,Somalia,Canada,3035,948,0,3983
959,2017,Spain,Canada,6,37,0,43
960,2017,Viet Nam,Canada,44,38,0,82
961,2017,Saint Kitts and Nevis,Canada,40,11,0,51
962,2017,Sudan,Canada,802,609,0,1411
963,2017,Suriname,Canada,8,0,0,8
964,2017,South Sudan,Canada,12,0,0,12
965,2017,Slovakia,Canada,696,664,0,1360
966,2017,Slovenia,Canada,5,9,0,14
967,2017,Eswatini,Canada,141,14,0,155
968,2017,Syrian Arab Rep.,Canada,3095,807,0,3902
969,2017,United Rep. of Tanzania,Canada,147,74,0,221
970,2017,Turks and Caicos Islands,Canada,0,5,0,5
971,2017,Thailand,Canada,17,8,0,25
972,2017,Tajikistan,Canada,44,11,0,55
973,2017,Turkmenistan,Canada,13,8,0,21
974,2017,Togo,Canada,110,47,0,157
975,2017,Trinidad and Tobago,Canada,135,26,0,161
976,2017,Tunisia,Canada,189,67,0,256
977,2017,Türkiye,Canada,2833,1778,0,4611
978,2017,United Arab Emirates,Canada,35,11,0,46
979,2017,Uganda,Canada,541,189,0,730
980,2017,Ukraine,Canada,1126,432,0,1558
981,2017,Uruguay,Canada,7,5,0,12
982,2017,United States of America,Canada,48,1939,0,1987
983,2017,Uzbekistan,Canada,172,69,0,241
984,2017,Saint Vincent and the Grenadines,Canada,1253,109,0,1362
985,2017,Venezuela (Bolivarian Republic of),Canada,1345,1059,0,2404
986,2017,Yemen,Canada,648,694,0,1342
987,2017,Zambia,Canada,28,13,0,41
988,2017,Zimbabwe,Canada,1146,142,0,1288
991,2017,Angola,Central African Rep.,14,0,0,14
992,2017,Burundi,Central African Rep.,24,0,0,24
993,2017,Central African Rep.,Central African Rep.,0,0,688700,0
994,2017,Chad,Central African Rep.,3184,42,0,3226
995,2017,Cameroon,Central African Rep.,5,6,0,11
996,2017,Congo,Central African Rep.,13,8,0,21
997,2017,Dem. Rep. of the Congo,Central African Rep.,4025,472,0,4497
998,2017,Guinea,Central African Rep.,7,0,0,7
999,2017,Cote d'Ivoire,Central African Rep.,9,0,0,9
1000,2017,Liberia,Central African Rep.,5,5,0,10
1001,2017,Rwanda,Central African Rep.,184,11,0,195
1002,2017,Sudan,Central African Rep.,502,12,0,514
1003,2017,South Sudan,Central African Rep.,2049,9,0,2058
1004,2017,Togo,Central African Rep.,0,6,0,6
1005,2017,Türkiye,Central African Rep.,7,0,0,7
1006,2017,Uganda,Central African Rep.,5,0,0,5
1007,2017,Cuba,Cayman Islands,24,28,0,52
1008,2017,Mexico,Cayman Islands,5,0,0,5
1009,2017,Burundi,Chad,5,0,0,5
1010,2017,Central African Rep.,Chad,76653,469,0,77122
1011,2017,Chad,Chad,0,0,99983,0
1012,2017,Cameroon,Chad,11,5,0,16
1013,2017,Congo,Chad,9,5,0,14
1014,2017,Dem. Rep. of the Congo,Chad,316,51,0,367
1015,2017,Eritrea,Chad,6,6,0,12
1016,2017,Ethiopia,Chad,13,14,0,27
1017,2017,Cote d'Ivoire,Chad,5,0,0,5
1018,2017,Iran (Islamic Rep. of),Chad,5,0,0,5
1019,2017,Libya,Chad,9,5,0,14
1020,2017,Mali,Chad,0,0,0,0
1021,2017,Niger,Chad,495,0,0,495
1022,2017,Nigeria,Chad,9541,5,0,9546
1023,2017,Rwanda,Chad,17,0,0,17
1024,2017,Somalia,Chad,10,0,0,10
1025,2017,Sudan,Chad,324327,62,0,324389
1026,2017,South Sudan,Chad,8,0,0,8
1027,2017,Syrian Arab Rep.,Chad,39,29,0,68
1028,2017,Türkiye,Chad,6,0,0,6
1029,2017,Yemen,Chad,0,9,0,9
1031,2017,Afghanistan,China,8,18,0,26
1032,2017,Burundi,China,5,5,0,10
1033,2017,Benin,China,0,5,0,5
1034,2017,Cameroon,China,0,103,0,103
1035,2017,Dem. Rep. of the Congo,China,5,16,0,21
1036,2017,Eritrea,China,0,5,0,5
1037,2017,Gambia,China,0,10,0,10
1038,2017,Palestinian,China,9,6,0,15
1039,2017,Ghana,China,5,38,0,43
1040,2017,Guinea,China,0,11,0,11
1041,2017,Cote d'Ivoire,China,0,12,0,12
1042,2017,Iraq,China,12,19,0,31
1043,2017,Kenya,China,0,6,0,6
1044,2017,Liberia,China,0,125,0,125
1045,2017,Mozambique,China,0,14,0,14
1046,2017,Nigeria,China,0,54,0,54
1047,2017,Pakistan,China,18,15,0,33
1048,2017,Rwanda,China,0,8,0,8
1049,2017,Sierra Leone,China,0,18,0,18
1050,2017,Somalia,China,91,19,0,110
1051,2017,Viet Nam,China,321502,0,0,321502
1052,2017,Syrian Arab Rep.,China,42,32,0,74
1053,2017,Türkiye,China,0,15,0,15
1054,2017,Uganda,China,5,38,0,43
1055,2017,Yemen,China,7,15,0,22
1056,2017,Zimbabwe,China,5,84,0,89
1057,2017,Afghanistan,Chile,13,12,0,25
1058,2017,Angola,Chile,0,8,0,8
1059,2017,Egypt,Chile,0,5,0,5
1060,2017,Bangladesh,Chile,0,5,0,5
1061,2017,Bolivia (Plurinational State of),Chile,0,21,0,21
1062,2017,Congo,Chile,8,5,0,13
1063,2017,Dem. Rep. of the Congo,Chile,6,0,0,6
1064,2017,Colombia,Chile,1117,4765,0,5882
1065,2017,Costa Rica,Chile,5,0,0,5
1066,2017,Cuba,Chile,18,1649,0,1667
1067,2017,Dominican Rep.,Chile,0,150,0,150
1068,2017,Ecuador,Chile,23,31,0,54
1069,2017,Palestinian,Chile,11,16,0,27
1070,2017,Ghana,Chile,0,9,0,9
1071,2017,Haiti,Chile,0,32,0,32
1072,2017,Honduras,Chile,0,5,0,5
1073,2017,Iraq,Chile,0,5,0,5
1074,2017,Kenya,Chile,5,0,0,5
1075,2017,Rep. of Korea,Chile,0,5,0,5
1076,2017,Sri Lanka,Chile,5,0,0,5
1077,2017,Mexico,Chile,0,5,0,5
1078,2017,Pakistan,Chile,0,7,0,7
1079,2017,Peru,Chile,113,22,0,135
1080,2017,Russian Federation,Chile,0,12,0,12
1081,2017,El Salvador,Chile,9,20,0,29
1082,2017,Senegal,Chile,5,5,0,10
1083,2017,Syrian Arab Rep.,Chile,85,42,0,127
1084,2017,Türkiye,Chile,5,30,0,35
1085,2017,United States of America,Chile,0,5,0,5
1086,2017,Venezuela (Bolivarian Republic of),Chile,0,1586,0,1586
1087,2017,Yemen,Chile,0,5,0,5
1089,2017,Angola,Cameroon,5,0,0,5
1090,2017,Burundi,Cameroon,60,27,0,87
1091,2017,Burkina Faso,Cameroon,0,7,0,7
1092,2017,Central African Rep.,Cameroon,248843,4744,0,253587
1093,2017,Chad,Cameroon,1521,326,0,1847
1094,2017,Cameroon,Cameroon,0,0,221695,0
1095,2017,Congo,Cameroon,51,18,0,69
1096,2017,Dem. Rep. of the Congo,Cameroon,523,144,0,667
1097,2017,Gabon,Cameroon,0,5,0,5
1098,2017,Gambia,Cameroon,0,5,0,5
1099,2017,Guinea-Bissau,Cameroon,0,7,0,7
1100,2017,Guinea,Cameroon,11,100,0,111
1101,2017,Cote d'Ivoire,Cameroon,68,79,0,147
1102,2017,Iran (Islamic Rep. of),Cameroon,5,0,0,5
1103,2017,Liberia,Cameroon,9,0,0,9
1104,2017,Mauritania,Cameroon,5,5,0,10
1105,2017,Mali,Cameroon,0,53,0,53
1106,2017,Morocco,Cameroon,7,0,0,7
1107,2017,Niger,Cameroon,0,5,0,5
1108,2017,Nigeria,Cameroon,85319,6,0,85325
1109,2017,Rwanda,Cameroon,832,172,0,1004
1110,2017,Senegal,Cameroon,0,11,0,11
1111,2017,Sudan,Cameroon,79,27,0,106
1112,2017,South Sudan,Cameroon,12,0,0,12
1113,2017,Syrian Arab Rep.,Cameroon,15,9,0,24
1114,2017,Togo,Cameroon,17,0,0,17
1115,2017,Türkiye,Cameroon,0,15,0,15
1116,2017,Algeria,Congo,0,5,0,5
1117,2017,Angola,Congo,318,77,0,395
1118,2017,Burundi,Congo,98,14,0,112
1119,2017,Central African Rep.,Congo,26403,4388,0,30791
1120,2017,Chad,Congo,37,28,0,65
1121,2017,Cameroon,Congo,5,10,0,15
1122,2017,Congo,Congo,0,0,107828,0
1123,2017,Dem. Rep. of the Congo,Congo,12316,1872,0,14188
1124,2017,Guinea,Congo,0,8,0,8
1125,2017,Cote d'Ivoire,Congo,5,30,0,35
1126,2017,Liberia,Congo,0,7,0,7
1127,2017,Mauritania,Congo,0,60,0,60
1128,2017,Mali,Congo,6,12,0,18
1129,2017,Nigeria,Congo,6,0,0,6
1130,2017,Rwanda,Congo,9275,516,0,9791
1131,2017,Sierra Leone,Congo,5,0,0,5
1132,2017,Sudan,Congo,26,35,0,61
1133,2017,South Sudan,Congo,0,13,0,13
1134,2017,Syrian Arab Rep.,Congo,9,12,0,21
1135,2017,Türkiye,Congo,0,5,0,5
1136,2017,Angola,Dem. Rep. of the Congo,494,13,0,507
1137,2017,Burundi,Dem. Rep. of the Congo,44450,225,0,44675
1138,2017,Central African Rep.,Dem. Rep. of the Congo,181917,180,0,182097
1139,2017,Chad,Dem. Rep. of the Congo,5,16,0,21
1140,2017,Cameroon,Dem. Rep. of the Congo,0,17,0,17
1141,2017,Congo,Dem. Rep. of the Congo,661,29,0,690
1142,2017,Dem. Rep. of the Congo,Dem. Rep. of the Congo,0,0,4351376,0
1143,2017,Eritrea,Dem. Rep. of the Congo,5,0,0,5
1144,2017,Cote d'Ivoire,Dem. Rep. of the Congo,7,7,0,14
1145,2017,Kenya,Dem. Rep. of the Congo,0,5,0,5
1146,2017,Liberia,Dem. Rep. of the Congo,5,19,0,24
1147,2017,Mali,Dem. Rep. of the Congo,0,15,0,15
1148,2017,Nepal,Dem. Rep. of the Congo,0,5,0,5
1149,2017,Nigeria,Dem. Rep. of the Congo,0,5,0,5
1150,2017,Rwanda,Dem. Rep. of the Congo,220377,181,0,220558
1151,2017,Somalia,Dem. Rep. of the Congo,14,48,0,62
1152,2017,Sudan,Dem. Rep. of the Congo,151,0,0,151
1153,2017,South Sudan,Dem. Rep. of the Congo,88970,17,0,88987
1154,2017,Syrian Arab Rep.,Dem. Rep. of the Congo,8,20,0,28
1155,2017,Uganda,Dem. Rep. of the Congo,25,5,0,30
1156,2017,Afghanistan,Colombia,8,0,0,8
1157,2017,Bolivia (Plurinational State of),Colombia,5,0,0,5
1158,2017,Colombia,Colombia,0,0,7677609,0
1159,2017,Cuba,Colombia,71,25,0,96
1160,2017,Ecuador,Colombia,9,0,0,9
1161,2017,Eritrea,Colombia,5,0,0,5
1162,2017,Ethiopia,Colombia,17,0,0,17
1163,2017,Honduras,Colombia,5,0,0,5
1164,2017,Hungary,Colombia,7,0,0,7
1165,2017,Iraq,Colombia,9,0,0,9
1166,2017,Nicaragua,Colombia,14,0,0,14
1167,2017,Pakistan,Colombia,0,5,0,5
1168,2017,Romania,Colombia,7,0,0,7
1169,2017,El Salvador,Colombia,11,0,0,11
1170,2017,Serbia and Kosovo: S/RES/1244 (1999),Colombia,7,0,0,7
1171,2017,Sierra Leone,Colombia,5,0,0,5
1172,2017,Somalia,Colombia,11,0,0,11
1173,2017,Syrian Arab Rep.,Colombia,8,5,0,13
1174,2017,Türkiye,Colombia,0,14,0,14
1175,2017,Venezuela (Bolivarian Republic of),Colombia,61,469,0,530
1176,2017,Yemen,Colombia,0,7,0,7
1178,2017,Argentina,Costa Rica,0,5,0,5
1179,2017,Bangladesh,Costa Rica,0,16,0,16
1180,2017,Brazil,Costa Rica,0,5,0,5
1181,2017,Canada,Costa Rica,0,5,0,5
1182,2017,Cameroon,Costa Rica,0,19,0,19
1183,2017,Congo,Costa Rica,0,45,0,45
1184,2017,Dem. Rep. of the Congo,Costa Rica,5,16,0,21
1185,2017,Colombia,Costa Rica,2340,657,0,2997
1186,2017,Cuba,Costa Rica,379,213,0,592
1187,2017,Ecuador,Costa Rica,0,9,0,9
1188,2017,Eritrea,Costa Rica,0,5,0,5
1189,2017,Gambia,Costa Rica,0,5,0,5
1190,2017,Germany,Costa Rica,0,5,0,5
1191,2017,Ghana,Costa Rica,0,74,0,74
1192,2017,Guatemala,Costa Rica,26,19,0,45
1193,2017,Guinea,Costa Rica,0,5,0,5
1194,2017,Haiti,Costa Rica,12,72,0,84
1195,2017,Honduras,Costa Rica,144,296,0,440
1196,2017,Cote d'Ivoire,Costa Rica,0,5,0,5
1197,2017,India,Costa Rica,5,0,0,5
1198,2017,Iran (Islamic Rep. of),Costa Rica,5,0,0,5
1199,2017,Israel,Costa Rica,0,5,0,5
1200,2017,Mexico,Costa Rica,6,10,0,16
1201,2017,Nepal,Costa Rica,0,107,0,107
1202,2017,Niger,Costa Rica,0,7,0,7
1203,2017,Nicaragua,Costa Rica,461,73,0,534
1204,2017,Nigeria,Costa Rica,19,5,0,24
1205,2017,Pakistan,Costa Rica,0,11,0,11
1206,2017,Panama,Costa Rica,5,5,0,10
1207,2017,Peru,Costa Rica,15,0,0,15
1208,2017,Russian Federation,Costa Rica,19,5,0,24
1209,2017,El Salvador,Costa Rica,667,2037,0,2704
1210,2017,Senegal,Costa Rica,0,6,0,6
1211,2017,Somalia,Costa Rica,7,7,0,14
1212,2017,Spain,Costa Rica,0,6,0,6
1213,2017,Syrian Arab Rep.,Costa Rica,9,9,0,18
1214,2017,Ukraine,Costa Rica,17,0,0,17
1215,2017,United States of America,Costa Rica,0,15,0,15
1216,2017,Venezuela (Bolivarian Republic of),Costa Rica,338,3438,0,3776
1217,2017,Zimbabwe,Costa Rica,0,5,0,5
1220,2017,Afghanistan,Cuba,45,0,0,45
1221,2017,Eritrea,Cuba,20,0,0,20
1222,2017,Ethiopia,Cuba,5,5,0,10
1223,2017,Palestinian,Cuba,6,0,0,6
1224,2017,Iran (Islamic Rep. of),Cuba,26,10,0,36
1225,2017,Iraq,Cuba,5,0,0,5
1226,2017,Syrian Arab Rep.,Cuba,43,0,0,43
1227,2017,Western Sahara,Cuba,176,0,0,176
1228,2017,Yemen,Cuba,17,0,0,17
1230,2017,Afghanistan,Cyprus,12,5,0,17
1231,2017,Algeria,Cyprus,8,0,0,8
1232,2017,Egypt,Cyprus,98,438,0,536
1233,2017,Armenia,Cyprus,26,20,0,46
1234,2017,Bangladesh,Cyprus,5,274,0,279
1235,2017,Bosnia and Herzegovina,Cyprus,15,0,0,15
1236,2017,China,Cyprus,5,5,0,10
1237,2017,Cameroon,Cyprus,32,185,0,217
1238,2017,Congo,Cyprus,5,32,0,37
1239,2017,Dem. Rep. of the Congo,Cyprus,17,36,0,53
1240,2017,Cuba,Cyprus,0,5,0,5
1241,2017,Eritrea,Cyprus,53,0,0,53
1242,2017,Ethiopia,Cyprus,5,18,0,23
1243,2017,Gambia,Cyprus,0,39,0,39
1244,2017,Palestinian,Cyprus,1964,214,0,2178
1245,2017,Georgia,Cyprus,85,102,0,187
1246,2017,Ghana,Cyprus,0,5,0,5
1247,2017,Guinea,Cyprus,5,9,0,14
1248,2017,Cote d'Ivoire,Cyprus,5,18,0,23
1249,2017,India,Cyprus,7,408,0,415
1250,2017,Iran (Islamic Rep. of),Cyprus,523,131,0,654
1251,2017,Iraq,Cyprus,854,216,0,1070
1252,2017,Jordan,Cyprus,37,45,0,82
1253,2017,Kazakhstan,Cyprus,5,0,0,5
1254,2017,Kyrgyzstan,Cyprus,5,0,0,5
1255,2017,Lebanon,Cyprus,48,31,0,79
1256,2017,Sri Lanka,Cyprus,25,172,0,197
1257,2017,Rep. of Moldova,Cyprus,18,5,0,23
1258,2017,Mali,Cyprus,0,5,0,5
1259,2017,Morocco,Cyprus,0,5,0,5
1260,2017,Nepal,Cyprus,0,102,0,102
1261,2017,Nigeria,Cyprus,9,82,0,91
1262,2017,Pakistan,Cyprus,17,208,0,225
1263,2017,Philippines,Cyprus,12,105,0,117
1264,2017,Russian Federation,Cyprus,76,28,0,104
1265,2017,Rwanda,Cyprus,5,0,0,5
1266,2017,Serbia and Kosovo: S/RES/1244 (1999),Cyprus,59,5,0,64
1267,2017,Senegal,Cyprus,0,5,0,5
1268,2017,Sierra Leone,Cyprus,24,0,0,24
1269,2017,Somalia,Cyprus,148,113,0,261
1270,2017,Viet Nam,Cyprus,0,330,0,330
1271,2017,Sudan,Cyprus,10,5,0,15
1272,2017,Syrian Arab Rep.,Cyprus,5274,1585,0,6859
1273,2017,Tunisia,Cyprus,0,5,0,5
1274,2017,Türkiye,Cyprus,193,78,0,271
1275,2017,Ukraine,Cyprus,30,110,0,140
1276,2017,Uzbekistan,Cyprus,5,5,0,10
1277,2017,Yemen,Cyprus,10,13,0,23
1278,2017,Zimbabwe,Cyprus,0,5,0,5
1281,2017,Afghanistan,Czechia,234,5,0,239
1282,2017,Albania,Czechia,6,0,0,6
1283,2017,Algeria,Czechia,0,5,0,5
1284,2017,Angola,Czechia,19,0,0,19
1285,2017,Armenia,Czechia,69,81,0,150
1286,2017,Azerbaijan,Czechia,31,73,0,104
1287,2017,Belarus,Czechia,364,11,0,375
1288,2017,Bosnia and Herzegovina,Czechia,13,0,0,13
1289,2017,Bulgaria,Czechia,16,0,0,16
1290,2017,China,Czechia,13,81,0,94
1291,2017,Cameroon,Czechia,6,5,0,11
1292,2017,Congo,Czechia,5,0,0,5
1293,2017,Dem. Rep. of the Congo,Czechia,21,5,0,26
1294,2017,Cuba,Czechia,228,43,0,271
1295,2017,Ecuador,Czechia,5,0,0,5
1296,2017,Eritrea,Czechia,17,0,0,17
1297,2017,Ethiopia,Czechia,10,0,0,10
1298,2017,Georgia,Czechia,34,40,0,74
1299,2017,Ghana,Czechia,11,0,0,11
1300,2017,Guinea,Czechia,7,0,0,7
1301,2017,India,Czechia,5,0,0,5
1302,2017,Iran (Islamic Rep. of),Czechia,26,0,0,26
1303,2017,Iraq,Czechia,199,35,0,234
1304,2017,Kazakhstan,Czechia,234,13,0,247
1305,2017,Kyrgyzstan,Czechia,21,6,0,27
1306,2017,Liberia,Czechia,5,0,0,5
1307,2017,Libya,Czechia,9,8,0,17
1308,2017,Lebanon,Czechia,5,0,0,5
1309,2017,Sri Lanka,Czechia,14,5,0,19
1310,2017,Rep. of Moldova,Czechia,25,13,0,38
1311,2017,Mongolia,Czechia,5,5,0,10
1312,2017,Morocco,Czechia,5,0,0,5
1313,2017,Myanmar,Czechia,160,5,0,165
1314,2017,Nigeria,Czechia,13,9,0,22
1315,2017,Pakistan,Czechia,20,8,0,28
1316,2017,Romania,Czechia,81,0,0,81
1317,2017,South Africa,Czechia,5,0,0,5
1318,2017,Russian Federation,Czechia,319,33,0,352
1319,2017,Saudi Arabia,Czechia,5,0,0,5
1320,2017,Serbia and Kosovo: S/RES/1244 (1999),Czechia,9,0,0,9
1321,2017,Sierra Leone,Czechia,5,0,0,5
1322,2017,Somalia,Czechia,22,0,0,22
1323,2017,Viet Nam,Czechia,70,44,0,114
1324,2017,Sudan,Czechia,17,0,0,17
1325,2017,Syrian Arab Rep.,Czechia,365,38,0,403
1326,2017,Tajikistan,Czechia,5,0,0,5
1327,2017,Turkmenistan,Czechia,5,0,0,5
1328,2017,Togo,Czechia,6,0,0,6
1329,2017,Tunisia,Czechia,0,6,0,6
1330,2017,Türkiye,Czechia,8,18,0,26
1331,2017,Uganda,Czechia,5,0,0,5
1332,2017,Ukraine,Czechia,444,186,0,630
1333,2017,Uzbekistan,Czechia,99,9,0,108
1334,2017,Venezuela (Bolivarian Republic of),Czechia,5,0,0,5
1337,2017,Afghanistan,Denmark,2668,769,0,3437
1338,2017,Albania,Denmark,5,10,0,15
1339,2017,Algeria,Denmark,5,17,0,22
1340,2017,Egypt,Denmark,16,8,0,24
1341,2017,Armenia,Denmark,70,47,0,117
1342,2017,Azerbaijan,Denmark,50,29,0,79
1343,2017,Burundi,Denmark,5,5,0,10
1344,2017,Bangladesh,Denmark,20,10,0,30
1345,2017,Bhutan,Denmark,5,0,0,5
1346,2017,Belarus,Denmark,5,25,0,30
1347,2017,Bosnia and Herzegovina,Denmark,5,0,0,5
1348,2017,China,Denmark,17,5,0,22
1349,2017,Cameroon,Denmark,6,13,0,19
1350,2017,Congo,Denmark,5,0,0,5
1351,2017,Dem. Rep. of the Congo,Denmark,87,17,0,104
1352,2017,Colombia,Denmark,5,10,0,15
1353,2017,Eritrea,Denmark,4006,188,0,4194
1354,2017,Ethiopia,Denmark,94,44,0,138
1355,2017,Gambia,Denmark,5,11,0,16
1356,2017,Palestinian,Denmark,24,0,0,24
1357,2017,Georgia,Denmark,5,59,0,64
1358,2017,Ghana,Denmark,5,12,0,17
1359,2017,Guinea-Bissau,Denmark,5,0,0,5
1360,2017,Guinea,Denmark,0,16,0,16
1361,2017,Cote d'Ivoire,Denmark,14,0,0,14
1362,2017,India,Denmark,5,5,0,10
1363,2017,Indonesia,Denmark,0,6,0,6
1364,2017,Iran (Islamic Rep. of),Denmark,3107,841,0,3948
1365,2017,Iraq,Denmark,661,421,0,1082
1366,2017,Jordan,Denmark,5,7,0,12
1367,2017,Kenya,Denmark,6,11,0,17
1368,2017,Kyrgyzstan,Denmark,5,0,0,5
1369,2017,Dem. People's Rep. of Korea,Denmark,9,0,0,9
1370,2017,Kuwait,Denmark,0,95,0,95
1371,2017,Libya,Denmark,11,23,0,34
1372,2017,Lebanon,Denmark,26,30,0,56
1373,2017,Sri Lanka,Denmark,71,19,0,90
1374,2017,North Macedonia,Denmark,0,5,0,5
1375,2017,Rep. of Moldova,Denmark,0,12,0,12
1376,2017,Morocco,Denmark,8,64,0,72
1377,2017,Myanmar,Denmark,45,5,0,50
1378,2017,Nepal,Denmark,7,0,0,7
1379,2017,Nigeria,Denmark,12,45,0,57
1380,2017,Pakistan,Denmark,58,22,0,80
1381,2017,Russian Federation,Denmark,1029,27,0,1056
1382,2017,Rwanda,Denmark,20,0,0,20
1383,2017,El Salvador,Denmark,5,5,0,10
1384,2017,Serbia and Kosovo: S/RES/1244 (1999),Denmark,5,9,0,14
1385,2017,Sierra Leone,Denmark,0,5,0,5
1386,2017,Somalia,Denmark,1292,128,0,1420
1387,2017,Sudan,Denmark,77,8,0,85
1388,2017,Syrian Arab Rep.,Denmark,19221,285,0,19506
1389,2017,Thailand,Denmark,5,0,0,5
1390,2017,Tajikistan,Denmark,5,0,0,5
1391,2017,Tunisia,Denmark,0,7,0,7
1392,2017,Türkiye,Denmark,5,21,0,26
1393,2017,Uganda,Denmark,75,30,0,105
1394,2017,Ukraine,Denmark,26,43,0,69
1395,2017,United States of America,Denmark,0,5,0,5
1396,2017,Uzbekistan,Denmark,11,5,0,16
1397,2017,Venezuela (Bolivarian Republic of),Denmark,0,12,0,12
1398,2017,Yemen,Denmark,5,5,0,10
1399,2017,Zimbabwe,Denmark,13,0,0,13
1402,2017,Eritrea,Djibouti,406,787,0,1193
1403,2017,Ethiopia,Djibouti,527,8504,0,9031
1404,2017,Iraq,Djibouti,14,5,0,19
1405,2017,Kenya,Djibouti,10,0,0,10
1406,2017,Philippines,Djibouti,5,0,0,5
1407,2017,Somalia,Djibouti,13108,56,0,13164
1408,2017,Sudan,Djibouti,6,0,0,6
1409,2017,South Sudan,Djibouti,0,5,0,5
1410,2017,Syrian Arab Rep.,Djibouti,9,0,0,9
1411,2017,Yemen,Djibouti,3468,0,0,3468
1412,2017,Afghanistan,Dominican Rep.,5,7,0,12
1413,2017,Colombia,Dominican Rep.,0,14,0,14
1414,2017,Cuba,Dominican Rep.,0,33,0,33
1415,2017,Ecuador,Dominican Rep.,5,0,0,5
1416,2017,Haiti,Dominican Rep.,574,730,0,1304
1417,2017,Honduras,Dominican Rep.,0,5,0,5
1418,2017,Iraq,Dominican Rep.,5,0,0,5
1419,2017,Syrian Arab Rep.,Dominican Rep.,0,6,0,6
1420,2017,Türkiye,Dominican Rep.,0,5,0,5
1421,2017,Ukraine,Dominican Rep.,5,0,0,5
1422,2017,Venezuela (Bolivarian Republic of),Dominican Rep.,0,50,0,50
1423,2017,Afghanistan,Ecuador,94,63,0,157
1424,2017,Albania,Ecuador,6,0,0,6
1425,2017,Angola,Ecuador,0,26,0,26
1426,2017,Egypt,Ecuador,0,8,0,8
1427,2017,Bangladesh,Ecuador,0,12,0,12
1428,2017,Brazil,Ecuador,5,6,0,11
1429,2017,Canada,Ecuador,0,5,0,5
1430,2017,China,Ecuador,12,0,0,12
1431,2017,Chile,Ecuador,5,6,0,11
1432,2017,Cameroon,Ecuador,0,9,0,9
1433,2017,Congo,Ecuador,5,0,0,5
1434,2017,Dem. Rep. of the Congo,Ecuador,0,14,0,14
1435,2017,Colombia,Ecuador,46616,10310,0,56926
1436,2017,Cuba,Ecuador,212,53,0,265
1437,2017,Dominican Rep.,Ecuador,5,9,0,14
1438,2017,Eritrea,Ecuador,11,0,0,11
1439,2017,Ethiopia,Ecuador,5,0,0,5
1440,2017,Gambia,Ecuador,0,5,0,5
1441,2017,Palestinian,Ecuador,7,5,0,12
1442,2017,Ghana,Ecuador,5,5,0,10
1443,2017,Guinea,Ecuador,9,0,0,9
1444,2017,Haiti,Ecuador,21,7,0,28
1445,2017,India,Ecuador,0,7,0,7
1446,2017,Iran (Islamic Rep. of),Ecuador,23,43,0,66
1447,2017,Iraq,Ecuador,35,33,0,68
1448,2017,Liberia,Ecuador,5,0,0,5
1449,2017,Libya,Ecuador,0,8,0,8
1450,2017,Lebanon,Ecuador,5,5,0,10
1451,2017,Sri Lanka,Ecuador,14,6,0,20
1452,2017,North Macedonia,Ecuador,14,0,0,14
1453,2017,Mexico,Ecuador,0,5,0,5
1454,2017,Mali,Ecuador,5,0,0,5
1455,2017,Morocco,Ecuador,5,0,0,5
1456,2017,Nepal,Ecuador,5,0,0,5
1457,2017,Nigeria,Ecuador,23,13,0,36
1458,2017,Pakistan,Ecuador,25,11,0,36
1459,2017,Peru,Ecuador,80,89,0,169
1460,2017,Philippines,Ecuador,0,6,0,6
1461,2017,Russian Federation,Ecuador,30,0,0,30
1462,2017,El Salvador,Ecuador,0,18,0,18
1463,2017,Saudi Arabia,Ecuador,5,0,0,5
1464,2017,Somalia,Ecuador,7,0,0,7
1465,2017,Spain,Ecuador,5,0,0,5
1466,2017,Viet Nam,Ecuador,5,0,0,5
1467,2017,Sudan,Ecuador,5,0,0,5
1468,2017,Syrian Arab Rep.,Ecuador,39,115,0,154
1469,2017,Turkmenistan,Ecuador,0,8,0,8
1470,2017,Türkiye,Ecuador,0,5,0,5
1471,2017,Ukraine,Ecuador,0,14,0,14
1472,2017,United States of America,Ecuador,6,0,0,6
1473,2017,Uzbekistan,Ecuador,5,0,0,5
1474,2017,Venezuela (Bolivarian Republic of),Ecuador,5,862,0,867
1475,2017,Western Sahara,Ecuador,5,0,0,5
1476,2017,Yemen,Ecuador,0,104,0,104
1477,2017,Zimbabwe,Ecuador,5,0,0,5
1479,2017,Eritrea,Eritrea,0,0,0,0
1480,2017,Ethiopia,Eritrea,30,0,0,30
1481,2017,Somalia,Eritrea,2286,0,0,2286
1482,2017,Sudan,Eritrea,67,0,0,67
1483,2017,South Sudan,Eritrea,9,0,0,9
1484,2017,Afghanistan,Estonia,23,0,0,23
1485,2017,Albania,Estonia,0,5,0,5
1486,2017,Bangladesh,Estonia,5,0,0,5
1487,2017,Belarus,Estonia,7,5,0,12
1488,2017,Eritrea,Estonia,5,0,0,5
1489,2017,Palestinian,Estonia,5,0,0,5
1490,2017,Georgia,Estonia,7,0,0,7
1491,2017,Iran (Islamic Rep. of),Estonia,0,5,0,5
1492,2017,Iraq,Estonia,32,6,0,38
1493,2017,Sri Lanka,Estonia,12,0,0,12
1494,2017,Pakistan,Estonia,5,0,0,5
1495,2017,Russian Federation,Estonia,26,9,0,35
1496,2017,Serbia and Kosovo: S/RES/1244 (1999),Estonia,5,0,0,5
1497,2017,Somalia,Estonia,5,0,0,5
1498,2017,Sudan,Estonia,24,0,0,24
1499,2017,Syrian Arab Rep.,Estonia,151,0,0,151
1500,2017,Türkiye,Estonia,5,0,0,5
1501,2017,Ukraine,Estonia,88,0,0,88
1502,2017,Venezuela (Bolivarian Republic of),Estonia,0,6,0,6
1504,2017,Egypt,Ethiopia,5,0,0,5
1505,2017,Burundi,Ethiopia,58,74,0,132
1506,2017,Dem. Rep. of the Congo,Ethiopia,530,523,0,1053
1507,2017,Cuba,Ethiopia,5,0,0,5
1508,2017,Djibouti,Ethiopia,76,8,0,84
1509,2017,Eritrea,Ethiopia,164605,216,0,164821
1510,2017,Ethiopia,Ethiopia,0,0,1078429,0
1511,2017,Cote d'Ivoire,Ethiopia,5,0,0,5
1512,2017,Iraq,Ethiopia,10,0,0,10
1513,2017,Kenya,Ethiopia,3459,429,0,3888
1514,2017,Rwanda,Ethiopia,10,6,0,16
1515,2017,Somalia,Ethiopia,253779,83,0,253862
1516,2017,Sudan,Ethiopia,43892,497,0,44389
1517,2017,South Sudan,Ethiopia,421373,494,0,421867
1518,2017,Syrian Arab Rep.,Ethiopia,9,67,0,76
1519,2017,Uganda,Ethiopia,18,5,0,23
1520,2017,Yemen,Ethiopia,1578,191,0,1769
1521,2017,Afghanistan,Fiji,7,5,0,12
1522,2017,Pakistan,Fiji,0,5,0,5
1523,2017,Afghanistan,Finland,2571,320,0,2891
1524,2017,Albania,Finland,5,5,0,10
1525,2017,Algeria,Finland,17,10,0,27
1526,2017,Angola,Finland,139,15,0,154
1527,2017,Egypt,Finland,13,12,0,25
1528,2017,Azerbaijan,Finland,43,9,0,52
1529,2017,Burundi,Finland,5,0,0,5
1530,2017,Bangladesh,Finland,22,10,0,32
1531,2017,Burkina Faso,Finland,5,5,0,10
1532,2017,Belarus,Finland,13,10,0,23
1533,2017,Brazil,Finland,5,0,0,5
1534,2017,Bosnia and Herzegovina,Finland,5,0,0,5
1535,2017,Bulgaria,Finland,0,5,0,5
1536,2017,Cambodia,Finland,5,0,0,5
1537,2017,Central African Rep.,Finland,5,0,0,5
1538,2017,China,Finland,90,66,0,156
1539,2017,Cameroon,Finland,90,29,0,119
1540,2017,Congo,Finland,10,0,0,10
1541,2017,Dem. Rep. of the Congo,Finland,158,14,0,172
1542,2017,Cuba,Finland,5,0,0,5
1543,2017,Dominican Rep.,Finland,5,0,0,5
1544,2017,Ecuador,Finland,5,0,0,5
1545,2017,Eritrea,Finland,564,276,0,840
1546,2017,Ethiopia,Finland,144,30,0,174
1547,2017,Gambia,Finland,29,13,0,42
1548,2017,Georgia,Finland,5,45,0,50
1549,2017,Ghana,Finland,52,10,0,62
1550,2017,Guatemala,Finland,5,0,0,5
1551,2017,Guinea,Finland,21,0,0,21
1552,2017,Honduras,Finland,11,0,0,11
1553,2017,Croatia,Finland,10,0,0,10
1554,2017,Cote d'Ivoire,Finland,13,0,0,13
1555,2017,India,Finland,8,9,0,17
1556,2017,Indonesia,Finland,0,10,0,10
1557,2017,Iran (Islamic Rep. of),Finland,877,82,0,959
1558,2017,Iraq,Finland,7849,1057,0,8906
1559,2017,Kazakhstan,Finland,13,0,0,13
1560,2017,Kenya,Finland,13,0,0,13
1561,2017,Kyrgyzstan,Finland,19,0,0,19
1562,2017,Liberia,Finland,5,0,0,5
1563,2017,Libya,Finland,27,5,0,32
1564,2017,Lebanon,Finland,14,0,0,14
1565,2017,Sri Lanka,Finland,107,19,0,126
1566,2017,Mauritania,Finland,5,0,0,5
1567,2017,North Macedonia,Finland,0,5,0,5
1568,2017,Rep. of Moldova,Finland,6,0,0,6
1569,2017,Mali,Finland,6,0,0,6
1570,2017,Morocco,Finland,37,15,0,52
1571,2017,Myanmar,Finland,30,0,0,30
1572,2017,Nigeria,Finland,161,58,0,219
1573,2017,Pakistan,Finland,66,38,0,104
1574,2017,Russian Federation,Finland,761,332,0,1093
1575,2017,Rwanda,Finland,24,12,0,36
1576,2017,El Salvador,Finland,10,0,0,10
1577,2017,Serbia and Kosovo: S/RES/1244 (1999),Finland,96,6,0,102
1578,2017,Senegal,Finland,5,0,0,5
1579,2017,Sierra Leone,Finland,6,0,0,6
1580,2017,Somalia,Finland,3257,188,0,3445
1581,2017,Viet Nam,Finland,5,0,0,5
1582,2017,Sudan,Finland,38,7,0,45
1583,2017,South Sudan,Finland,5,0,0,5
1584,2017,Syrian Arab Rep.,Finland,2370,132,0,2502
1585,2017,United Rep. of Tanzania,Finland,5,0,0,5
1586,2017,Tajikistan,Finland,0,5,0,5
1587,2017,Togo,Finland,5,0,0,5
1588,2017,Tunisia,Finland,5,0,0,5
1589,2017,Türkiye,Finland,145,92,0,237
1590,2017,Uganda,Finland,27,8,0,35
1591,2017,Ukraine,Finland,10,21,0,31
1592,2017,Uzbekistan,Finland,6,0,0,6
1593,2017,Venezuela (Bolivarian Republic of),Finland,5,11,0,16
1594,2017,Yemen,Finland,139,49,0,188
1595,2017,Zambia,Finland,0,5,0,5
1598,2017,Afghanistan,France,13425,4314,0,17739
1599,2017,Albania,France,4349,4229,0,8578
1600,2017,Algeria,France,1654,1424,0,3078
1601,2017,Angola,France,3428,734,0,4162
1602,2017,Egypt,France,886,302,0,1188
1603,2017,Argentina,France,5,0,0,5
1604,2017,Armenia,France,4113,1432,0,5545
1605,2017,Azerbaijan,France,2916,306,0,3222
1606,2017,Bahrain,France,6,0,0,6
1607,2017,Burundi,France,607,195,0,802
1608,2017,Benin,France,36,26,0,62
1609,2017,Bangladesh,France,5160,2451,0,7611
1610,2017,Bhutan,France,117,8,0,125
1611,2017,Burkina Faso,France,193,69,0,262
1612,2017,Belarus,France,514,10,0,524
1613,2017,Bolivia (Plurinational State of),France,36,0,0,36
1614,2017,Brazil,France,12,0,0,12
1615,2017,Bosnia and Herzegovina,France,4085,383,0,4468
1616,2017,Bulgaria,France,71,0,0,71
1617,2017,Cambodia,France,11361,13,0,11374
1618,2017,Central African Rep.,France,2642,790,0,3432
1619,2017,Chad,France,1392,613,0,2005
1620,2017,China,France,4541,900,0,5441
1621,2017,Chile,France,67,0,0,67
1622,2017,Cameroon,France,1041,535,0,1576
1623,2017,Congo,France,3317,961,0,4278
1624,2017,Dem. Rep. of the Congo,France,15697,2850,0,18547
1625,2017,Comoros,France,575,250,0,825
1626,2017,Colombia,France,488,128,0,616
1627,2017,Cuba,France,167,9,0,176
1628,2017,Czechia,France,27,0,0,27
1629,2017,Djibouti,France,256,46,0,302
1630,2017,Dominican Rep.,France,49,241,0,290
1631,2017,Ecuador,France,26,0,0,26
1632,2017,Equatorial Guinea,France,32,5,0,37
1633,2017,Eritrea,France,3768,840,0,4608
1634,2017,Estonia,France,7,0,0,7
1635,2017,Ethiopia,France,1109,554,0,1663
1636,2017,Gabon,France,82,371,0,453
1637,2017,Gambia,France,252,80,0,332
1638,2017,Palestinian,France,813,199,0,1012
1639,2017,Georgia,France,3083,1394,0,4477
1640,2017,Germany,France,6,0,0,6
1641,2017,Ghana,France,516,16,0,532
1642,2017,Guinea-Bissau,France,896,44,0,940
1643,2017,Guatemala,France,14,0,0,14
1644,2017,Guinea,France,7788,3178,0,10966
1645,2017,Guyana,France,16,0,0,16
1646,2017,Haiti,France,3497,3282,0,6779
1647,2017,Honduras,France,6,0,0,6
1648,2017,Croatia,France,62,0,0,62
1649,2017,Hungary,France,65,0,0,65
1650,2017,Cote d'Ivoire,France,3263,2928,0,6191
1651,2017,India,France,213,35,0,248
1652,2017,Indonesia,France,6,0,0,6
1653,2017,Iran (Islamic Rep. of),France,2580,415,0,2995
1654,2017,Iraq,France,7265,946,0,8211
1655,2017,Israel,France,7,0,0,7
1656,2017,Jamaica,France,14,0,0,14
1657,2017,Jordan,France,27,0,0,27
1658,2017,Kazakhstan,France,553,42,0,595
1659,2017,Kenya,France,107,17,0,124
1660,2017,Kyrgyzstan,France,306,10,0,316
1661,2017,Dem. People's Rep. of Korea,France,5,7,0,12
1662,2017,Kuwait,France,77,0,0,77
1663,2017,Lao People's Dem. Rep.,France,6721,0,0,6721
1664,2017,Liberia,France,232,24,0,256
1665,2017,Libya,France,540,519,0,1059
1666,2017,Lebanon,France,135,30,0,165
1667,2017,Sri Lanka,France,24110,1463,0,25573
1668,2017,Lithuania,France,11,0,0,11
1669,2017,Latvia,France,38,0,0,38
1670,2017,Madagascar,France,221,35,0,256
1671,2017,Mauritania,France,5320,526,0,5846
1672,2017,North Macedonia,France,340,492,0,832
1673,2017,Rep. of Moldova,France,322,6,0,328
1674,2017,Mexico,France,23,0,0,23
1675,2017,Mali,France,4381,1030,0,5411
1676,2017,Malaysia,France,9,0,0,9
1677,2017,Mongolia,France,422,48,0,470
1678,2017,Morocco,France,473,359,0,832
1679,2017,Mozambique,France,9,6,0,15
1680,2017,Montenegro,France,86,46,0,132
1681,2017,Mauritius,France,16,8,0,24
1682,2017,Myanmar,France,316,30,0,346
1683,2017,Nepal,France,129,67,0,196
1684,2017,Niger,France,64,44,0,108
1685,2017,Nigeria,France,2101,1857,0,3958
1686,2017,Pakistan,France,1399,1279,0,2678
1687,2017,Paraguay,France,6,0,0,6
1688,2017,Peru,France,298,9,0,307
1689,2017,Poland,France,140,0,0,140
1690,2017,Romania,France,151,0,0,151
1691,2017,South Africa,France,32,0,0,32
1692,2017,Russian Federation,France,15634,1731,0,17365
1693,2017,Rwanda,France,2807,342,0,3149
1694,2017,El Salvador,France,38,5,0,43
1695,2017,Saudi Arabia,France,12,0,0,12
1696,2017,Serbia and Kosovo: S/RES/1244 (1999),France,13376,2294,0,15670
1697,2017,Senegal,France,1094,802,0,1896
1698,2017,Sierra Leone,France,541,70,0,611
1699,2017,Somalia,France,2964,1217,0,4181
1700,2017,Viet Nam,France,7911,18,0,7929
1701,2017,Sao Tome and Principe,France,5,0,0,5
1702,2017,Sudan,France,11337,3832,0,15169
1703,2017,Suriname,France,0,5,0,5
1704,2017,South Sudan,France,27,0,0,27
1705,2017,Slovakia,France,116,0,0,116
1706,2017,Syrian Arab Rep.,France,12520,2394,0,14914
1707,2017,United Rep. of Tanzania,France,8,5,0,13
1708,2017,Thailand,France,6,0,0,6
1709,2017,Tajikistan,France,48,5,0,53
1710,2017,Turkmenistan,France,21,0,0,21
1711,2017,Togo,France,719,184,0,903
1712,2017,Tunisia,France,293,43,0,336
1713,2017,Türkiye,France,10727,1083,0,11810
1714,2017,Uganda,France,120,5,0,125
1715,2017,Ukraine,France,1605,439,0,2044
1716,2017,United States of America,France,0,5,0,5
1717,2017,Uzbekistan,France,212,6,0,218
1718,2017,Venezuela (Bolivarian Republic of),France,123,189,0,312
1719,2017,Western Sahara,France,512,1104,0,1616
1720,2017,Yemen,France,218,11,0,229
1721,2017,Zimbabwe,France,44,0,0,44
1724,2017,Burundi,Gabon,8,0,0,8
1725,2017,Central African Rep.,Gabon,38,0,0,38
1726,2017,Chad,Gabon,570,0,0,570
1727,2017,Cameroon,Gabon,5,0,0,5
1728,2017,Congo,Gabon,86,0,0,86
1729,2017,Dem. Rep. of the Congo,Gabon,74,5,0,79
1730,2017,Equatorial Guinea,Gabon,5,0,0,5
1731,2017,Mauritania,Gabon,8,0,0,8
1732,2017,Sao Tome and Principe,Gabon,26,0,0,26
1733,2017,Sudan,Gabon,5,0,0,5
1734,2017,South Sudan,Gabon,5,0,0,5
1735,2017,Togo,Gabon,15,0,0,15
1736,2017,Congo,Gambia,9,0,0,9
1737,2017,Dem. Rep. of the Congo,Gambia,59,0,0,59
1738,2017,Guinea-Bissau,Gambia,12,0,0,12
1739,2017,Cote d'Ivoire,Gambia,188,0,0,188
1740,2017,Liberia,Gambia,67,0,0,67
1741,2017,Senegal,Gambia,7557,5,0,7562
1742,2017,Sierra Leone,Gambia,119,0,0,119
1743,2017,Somalia,Gambia,5,0,0,5
1744,2017,Togo,Gambia,23,0,0,23
1745,2017,Afghanistan,United Kingdom of Great Britain and Northern Ireland,9858,2347,0,12205
1746,2017,Albania,United Kingdom of Great Britain and Northern Ireland,2423,2991,0,5414
1747,2017,Algeria,United Kingdom of Great Britain and Northern Ireland,323,201,0,524
1748,2017,Angola,United Kingdom of Great Britain and Northern Ireland,195,60,0,255
1749,2017,Antigua and Barbuda,United Kingdom of Great Britain and Northern Ireland,0,5,0,5
1750,2017,Egypt,United Kingdom of Great Britain and Northern Ireland,651,406,0,1057
1751,2017,Argentina,United Kingdom of Great Britain and Northern Ireland,0,5,0,5
1752,2017,Armenia,United Kingdom of Great Britain and Northern Ireland,50,40,0,90
1753,2017,Australia,United Kingdom of Great Britain and Northern Ireland,5,5,0,10
1754,2017,Azerbaijan,United Kingdom of Great Britain and Northern Ireland,79,58,0,137
1755,2017,Bahrain,United Kingdom of Great Britain and Northern Ireland,154,18,0,172
1756,2017,Barbados,United Kingdom of Great Britain and Northern Ireland,5,11,0,16
1757,2017,Burundi,United Kingdom of Great Britain and Northern Ireland,48,23,0,71
1758,2017,Benin,United Kingdom of Great Britain and Northern Ireland,6,14,0,20
1759,2017,Bangladesh,United Kingdom of Great Britain and Northern Ireland,1170,1686,0,2856
1760,2017,Bahamas,United Kingdom of Great Britain and Northern Ireland,5,0,0,5
1761,2017,Bhutan,United Kingdom of Great Britain and Northern Ireland,86,0,0,86
1762,2017,Burkina Faso,United Kingdom of Great Britain and Northern Ireland,5,8,0,13
1763,2017,Belarus,United Kingdom of Great Britain and Northern Ireland,160,24,0,184
1764,2017,Bolivia (Plurinational State of),United Kingdom of Great Britain and Northern Ireland,15,7,0,22
1765,2017,Botswana,United Kingdom of Great Britain and Northern Ireland,19,24,0,43
1766,2017,Brazil,United Kingdom of Great Britain and Northern Ireland,13,36,0,49
1767,2017,Bosnia and Herzegovina,United Kingdom of Great Britain and Northern Ireland,27,5,0,32
1768,2017,Belize,United Kingdom of Great Britain and Northern Ireland,5,0,0,5
1769,2017,Canada,United Kingdom of Great Britain and Northern Ireland,9,7,0,16
1770,2017,Central African Rep.,United Kingdom of Great Britain and Northern Ireland,9,0,0,9
1771,2017,Chad,United Kingdom of Great Britain and Northern Ireland,41,9,0,50
1772,2017,China,United Kingdom of Great Britain and Northern Ireland,1571,773,0,2344
1773,2017,Cameroon,United Kingdom of Great Britain and Northern Ireland,534,209,0,743
1774,2017,Congo,United Kingdom of Great Britain and Northern Ireland,130,36,0,166
1775,2017,Dem. Rep. of the Congo,United Kingdom of Great Britain and Northern Ireland,1103,241,0,1344
1776,2017,Comoros,United Kingdom of Great Britain and Northern Ireland,5,8,0,13
1777,2017,Colombia,United Kingdom of Great Britain and Northern Ireland,40,25,0,65
1778,2017,Cuba,United Kingdom of Great Britain and Northern Ireland,13,0,0,13
1779,2017,Cabo Verde,United Kingdom of Great Britain and Northern Ireland,5,0,0,5
1780,2017,Djibouti,United Kingdom of Great Britain and Northern Ireland,5,5,0,10
1781,2017,Dominica,United Kingdom of Great Britain and Northern Ireland,11,5,0,16
1782,2017,Ecuador,United Kingdom of Great Britain and Northern Ireland,14,5,0,19
1783,2017,Eritrea,United Kingdom of Great Britain and Northern Ireland,13590,950,0,14540
1784,2017,Ethiopia,United Kingdom of Great Britain and Northern Ireland,1387,494,0,1881
1785,2017,Fiji,United Kingdom of Great Britain and Northern Ireland,8,0,0,8
1786,2017,Gambia,United Kingdom of Great Britain and Northern Ireland,1312,136,0,1448
1787,2017,Palestinian,United Kingdom of Great Britain and Northern Ireland,486,238,0,724
1788,2017,Georgia,United Kingdom of Great Britain and Northern Ireland,48,74,0,122
1789,2017,Ghana,United Kingdom of Great Britain and Northern Ireland,278,233,0,511
1790,2017,Guinea-Bissau,United Kingdom of Great Britain and Northern Ireland,7,0,0,7
1791,2017,Greece,United Kingdom of Great Britain and Northern Ireland,5,0,0,5
1792,2017,Grenada,United Kingdom of Great Britain and Northern Ireland,15,15,0,30
1793,2017,Guatemala,United Kingdom of Great Britain and Northern Ireland,5,10,0,15
1794,2017,Guinea,United Kingdom of Great Britain and Northern Ireland,263,48,0,311
1795,2017,Guyana,United Kingdom of Great Britain and Northern Ireland,16,6,0,22
1796,2017,Haiti,United Kingdom of Great Britain and Northern Ireland,0,8,0,8
1797,2017,"China, Hong Kong SAR",United Kingdom of Great Britain and Northern Ireland,0,9,0,9
1798,2017,Honduras,United Kingdom of Great Britain and Northern Ireland,34,6,0,40
1799,2017,Croatia,United Kingdom of Great Britain and Northern Ireland,0,5,0,5
1800,2017,Cote d'Ivoire,United Kingdom of Great Britain and Northern Ireland,220,61,0,281
1801,2017,India,United Kingdom of Great Britain and Northern Ireland,351,1231,0,1582
1802,2017,Indonesia,United Kingdom of Great Britain and Northern Ireland,16,32,0,48
1803,2017,Iran (Islamic Rep. of),United Kingdom of Great Britain and Northern Ireland,16085,2187,0,18272
1804,2017,Iraq,United Kingdom of Great Britain and Northern Ireland,4192,2868,0,7060
1805,2017,Israel,United Kingdom of Great Britain and Northern Ireland,10,6,0,16
1806,2017,Italy,United Kingdom of Great Britain and Northern Ireland,0,5,0,5
1807,2017,Jamaica,United Kingdom of Great Britain and Northern Ireland,358,160,0,518
1808,2017,Jordan,United Kingdom of Great Britain and Northern Ireland,54,39,0,93
1809,2017,Kazakhstan,United Kingdom of Great Britain and Northern Ireland,13,26,0,39
1810,2017,Kenya,United Kingdom of Great Britain and Northern Ireland,277,125,0,402
1811,2017,Kyrgyzstan,United Kingdom of Great Britain and Northern Ireland,28,11,0,39
1812,2017,Rep. of Korea,United Kingdom of Great Britain and Northern Ireland,7,9,0,16
1813,2017,Dem. People's Rep. of Korea,United Kingdom of Great Britain and Northern Ireland,362,36,0,398
1814,2017,Kuwait,United Kingdom of Great Britain and Northern Ireland,542,159,0,701
1815,2017,Liberia,United Kingdom of Great Britain and Northern Ireland,34,5,0,39
1816,2017,Libya,United Kingdom of Great Britain and Northern Ireland,1753,990,0,2743
1817,2017,Saint Lucia,United Kingdom of Great Britain and Northern Ireland,19,16,0,35
1818,2017,Lebanon,United Kingdom of Great Britain and Northern Ireland,150,92,0,242
1819,2017,Lesotho,United Kingdom of Great Britain and Northern Ireland,0,5,0,5
1820,2017,Sri Lanka,United Kingdom of Great Britain and Northern Ireland,5804,1401,0,7205
1821,2017,Lithuania,United Kingdom of Great Britain and Northern Ireland,0,7,0,7
1822,2017,Mauritania,United Kingdom of Great Britain and Northern Ireland,5,0,0,5
1823,2017,North Macedonia,United Kingdom of Great Britain and Northern Ireland,21,5,0,26
1824,2017,Rep. of Moldova,United Kingdom of Great Britain and Northern Ireland,18,0,0,18
1825,2017,Maldives,United Kingdom of Great Britain and Northern Ireland,30,7,0,37
1826,2017,Mexico,United Kingdom of Great Britain and Northern Ireland,9,29,0,38
1827,2017,Mali,United Kingdom of Great Britain and Northern Ireland,24,8,0,32
1828,2017,Malaysia,United Kingdom of Great Britain and Northern Ireland,126,98,0,224
1829,2017,Malawi,United Kingdom of Great Britain and Northern Ireland,319,102,0,421
1830,2017,Mongolia,United Kingdom of Great Britain and Northern Ireland,77,28,0,105
1831,2017,Morocco,United Kingdom of Great Britain and Northern Ireland,167,115,0,282
1832,2017,Mozambique,United Kingdom of Great Britain and Northern Ireland,5,6,0,11
1833,2017,Mauritius,United Kingdom of Great Britain and Northern Ireland,43,61,0,104
1834,2017,Myanmar,United Kingdom of Great Britain and Northern Ireland,836,90,0,926
1835,2017,Namibia,United Kingdom of Great Britain and Northern Ireland,30,101,0,131
1836,2017,Nepal,United Kingdom of Great Britain and Northern Ireland,24,135,0,159
1837,2017,Niger,United Kingdom of Great Britain and Northern Ireland,6,0,0,6
1838,2017,Nigeria,United Kingdom of Great Britain and Northern Ireland,2205,1749,0,3954
1839,2017,Norway,United Kingdom of Great Britain and Northern Ireland,5,0,0,5
1840,2017,Oman,United Kingdom of Great Britain and Northern Ireland,11,11,0,22
1841,2017,Pakistan,United Kingdom of Great Britain and Northern Ireland,7207,2758,0,9965
1842,2017,Philippines,United Kingdom of Great Britain and Northern Ireland,18,72,0,90
1843,2017,Poland,United Kingdom of Great Britain and Northern Ireland,0,5,0,5
1844,2017,Qatar,United Kingdom of Great Britain and Northern Ireland,6,0,0,6
1845,2017,Romania,United Kingdom of Great Britain and Northern Ireland,5,0,0,5
1846,2017,South Africa,United Kingdom of Great Britain and Northern Ireland,168,86,0,254
1847,2017,Russian Federation,United Kingdom of Great Britain and Northern Ireland,484,167,0,651
1848,2017,Rwanda,United Kingdom of Great Britain and Northern Ireland,111,28,0,139
1849,2017,El Salvador,United Kingdom of Great Britain and Northern Ireland,81,45,0,126
1850,2017,Saudi Arabia,United Kingdom of Great Britain and Northern Ireland,129,55,0,184
1851,2017,Serbia and Kosovo: S/RES/1244 (1999),United Kingdom of Great Britain and Northern Ireland,105,46,0,151
1852,2017,Senegal,United Kingdom of Great Britain and Northern Ireland,79,52,0,131
1853,2017,Seychelles,United Kingdom of Great Britain and Northern Ireland,0,5,0,5
1854,2017,Singapore,United Kingdom of Great Britain and Northern Ireland,5,14,0,19
1855,2017,Sierra Leone,United Kingdom of Great Britain and Northern Ireland,292,81,0,373
1856,2017,Somalia,United Kingdom of Great Britain and Northern Ireland,4670,347,0,5017
1857,2017,Viet Nam,United Kingdom of Great Britain and Northern Ireland,1015,1199,0,2214
1858,2017,Saint Kitts and Nevis,United Kingdom of Great Britain and Northern Ireland,6,7,0,13
1859,2017,Sudan,United Kingdom of Great Britain and Northern Ireland,8132,1415,0,9547
1860,2017,South Sudan,United Kingdom of Great Britain and Northern Ireland,32,27,0,59
1861,2017,Eswatini,United Kingdom of Great Britain and Northern Ireland,57,7,0,64
1862,2017,Syrian Arab Rep.,United Kingdom of Great Britain and Northern Ireland,9100,574,0,9674
1863,2017,United Rep. of Tanzania,United Kingdom of Great Britain and Northern Ireland,82,39,0,121
1864,2017,Thailand,United Kingdom of Great Britain and Northern Ireland,29,38,0,67
1865,2017,Tajikistan,United Kingdom of Great Britain and Northern Ireland,12,0,0,12
1866,2017,Turkmenistan,United Kingdom of Great Britain and Northern Ireland,11,5,0,16
1867,2017,Timor-Leste,United Kingdom of Great Britain and Northern Ireland,0,5,0,5
1868,2017,Togo,United Kingdom of Great Britain and Northern Ireland,17,7,0,24
1869,2017,Trinidad and Tobago,United Kingdom of Great Britain and Northern Ireland,64,32,0,96
1870,2017,Tunisia,United Kingdom of Great Britain and Northern Ireland,39,37,0,76
1871,2017,Türkiye,United Kingdom of Great Britain and Northern Ireland,864,700,0,1564
1872,2017,United Arab Emirates,United Kingdom of Great Britain and Northern Ireland,18,5,0,23
1873,2017,Uganda,United Kingdom of Great Britain and Northern Ireland,1156,163,0,1319
1874,2017,Ukraine,United Kingdom of Great Britain and Northern Ireland,110,137,0,247
1875,2017,United States of America,United Kingdom of Great Britain and Northern Ireland,42,52,0,94
1876,2017,Uzbekistan,United Kingdom of Great Britain and Northern Ireland,69,37,0,106
1877,2017,Saint Vincent and the Grenadines,United Kingdom of Great Britain and Northern Ireland,17,10,0,27
1878,2017,Venezuela (Bolivarian Republic of),United Kingdom of Great Britain and Northern Ireland,31,23,0,54
1879,2017,Western Sahara,United Kingdom of Great Britain and Northern Ireland,11,0,0,11
1880,2017,Yemen,United Kingdom of Great Britain and Northern Ireland,453,124,0,577
1881,2017,Zambia,United Kingdom of Great Britain and Northern Ireland,71,26,0,97
1882,2017,Zimbabwe,United Kingdom of Great Britain and Northern Ireland,8236,287,0,8523
1885,2017,Afghanistan,Georgia,5,16,0,21
1886,2017,Egypt,Georgia,19,70,0,89
1887,2017,Azerbaijan,Georgia,6,9,0,15
1888,2017,Bangladesh,Georgia,0,23,0,23
1889,2017,Cameroon,Georgia,0,5,0,5
1890,2017,Congo,Georgia,0,6,0,6
1891,2017,Eritrea,Georgia,0,69,0,69
1892,2017,Georgia,Georgia,0,0,278103,0
1893,2017,Ghana,Georgia,0,5,0,5
1894,2017,India,Georgia,0,12,0,12
1895,2017,Iran (Islamic Rep. of),Georgia,34,37,0,71
1896,2017,Iraq,Georgia,630,28,0,658
1897,2017,Lebanon,Georgia,6,0,0,6
1898,2017,Sri Lanka,Georgia,0,5,0,5
1899,2017,Nigeria,Georgia,0,19,0,19
1900,2017,Pakistan,Georgia,10,40,0,50
1901,2017,Russian Federation,Georgia,259,30,0,289
1902,2017,Saudi Arabia,Georgia,0,5,0,5
1903,2017,Somalia,Georgia,0,24,0,24
1904,2017,Sudan,Georgia,6,5,0,11
1905,2017,Syrian Arab Rep.,Georgia,445,9,0,454
1906,2017,Tajikistan,Georgia,5,0,0,5
1907,2017,Türkiye,Georgia,0,41,0,41
1908,2017,Ukraine,Georgia,654,5,0,659
1909,2017,Yemen,Georgia,5,50,0,55
1912,2017,Afghanistan,Germany,104385,87321,0,191706
1913,2017,Albania,Germany,983,4838,0,5821
1914,2017,Algeria,Germany,524,1748,0,2272
1915,2017,Angola,Germany,803,318,0,1121
1916,2017,Egypt,Germany,1798,3038,0,4836
1917,2017,Argentina,Germany,14,0,0,14
1918,2017,Armenia,Germany,2038,9030,0,11068
1919,2017,Australia,Germany,5,0,0,5
1920,2017,Austria,Germany,5,0,0,5
1921,2017,Azerbaijan,Germany,3313,6788,0,10101
1922,2017,Bahrain,Germany,73,18,0,91
1923,2017,Burundi,Germany,90,44,0,134
1924,2017,Belgium,Germany,6,0,0,6
1925,2017,Benin,Germany,73,270,0,343
1926,2017,Bangladesh,Germany,589,2393,0,2982
1927,2017,Bhutan,Germany,21,15,0,36
1928,2017,Burkina Faso,Germany,72,223,0,295
1929,2017,Belarus,Germany,179,359,0,538
1930,2017,Bolivia (Plurinational State of),Germany,8,0,0,8
1931,2017,Botswana,Germany,5,0,0,5
1932,2017,Brazil,Germany,32,14,0,46
1933,2017,Bosnia and Herzegovina,Germany,1478,963,0,2441
1934,2017,Bulgaria,Germany,82,15,0,97
1935,2017,Cambodia,Germany,27,25,0,52
1936,2017,Canada,Germany,24,5,0,29
1937,2017,Central African Rep.,Germany,32,79,0,111
1938,2017,Chad,Germany,83,295,0,378
1939,2017,China,Germany,1588,1186,0,2774
1940,2017,Chile,Germany,178,0,0,178
1941,2017,Cameroon,Germany,594,2667,0,3261
1942,2017,Congo,Germany,249,119,0,368
1943,2017,Dem. Rep. of the Congo,Germany,1594,718,0,2312
1944,2017,Comoros,Germany,0,18,0,18
1945,2017,Colombia,Germany,67,103,0,170
1946,2017,Cuba,Germany,97,113,0,210
1947,2017,Czechia,Germany,777,0,0,777
1948,2017,Djibouti,Germany,24,18,0,42
1949,2017,Dominican Rep.,Germany,9,5,0,14
1950,2017,Ecuador,Germany,12,5,0,17
1951,2017,Equatorial Guinea,Germany,22,8,0,30
1952,2017,Eritrea,Germany,49253,6905,0,56158
1953,2017,Estonia,Germany,5,0,0,5
1954,2017,Ethiopia,Germany,4230,7192,0,11422
1955,2017,France,Germany,15,0,0,15
1956,2017,Gabon,Germany,8,33,0,41
1957,2017,Gambia,Germany,558,8839,0,9397
1958,2017,United Kingdom of Great Britain and Northern Ireland,Germany,18,5,0,23
1959,2017,Georgia,Germany,502,4673,0,5175
1960,2017,Ghana,Germany,462,2218,0,2680
1961,2017,Guinea-Bissau,Germany,75,296,0,371
1962,2017,Greece,Germany,48,0,0,48
1963,2017,Guatemala,Germany,5,5,0,10
1964,2017,Guinea,Germany,1663,5783,0,7446
1965,2017,Haiti,Germany,16,10,0,26
1966,2017,Honduras,Germany,49,9,0,58
1967,2017,Croatia,Germany,311,5,0,316
1968,2017,Hungary,Germany,259,5,0,264
1969,2017,Iceland,Germany,5,0,0,5
1970,2017,Cote d'Ivoire,Germany,339,2143,0,2482
1971,2017,India,Germany,351,1711,0,2062
1972,2017,Indonesia,Germany,12,17,0,29
1973,2017,Iran (Islamic Rep. of),Germany,38262,17876,0,56138
1974,2017,Iraq,Germany,130640,45672,0,176312
1975,2017,Israel,Germany,33,38,0,71
1976,2017,Italy,Germany,17,33,0,50
1977,2017,Jamaica,Germany,46,63,0,109
1978,2017,Jordan,Germany,318,389,0,707
1979,2017,Japan,Germany,28,0,0,28
1980,2017,Kazakhstan,Germany,95,217,0,312
1981,2017,Kenya,Germany,180,470,0,650
1982,2017,Kyrgyzstan,Germany,165,273,0,438
1983,2017,Rep. of Korea,Germany,45,13,0,58
1984,2017,Dem. People's Rep. of Korea,Germany,92,75,0,167
1985,2017,Kuwait,Germany,31,41,0,72
1986,2017,Lao People's Dem. Rep.,Germany,44,0,0,44
1987,2017,Liberia,Germany,73,301,0,374
1988,2017,Libya,Germany,1379,1692,0,3071
1989,2017,Lebanon,Germany,1390,4148,0,5538
1990,2017,Sri Lanka,Germany,3863,1608,0,5471
1991,2017,Lithuania,Germany,5,0,0,5
1992,2017,Latvia,Germany,12,11,0,23
1993,2017,Madagascar,Germany,0,5,0,5
1994,2017,Mauritania,Germany,33,120,0,153
1995,2017,North Macedonia,Germany,605,2872,0,3477
1996,2017,Rep. of Moldova,Germany,86,445,0,531
1997,2017,Mexico,Germany,13,5,0,18
1998,2017,Mali,Germany,216,1258,0,1474
1999,2017,Malaysia,Germany,10,21,0,31
2000,2017,Malawi,Germany,5,5,0,10
2001,2017,Mongolia,Germany,103,990,0,1093
2002,2017,Morocco,Germany,576,1691,0,2267
2003,2017,Mozambique,Germany,11,27,0,38
2004,2017,Montenegro,Germany,283,436,0,719
2005,2017,Mauritius,Germany,5,5,0,10
2006,2017,Myanmar,Germany,831,134,0,965
2007,2017,Namibia,Germany,0,5,0,5
2008,2017,Nepal,Germany,50,142,0,192
2009,2017,Netherlands,Germany,21,5,0,26
2010,2017,Niger,Germany,44,194,0,238
2011,2017,Nigeria,Germany,3971,19817,0,23788
2012,2017,Norway,Germany,5,0,0,5
2013,2017,New Zealand,Germany,8,0,0,8
2014,2017,Oman,Germany,9,6,0,15
2015,2017,Pakistan,Germany,6572,17952,0,24524
2016,2017,Peru,Germany,38,0,0,38
2017,2017,Philippines,Germany,28,41,0,69
2018,2017,Poland,Germany,666,0,0,666
2019,2017,Portugal,Germany,6,0,0,6
2020,2017,Romania,Germany,163,5,0,168
2021,2017,South Africa,Germany,17,34,0,51
2022,2017,Russian Federation,Germany,6960,19253,0,26213
2023,2017,Rwanda,Germany,207,119,0,326
2024,2017,El Salvador,Germany,11,40,0,51
2025,2017,Saudi Arabia,Germany,105,42,0,147
2026,2017,Serbia and Kosovo: S/RES/1244 (1999),Germany,9232,6947,0,16179
2027,2017,Senegal,Germany,130,704,0,834
2028,2017,Singapore,Germany,7,0,0,7
2029,2017,Sierra Leone,Germany,563,1592,0,2155
2030,2017,Solomon Islands,Germany,8,0,0,8
2031,2017,Somalia,Germany,19508,10344,0,29852
2032,2017,Spain,Germany,17,39,0,56
2033,2017,Viet Nam,Germany,1279,252,0,1531
2034,2017,Sudan,Germany,1974,2290,0,4264
2035,2017,South Sudan,Germany,59,106,0,165
2036,2017,Slovakia,Germany,85,0,0,85
2037,2017,Slovenia,Germany,7,0,0,7
2038,2017,Eswatini,Germany,5,0,0,5
2039,2017,Sweden,Germany,6,0,0,6
2040,2017,Syrian Arab Rep.,Germany,496674,70833,0,567507
2041,2017,United Rep. of Tanzania,Germany,34,151,0,185
2042,2017,Thailand,Germany,26,10,0,36
2043,2017,Tajikistan,Germany,490,2443,0,2933
2044,2017,Turkmenistan,Germany,50,243,0,293
2045,2017,Togo,Germany,1081,947,0,2028
2046,2017,Tunisia,Germany,160,592,0,752
2047,2017,Türkiye,Germany,21120,10761,0,31881
2048,2017,United Arab Emirates,Germany,27,5,0,32
2049,2017,Uganda,Germany,160,292,0,452
2050,2017,Ukraine,Germany,631,3963,0,4594
2051,2017,United States of America,Germany,141,22,0,163
2052,2017,Uzbekistan,Germany,101,132,0,233
2053,2017,Saint Vincent and the Grenadines,Germany,5,0,0,5
2054,2017,Venezuela (Bolivarian Republic of),Germany,80,207,0,287
2055,2017,Yemen,Germany,1171,682,0,1853
2056,2017,Zambia,Germany,7,14,0,21
2057,2017,Zimbabwe,Germany,154,267,0,421
2060,2017,Egypt,Ghana,0,16,0,16
2061,2017,Burundi,Ghana,10,15,0,25
2062,2017,Benin,Ghana,5,0,0,5
2063,2017,Central African Rep.,Ghana,107,73,0,180
2064,2017,Chad,Ghana,30,8,0,38
2065,2017,Cameroon,Ghana,6,5,0,11
2066,2017,Congo,Ghana,5,12,0,17
2067,2017,Dem. Rep. of the Congo,Ghana,41,47,0,88
2068,2017,Eritrea,Ghana,13,130,0,143
2069,2017,Ethiopia,Ghana,6,5,0,11
2070,2017,Palestinian,Ghana,13,5,0,18
2071,2017,Cote d'Ivoire,Ghana,6687,388,0,7075
2072,2017,Iraq,Ghana,11,0,0,11
2073,2017,Liberia,Ghana,1209,0,0,1209
2074,2017,Libya,Ghana,0,8,0,8
2075,2017,Lebanon,Ghana,7,0,0,7
2076,2017,Mali,Ghana,0,5,0,5
2077,2017,Nigeria,Ghana,9,14,0,23
2078,2017,Pakistan,Ghana,26,9,0,35
2079,2017,Rwanda,Ghana,36,0,0,36
2080,2017,Sierra Leone,Ghana,87,5,0,92
2081,2017,Somalia,Ghana,62,17,0,79
2082,2017,Sudan,Ghana,299,303,0,602
2083,2017,South Sudan,Ghana,6,0,0,6
2084,2017,Syrian Arab Rep.,Ghana,39,150,0,189
2085,2017,Togo,Ghana,3425,83,0,3508
2086,2017,Uganda,Ghana,5,0,0,5
2087,2017,Uzbekistan,Ghana,9,0,0,9
2088,2017,Yemen,Ghana,0,5,0,5
2089,2017,Burundi,Guinea-Bissau,11,0,0,11
2090,2017,Congo,Guinea-Bissau,5,0,0,5
2091,2017,Dem. Rep. of the Congo,Guinea-Bissau,5,0,0,5
2092,2017,Gambia,Guinea-Bissau,6,0,0,6
2093,2017,Guinea,Guinea-Bissau,10,0,0,10
2094,2017,Cote d'Ivoire,Guinea-Bissau,15,6,0,21
2095,2017,Liberia,Guinea-Bissau,5,0,0,5
2096,2017,Nigeria,Guinea-Bissau,5,0,0,5
2097,2017,Senegal,Guinea-Bissau,10061,0,0,10061
2098,2017,Sierra Leone,Guinea-Bissau,12,5,0,17
2100,2017,Afghanistan,Greece,4751,6922,0,11673
2101,2017,Albania,Greece,150,2209,0,2359
2102,2017,Algeria,Greece,62,328,0,390
2103,2017,Angola,Greece,5,11,0,16
2104,2017,Egypt,Greece,191,685,0,876
2105,2017,Armenia,Greece,11,99,0,110
2106,2017,Azerbaijan,Greece,5,0,0,5
2107,2017,Burundi,Greece,18,14,0,32
2108,2017,Bangladesh,Greece,244,1618,0,1862
2109,2017,Burkina Faso,Greece,14,20,0,34
2110,2017,Belarus,Greece,5,5,0,10
2111,2017,Botswana,Greece,0,5,0,5
2112,2017,Bosnia and Herzegovina,Greece,0,5,0,5
2113,2017,Central African Rep.,Greece,9,5,0,14
2114,2017,China,Greece,56,341,0,397
2115,2017,Cameroon,Greece,151,290,0,441
2116,2017,Congo,Greece,61,70,0,131
2117,2017,Dem. Rep. of the Congo,Greece,304,797,0,1101
2118,2017,Comoros,Greece,5,8,0,13
2119,2017,Cuba,Greece,0,7,0,7
2120,2017,Dominican Rep.,Greece,7,30,0,37
2121,2017,Equatorial Guinea,Greece,0,8,0,8
2122,2017,Eritrea,Greece,864,191,0,1055
2123,2017,Ethiopia,Greece,296,202,0,498
2124,2017,Gabon,Greece,0,5,0,5
2125,2017,Gambia,Greece,25,22,0,47
2126,2017,Palestinian,Greece,606,622,0,1228
2127,2017,Georgia,Greece,266,985,0,1251
2128,2017,Ghana,Greece,49,74,0,123
2129,2017,Guinea,Greece,63,106,0,169
2130,2017,Haiti,Greece,5,19,0,24
2131,2017,Cote d'Ivoire,Greece,68,53,0,121
2132,2017,India,Greece,27,158,0,185
2133,2017,Indonesia,Greece,12,34,0,46
2134,2017,Iran (Islamic Rep. of),Greece,1059,1140,0,2199
2135,2017,Iraq,Greece,4473,5436,0,9909
2136,2017,Jordan,Greece,8,26,0,34
2137,2017,Kazakhstan,Greece,5,5,0,10
2138,2017,Kenya,Greece,28,8,0,36
2139,2017,Kuwait,Greece,42,210,0,252
2140,2017,Libya,Greece,29,13,0,42
2141,2017,Lebanon,Greece,30,80,0,110
2142,2017,Sri Lanka,Greece,40,58,0,98
2143,2017,Mauritania,Greece,49,8,0,57
2144,2017,North Macedonia,Greece,0,5,0,5
2145,2017,Rep. of Moldova,Greece,11,40,0,51
2146,2017,Mali,Greece,39,61,0,100
2147,2017,Morocco,Greece,107,275,0,382
2148,2017,Myanmar,Greece,30,61,0,91
2149,2017,Nepal,Greece,5,63,0,68
2150,2017,Niger,Greece,5,5,0,10
2151,2017,Nigeria,Greece,265,238,0,503
2152,2017,Pakistan,Greece,726,7705,0,8431
2153,2017,Philippines,Greece,7,6,0,13
2154,2017,Russian Federation,Greece,11,33,0,44
2155,2017,Rwanda,Greece,8,0,0,8
2156,2017,El Salvador,Greece,7,6,0,13
2157,2017,Saudi Arabia,Greece,5,5,0,10
2158,2017,Serbia and Kosovo: S/RES/1244 (1999),Greece,22,10,0,32
2159,2017,Senegal,Greece,49,49,0,98
2160,2017,Sierra Leone,Greece,32,42,0,74
2161,2017,Somalia,Greece,335,194,0,529
2162,2017,Viet Nam,Greece,7,14,0,21
2163,2017,Sudan,Greece,398,72,0,470
2164,2017,South Sudan,Greece,7,12,0,19
2165,2017,Syrian Arab Rep.,Greece,13714,9605,0,23319
2166,2017,United Rep. of Tanzania,Greece,13,11,0,24
2167,2017,Togo,Greece,6,16,0,22
2168,2017,Tunisia,Greece,16,55,0,71
2169,2017,Türkiye,Greece,199,1670,0,1869
2170,2017,Uganda,Greece,21,22,0,43
2171,2017,Ukraine,Greece,134,99,0,233
2172,2017,United States of America,Greece,0,5,0,5
2173,2017,Uzbekistan,Greece,14,0,0,14
2174,2017,Venezuela (Bolivarian Republic of),Greece,0,27,0,27
2175,2017,Western Sahara,Greece,0,6,0,6
2176,2017,Yemen,Greece,158,108,0,266
2177,2017,Zimbabwe,Greece,5,11,0,16
2180,2017,Colombia,Guatemala,8,0,0,8
2181,2017,Honduras,Guatemala,36,8,0,44
2182,2017,Nicaragua,Guatemala,100,0,0,100
2183,2017,El Salvador,Guatemala,206,12,0,218
2184,2017,Venezuela (Bolivarian Republic of),Guatemala,10,8,0,18
2186,2017,Burundi,Guinea,5,0,0,5
2187,2017,Central African Rep.,Guinea,37,0,0,37
2188,2017,Dem. Rep. of the Congo,Guinea,30,19,0,49
2189,2017,Cote d'Ivoire,Guinea,4539,33,0,4572
2190,2017,Liberia,Guinea,298,34,0,332
2191,2017,Sri Lanka,Guinea,8,0,0,8
2192,2017,Mali,Guinea,6,0,0,6
2193,2017,Nigeria,Guinea,7,0,0,7
2194,2017,Rwanda,Guinea,10,0,0,10
2195,2017,Sierra Leone,Guinea,202,22,0,224
2196,2017,Somalia,Guinea,6,0,0,6
2197,2017,Togo,Guinea,8,0,0,8
2198,2017,Dem. Rep. of the Congo,Guyana,7,0,0,7
2199,2017,Pakistan,Guyana,5,0,0,5
2200,2017,Rwanda,Guyana,5,0,0,5
2201,2017,Ethiopia,Haiti,5,0,0,5
2203,2017,Egypt,"China, Hong Kong SAR",5,0,0,5
2204,2017,Indonesia,"China, Hong Kong SAR",5,0,0,5
2205,2017,Sri Lanka,"China, Hong Kong SAR",21,0,0,21
2206,2017,Pakistan,"China, Hong Kong SAR",8,0,0,8
2207,2017,Rwanda,"China, Hong Kong SAR",20,5,0,25
2208,2017,Somalia,"China, Hong Kong SAR",21,0,0,21
2209,2017,Yemen,"China, Hong Kong SAR",5,0,0,5
2210,2017,Honduras,Honduras,0,0,174000,0
2211,2017,Iran (Islamic Rep. of),Honduras,5,0,0,5
2212,2017,Nicaragua,Honduras,6,0,0,6
2213,2017,El Salvador,Honduras,11,11,0,22
2214,2017,Venezuela (Bolivarian Republic of),Honduras,5,0,0,5
2215,2017,Afghanistan,Croatia,45,93,0,138
2216,2017,Albania,Croatia,0,5,0,5
2217,2017,Algeria,Croatia,0,20,0,20
2218,2017,Egypt,Croatia,5,9,0,14
2219,2017,Azerbaijan,Croatia,5,0,0,5
2220,2017,Bangladesh,Croatia,0,15,0,15
2221,2017,Belarus,Croatia,5,0,0,5
2222,2017,Bosnia and Herzegovina,Croatia,37,0,0,37
2223,2017,Congo,Croatia,5,0,0,5
2224,2017,Cuba,Croatia,0,5,0,5
2225,2017,Eritrea,Croatia,19,0,0,19
2226,2017,Palestinian,Croatia,5,5,0,10
2227,2017,Georgia,Croatia,5,0,0,5
2228,2017,Croatia,Croatia,0,0,0,0
2229,2017,India,Croatia,0,7,0,7
2230,2017,Iran (Islamic Rep. of),Croatia,14,52,0,66
2231,2017,Iraq,Croatia,62,31,0,93
2232,2017,Kazakhstan,Croatia,5,0,0,5
2233,2017,Libya,Croatia,5,9,0,14
2234,2017,Mauritania,Croatia,5,0,0,5
2235,2017,Morocco,Croatia,0,7,0,7
2236,2017,Nigeria,Croatia,10,5,0,15
2237,2017,Pakistan,Croatia,5,32,0,37
2238,2017,Russian Federation,Croatia,14,5,0,19
2239,2017,Somalia,Croatia,22,0,0,22
2240,2017,Sudan,Croatia,5,0,0,5
2241,2017,Syrian Arab Rep.,Croatia,194,77,0,271
2242,2017,Tunisia,Croatia,0,15,0,15
2243,2017,Türkiye,Croatia,16,9,0,25
2244,2017,Uganda,Croatia,5,0,0,5
2245,2017,Ukraine,Croatia,5,0,0,5
2246,2017,Uzbekistan,Croatia,5,0,0,5
2247,2017,Yemen,Croatia,5,0,0,5
2250,2017,Afghanistan,Hungary,1412,241,0,1653
2251,2017,Algeria,Hungary,15,5,0,20
2252,2017,Angola,Hungary,5,0,0,5
2253,2017,Egypt,Hungary,13,0,0,13
2254,2017,Armenia,Hungary,47,0,0,47
2255,2017,Azerbaijan,Hungary,16,0,0,16
2256,2017,Bangladesh,Hungary,9,0,0,9
2257,2017,China,Hungary,5,0,0,5
2258,2017,Cameroon,Hungary,35,9,0,44
2259,2017,Congo,Hungary,13,0,0,13
2260,2017,Dem. Rep. of the Congo,Hungary,21,0,0,21
2261,2017,Cuba,Hungary,80,0,0,80
2262,2017,Eritrea,Hungary,48,5,0,53
2263,2017,Ethiopia,Hungary,33,6,0,39
2264,2017,Palestinian,Hungary,87,7,0,94
2265,2017,Georgia,Hungary,62,5,0,67
2266,2017,Germany,Hungary,0,5,0,5
2267,2017,Ghana,Hungary,7,0,0,7
2268,2017,Guinea,Hungary,5,0,0,5
2269,2017,Cote d'Ivoire,Hungary,15,0,0,15
2270,2017,India,Hungary,5,0,0,5
2271,2017,Iran (Islamic Rep. of),Hungary,142,46,0,188
2272,2017,Iraq,Hungary,598,121,0,719
2273,2017,Libya,Hungary,6,0,0,6
2274,2017,Lebanon,Hungary,7,0,0,7
2275,2017,Sri Lanka,Hungary,12,0,0,12
2276,2017,Rep. of Moldova,Hungary,5,0,0,5
2277,2017,Mali,Hungary,5,5,0,10
2278,2017,Myanmar,Hungary,5,0,0,5
2279,2017,Nepal,Hungary,11,0,0,11
2280,2017,Nigeria,Hungary,54,5,0,59
2281,2017,Pakistan,Hungary,55,32,0,87
2282,2017,Russian Federation,Hungary,36,5,0,41
2283,2017,Serbia and Kosovo: S/RES/1244 (1999),Hungary,56,47,0,103
2284,2017,Sierra Leone,Hungary,5,0,0,5
2285,2017,Somalia,Hungary,651,0,0,651
2286,2017,Sudan,Hungary,68,0,0,68
2287,2017,Syrian Arab Rep.,Hungary,925,108,0,1033
2288,2017,Tunisia,Hungary,8,0,0,8
2289,2017,Türkiye,Hungary,34,5,0,39
2290,2017,Uganda,Hungary,6,0,0,6
2291,2017,Ukraine,Hungary,19,0,0,19
2292,2017,Uzbekistan,Hungary,7,0,0,7
2293,2017,Yemen,Hungary,17,0,0,17
2294,2017,Zimbabwe,Hungary,5,0,0,5
2297,2017,Afghanistan,Iceland,44,10,0,54
2298,2017,Albania,Iceland,6,20,0,26
2299,2017,Algeria,Iceland,0,6,0,6
2300,2017,Azerbaijan,Iceland,0,5,0,5
2301,2017,Bangladesh,Iceland,0,5,0,5
2302,2017,Bosnia and Herzegovina,Iceland,0,6,0,6
2303,2017,China,Iceland,5,0,0,5
2304,2017,Eritrea,Iceland,11,0,0,11
2305,2017,Palestinian,Iceland,10,8,0,18
2306,2017,Georgia,Iceland,5,68,0,73
2307,2017,Ghana,Iceland,0,5,0,5
2308,2017,Iran (Islamic Rep. of),Iceland,33,15,0,48
2309,2017,Iraq,Iceland,70,64,0,134
2310,2017,Kazakhstan,Iceland,5,0,0,5
2311,2017,Kenya,Iceland,5,0,0,5
2312,2017,Libya,Iceland,5,5,0,10
2313,2017,Sri Lanka,Iceland,5,0,0,5
2314,2017,North Macedonia,Iceland,5,10,0,15
2315,2017,Mongolia,Iceland,0,5,0,5
2316,2017,Morocco,Iceland,5,8,0,13
2317,2017,Nigeria,Iceland,6,5,0,11
2318,2017,Pakistan,Iceland,11,12,0,23
2319,2017,Russian Federation,Iceland,11,5,0,16
2320,2017,El Salvador,Iceland,8,5,0,13
2321,2017,Serbia and Kosovo: S/RES/1244 (1999),Iceland,5,15,0,20
2322,2017,Senegal,Iceland,0,5,0,5
2323,2017,Somalia,Iceland,13,19,0,32
2324,2017,South Sudan,Iceland,0,5,0,5
2325,2017,Syrian Arab Rep.,Iceland,58,5,0,63
2326,2017,Ukraine,Iceland,15,6,0,21
2327,2017,Yemen,Iceland,0,5,0,5
2330,2017,Burundi,Cote d'Ivoire,34,0,0,34
2331,2017,Benin,Cote d'Ivoire,0,5,0,5
2332,2017,Burkina Faso,Cote d'Ivoire,0,6,0,6
2333,2017,Cambodia,Cote d'Ivoire,5,0,0,5
2334,2017,Central African Rep.,Cote d'Ivoire,332,118,0,450
2335,2017,Chad,Cote d'Ivoire,0,5,0,5
2336,2017,Cameroon,Cote d'Ivoire,0,5,0,5
2337,2017,Congo,Cote d'Ivoire,51,9,0,60
2338,2017,Dem. Rep. of the Congo,Cote d'Ivoire,112,41,0,153
2339,2017,Eritrea,Cote d'Ivoire,0,5,0,5
2340,2017,Ethiopia,Cote d'Ivoire,0,5,0,5
2341,2017,Palestinian,Cote d'Ivoire,0,5,0,5
2342,2017,Guinea,Cote d'Ivoire,0,11,0,11
2343,2017,Cote d'Ivoire,Cote d'Ivoire,0,0,0,0
2344,2017,Liberia,Cote d'Ivoire,907,75,0,982
2345,2017,Mauritania,Cote d'Ivoire,0,5,0,5
2346,2017,Mali,Cote d'Ivoire,5,19,0,24
2347,2017,Nigeria,Cote d'Ivoire,5,18,0,23
2348,2017,Rwanda,Cote d'Ivoire,47,5,0,52
2349,2017,Somalia,Cote d'Ivoire,0,5,0,5
2350,2017,Viet Nam,Cote d'Ivoire,5,0,0,5
2351,2017,Sudan,Cote d'Ivoire,9,0,0,9
2352,2017,Syrian Arab Rep.,Cote d'Ivoire,12,9,0,21
2353,2017,Togo,Cote d'Ivoire,15,17,0,32
2354,2017,Türkiye,Cote d'Ivoire,20,0,0,20
2356,2017,Afghanistan,India,7758,5743,0,13501
2357,2017,Burundi,India,0,5,0,5
2358,2017,China,India,108008,0,0,108008
2359,2017,Cameroon,India,0,19,0,19
2360,2017,Congo,India,0,11,0,11
2361,2017,Dem. Rep. of the Congo,India,49,42,0,91
2362,2017,Eritrea,India,29,6,0,35
2363,2017,Ethiopia,India,20,30,0,50
2364,2017,Palestinian,India,75,0,0,75
2365,2017,Cote d'Ivoire,India,5,7,0,12
2366,2017,Iran (Islamic Rep. of),India,57,12,0,69
2367,2017,Iraq,India,344,110,0,454
2368,2017,Libya,India,0,6,0,6
2369,2017,Sri Lanka,India,61842,0,0,61842
2370,2017,Maldives,India,5,0,0,5
2371,2017,Myanmar,India,18089,3152,0,21241
2372,2017,Nigeria,India,0,8,0,8
2373,2017,Russian Federation,India,0,7,0,7
2374,2017,Rwanda,India,5,0,0,5
2375,2017,Saudi Arabia,India,5,0,0,5
2376,2017,Somalia,India,664,269,0,933
2377,2017,Sudan,India,89,41,0,130
2378,2017,South Sudan,India,6,73,0,79
2379,2017,Syrian Arab Rep.,India,87,17,0,104
2380,2017,Tajikistan,India,0,5,0,5
2381,2017,Uganda,India,0,5,0,5
2382,2017,Ukraine,India,0,6,0,6
2383,2017,Yemen,India,5,934,0,939
2384,2017,Afghanistan,Indonesia,5477,2082,0,7559
2385,2017,Algeria,Indonesia,0,14,0,14
2386,2017,Angola,Indonesia,0,7,0,7
2387,2017,Egypt,Indonesia,14,15,0,29
2388,2017,Bangladesh,Indonesia,0,28,0,28
2389,2017,China,Indonesia,9,10,0,19
2390,2017,Cameroon,Indonesia,0,61,0,61
2391,2017,Dem. Rep. of the Congo,Indonesia,5,14,0,19
2392,2017,Eritrea,Indonesia,32,25,0,57
2393,2017,Ethiopia,Indonesia,143,100,0,243
2394,2017,Palestinian,Indonesia,388,45,0,433
2395,2017,Cote d'Ivoire,Indonesia,0,13,0,13
2396,2017,India,Indonesia,0,7,0,7
2397,2017,Iran (Islamic Rep. of),Indonesia,239,123,0,362
2398,2017,Iraq,Indonesia,560,323,0,883
2399,2017,Kuwait,Indonesia,11,0,0,11
2400,2017,Libya,Indonesia,6,9,0,15
2401,2017,Sri Lanka,Indonesia,389,144,0,533
2402,2017,Mali,Indonesia,0,5,0,5
2403,2017,Myanmar,Indonesia,766,49,0,815
2404,2017,Nigeria,Indonesia,0,24,0,24
2405,2017,Pakistan,Indonesia,372,27,0,399
2406,2017,Senegal,Indonesia,0,5,0,5
2407,2017,Sierra Leone,Indonesia,0,10,0,10
2408,2017,Somalia,Indonesia,976,543,0,1519
2409,2017,Viet Nam,Indonesia,18,0,0,18
2410,2017,Sudan,Indonesia,266,143,0,409
2411,2017,Syrian Arab Rep.,Indonesia,35,27,0,62
2412,2017,Türkiye,Indonesia,0,38,0,38
2413,2017,Yemen,Indonesia,76,125,0,201
2414,2017,Afghanistan,Ireland,230,180,0,410
2415,2017,Albania,Ireland,78,635,0,713
2416,2017,Algeria,Ireland,189,197,0,386
2417,2017,Angola,Ireland,236,20,0,256
2418,2017,Egypt,Ireland,29,39,0,68
2419,2017,Armenia,Ireland,11,9,0,20
2420,2017,Azerbaijan,Ireland,15,0,0,15
2421,2017,Bahrain,Ireland,0,6,0,6
2422,2017,Burundi,Ireland,25,11,0,36
2423,2017,Benin,Ireland,5,0,0,5
2424,2017,Bangladesh,Ireland,30,280,0,310
2425,2017,Bhutan,Ireland,10,0,0,10
2426,2017,Belarus,Ireland,43,7,0,50
2427,2017,Bolivia (Plurinational State of),Ireland,7,11,0,18
2428,2017,Botswana,Ireland,0,18,0,18
2429,2017,Brazil,Ireland,0,57,0,57
2430,2017,Bosnia and Herzegovina,Ireland,14,0,0,14
2431,2017,Central African Rep.,Ireland,9,0,0,9
2432,2017,Chad,Ireland,5,0,0,5
2433,2017,China,Ireland,54,65,0,119
2434,2017,Cameroon,Ireland,85,33,0,118
2435,2017,Congo,Ireland,186,5,0,191
2436,2017,Dem. Rep. of the Congo,Ireland,396,244,0,640
2437,2017,Cuba,Ireland,22,5,0,27
2438,2017,Eritrea,Ireland,48,8,0,56
2439,2017,Ethiopia,Ireland,42,10,0,52
2440,2017,Gambia,Ireland,5,5,0,10
2441,2017,Palestinian,Ireland,94,26,0,120
2442,2017,Georgia,Ireland,70,367,0,437
2443,2017,Ghana,Ireland,26,47,0,73
2444,2017,Guatemala,Ireland,0,5,0,5
2445,2017,Guinea,Ireland,17,0,0,17
2446,2017,Guyana,Ireland,0,5,0,5
2447,2017,Honduras,Ireland,5,0,0,5
2448,2017,Cote d'Ivoire,Ireland,19,5,0,24
2449,2017,India,Ireland,5,98,0,103
2450,2017,Iran (Islamic Rep. of),Ireland,135,26,0,161
2451,2017,Iraq,Ireland,491,96,0,587
2452,2017,Israel,Ireland,5,5,0,10
2453,2017,Jordan,Ireland,7,5,0,12
2454,2017,Kazakhstan,Ireland,35,0,0,35
2455,2017,Kenya,Ireland,56,6,0,62
2456,2017,Kyrgyzstan,Ireland,5,9,0,14
2457,2017,Dem. People's Rep. of Korea,Ireland,5,5,0,10
2458,2017,Kuwait,Ireland,46,26,0,72
2459,2017,Liberia,Ireland,23,5,0,28
2460,2017,Libya,Ireland,255,74,0,329
2461,2017,Lebanon,Ireland,13,5,0,18
2462,2017,Sri Lanka,Ireland,20,11,0,31
2463,2017,Mauritania,Ireland,5,0,0,5
2464,2017,Rep. of Moldova,Ireland,105,8,0,113
2465,2017,Mexico,Ireland,0,6,0,6
2466,2017,Mali,Ireland,8,0,0,8
2467,2017,Malaysia,Ireland,5,16,0,21
2468,2017,Malawi,Ireland,51,177,0,228
2469,2017,Mongolia,Ireland,5,11,0,16
2470,2017,Morocco,Ireland,8,25,0,33
2471,2017,Mozambique,Ireland,6,0,0,6
2472,2017,Montenegro,Ireland,6,0,0,6
2473,2017,Mauritius,Ireland,7,39,0,46
2474,2017,Myanmar,Ireland,9,10,0,19
2475,2017,Nepal,Ireland,0,17,0,17
2476,2017,Niger,Ireland,5,0,0,5
2477,2017,Nigeria,Ireland,421,504,0,925
2478,2017,Pakistan,Ireland,172,940,0,1112
2479,2017,Philippines,Ireland,0,5,0,5
2480,2017,South Africa,Ireland,51,228,0,279
2481,2017,Russian Federation,Ireland,159,31,0,190
2482,2017,Rwanda,Ireland,66,0,0,66
2483,2017,Saudi Arabia,Ireland,10,6,0,16
2484,2017,Serbia and Kosovo: S/RES/1244 (1999),Ireland,200,24,0,224
2485,2017,Senegal,Ireland,0,7,0,7
2486,2017,Sierra Leone,Ireland,53,34,0,87
2487,2017,Somalia,Ireland,480,41,0,521
2488,2017,Viet Nam,Ireland,7,5,0,12
2489,2017,Sudan,Ireland,188,32,0,220
2490,2017,Eswatini,Ireland,15,13,0,28
2491,2017,Syrian Arab Rep.,Ireland,718,138,0,856
2492,2017,United Rep. of Tanzania,Ireland,9,0,0,9
2493,2017,Tajikistan,Ireland,12,0,0,12
2494,2017,Togo,Ireland,37,5,0,42
2495,2017,Tunisia,Ireland,0,14,0,14
2496,2017,Türkiye,Ireland,14,5,0,19
2497,2017,Uganda,Ireland,42,12,0,54
2498,2017,Ukraine,Ireland,110,66,0,176
2499,2017,United States of America,Ireland,0,8,0,8
2500,2017,Uzbekistan,Ireland,24,0,0,24
2501,2017,Venezuela (Bolivarian Republic of),Ireland,11,42,0,53
2502,2017,Yemen,Ireland,5,9,0,14
2503,2017,Zambia,Ireland,5,6,0,11
2504,2017,Zimbabwe,Ireland,252,513,0,765
2507,2017,Afghanistan,Iran (Islamic Rep. of),951142,0,0,951142
2508,2017,Iraq,Iran (Islamic Rep. of),28268,0,0,28268
2509,2017,Kuwait,Iran (Islamic Rep. of),8,0,0,8
2510,2017,Myanmar,Iran (Islamic Rep. of),0,84,0,84
2511,2017,Pakistan,Iran (Islamic Rep. of),10,0,0,10
2512,2017,Uzbekistan,Iran (Islamic Rep. of),7,0,0,7
2513,2017,Afghanistan,Iraq,11,107,0,118
2514,2017,Egypt,Iraq,0,23,0,23
2515,2017,Bahrain,Iraq,0,39,0,39
2516,2017,Eritrea,Iraq,5,0,0,5
2517,2017,Ethiopia,Iraq,0,5,0,5
2518,2017,Palestinian,Iraq,7865,136,0,8001
2519,2017,Indonesia,Iraq,0,5,0,5
2520,2017,Iran (Islamic Rep. of),Iraq,7143,6317,0,13460
2521,2017,Iraq,Iraq,0,0,2615988,0
2522,2017,Jordan,Iraq,9,5,0,14
2523,2017,Kyrgyzstan,Iraq,0,6,0,6
2524,2017,Kuwait,Iraq,0,131,0,131
2525,2017,Lebanon,Iraq,0,5,0,5
2526,2017,Morocco,Iraq,0,5,0,5
2527,2017,Pakistan,Iraq,0,45,0,45
2528,2017,Saudi Arabia,Iraq,0,8,0,8
2529,2017,Somalia,Iraq,0,8,0,8
2530,2017,Sudan,Iraq,64,890,0,954
2531,2017,South Sudan,Iraq,0,14,0,14
2532,2017,Syrian Arab Rep.,Iraq,247057,0,0,247057
2533,2017,Tunisia,Iraq,0,6,0,6
2534,2017,Türkiye,Iraq,15514,5191,0,20705
2535,2017,Uzbekistan,Iraq,0,5,0,5
2536,2017,Yemen,Iraq,0,84,0,84
2538,2017,Egypt,Israel,0,12,0,12
2539,2017,Armenia,Israel,0,29,0,29
2540,2017,Azerbaijan,Israel,0,13,0,13
2541,2017,Belarus,Israel,0,117,0,117
2542,2017,Botswana,Israel,0,5,0,5
2543,2017,Central African Rep.,Israel,0,10,0,10
2544,2017,Chad,Israel,0,8,0,8
2545,2017,China,Israel,0,53,0,53
2546,2017,Cameroon,Israel,0,20,0,20
2547,2017,Congo,Israel,0,28,0,28
2548,2017,Dem. Rep. of the Congo,Israel,209,189,0,398
2549,2017,Colombia,Israel,0,23,0,23
2550,2017,Eritrea,Israel,22010,4553,0,26563
2551,2017,Ethiopia,Israel,89,897,0,986
2552,2017,Georgia,Israel,0,3472,0,3472
2553,2017,Ghana,Israel,0,403,0,403
2554,2017,Guinea,Israel,0,32,0,32
2555,2017,Cote d'Ivoire,Israel,5,23,0,28
2556,2017,India,Israel,0,439,0,439
2557,2017,Iran (Islamic Rep. of),Israel,6,5,0,11
2558,2017,Iraq,Israel,10,0,0,10
2559,2017,Kazakhstan,Israel,0,31,0,31
2560,2017,Kenya,Israel,0,44,0,44
2561,2017,Kyrgyzstan,Israel,0,17,0,17
2562,2017,Dem. People's Rep. of Korea,Israel,5,0,0,5
2563,2017,Lesotho,Israel,0,5,0,5
2564,2017,Sri Lanka,Israel,0,566,0,566
2565,2017,Rep. of Moldova,Israel,0,426,0,426
2566,2017,Mali,Israel,0,6,0,6
2567,2017,Malawi,Israel,0,12,0,12
2568,2017,Mongolia,Israel,0,83,0,83
2569,2017,Myanmar,Israel,0,38,0,38
2570,2017,Nepal,Israel,0,8,0,8
2571,2017,Nigeria,Israel,5,725,0,730
2572,2017,Romania,Israel,0,29,0,29
2573,2017,South Africa,Israel,0,249,0,249
2574,2017,Russian Federation,Israel,0,805,0,805
2575,2017,Sierra Leone,Israel,5,23,0,28
2576,2017,Somalia,Israel,0,13,0,13
2577,2017,Sudan,Israel,3187,4437,0,7624
2578,2017,South Sudan,Israel,126,98,0,224
2579,2017,Türkiye,Israel,0,50,0,50
2580,2017,Uganda,Israel,0,26,0,26
2581,2017,Ukraine,Israel,0,11507,0,11507
2582,2017,Uzbekistan,Israel,0,130,0,130
2583,2017,Zimbabwe,Israel,0,5,0,5
2586,2017,Afghanistan,Italy,17171,322,0,17493
2587,2017,Albania,Italy,538,800,0,1338
2588,2017,Algeria,Italy,186,169,0,355
2589,2017,Angola,Italy,35,28,0,63
2590,2017,Egypt,Italy,1995,968,0,2963
2591,2017,Argentina,Italy,5,13,0,18
2592,2017,Armenia,Italy,289,261,0,550
2593,2017,Azerbaijan,Italy,62,15,0,77
2594,2017,Bahrain,Italy,5,0,0,5
2595,2017,Burundi,Italy,19,10,0,29
2596,2017,Benin,Italy,228,261,0,489
2597,2017,Bangladesh,Italy,5671,18209,0,23880
2598,2017,Bahamas,Italy,0,5,0,5
2599,2017,Burkina Faso,Italy,1014,1431,0,2445
2600,2017,Belarus,Italy,34,36,0,70
2601,2017,Bolivia (Plurinational State of),Italy,13,5,0,18
2602,2017,Brazil,Italy,100,117,0,217
2603,2017,Bosnia and Herzegovina,Italy,618,121,0,739
2604,2017,Cambodia,Italy,5,0,0,5
2605,2017,Central African Rep.,Italy,90,78,0,168
2606,2017,Chad,Italy,448,172,0,620
2607,2017,China,Italy,166,746,0,912
2608,2017,Chile,Italy,8,9,0,17
2609,2017,Cameroon,Italy,1348,2996,0,4344
2610,2017,Congo,Italy,425,139,0,564
2611,2017,Dem. Rep. of the Congo,Italy,556,144,0,700
2612,2017,Comoros,Italy,0,38,0,38
2613,2017,Colombia,Italy,353,330,0,683
2614,2017,Costa Rica,Italy,0,7,0,7
2615,2017,Cuba,Italy,195,154,0,349
2616,2017,Cabo Verde,Italy,0,5,0,5
2617,2017,Dominica,Italy,0,5,0,5
2618,2017,Dominican Rep.,Italy,17,14,0,31
2619,2017,Ecuador,Italy,31,13,0,44
2620,2017,Equatorial Guinea,Italy,14,6,0,20
2621,2017,Eritrea,Italy,7940,18570,0,26510
2622,2017,Ethiopia,Italy,1309,260,0,1569
2623,2017,Gabon,Italy,29,36,0,65
2624,2017,Gambia,Italy,10273,10570,0,20843
2625,2017,Palestinian,Italy,954,234,0,1188
2626,2017,Georgia,Italy,329,975,0,1304
2627,2017,Ghana,Italy,4861,7121,0,11982
2628,2017,Guinea-Bissau,Italy,709,1127,0,1836
2629,2017,Guatemala,Italy,6,7,0,13
2630,2017,Guinea,Italy,3387,11176,0,14563
2631,2017,Haiti,Italy,9,0,0,9
2632,2017,Honduras,Italy,42,168,0,210
2633,2017,Croatia,Italy,18,0,0,18
2634,2017,Cote d'Ivoire,Italy,6412,11429,0,17841
2635,2017,India,Italy,205,837,0,1042
2636,2017,Indonesia,Italy,0,5,0,5
2637,2017,Iran (Islamic Rep. of),Italy,1828,236,0,2064
2638,2017,Iraq,Italy,5359,1565,0,6924
2639,2017,Israel,Italy,7,0,0,7
2640,2017,Jamaica,Italy,5,0,0,5
2641,2017,Jordan,Italy,27,17,0,44
2642,2017,Kazakhstan,Italy,8,17,0,25
2643,2017,Kenya,Italy,138,41,0,179
2644,2017,Kyrgyzstan,Italy,25,165,0,190
2645,2017,Rep. of Korea,Italy,5,0,0,5
2646,2017,Kuwait,Italy,5,5,0,10
2647,2017,Liberia,Italy,320,502,0,822
2648,2017,Libya,Italy,837,604,0,1441
2649,2017,Lebanon,Italy,313,61,0,374
2650,2017,Lesotho,Italy,0,5,0,5
2651,2017,Sri Lanka,Italy,517,598,0,1115
2652,2017,Madagascar,Italy,18,7,0,25
2653,2017,Mauritania,Italy,342,48,0,390
2654,2017,North Macedonia,Italy,56,66,0,122
2655,2017,Rep. of Moldova,Italy,100,38,0,138
2656,2017,Mexico,Italy,5,5,0,10
2657,2017,Mali,Italy,13206,10722,0,23928
2658,2017,Malaysia,Italy,0,5,0,5
2659,2017,Malawi,Italy,5,0,0,5
2660,2017,Mongolia,Italy,5,0,0,5
2661,2017,Morocco,Italy,746,1901,0,2647
2662,2017,Mozambique,Italy,5,0,0,5
2663,2017,Montenegro,Italy,81,14,0,95
2664,2017,Mauritius,Italy,16,0,0,16
2665,2017,Myanmar,Italy,34,35,0,69
2666,2017,Namibia,Italy,5,0,0,5
2667,2017,Nepal,Italy,95,156,0,251
2668,2017,Niger,Italy,431,860,0,1291
2669,2017,Nicaragua,Italy,14,6,0,20
2670,2017,Nigeria,Italy,18026,37967,0,55993
2671,2017,Norway,Italy,0,5,0,5
2672,2017,Pakistan,Italy,15966,11864,0,27830
2673,2017,Paraguay,Italy,5,9,0,14
2674,2017,Peru,Italy,70,218,0,288
2675,2017,Philippines,Italy,29,137,0,166
2676,2017,Palau,Italy,0,5,0,5
2677,2017,South Africa,Italy,8,0,0,8
2678,2017,Russian Federation,Italy,208,261,0,469
2679,2017,Rwanda,Italy,13,9,0,22
2680,2017,El Salvador,Italy,674,2848,0,3522
2681,2017,Saudi Arabia,Italy,7,13,0,20
2682,2017,Serbia and Kosovo: S/RES/1244 (1999),Italy,1128,1308,0,2436
2683,2017,Senegal,Italy,6197,11442,0,17639
2684,2017,Sierra Leone,Italy,539,1699,0,2238
2685,2017,Somalia,Italy,15641,1258,0,16899
2686,2017,Viet Nam,Italy,7,0,0,7
2687,2017,Sudan,Italy,1665,546,0,2211
2688,2017,South Sudan,Italy,61,41,0,102
2689,2017,Eswatini,Italy,8,0,0,8
2690,2017,Syrian Arab Rep.,Italy,3618,1696,0,5314
2691,2017,United Rep. of Tanzania,Italy,26,9,0,35
2692,2017,Thailand,Italy,0,8,0,8
2693,2017,Tajikistan,Italy,8,18,0,26
2694,2017,Turkmenistan,Italy,5,0,0,5
2695,2017,Timor-Leste,Italy,5,0,0,5
2696,2017,Togo,Italy,963,1039,0,2002
2697,2017,Tunisia,Italy,601,548,0,1149
2698,2017,Türkiye,Italy,2456,396,0,2852
2699,2017,United Arab Emirates,Italy,0,5,0,5
2700,2017,Uganda,Italy,67,17,0,84
2701,2017,Ukraine,Italy,4947,4453,0,9400
2702,2017,Uruguay,Italy,0,8,0,8
2703,2017,United States of America,Italy,5,5,0,10
2704,2017,Uzbekistan,Italy,6,11,0,17
2705,2017,Venezuela (Bolivarian Republic of),Italy,177,915,0,1092
2706,2017,Western Sahara,Italy,5,0,0,5
2707,2017,Yemen,Italy,113,42,0,155
2708,2017,Zimbabwe,Italy,24,11,0,35
2711,2017,Cuba,Jamaica,0,8,0,8
2712,2017,Haiti,Jamaica,8,0,0,8
2713,2017,Syrian Arab Rep.,Jamaica,5,0,0,5
2714,2017,Afghanistan,Jordan,8,9,0,17
2715,2017,Algeria,Jordan,5,7,0,12
2716,2017,Egypt,Jordan,79,564,0,643
2717,2017,Bangladesh,Jordan,0,8,0,8
2718,2017,Burkina Faso,Jordan,0,5,0,5
2719,2017,Bosnia and Herzegovina,Jordan,10,0,0,10
2720,2017,Chad,Jordan,0,21,0,21
2721,2017,Eritrea,Jordan,25,16,0,41
2722,2017,Ethiopia,Jordan,8,42,0,50
2723,2017,Ghana,Jordan,0,6,0,6
2724,2017,India,Jordan,0,7,0,7
2725,2017,Indonesia,Jordan,0,5,0,5
2726,2017,Iran (Islamic Rep. of),Jordan,7,5,0,12
2727,2017,Iraq,Jordan,34037,31885,0,65922
2728,2017,Kenya,Jordan,0,25,0,25
2729,2017,Libya,Jordan,27,183,0,210
2730,2017,Lebanon,Jordan,6,105,0,111
2731,2017,Sri Lanka,Jordan,5,8,0,13
2732,2017,Morocco,Jordan,0,13,0,13
2733,2017,Nigeria,Jordan,0,13,0,13
2734,2017,Pakistan,Jordan,5,18,0,23
2735,2017,Philippines,Jordan,0,6,0,6
2736,2017,South Africa,Jordan,0,5,0,5
2737,2017,Russian Federation,Jordan,25,20,0,45
2738,2017,Saudi Arabia,Jordan,0,8,0,8
2739,2017,Serbia and Kosovo: S/RES/1244 (1999),Jordan,0,5,0,5
2740,2017,Senegal,Jordan,0,5,0,5
2741,2017,Somalia,Jordan,645,164,0,809
2742,2017,Sudan,Jordan,2567,1469,0,4036
2743,2017,Suriname,Jordan,0,7,0,7
2744,2017,South Sudan,Jordan,12,5,0,17
2745,2017,Syrian Arab Rep.,Jordan,653031,0,0,653031
2746,2017,Tajikistan,Jordan,0,5,0,5
2747,2017,Tunisia,Jordan,8,20,0,28
2748,2017,Türkiye,Jordan,0,8,0,8
2749,2017,Ukraine,Jordan,0,17,0,17
2750,2017,Yemen,Jordan,494,8951,0,9445
2752,2017,Afghanistan,Japan,51,0,0,51
2753,2017,Burundi,Japan,8,0,0,8
2754,2017,Bangladesh,Japan,27,1049,0,1076
2755,2017,Cambodia,Japan,0,1085,0,1085
2756,2017,China,Japan,69,535,0,604
2757,2017,Cameroon,Japan,17,218,0,235
2758,2017,Dem. Rep. of the Congo,Japan,7,0,0,7
2759,2017,Ethiopia,Japan,23,0,0,23
2760,2017,Ghana,Japan,0,330,0,330
2761,2017,India,Japan,0,1257,0,1257
2762,2017,Indonesia,Japan,0,2613,0,2613
2763,2017,Iran (Islamic Rep. of),Japan,17,307,0,324
2764,2017,Iraq,Japan,13,0,0,13
2765,2017,Sri Lanka,Japan,59,3549,0,3608
2766,2017,Mongolia,Japan,0,70,0,70
2767,2017,Myanmar,Japan,1469,2241,0,3710
2768,2017,Nepal,Japan,0,4520,0,4520
2769,2017,Nigeria,Japan,0,328,0,328
2770,2017,Pakistan,Japan,34,1017,0,1051
2771,2017,Philippines,Japan,0,5298,0,5298
2772,2017,Senegal,Japan,0,141,0,141
2773,2017,Somalia,Japan,5,0,0,5
2774,2017,Viet Nam,Japan,0,2490,0,2490
2775,2017,Sudan,Japan,15,0,0,15
2776,2017,Syrian Arab Rep.,Japan,66,0,0,66
2777,2017,Thailand,Japan,0,52,0,52
2778,2017,Tunisia,Japan,0,155,0,155
2779,2017,Türkiye,Japan,39,2949,0,2988
2780,2017,Uganda,Japan,0,160,0,160
2783,2017,Afghanistan,Kazakhstan,561,164,0,725
2784,2017,China,Kazakhstan,6,6,0,12
2785,2017,Syrian Arab Rep.,Kazakhstan,17,23,0,40
2786,2017,Türkiye,Kazakhstan,0,14,0,14
2787,2017,Uzbekistan,Kazakhstan,18,0,0,18
2789,2017,Afghanistan,Kenya,8,5,0,13
2790,2017,Angola,Kenya,0,6,0,6
2791,2017,Burundi,Kenya,1902,10926,0,12828
2792,2017,Central African Rep.,Kenya,0,6,0,6
2793,2017,Cameroon,Kenya,0,17,0,17
2794,2017,Congo,Kenya,26,109,0,135
2795,2017,Dem. Rep. of the Congo,Kenya,13941,21769,0,35710
2796,2017,Eritrea,Kenya,702,639,0,1341
2797,2017,Ethiopia,Kenya,17873,10007,0,27880
2798,2017,Cote d'Ivoire,Kenya,0,9,0,9
2799,2017,India,Kenya,0,5,0,5
2800,2017,Iraq,Kenya,5,0,0,5
2801,2017,Liberia,Kenya,0,5,0,5
2802,2017,Sri Lanka,Kenya,9,0,0,9
2803,2017,Mozambique,Kenya,7,0,0,7
2804,2017,Nigeria,Kenya,5,14,0,19
2805,2017,Pakistan,Kenya,9,0,0,9
2806,2017,Rwanda,Kenya,576,1066,0,1642
2807,2017,Sierra Leone,Kenya,5,0,0,5
2808,2017,Somalia,Kenya,281692,2654,0,284346
2809,2017,Sudan,Kenya,2922,7086,0,10008
2810,2017,South Sudan,Kenya,111510,102,0,111612
2811,2017,Syrian Arab Rep.,Kenya,0,7,0,7
2812,2017,United Rep. of Tanzania,Kenya,9,28,0,37
2813,2017,Türkiye,Kenya,0,12,0,12
2814,2017,Uganda,Kenya,626,1856,0,2482
2815,2017,Yemen,Kenya,68,157,0,225
2816,2017,Zimbabwe,Kenya,0,14,0,14
2818,2017,Afghanistan,Kyrgyzstan,236,46,0,282
2819,2017,Iraq,Kyrgyzstan,0,5,0,5
2820,2017,Syrian Arab Rep.,Kyrgyzstan,69,12,0,81
2821,2017,Tajikistan,Kyrgyzstan,0,5,0,5
2822,2017,Türkiye,Kyrgyzstan,0,13,0,13
2823,2017,Ukraine,Kyrgyzstan,17,9,0,26
2824,2017,Uzbekistan,Kyrgyzstan,12,17,0,29
2826,2017,Afghanistan,Rep. of Korea,37,7,0,44
2827,2017,Algeria,Rep. of Korea,5,47,0,52
2828,2017,Angola,Rep. of Korea,5,30,0,35
2829,2017,Egypt,Rep. of Korea,19,635,0,654
2830,2017,Burundi,Rep. of Korea,18,10,0,28
2831,2017,Bangladesh,Rep. of Korea,98,413,0,511
2832,2017,Burkina Faso,Rep. of Korea,0,18,0,18
2833,2017,Bosnia and Herzegovina,Rep. of Korea,0,5,0,5
2834,2017,Cambodia,Rep. of Korea,0,11,0,11
2835,2017,China,Rep. of Korea,39,1119,0,1158
2836,2017,Cameroon,Rep. of Korea,18,135,0,153
2837,2017,Dem. Rep. of the Congo,Rep. of Korea,49,17,0,66
2838,2017,Ecuador,Rep. of Korea,0,5,0,5
2839,2017,Eritrea,Rep. of Korea,5,5,0,10
2840,2017,Ethiopia,Rep. of Korea,130,121,0,251
2841,2017,Gabon,Rep. of Korea,0,5,0,5
2842,2017,Gambia,Rep. of Korea,0,51,0,51
2843,2017,Palestinian,Rep. of Korea,5,0,0,5
2844,2017,Ghana,Rep. of Korea,6,145,0,151
2845,2017,Guinea-Bissau,Rep. of Korea,0,7,0,7
2846,2017,Guinea,Rep. of Korea,0,85,0,85
2847,2017,Haiti,Rep. of Korea,0,5,0,5
2848,2017,Cote d'Ivoire,Rep. of Korea,30,28,0,58
2849,2017,India,Rep. of Korea,0,720,0,720
2850,2017,Indonesia,Rep. of Korea,0,9,0,9
2851,2017,Iran (Islamic Rep. of),Rep. of Korea,48,54,0,102
2852,2017,Iraq,Rep. of Korea,27,23,0,50
2853,2017,Jordan,Rep. of Korea,0,16,0,16
2854,2017,Kazakhstan,Rep. of Korea,5,1152,0,1157
2855,2017,Kenya,Rep. of Korea,5,26,0,31
2856,2017,Kyrgyzstan,Rep. of Korea,0,83,0,83
2857,2017,Liberia,Rep. of Korea,9,176,0,185
2858,2017,Libya,Rep. of Korea,5,6,0,11
2859,2017,Sri Lanka,Rep. of Korea,8,115,0,123
2860,2017,Mali,Rep. of Korea,6,64,0,70
2861,2017,Malaysia,Rep. of Korea,0,451,0,451
2862,2017,Mongolia,Rep. of Korea,0,159,0,159
2863,2017,Morocco,Rep. of Korea,5,144,0,149
2864,2017,Mozambique,Rep. of Korea,0,7,0,7
2865,2017,Mauritius,Rep. of Korea,0,5,0,5
2866,2017,Myanmar,Rep. of Korea,292,12,0,304
2867,2017,Nepal,Rep. of Korea,5,135,0,140
2868,2017,Nigeria,Rep. of Korea,10,431,0,441
2869,2017,Pakistan,Rep. of Korea,86,805,0,891
2870,2017,Philippines,Rep. of Korea,0,255,0,255
2871,2017,South Africa,Rep. of Korea,0,111,0,111
2872,2017,Russian Federation,Rep. of Korea,13,618,0,631
2873,2017,Rwanda,Rep. of Korea,0,5,0,5
2874,2017,Senegal,Rep. of Korea,0,168,0,168
2875,2017,Sierra Leone,Rep. of Korea,0,5,0,5
2876,2017,Somalia,Rep. of Korea,5,0,0,5
2877,2017,Viet Nam,Rep. of Korea,0,42,0,42
2878,2017,Sudan,Rep. of Korea,12,36,0,48
2879,2017,Syrian Arab Rep.,Rep. of Korea,1122,68,0,1190
2880,2017,United Rep. of Tanzania,Rep. of Korea,5,36,0,41
2881,2017,Thailand,Rep. of Korea,5,278,0,283
2882,2017,Tajikistan,Rep. of Korea,0,13,0,13
2883,2017,Togo,Rep. of Korea,0,8,0,8
2884,2017,Tunisia,Rep. of Korea,0,26,0,26
2885,2017,Türkiye,Rep. of Korea,0,47,0,47
2886,2017,Uganda,Rep. of Korea,31,75,0,106
2887,2017,Ukraine,Rep. of Korea,12,18,0,30
2888,2017,Uzbekistan,Rep. of Korea,8,40,0,48
2889,2017,Venezuela (Bolivarian Republic of),Rep. of Korea,0,5,0,5
2890,2017,Yemen,Rep. of Korea,50,201,0,251
2891,2017,Zimbabwe,Rep. of Korea,0,7,0,7
2893,2017,Egypt,Kuwait,0,18,0,18
2894,2017,Djibouti,Kuwait,0,5,0,5
2895,2017,Eritrea,Kuwait,0,24,0,24
2896,2017,Ethiopia,Kuwait,0,11,0,11
2897,2017,Palestinian,Kuwait,0,5,0,5
2898,2017,Iran (Islamic Rep. of),Kuwait,9,83,0,92
2899,2017,Iraq,Kuwait,328,285,0,613
2900,2017,Jordan,Kuwait,0,6,0,6
2901,2017,Lebanon,Kuwait,0,5,0,5
2902,2017,Sri Lanka,Kuwait,0,6,0,6
2903,2017,Pakistan,Kuwait,0,12,0,12
2904,2017,Philippines,Kuwait,0,5,0,5
2905,2017,Somalia,Kuwait,227,419,0,646
2906,2017,Sudan,Kuwait,0,19,0,19
2907,2017,Syrian Arab Rep.,Kuwait,44,31,0,75
2908,2017,Ukraine,Kuwait,0,5,0,5
2909,2017,Yemen,Kuwait,5,9,0,14
2911,2017,Dem. Rep. of the Congo,Liberia,10,0,0,10
2912,2017,Cote d'Ivoire,Liberia,11063,0,0,11063
2913,2017,Iraq,Liberia,0,5,0,5
2914,2017,Mali,Liberia,19,0,0,19
2915,2017,Nigeria,Liberia,0,9,0,9
2916,2017,Rwanda,Liberia,0,5,0,5
2917,2017,Sierra Leone,Liberia,0,0,0,0
2918,2017,Sudan,Liberia,5,0,0,5
2919,2017,Syrian Arab Rep.,Liberia,7,6,0,13
2920,2017,Togo,Liberia,5,0,0,5
2921,2017,Türkiye,Liberia,0,5,0,5
2922,2017,Afghanistan,Libya,0,11,0,11
2923,2017,Algeria,Libya,5,0,0,5
2924,2017,Egypt,Libya,5,0,0,5
2925,2017,Chad,Libya,20,56,0,76
2926,2017,Dem. Rep. of the Congo,Libya,14,11,0,25
2927,2017,Eritrea,Libya,471,4661,0,5132
2928,2017,Ethiopia,Libya,24,744,0,768
2929,2017,Palestinian,Libya,5303,1676,0,6979
2930,2017,Iraq,Libya,2459,652,0,3111
2931,2017,Liberia,Libya,22,0,0,22
2932,2017,Libya,Libya,0,0,180937,0
2933,2017,Morocco,Libya,0,5,0,5
2934,2017,Somalia,Libya,143,2253,0,2396
2935,2017,Sudan,Libya,629,3660,0,4289
2936,2017,South Sudan,Libya,0,5,0,5
2937,2017,Syrian Arab Rep.,Libya,257,21890,0,22147
2938,2017,Yemen,Libya,0,26,0,26
2939,2017,Afghanistan,Lebanon,22,6,0,28
2940,2017,Algeria,Lebanon,0,5,0,5
2941,2017,Egypt,Lebanon,66,166,0,232
2942,2017,Armenia,Lebanon,0,0,0,0
2943,2017,Bahrain,Lebanon,27,10,0,37
2944,2017,Benin,Lebanon,0,5,0,5
2945,2017,Bangladesh,Lebanon,0,30,0,30
2946,2017,Cameroon,Lebanon,0,14,0,14
2947,2017,Dem. Rep. of the Congo,Lebanon,5,5,0,10
2948,2017,Eritrea,Lebanon,20,39,0,59
2949,2017,Ethiopia,Lebanon,30,396,0,426
2950,2017,Gambia,Lebanon,0,5,0,5
2951,2017,Palestinian,Lebanon,0,5,0,5
2952,2017,Hungary,Lebanon,0,0,0,0
2953,2017,Cote d'Ivoire,Lebanon,0,7,0,7
2954,2017,India,Lebanon,0,5,0,5
2955,2017,Iran (Islamic Rep. of),Lebanon,33,17,0,50
2956,2017,Iraq,Lebanon,5695,13612,0,19307
2957,2017,Jordan,Lebanon,32,48,0,80
2958,2017,Kenya,Lebanon,0,13,0,13
2959,2017,Libya,Lebanon,12,10,0,22
2960,2017,Sri Lanka,Lebanon,0,0,0,0
2961,2017,Madagascar,Lebanon,0,0,0,0
2962,2017,Mauritania,Lebanon,0,5,0,5
2963,2017,Morocco,Lebanon,0,0,0,0
2964,2017,Nigeria,Lebanon,0,19,0,19
2965,2017,Pakistan,Lebanon,0,16,0,16
2966,2017,Philippines,Lebanon,0,29,0,29
2967,2017,Saudi Arabia,Lebanon,10,8,0,18
2968,2017,Somalia,Lebanon,19,5,0,24
2969,2017,Sudan,Lebanon,705,716,0,1421
2970,2017,South Sudan,Lebanon,39,0,0,39
2971,2017,Syrian Arab Rep.,Lebanon,992127,10,0,992137
2972,2017,Tunisia,Lebanon,11,0,0,11
2973,2017,Türkiye,Lebanon,8,7,0,15
2974,2017,Ukraine,Lebanon,0,5,0,5
2975,2017,United States of America,Lebanon,0,0,0,0
2976,2017,Yemen,Lebanon,15,103,0,118
2977,2017,Dem. Rep. of the Congo,Lesotho,27,28,0,55
2978,2017,Eritrea,Lesotho,5,0,0,5
2979,2017,Ethiopia,Lesotho,12,0,0,12
2980,2017,Uganda,Lesotho,6,0,0,6
2981,2017,Zimbabwe,Lesotho,5,0,0,5
2982,2017,Afghanistan,Liechtenstein,5,0,0,5
2983,2017,Albania,Liechtenstein,0,6,0,6
2984,2017,Armenia,Liechtenstein,8,0,0,8
2985,2017,China,Liechtenstein,27,5,0,32
2986,2017,Eritrea,Liechtenstein,11,0,0,11
2987,2017,Georgia,Liechtenstein,0,5,0,5
2988,2017,Iran (Islamic Rep. of),Liechtenstein,5,5,0,10
2989,2017,Iraq,Liechtenstein,7,5,0,12
2990,2017,North Macedonia,Liechtenstein,0,7,0,7
2991,2017,Serbia and Kosovo: S/RES/1244 (1999),Liechtenstein,36,36,0,72
2992,2017,Somalia,Liechtenstein,28,5,0,33
2993,2017,Syrian Arab Rep.,Liechtenstein,32,0,0,32
2994,2017,Ukraine,Liechtenstein,5,5,0,10
2995,2017,Afghanistan,Sri Lanka,133,58,0,191
2996,2017,Palestinian,Sri Lanka,10,0,0,10
2997,2017,Iran (Islamic Rep. of),Sri Lanka,8,11,0,19
2998,2017,Sri Lanka,Sri Lanka,0,0,39322,0
2999,2017,Maldives,Sri Lanka,8,5,0,13
3000,2017,Myanmar,Sri Lanka,35,0,0,35
3001,2017,Nepal,Sri Lanka,0,5,0,5
3002,2017,Nigeria,Sri Lanka,0,5,0,5
3003,2017,Pakistan,Sri Lanka,600,536,0,1136
3004,2017,Syrian Arab Rep.,Sri Lanka,14,0,0,14
3005,2017,Yemen,Sri Lanka,12,9,0,21
3006,2017,Afghanistan,Lithuania,212,9,0,221
3007,2017,Armenia,Lithuania,5,19,0,24
3008,2017,Azerbaijan,Lithuania,12,5,0,17
3009,2017,Belarus,Lithuania,35,18,0,53
3010,2017,Cameroon,Lithuania,5,0,0,5
3011,2017,Cuba,Lithuania,5,0,0,5
3012,2017,Eritrea,Lithuania,38,0,0,38
3013,2017,Ethiopia,Lithuania,5,0,0,5
3014,2017,Georgia,Lithuania,5,0,0,5
3015,2017,Iran (Islamic Rep. of),Lithuania,6,0,0,6
3016,2017,Iraq,Lithuania,57,0,0,57
3017,2017,Kyrgyzstan,Lithuania,0,7,0,7
3018,2017,Sri Lanka,Lithuania,10,13,0,23
3019,2017,Nigeria,Lithuania,5,0,0,5
3020,2017,Pakistan,Lithuania,5,6,0,11
3021,2017,Russian Federation,Lithuania,636,60,0,696
3022,2017,Somalia,Lithuania,22,0,0,22
3023,2017,Syrian Arab Rep.,Lithuania,362,52,0,414
3024,2017,Tajikistan,Lithuania,24,34,0,58
3025,2017,Türkiye,Lithuania,14,5,0,19
3026,2017,Ukraine,Lithuania,63,21,0,84
3027,2017,Uzbekistan,Lithuania,16,0,0,16
3029,2017,Afghanistan,Luxembourg,43,70,0,113
3030,2017,Albania,Luxembourg,82,65,0,147
3031,2017,Algeria,Luxembourg,0,50,0,50
3032,2017,Angola,Luxembourg,15,0,0,15
3033,2017,Egypt,Luxembourg,5,10,0,15
3034,2017,Armenia,Luxembourg,6,0,0,6
3035,2017,Azerbaijan,Luxembourg,15,5,0,20
3036,2017,Benin,Luxembourg,0,5,0,5
3037,2017,Bhutan,Luxembourg,5,0,0,5
3038,2017,Belarus,Luxembourg,7,10,0,17
3039,2017,Bosnia and Herzegovina,Luxembourg,7,15,0,22
3040,2017,China,Luxembourg,5,0,0,5
3041,2017,Cameroon,Luxembourg,12,10,0,22
3042,2017,Congo,Luxembourg,5,0,0,5
3043,2017,Dem. Rep. of the Congo,Luxembourg,38,20,0,58
3044,2017,Eritrea,Luxembourg,79,245,0,324
3045,2017,Ethiopia,Luxembourg,43,25,0,68
3046,2017,Gabon,Luxembourg,5,5,0,10
3047,2017,Gambia,Luxembourg,6,5,0,11
3048,2017,Georgia,Luxembourg,0,40,0,40
3049,2017,Ghana,Luxembourg,0,5,0,5
3050,2017,Guinea,Luxembourg,10,20,0,30
3051,2017,Cote d'Ivoire,Luxembourg,6,10,0,16
3052,2017,India,Luxembourg,0,5,0,5
3053,2017,Iran (Islamic Rep. of),Luxembourg,148,55,0,203
3054,2017,Iraq,Luxembourg,280,200,0,480
3055,2017,Jordan,Luxembourg,0,5,0,5
3056,2017,Dem. People's Rep. of Korea,Luxembourg,12,0,0,12
3057,2017,Libya,Luxembourg,5,10,0,15
3058,2017,Lebanon,Luxembourg,0,5,0,5
3059,2017,Sri Lanka,Luxembourg,5,0,0,5
3060,2017,North Macedonia,Luxembourg,0,10,0,10
3061,2017,Rep. of Moldova,Luxembourg,0,5,0,5
3062,2017,Mexico,Luxembourg,5,0,0,5
3063,2017,Mali,Luxembourg,0,5,0,5
3064,2017,Morocco,Luxembourg,0,55,0,55
3065,2017,Montenegro,Luxembourg,18,10,0,28
3066,2017,Nigeria,Luxembourg,10,15,0,25
3067,2017,Peru,Luxembourg,5,0,0,5
3068,2017,Russian Federation,Luxembourg,33,10,0,43
3069,2017,Rwanda,Luxembourg,19,0,0,19
3070,2017,Serbia and Kosovo: S/RES/1244 (1999),Luxembourg,265,80,0,345
3071,2017,Senegal,Luxembourg,0,5,0,5
3072,2017,Somalia,Luxembourg,44,15,0,59
3073,2017,Sudan,Luxembourg,0,25,0,25
3074,2017,Syrian Arab Rep.,Luxembourg,686,225,0,911
3075,2017,Tajikistan,Luxembourg,0,5,0,5
3076,2017,Turkmenistan,Luxembourg,5,0,0,5
3077,2017,Togo,Luxembourg,5,5,0,10
3078,2017,Tunisia,Luxembourg,5,45,0,50
3079,2017,Türkiye,Luxembourg,24,30,0,54
3080,2017,Ukraine,Luxembourg,6,40,0,46
3081,2017,Yemen,Luxembourg,0,5,0,5
3084,2017,Afghanistan,Latvia,58,8,0,66
3085,2017,Egypt,Latvia,5,0,0,5
3086,2017,Azerbaijan,Latvia,6,0,0,6
3087,2017,Belarus,Latvia,7,0,0,7
3088,2017,Eritrea,Latvia,30,0,0,30
3089,2017,Palestinian,Latvia,5,0,0,5
3090,2017,Iran (Islamic Rep. of),Latvia,23,0,0,23
3091,2017,Iraq,Latvia,34,0,0,34
3092,2017,Kazakhstan,Latvia,5,11,0,16
3093,2017,Kyrgyzstan,Latvia,10,0,0,10
3094,2017,Lebanon,Latvia,5,0,0,5
3095,2017,Sri Lanka,Latvia,5,0,0,5
3096,2017,Pakistan,Latvia,5,0,0,5
3097,2017,Russian Federation,Latvia,24,19,0,43
3098,2017,Somalia,Latvia,7,0,0,7
3099,2017,Viet Nam,Latvia,0,6,0,6
3100,2017,Syrian Arab Rep.,Latvia,393,0,0,393
3101,2017,Tajikistan,Latvia,5,5,0,10
3102,2017,Türkiye,Latvia,14,0,0,14
3103,2017,Uzbekistan,Latvia,12,5,0,17
3105,2017,India,"China, Macao SAR",0,5,0,5
3106,2017,Afghanistan,Madagascar,5,0,0,5
3107,2017,Dem. Rep. of the Congo,Madagascar,0,9,0,9
3108,2017,Pakistan,Madagascar,12,0,0,12
3109,2017,Somalia,Madagascar,0,5,0,5
3110,2017,Türkiye,Madagascar,0,20,0,20
3111,2017,Yemen,Madagascar,22,23,0,45
3112,2017,Afghanistan,Mauritania,0,7,0,7
3113,2017,Algeria,Mauritania,0,13,0,13
3114,2017,Egypt,Mauritania,0,5,0,5
3115,2017,Burundi,Mauritania,5,0,0,5
3116,2017,Benin,Mauritania,0,6,0,6
3117,2017,Central African Rep.,Mauritania,555,70,0,625
3118,2017,Chad,Mauritania,5,0,0,5
3119,2017,Cameroon,Mauritania,5,47,0,52
3120,2017,Congo,Mauritania,9,6,0,15
3121,2017,Dem. Rep. of the Congo,Mauritania,47,22,0,69
3122,2017,Ethiopia,Mauritania,6,0,0,6
3123,2017,Gabon,Mauritania,0,5,0,5
3124,2017,Gambia,Mauritania,0,5,0,5
3125,2017,Palestinian,Mauritania,40,26,0,66
3126,2017,Guinea,Mauritania,8,45,0,53
3127,2017,Cote d'Ivoire,Mauritania,269,64,0,333
3128,2017,Iraq,Mauritania,38,5,0,43
3129,2017,Libya,Mauritania,0,5,0,5
3130,2017,Lebanon,Mauritania,0,5,0,5
3131,2017,Mali,Mauritania,49829,29,0,49858
3132,2017,Nigeria,Mauritania,17,70,0,87
3133,2017,Senegal,Mauritania,70,54,0,124
3134,2017,Sierra Leone,Mauritania,0,21,0,21
3135,2017,Somalia,Mauritania,5,5,0,10
3136,2017,Sudan,Mauritania,12,26,0,38
3137,2017,South Sudan,Mauritania,0,5,0,5
3138,2017,Syrian Arab Rep.,Mauritania,464,112,0,576
3139,2017,Togo,Mauritania,30,17,0,47
3140,2017,Türkiye,Mauritania,0,71,0,71
3141,2017,Ukraine,Mauritania,5,0,0,5
3142,2017,Western Sahara,Mauritania,26000,0,0,26000
3143,2017,Yemen,Mauritania,5,0,0,5
3144,2017,Afghanistan,North Macedonia,5,0,0,5
3145,2017,Algeria,North Macedonia,0,5,0,5
3146,2017,Iraq,North Macedonia,0,5,0,5
3147,2017,Serbia and Kosovo: S/RES/1244 (1999),North Macedonia,394,0,0,394
3148,2017,Syrian Arab Rep.,North Macedonia,15,5,0,20
3149,2017,Türkiye,North Macedonia,0,11,0,11
3152,2017,Afghanistan,Rep. of Moldova,18,7,0,25
3153,2017,Egypt,Rep. of Moldova,5,0,0,5
3154,2017,Armenia,Rep. of Moldova,19,0,0,19
3155,2017,Azerbaijan,Rep. of Moldova,5,0,0,5
3156,2017,Palestinian,Rep. of Moldova,5,0,0,5
3157,2017,Georgia,Rep. of Moldova,0,5,0,5
3158,2017,Iran (Islamic Rep. of),Rep. of Moldova,5,0,0,5
3159,2017,Iraq,Rep. of Moldova,24,0,0,24
3160,2017,Kyrgyzstan,Rep. of Moldova,11,5,0,16
3161,2017,Russian Federation,Rep. of Moldova,5,0,0,5
3162,2017,Sudan,Rep. of Moldova,9,0,0,9
3163,2017,Syrian Arab Rep.,Rep. of Moldova,204,18,0,222
3164,2017,Tajikistan,Rep. of Moldova,7,0,0,7
3165,2017,Türkiye,Rep. of Moldova,0,10,0,10
3166,2017,Ukraine,Rep. of Moldova,60,16,0,76
3167,2017,Uzbekistan,Rep. of Moldova,9,0,0,9
3168,2017,Yemen,Rep. of Moldova,5,0,0,5
3170,2017,Afghanistan,Mexico,0,6,0,6
3171,2017,Albania,Mexico,8,8,0,16
3172,2017,Angola,Mexico,5,0,0,5
3173,2017,Egypt,Mexico,5,0,0,5
3174,2017,Bangladesh,Mexico,5,10,0,15
3175,2017,Belize,Mexico,0,5,0,5
3176,2017,Canada,Mexico,0,5,0,5
3177,2017,China,Mexico,5,5,0,10
3178,2017,Cameroon,Mexico,18,68,0,86
3179,2017,Congo,Mexico,19,10,0,29
3180,2017,Dem. Rep. of the Congo,Mexico,68,10,0,78
3181,2017,Colombia,Mexico,284,137,0,421
3182,2017,Costa Rica,Mexico,0,5,0,5
3183,2017,Cuba,Mexico,69,244,0,313
3184,2017,Dominican Rep.,Mexico,9,10,0,19
3185,2017,Ecuador,Mexico,0,18,0,18
3186,2017,Eritrea,Mexico,7,0,0,7
3187,2017,Ethiopia,Mexico,7,0,0,7
3188,2017,Palestinian,Mexico,5,0,0,5
3189,2017,Ghana,Mexico,7,38,0,45
3190,2017,Guatemala,Mexico,627,429,0,1056
3191,2017,Guinea,Mexico,0,10,0,10
3192,2017,Haiti,Mexico,179,429,0,608
3193,2017,Honduras,Mexico,2895,2983,0,5878
3194,2017,Cote d'Ivoire,Mexico,5,0,0,5
3195,2017,India,Mexico,11,114,0,125
3196,2017,Iran (Islamic Rep. of),Mexico,36,0,0,36
3197,2017,Iraq,Mexico,42,6,0,48
3198,2017,Italy,Mexico,0,5,0,5
3199,2017,Sri Lanka,Mexico,19,10,0,29
3200,2017,Myanmar,Mexico,0,5,0,5
3201,2017,Nepal,Mexico,0,5,0,5
3202,2017,Nicaragua,Mexico,28,57,0,85
3203,2017,Nigeria,Mexico,25,41,0,66
3204,2017,Pakistan,Mexico,7,9,0,16
3205,2017,Panama,Mexico,0,5,0,5
3206,2017,Peru,Mexico,11,0,0,11
3207,2017,Romania,Mexico,7,0,0,7
3208,2017,Russian Federation,Mexico,19,11,0,30
3209,2017,El Salvador,Mexico,3332,2418,0,5750
3210,2017,Sierra Leone,Mexico,0,5,0,5
3211,2017,Somalia,Mexico,0,12,0,12
3212,2017,Syrian Arab Rep.,Mexico,23,0,0,23
3213,2017,Togo,Mexico,0,5,0,5
3214,2017,Türkiye,Mexico,7,0,0,7
3215,2017,Uganda,Mexico,0,5,0,5
3216,2017,Ukraine,Mexico,9,0,0,9
3217,2017,Uruguay,Mexico,0,5,0,5
3218,2017,United States of America,Mexico,0,16,0,16
3219,2017,Uzbekistan,Mexico,0,5,0,5
3220,2017,Venezuela (Bolivarian Republic of),Mexico,1185,3183,0,4368
3221,2017,Yemen,Mexico,5,5,0,10
3223,2017,Burundi,Mali,7,5,0,12
3224,2017,Central African Rep.,Mali,809,458,0,1267
3225,2017,Congo,Mali,24,5,0,29
3226,2017,Dem. Rep. of the Congo,Mali,233,36,0,269
3227,2017,Cote d'Ivoire,Mali,614,44,0,658
3228,2017,Mauritania,Mali,15319,0,0,15319
3229,2017,Mali,Mali,0,0,38172,0
3230,2017,Pakistan,Mali,0,6,0,6
3231,2017,Rwanda,Mali,7,0,0,7
3232,2017,Syrian Arab Rep.,Mali,9,0,0,9
3233,2017,Togo,Mali,14,0,0,14
3234,2017,Afghanistan,Malaysia,389,798,0,1187
3235,2017,Algeria,Malaysia,0,5,0,5
3236,2017,Egypt,Malaysia,5,19,0,24
3237,2017,Bangladesh,Malaysia,27,15,0,42
3238,2017,Cambodia,Malaysia,71,0,0,71
3239,2017,Central African Rep.,Malaysia,0,6,0,6
3240,2017,China,Malaysia,15,15,0,30
3241,2017,Dem. Rep. of the Congo,Malaysia,0,6,0,6
3242,2017,Eritrea,Malaysia,5,11,0,16
3243,2017,Ethiopia,Malaysia,8,5,0,13
3244,2017,Palestinian,Malaysia,236,482,0,718
3245,2017,United Kingdom of Great Britain and Northern Ireland,Malaysia,5,0,0,5
3246,2017,Guinea,Malaysia,0,13,0,13
3247,2017,Cote d'Ivoire,Malaysia,5,0,0,5
3248,2017,India,Malaysia,0,7,0,7
3249,2017,Indonesia,Malaysia,883,15,0,898
3250,2017,Iran (Islamic Rep. of),Malaysia,187,200,0,387
3251,2017,Iraq,Malaysia,452,966,0,1418
3252,2017,Jordan,Malaysia,5,5,0,10
3253,2017,Liberia,Malaysia,10,13,0,23
3254,2017,Libya,Malaysia,0,25,0,25
3255,2017,Lebanon,Malaysia,5,0,0,5
3256,2017,Sri Lanka,Malaysia,974,1065,0,2039
3257,2017,Mali,Malaysia,5,11,0,16
3258,2017,Myanmar,Malaysia,98041,33656,0,131697
3259,2017,Nepal,Malaysia,10,0,0,10
3260,2017,Nigeria,Malaysia,5,13,0,18
3261,2017,Pakistan,Malaysia,1090,4269,0,5359
3262,2017,Philippines,Malaysia,20,0,0,20
3263,2017,Russian Federation,Malaysia,5,5,0,10
3264,2017,Sierra Leone,Malaysia,5,21,0,26
3265,2017,Somalia,Malaysia,816,1422,0,2238
3266,2017,Sudan,Malaysia,68,163,0,231
3267,2017,South Sudan,Malaysia,5,8,0,13
3268,2017,Syrian Arab Rep.,Malaysia,372,1937,0,2309
3269,2017,Thailand,Malaysia,24,5,0,29
3270,2017,Togo,Malaysia,0,5,0,5
3271,2017,Türkiye,Malaysia,0,6,0,6
3272,2017,United Arab Emirates,Malaysia,0,5,0,5
3273,2017,Uganda,Malaysia,0,11,0,11
3274,2017,United States of America,Malaysia,8,0,0,8
3275,2017,Uzbekistan,Malaysia,0,14,0,14
3276,2017,Yemen,Malaysia,76,2287,0,2363
3277,2017,Zimbabwe,Malaysia,5,0,0,5
3279,2017,Burundi,Malawi,1649,5490,0,7139
3280,2017,Dem. Rep. of the Congo,Malawi,5334,13726,0,19060
3281,2017,Ethiopia,Malawi,5,29,0,34
3282,2017,Cote d'Ivoire,Malawi,0,5,0,5
3283,2017,Mozambique,Malawi,0,3367,0,3367
3284,2017,Rwanda,Malawi,1943,3307,0,5250
3285,2017,Somalia,Malawi,46,43,0,89
3286,2017,United Rep. of Tanzania,Malawi,0,5,0,5
3287,2017,Uganda,Malawi,0,8,0,8
3288,2017,Zimbabwe,Malawi,0,7,0,7
3289,2017,Afghanistan,Mongolia,5,0,0,5
3290,2017,China,Mongolia,0,5,0,5
3291,2017,Mongolia,Mongolia,0,0,0,0
3293,2017,Afghanistan,Morocco,5,0,0,5
3294,2017,Algeria,Morocco,5,5,0,10
3295,2017,Egypt,Morocco,0,5,0,5
3296,2017,Benin,Morocco,0,5,0,5
3297,2017,Burkina Faso,Morocco,0,13,0,13
3298,2017,Central African Rep.,Morocco,243,56,0,299
3299,2017,Chad,Morocco,5,6,0,11
3300,2017,Cameroon,Morocco,79,535,0,614
3301,2017,Congo,Morocco,16,62,0,78
3302,2017,Dem. Rep. of the Congo,Morocco,178,140,0,318
3303,2017,Gambia,Morocco,5,7,0,12
3304,2017,Palestinian,Morocco,71,27,0,98
3305,2017,Guinea-Bissau,Morocco,0,9,0,9
3306,2017,Guinea,Morocco,31,503,0,534
3307,2017,Cote d'Ivoire,Morocco,311,262,0,573
3308,2017,Iraq,Morocco,150,9,0,159
3309,2017,Liberia,Morocco,5,25,0,30
3310,2017,Libya,Morocco,32,5,0,37
3311,2017,Lebanon,Morocco,0,17,0,17
3312,2017,Mauritania,Morocco,0,5,0,5
3313,2017,Mali,Morocco,16,79,0,95
3314,2017,Niger,Morocco,5,0,0,5
3315,2017,Nigeria,Morocco,9,63,0,72
3316,2017,Pakistan,Morocco,5,7,0,12
3317,2017,Senegal,Morocco,57,104,0,161
3318,2017,Sierra Leone,Morocco,0,38,0,38
3319,2017,Somalia,Morocco,0,5,0,5
3320,2017,Sudan,Morocco,5,10,0,15
3321,2017,Syrian Arab Rep.,Morocco,2953,0,0,2953
3322,2017,Togo,Morocco,0,9,0,9
3323,2017,Türkiye,Morocco,0,39,0,39
3324,2017,Yemen,Morocco,517,0,0,517
3325,2017,Burundi,Mozambique,982,6770,0,7752
3326,2017,Central African Rep.,Mozambique,0,5,0,5
3327,2017,Congo,Mozambique,12,14,0,26
3328,2017,Dem. Rep. of the Congo,Mozambique,2940,6859,0,9799
3329,2017,Ethiopia,Mozambique,5,8,0,13
3330,2017,Guinea,Mozambique,0,5,0,5
3331,2017,Cote d'Ivoire,Mozambique,0,15,0,15
3332,2017,Kenya,Mozambique,0,5,0,5
3333,2017,Mozambique,Mozambique,0,0,15128,0
3334,2017,Rwanda,Mozambique,766,2638,0,3404
3335,2017,Somalia,Mozambique,159,2444,0,2603
3336,2017,Sudan,Mozambique,5,17,0,22
3337,2017,Uganda,Mozambique,7,15,0,22
3338,2017,Afghanistan,Malta,0,6,0,6
3339,2017,Egypt,Malta,74,16,0,90
3340,2017,Bangladesh,Malta,8,0,0,8
3341,2017,Burkina Faso,Malta,0,5,0,5
3342,2017,Belarus,Malta,9,0,0,9
3343,2017,Chad,Malta,6,0,0,6
3344,2017,China,Malta,15,0,0,15
3345,2017,Cameroon,Malta,9,0,0,9
3346,2017,Dem. Rep. of the Congo,Malta,5,0,0,5
3347,2017,Eritrea,Malta,782,122,0,904
3348,2017,Ethiopia,Malta,161,32,0,193
3349,2017,Gambia,Malta,23,6,0,29
3350,2017,Palestinian,Malta,68,13,0,81
3351,2017,Georgia,Malta,5,10,0,15
3352,2017,Ghana,Malta,5,0,0,5
3353,2017,Cote d'Ivoire,Malta,10,11,0,21
3354,2017,Iran (Islamic Rep. of),Malta,28,5,0,33
3355,2017,Iraq,Malta,72,45,0,117
3356,2017,Jordan,Malta,5,0,0,5
3357,2017,Liberia,Malta,6,5,0,11
3358,2017,Libya,Malta,2459,257,0,2716
3359,2017,Sri Lanka,Malta,7,0,0,7
3360,2017,North Macedonia,Malta,5,7,0,12
3361,2017,Mali,Malta,17,5,0,22
3362,2017,Morocco,Malta,27,5,0,32
3363,2017,Nigeria,Malta,107,34,0,141
3364,2017,Pakistan,Malta,51,15,0,66
3365,2017,Russian Federation,Malta,12,5,0,17
3366,2017,Serbia and Kosovo: S/RES/1244 (1999),Malta,7,5,0,12
3367,2017,Senegal,Malta,5,0,0,5
3368,2017,Sierra Leone,Malta,5,5,0,10
3369,2017,Somalia,Malta,1730,337,0,2067
3370,2017,Sudan,Malta,187,22,0,209
3371,2017,South Sudan,Malta,22,0,0,22
3372,2017,Syrian Arab Rep.,Malta,1289,252,0,1541
3373,2017,Togo,Malta,5,5,0,10
3374,2017,Tunisia,Malta,12,5,0,17
3375,2017,Türkiye,Malta,5,15,0,20
3376,2017,Ukraine,Malta,120,68,0,188
3377,2017,Venezuela (Bolivarian Republic of),Malta,5,31,0,36
3380,2017,Algeria,Montenegro,0,81,0,81
3381,2017,Belarus,Montenegro,5,0,0,5
3382,2017,Bosnia and Herzegovina,Montenegro,29,0,0,29
3383,2017,Cuba,Montenegro,7,5,0,12
3384,2017,Croatia,Montenegro,14,0,0,14
3385,2017,Iran (Islamic Rep. of),Montenegro,0,5,0,5
3386,2017,Morocco,Montenegro,0,23,0,23
3387,2017,Pakistan,Montenegro,0,7,0,7
3388,2017,Serbia and Kosovo: S/RES/1244 (1999),Montenegro,729,0,0,729
3389,2017,Syrian Arab Rep.,Montenegro,0,47,0,47
3390,2017,Tunisia,Montenegro,0,5,0,5
3391,2017,Yemen,Montenegro,10,0,0,10
3394,2017,Syrian Arab Rep.,Mauritius,5,0,0,5
3395,2017,Myanmar,Myanmar,0,0,353108,0
3397,2017,Burundi,Namibia,275,154,0,429
3398,2017,Cameroon,Namibia,6,5,0,11
3399,2017,Congo,Namibia,5,0,0,5
3400,2017,Dem. Rep. of the Congo,Namibia,1666,1565,0,3231
3401,2017,Ethiopia,Namibia,7,0,0,7
3402,2017,Kenya,Namibia,0,5,0,5
3403,2017,Nigeria,Namibia,0,9,0,9
3404,2017,Rwanda,Namibia,145,36,0,181
3405,2017,Somalia,Namibia,9,6,0,15
3406,2017,Sudan,Namibia,0,6,0,6
3407,2017,United Rep. of Tanzania,Namibia,0,5,0,5
3408,2017,Uganda,Namibia,5,10,0,15
3409,2017,Zimbabwe,Namibia,64,88,0,152
3410,2017,Afghanistan,Nepal,57,0,0,57
3411,2017,Bangladesh,Nepal,12,0,0,12
3412,2017,Bhutan,Nepal,7422,0,0,7422
3413,2017,India,Nepal,0,0,0,0
3414,2017,Iran (Islamic Rep. of),Nepal,5,0,0,5
3415,2017,Sri Lanka,Nepal,20,5,0,25
3416,2017,Myanmar,Nepal,190,124,0,314
3417,2017,Nepal,Nepal,0,0,0,0
3418,2017,Pakistan,Nepal,228,14,0,242
3419,2017,Somalia,Nepal,24,5,0,29
3421,2017,Afghanistan,Netherlands,6205,413,0,6618
3422,2017,Albania,Netherlands,8,15,0,23
3423,2017,Algeria,Netherlands,18,192,0,210
3424,2017,Angola,Netherlands,58,5,0,63
3425,2017,Egypt,Netherlands,218,107,0,325
3426,2017,Argentina,Netherlands,5,0,0,5
3427,2017,Armenia,Netherlands,416,79,0,495
3428,2017,Azerbaijan,Netherlands,253,78,0,331
3429,2017,Bahrain,Netherlands,0,5,0,5
3430,2017,Burundi,Netherlands,236,30,0,266
3431,2017,Benin,Netherlands,6,0,0,6
3432,2017,Bangladesh,Netherlands,40,5,0,45
3433,2017,Bhutan,Netherlands,185,0,0,185
3434,2017,Burkina Faso,Netherlands,14,0,0,14
3435,2017,Belarus,Netherlands,61,52,0,113
3436,2017,Bosnia and Herzegovina,Netherlands,5,0,0,5
3437,2017,Cambodia,Netherlands,17,0,0,17
3438,2017,Central African Rep.,Netherlands,7,0,0,7
3439,2017,Chad,Netherlands,5,6,0,11
3440,2017,China,Netherlands,1153,54,0,1207
3441,2017,Cameroon,Netherlands,80,20,0,100
3442,2017,Congo,Netherlands,484,27,0,511
3443,2017,Dem. Rep. of the Congo,Netherlands,271,0,0,271
3444,2017,Colombia,Netherlands,45,14,0,59
3445,2017,Cuba,Netherlands,14,177,0,191
3446,2017,Ecuador,Netherlands,8,0,0,8
3447,2017,Eritrea,Netherlands,14713,295,0,15008
3448,2017,Ethiopia,Netherlands,597,70,0,667
3449,2017,Gambia,Netherlands,38,68,0,106
3450,2017,Palestinian,Netherlands,168,26,0,194
3451,2017,Georgia,Netherlands,44,36,0,80
3452,2017,Ghana,Netherlands,6,11,0,17
3453,2017,Guinea-Bissau,Netherlands,0,7,0,7
3454,2017,Guinea,Netherlands,719,102,0,821
3455,2017,Honduras,Netherlands,7,0,0,7
3456,2017,Cote d'Ivoire,Netherlands,314,13,0,327
3457,2017,India,Netherlands,6,5,0,11
3458,2017,Iran (Islamic Rep. of),Netherlands,4757,518,0,5275
3459,2017,Iraq,Netherlands,11369,398,0,11767
3460,2017,Jamaica,Netherlands,182,0,0,182
3461,2017,Jordan,Netherlands,18,11,0,29
3462,2017,Kazakhstan,Netherlands,41,0,0,41
3463,2017,Kenya,Netherlands,39,0,0,39
3464,2017,Kyrgyzstan,Netherlands,21,0,0,21
3465,2017,Dem. People's Rep. of Korea,Netherlands,48,0,0,48
3466,2017,Kuwait,Netherlands,5,0,0,5
3467,2017,Lao People's Dem. Rep.,Netherlands,33,0,0,33
3468,2017,Liberia,Netherlands,78,7,0,85
3469,2017,Libya,Netherlands,295,123,0,418
3470,2017,Lebanon,Netherlands,33,28,0,61
3471,2017,Sri Lanka,Netherlands,689,23,0,712
3472,2017,Mauritania,Netherlands,7,5,0,12
3473,2017,Rep. of Moldova,Netherlands,5,70,0,75
3474,2017,Mali,Netherlands,16,12,0,28
3475,2017,Malaysia,Netherlands,7,0,0,7
3476,2017,Malawi,Netherlands,5,0,0,5
3477,2017,Mongolia,Netherlands,40,0,0,40
3478,2017,Morocco,Netherlands,44,180,0,224
3479,2017,Myanmar,Netherlands,732,7,0,739
3480,2017,Namibia,Netherlands,5,0,0,5
3481,2017,Nepal,Netherlands,294,0,0,294
3482,2017,Niger,Netherlands,6,0,0,6
3483,2017,Nigeria,Netherlands,303,124,0,427
3484,2017,Pakistan,Netherlands,428,96,0,524
3485,2017,Peru,Netherlands,9,0,0,9
3486,2017,Russian Federation,Netherlands,274,99,0,373
3487,2017,Rwanda,Netherlands,67,0,0,67
3488,2017,Saudi Arabia,Netherlands,13,0,0,13
3489,2017,Serbia and Kosovo: S/RES/1244 (1999),Netherlands,30,0,0,30
3490,2017,Senegal,Netherlands,30,19,0,49
3491,2017,Sierra Leone,Netherlands,516,38,0,554
3492,2017,Somalia,Netherlands,15478,76,0,15554
3493,2017,Viet Nam,Netherlands,5,5,0,10
3494,2017,Sudan,Netherlands,790,116,0,906
3495,2017,Syrian Arab Rep.,Netherlands,30851,668,0,31519
3496,2017,United Rep. of Tanzania,Netherlands,6,0,0,6
3497,2017,Tajikistan,Netherlands,34,14,0,48
3498,2017,Turkmenistan,Netherlands,5,0,0,5
3499,2017,Togo,Netherlands,37,5,0,42
3500,2017,Trinidad and Tobago,Netherlands,56,18,0,74
3501,2017,Tunisia,Netherlands,18,30,0,48
3502,2017,Türkiye,Netherlands,520,295,0,815
3503,2017,Uganda,Netherlands,526,53,0,579
3504,2017,Ukraine,Netherlands,23,32,0,55
3505,2017,Uzbekistan,Netherlands,64,0,0,64
3506,2017,Venezuela (Bolivarian Republic of),Netherlands,0,46,0,46
3507,2017,Yemen,Netherlands,250,42,0,292
3508,2017,Zambia,Netherlands,8,0,0,8
3509,2017,Zimbabwe,Netherlands,36,0,0,36
3512,2017,Central African Rep.,Niger,65,31,0,96
3513,2017,Chad,Niger,165,0,0,165
3514,2017,Cameroon,Niger,5,6,0,11
3515,2017,Congo,Niger,5,0,0,5
3516,2017,Dem. Rep. of the Congo,Niger,75,11,0,86
3517,2017,Eritrea,Niger,0,132,0,132
3518,2017,Ethiopia,Niger,0,5,0,5
3519,2017,Cote d'Ivoire,Niger,51,5,0,56
3520,2017,Iraq,Niger,6,0,0,6
3521,2017,Libya,Niger,6,7,0,13
3522,2017,Mali,Niger,56838,0,0,56838
3523,2017,Niger,Niger,0,0,129015,0
3524,2017,Nigeria,Niger,108470,10,0,108480
3525,2017,Rwanda,Niger,18,0,0,18
3526,2017,Somalia,Niger,9,66,0,75
3527,2017,Sudan,Niger,9,0,0,9
3528,2017,Syrian Arab Rep.,Niger,7,0,0,7
3529,2017,Togo,Niger,0,5,0,5
3530,2017,Colombia,Nicaragua,6,0,0,6
3531,2017,Cuba,Nicaragua,15,0,0,15
3532,2017,Guatemala,Nicaragua,10,5,0,15
3533,2017,Honduras,Nicaragua,74,48,0,122
3534,2017,El Salvador,Nicaragua,217,354,0,571
3535,2017,Afghanistan,Nigeria,5,0,0,5
3536,2017,Central African Rep.,Nigeria,403,186,0,589
3537,2017,Chad,Nigeria,87,21,0,108
3538,2017,Cameroon,Nigeria,95,8050,0,8145
3539,2017,Congo,Nigeria,5,5,0,10
3540,2017,Dem. Rep. of the Congo,Nigeria,599,216,0,815
3541,2017,Eritrea,Nigeria,25,9,0,34
3542,2017,Ethiopia,Nigeria,6,0,0,6
3543,2017,Palestinian,Nigeria,8,0,0,8
3544,2017,Ghana,Nigeria,5,8,0,13
3545,2017,Guinea-Bissau,Nigeria,5,0,0,5
3546,2017,Guinea,Nigeria,17,5,0,22
3547,2017,Cote d'Ivoire,Nigeria,122,18,0,140
3548,2017,Liberia,Nigeria,9,5,0,14
3549,2017,Lebanon,Nigeria,0,5,0,5
3550,2017,Mali,Nigeria,137,35,0,172
3551,2017,Nigeria,Nigeria,0,0,1704080,0
3552,2017,Sierra Leone,Nigeria,21,0,0,21
3553,2017,Sudan,Nigeria,48,5,0,53
3554,2017,Syrian Arab Rep.,Nigeria,154,60,0,214
3555,2017,Togo,Nigeria,20,22,0,42
3556,2017,Türkiye,Nigeria,139,0,0,139
3557,2017,Afghanistan,Norway,6490,616,0,7106
3558,2017,Albania,Norway,27,12,0,39
3559,2017,Algeria,Norway,12,0,0,12
3560,2017,Angola,Norway,35,0,0,35
3561,2017,Egypt,Norway,58,7,0,65
3562,2017,Azerbaijan,Norway,46,0,0,46
3563,2017,Burundi,Norway,74,5,0,79
3564,2017,Bangladesh,Norway,10,12,0,22
3565,2017,Bhutan,Norway,5,0,0,5
3566,2017,Burkina Faso,Norway,5,0,0,5
3567,2017,Belarus,Norway,6,0,0,6
3568,2017,Bosnia and Herzegovina,Norway,7,0,0,7
3569,2017,Bulgaria,Norway,13,0,0,13
3570,2017,Central African Rep.,Norway,7,0,0,7
3571,2017,Chad,Norway,5,0,0,5
3572,2017,China,Norway,607,10,0,617
3573,2017,Cameroon,Norway,26,5,0,31
3574,2017,Congo,Norway,7,0,0,7
3575,2017,Dem. Rep. of the Congo,Norway,212,15,0,227
3576,2017,Colombia,Norway,17,0,0,17
3577,2017,Cuba,Norway,7,5,0,12
3578,2017,Eritrea,Norway,15456,442,0,15898
3579,2017,Ethiopia,Norway,2125,224,0,2349
3580,2017,Gambia,Norway,15,0,0,15
3581,2017,Georgia,Norway,5,5,0,10
3582,2017,Ghana,Norway,8,0,0,8
3583,2017,Guinea-Bissau,Norway,5,0,0,5
3584,2017,Guatemala,Norway,7,0,0,7
3585,2017,Guinea,Norway,54,0,0,54
3586,2017,Honduras,Norway,5,0,0,5
3587,2017,Cote d'Ivoire,Norway,23,0,0,23
3588,2017,India,Norway,5,0,0,5
3589,2017,Iran (Islamic Rep. of),Norway,2036,310,0,2346
3590,2017,Iraq,Norway,2564,265,0,2829
3591,2017,Israel,Norway,11,0,0,11
3592,2017,Jordan,Norway,9,5,0,14
3593,2017,Kazakhstan,Norway,13,0,0,13
3594,2017,Kenya,Norway,9,0,0,9
3595,2017,Kyrgyzstan,Norway,19,0,0,19
3596,2017,Dem. People's Rep. of Korea,Norway,5,0,0,5
3597,2017,Kuwait,Norway,8,0,0,8
3598,2017,Liberia,Norway,16,0,0,16
3599,2017,Libya,Norway,62,6,0,68
3600,2017,Lebanon,Norway,34,10,0,44
3601,2017,Sri Lanka,Norway,218,14,0,232
3602,2017,Rep. of Moldova,Norway,5,5,0,10
3603,2017,Mali,Norway,8,0,0,8
3604,2017,Mongolia,Norway,5,7,0,12
3605,2017,Morocco,Norway,29,13,0,42
3606,2017,Montenegro,Norway,5,0,0,5
3607,2017,Myanmar,Norway,130,5,0,135
3608,2017,Nepal,Norway,10,0,0,10
3609,2017,Nigeria,Norway,178,33,0,211
3610,2017,Pakistan,Norway,99,18,0,117
3611,2017,Philippines,Norway,6,5,0,11
3612,2017,Romania,Norway,5,0,0,5
3613,2017,Russian Federation,Norway,998,19,0,1017
3614,2017,Rwanda,Norway,45,0,0,45
3615,2017,Saudi Arabia,Norway,5,5,0,10
3616,2017,Serbia and Kosovo: S/RES/1244 (1999),Norway,139,0,0,139
3617,2017,Sierra Leone,Norway,15,0,0,15
3618,2017,Somalia,Norway,7527,118,0,7645
3619,2017,Viet Nam,Norway,45,0,0,45
3620,2017,Sudan,Norway,1961,16,0,1977
3621,2017,South Sudan,Norway,13,5,0,18
3622,2017,Syrian Arab Rep.,Norway,13349,447,0,13796
3623,2017,United Rep. of Tanzania,Norway,5,0,0,5
3624,2017,Tajikistan,Norway,11,5,0,16
3625,2017,Turkmenistan,Norway,8,0,0,8
3626,2017,Togo,Norway,5,0,0,5
3627,2017,Tunisia,Norway,5,7,0,12
3628,2017,Türkiye,Norway,200,95,0,295
3629,2017,Uganda,Norway,119,5,0,124
3630,2017,Ukraine,Norway,9,0,0,9
3631,2017,United States of America,Norway,5,0,0,5
3632,2017,Uzbekistan,Norway,240,10,0,250
3633,2017,Venezuela (Bolivarian Republic of),Norway,0,10,0,10
3634,2017,Yemen,Norway,231,14,0,245
3635,2017,Zimbabwe,Norway,14,0,0,14
3638,2017,Afghanistan,Nauru,81,0,0,81
3639,2017,Bangladesh,Nauru,9,33,0,42
3640,2017,India,Nauru,11,8,0,19
3641,2017,Indonesia,Nauru,5,0,0,5
3642,2017,Iran (Islamic Rep. of),Nauru,316,26,0,342
3643,2017,Iraq,Nauru,43,0,0,43
3644,2017,Kuwait,Nauru,5,0,0,5
3645,2017,Lebanon,Nauru,14,0,0,14
3646,2017,Sri Lanka,Nauru,101,28,0,129
3647,2017,Malaysia,Nauru,5,0,0,5
3648,2017,Myanmar,Nauru,115,0,0,115
3649,2017,Nepal,Nauru,5,9,0,14
3650,2017,Pakistan,Nauru,120,22,0,142
3651,2017,Somalia,Nauru,56,0,0,56
3652,2017,Sudan,Nauru,13,0,0,13
3654,2017,Afghanistan,New Zealand,42,20,0,62
3655,2017,Algeria,New Zealand,6,0,0,6
3656,2017,Egypt,New Zealand,28,5,0,33
3657,2017,Bahrain,New Zealand,24,0,0,24
3658,2017,Bangladesh,New Zealand,7,19,0,26
3659,2017,China,New Zealand,153,68,0,221
3660,2017,Chile,New Zealand,5,0,0,5
3661,2017,Cameroon,New Zealand,5,0,0,5
3662,2017,Congo,New Zealand,5,0,0,5
3663,2017,Dem. Rep. of the Congo,New Zealand,5,0,0,5
3664,2017,Colombia,New Zealand,24,6,0,30
3665,2017,Czechia,New Zealand,17,0,0,17
3666,2017,Eritrea,New Zealand,7,0,0,7
3667,2017,Ethiopia,New Zealand,9,7,0,16
3668,2017,Fiji,New Zealand,29,5,0,34
3669,2017,Palestinian,New Zealand,15,0,0,15
3670,2017,Hungary,New Zealand,8,0,0,8
3671,2017,India,New Zealand,6,25,0,31
3672,2017,Indonesia,New Zealand,5,0,0,5
3673,2017,Iran (Islamic Rep. of),New Zealand,159,11,0,170
3674,2017,Iraq,New Zealand,132,5,0,137
3675,2017,Jordan,New Zealand,8,9,0,17
3676,2017,Kuwait,New Zealand,7,0,0,7
3677,2017,Libya,New Zealand,22,0,0,22
3678,2017,Sri Lanka,New Zealand,81,16,0,97
3679,2017,Madagascar,New Zealand,5,0,0,5
3680,2017,Maldives,New Zealand,5,0,0,5
3681,2017,Mexico,New Zealand,5,0,0,5
3682,2017,Malaysia,New Zealand,5,5,0,10
3683,2017,Myanmar,New Zealand,12,5,0,17
3684,2017,Nepal,New Zealand,5,0,0,5
3685,2017,Pakistan,New Zealand,57,12,0,69
3686,2017,Philippines,New Zealand,0,7,0,7
3687,2017,Papua New Guinea,New Zealand,5,0,0,5
3688,2017,South Africa,New Zealand,10,0,0,10
3689,2017,Russian Federation,New Zealand,6,15,0,21
3690,2017,El Salvador,New Zealand,5,0,0,5
3691,2017,Saudi Arabia,New Zealand,59,5,0,64
3692,2017,Somalia,New Zealand,17,0,0,17
3693,2017,Viet Nam,New Zealand,8,0,0,8
3694,2017,Sudan,New Zealand,7,0,0,7
3695,2017,Syrian Arab Rep.,New Zealand,65,5,0,70
3696,2017,Türkiye,New Zealand,43,22,0,65
3697,2017,Uganda,New Zealand,5,0,0,5
3698,2017,Ukraine,New Zealand,0,5,0,5
3699,2017,Venezuela (Bolivarian Republic of),New Zealand,0,5,0,5
3700,2017,Yemen,New Zealand,5,0,0,5
3701,2017,Zimbabwe,New Zealand,32,0,0,32
3703,2017,Iraq,Oman,301,387,0,688
3704,2017,Sudan,Oman,0,5,0,5
3705,2017,Syrian Arab Rep.,Oman,7,6,0,13
3706,2017,Afghanistan,Pakistan,1392610,3241,0,1395851
3707,2017,Algeria,Pakistan,17,0,0,17
3708,2017,Palestinian,Pakistan,22,0,0,22
3709,2017,Iran (Islamic Rep. of),Pakistan,48,7,0,55
3710,2017,Iraq,Pakistan,21,7,0,28
3711,2017,Myanmar,Pakistan,21,0,0,21
3712,2017,Pakistan,Pakistan,0,0,174354,0
3713,2017,Russian Federation,Pakistan,7,0,0,7
3714,2017,Somalia,Pakistan,232,0,0,232
3715,2017,Syrian Arab Rep.,Pakistan,29,0,0,29
3716,2017,Tajikistan,Pakistan,6,0,0,6
3717,2017,Türkiye,Pakistan,6,224,0,230
3718,2017,Yemen,Pakistan,113,8,0,121
3719,2017,Afghanistan,Panama,5,6,0,11
3720,2017,Angola,Panama,0,7,0,7
3721,2017,Armenia,Panama,0,7,0,7
3722,2017,Bangladesh,Panama,0,18,0,18
3723,2017,Belarus,Panama,7,5,0,12
3724,2017,Brazil,Panama,0,5,0,5
3725,2017,Bosnia and Herzegovina,Panama,5,0,0,5
3726,2017,Cameroon,Panama,8,7,0,15
3727,2017,Dem. Rep. of the Congo,Panama,5,0,0,5
3728,2017,Colombia,Panama,1660,1506,0,3166
3729,2017,Cuba,Panama,120,89,0,209
3730,2017,Dominican Rep.,Panama,5,29,0,34
3731,2017,Ecuador,Panama,0,5,0,5
3732,2017,Eritrea,Panama,0,39,0,39
3733,2017,Guatemala,Panama,12,8,0,20
3734,2017,Haiti,Panama,19,0,0,19
3735,2017,Honduras,Panama,0,28,0,28
3736,2017,Croatia,Panama,5,0,0,5
3737,2017,Cote d'Ivoire,Panama,0,5,0,5
3738,2017,Iran (Islamic Rep. of),Panama,5,0,0,5
3739,2017,Italy,Panama,0,5,0,5
3740,2017,Jamaica,Panama,0,6,0,6
3741,2017,Kenya,Panama,0,7,0,7
3742,2017,Liberia,Panama,5,0,0,5
3743,2017,Mexico,Panama,5,0,0,5
3744,2017,Nepal,Panama,0,16,0,16
3745,2017,Nicaragua,Panama,173,630,0,803
3746,2017,Nigeria,Panama,10,36,0,46
3747,2017,Peru,Panama,23,5,0,28
3748,2017,El Salvador,Panama,302,1014,0,1316
3749,2017,Sierra Leone,Panama,5,0,0,5
3750,2017,Somalia,Panama,0,103,0,103
3751,2017,Sudan,Panama,5,0,0,5
3752,2017,Syrian Arab Rep.,Panama,0,11,0,11
3753,2017,Ukraine,Panama,0,5,0,5
3754,2017,Venezuela (Bolivarian Republic of),Panama,33,3687,0,3720
3755,2017,Bolivia (Plurinational State of),Paraguay,17,0,0,17
3756,2017,Colombia,Paraguay,35,0,0,35
3757,2017,Cuba,Paraguay,65,14,0,79
3758,2017,Iraq,Paraguay,6,0,0,6
3759,2017,Lebanon,Paraguay,0,5,0,5
3760,2017,Nigeria,Paraguay,0,5,0,5
3761,2017,Russian Federation,Paraguay,8,0,0,8
3762,2017,El Salvador,Paraguay,0,6,0,6
3763,2017,Viet Nam,Paraguay,6,0,0,6
3764,2017,Syrian Arab Rep.,Paraguay,53,26,0,79
3765,2017,Türkiye,Paraguay,5,0,0,5
3766,2017,Venezuela (Bolivarian Republic of),Paraguay,5,13,0,18
3767,2017,Bangladesh,Peru,20,8,0,28
3768,2017,Bolivia (Plurinational State of),Peru,9,5,0,14
3769,2017,Bosnia and Herzegovina,Peru,5,0,0,5
3770,2017,China,Peru,0,7,0,7
3771,2017,Cameroon,Peru,5,5,0,10
3772,2017,Congo,Peru,0,5,0,5
3773,2017,Dem. Rep. of the Congo,Peru,5,0,0,5
3774,2017,Colombia,Peru,604,376,0,980
3775,2017,Cuba,Peru,577,962,0,1539
3776,2017,Dominican Rep.,Peru,13,10,0,23
3777,2017,Ecuador,Peru,5,26,0,31
3778,2017,Ethiopia,Peru,5,0,0,5
3779,2017,Gambia,Peru,5,0,0,5
3780,2017,Palestinian,Peru,35,10,0,45
3781,2017,Ghana,Peru,5,6,0,11
3782,2017,Haiti,Peru,48,92,0,140
3783,2017,Hungary,Peru,6,0,0,6
3784,2017,India,Peru,6,0,0,6
3785,2017,Iran (Islamic Rep. of),Peru,10,5,0,15
3786,2017,Iraq,Peru,17,0,0,17
3787,2017,Sri Lanka,Peru,0,7,0,7
3788,2017,Nepal,Peru,0,5,0,5
3789,2017,Nigeria,Peru,16,9,0,25
3790,2017,Pakistan,Peru,0,13,0,13
3791,2017,Panama,Peru,0,5,0,5
3792,2017,Philippines,Peru,0,17,0,17
3793,2017,Poland,Peru,5,0,0,5
3794,2017,Portugal,Peru,0,5,0,5
3795,2017,Russian Federation,Peru,16,0,0,16
3796,2017,El Salvador,Peru,5,5,0,10
3797,2017,Serbia and Kosovo: S/RES/1244 (1999),Peru,64,0,0,64
3798,2017,Senegal,Peru,0,5,0,5
3799,2017,Spain,Peru,0,5,0,5
3800,2017,Syrian Arab Rep.,Peru,38,5,0,43
3801,2017,Türkiye,Peru,0,63,0,63
3802,2017,Ukraine,Peru,15,0,0,15
3803,2017,Venezuela (Bolivarian Republic of),Peru,249,36062,0,36311
3805,2017,Afghanistan,Philippines,13,5,0,18
3806,2017,Burundi,Philippines,10,0,0,10
3807,2017,Bangladesh,Philippines,0,5,0,5
3808,2017,Cambodia,Philippines,5,12,0,17
3809,2017,China,Philippines,5,5,0,10
3810,2017,Cameroon,Philippines,0,14,0,14
3811,2017,Congo,Philippines,0,6,0,6
3812,2017,Dem. Rep. of the Congo,Philippines,5,0,0,5
3813,2017,Eritrea,Philippines,16,0,0,16
3814,2017,Ethiopia,Philippines,5,0,0,5
3815,2017,Palestinian,Philippines,48,9,0,57
3816,2017,Cote d'Ivoire,Philippines,18,15,0,33
3817,2017,Iran (Islamic Rep. of),Philippines,66,9,0,75
3818,2017,Iraq,Philippines,46,7,0,53
3819,2017,Liberia,Philippines,5,0,0,5
3820,2017,Lebanon,Philippines,0,5,0,5
3821,2017,Sri Lanka,Philippines,20,0,0,20
3822,2017,Myanmar,Philippines,10,0,0,10
3823,2017,Nigeria,Philippines,5,10,0,15
3824,2017,Pakistan,Philippines,77,25,0,102
3825,2017,Philippines,Philippines,0,0,311943,0
3826,2017,Rwanda,Philippines,19,0,0,19
3827,2017,Saudi Arabia,Philippines,5,5,0,10
3828,2017,Somalia,Philippines,25,6,0,31
3829,2017,Viet Nam,Philippines,15,0,0,15
3830,2017,Sudan,Philippines,5,5,0,10
3831,2017,Syrian Arab Rep.,Philippines,74,40,0,114
3832,2017,Türkiye,Philippines,10,11,0,21
3833,2017,Yemen,Philippines,0,10,0,10
3836,2017,Afghanistan,Papua New Guinea,117,0,0,117
3837,2017,Bangladesh,Papua New Guinea,20,0,0,20
3838,2017,Indonesia,Papua New Guinea,9368,0,0,9368
3839,2017,Iran (Islamic Rep. of),Papua New Guinea,156,0,0,156
3840,2017,Iraq,Papua New Guinea,47,0,0,47
3841,2017,Sri Lanka,Papua New Guinea,21,0,0,21
3842,2017,Pakistan,Papua New Guinea,96,0,0,96
3843,2017,Somalia,Papua New Guinea,39,0,0,39
3844,2017,Sudan,Papua New Guinea,75,0,0,75
3846,2017,Afghanistan,Poland,99,7,0,106
3847,2017,Algeria,Poland,5,5,0,10
3848,2017,Egypt,Poland,56,5,0,61
3849,2017,Armenia,Poland,78,29,0,107
3850,2017,Azerbaijan,Poland,0,5,0,5
3851,2017,Bangladesh,Poland,7,0,0,7
3852,2017,Belarus,Poland,187,31,0,218
3853,2017,Central African Rep.,Poland,5,0,0,5
3854,2017,China,Poland,18,0,0,18
3855,2017,Cameroon,Poland,10,0,0,10
3856,2017,Congo,Poland,6,0,0,6
3857,2017,Dem. Rep. of the Congo,Poland,5,0,0,5
3858,2017,Cuba,Poland,17,0,0,17
3859,2017,Eritrea,Poland,30,0,0,30
3860,2017,Palestinian,Poland,16,0,0,16
3861,2017,Georgia,Poland,72,91,0,163
3862,2017,India,Poland,5,6,0,11
3863,2017,Iran (Islamic Rep. of),Poland,26,7,0,33
3864,2017,Iraq,Poland,229,13,0,242
3865,2017,Kazakhstan,Poland,52,10,0,62
3866,2017,Kenya,Poland,5,0,0,5
3867,2017,Kyrgyzstan,Poland,45,27,0,72
3868,2017,Libya,Poland,22,5,0,27
3869,2017,Sri Lanka,Poland,49,0,0,49
3870,2017,Rep. of Moldova,Poland,5,6,0,11
3871,2017,Mongolia,Poland,19,0,0,19
3872,2017,Nepal,Poland,7,0,0,7
3873,2017,Nigeria,Poland,10,5,0,15
3874,2017,Pakistan,Poland,18,20,0,38
3875,2017,Russian Federation,Poland,9950,2118,0,12068
3876,2017,Rwanda,Poland,5,0,0,5
3877,2017,Serbia and Kosovo: S/RES/1244 (1999),Poland,5,0,0,5
3878,2017,Senegal,Poland,5,0,0,5
3879,2017,Somalia,Poland,46,0,0,46
3880,2017,Viet Nam,Poland,15,13,0,28
3881,2017,Sudan,Poland,5,0,0,5
3882,2017,Syrian Arab Rep.,Poland,512,18,0,530
3883,2017,Tajikistan,Poland,49,82,0,131
3884,2017,Turkmenistan,Poland,32,0,0,32
3885,2017,Türkiye,Poland,17,28,0,45
3886,2017,Uganda,Poland,6,0,0,6
3887,2017,Ukraine,Poland,369,333,0,702
3888,2017,Uzbekistan,Poland,14,6,0,20
3889,2017,Yemen,Poland,5,0,0,5
3891,2017,Afghanistan,Portugal,18,0,0,18
3892,2017,Angola,Portugal,0,15,0,15
3893,2017,Armenia,Portugal,5,0,0,5
3894,2017,Bangladesh,Portugal,5,0,0,5
3895,2017,Belarus,Portugal,17,0,0,17
3896,2017,Bosnia and Herzegovina,Portugal,11,0,0,11
3897,2017,Central African Rep.,Portugal,8,0,0,8
3898,2017,Cameroon,Portugal,13,0,0,13
3899,2017,Congo,Portugal,7,0,0,7
3900,2017,Dem. Rep. of the Congo,Portugal,63,5,0,68
3901,2017,Colombia,Portugal,71,0,0,71
3902,2017,Cuba,Portugal,6,0,0,6
3903,2017,Eritrea,Portugal,140,0,0,140
3904,2017,Gambia,Portugal,5,0,0,5
3905,2017,Palestinian,Portugal,5,0,0,5
3906,2017,Georgia,Portugal,5,0,0,5
3907,2017,Ghana,Portugal,5,0,0,5
3908,2017,Guinea-Bissau,Portugal,13,0,0,13
3909,2017,Guinea,Portugal,103,15,0,118
3910,2017,Cote d'Ivoire,Portugal,33,0,0,33
3911,2017,Iran (Islamic Rep. of),Portugal,38,0,0,38
3912,2017,Iraq,Portugal,57,0,0,57
3913,2017,Kenya,Portugal,6,0,0,6
3914,2017,Libya,Portugal,14,0,0,14
3915,2017,Sri Lanka,Portugal,48,0,0,48
3916,2017,Mauritania,Portugal,5,0,0,5
3917,2017,Mali,Portugal,13,0,0,13
3918,2017,Morocco,Portugal,9,0,0,9
3919,2017,Nigeria,Portugal,27,0,0,27
3920,2017,Pakistan,Portugal,60,0,0,60
3921,2017,Russian Federation,Portugal,18,5,0,23
3922,2017,Rwanda,Portugal,5,0,0,5
3923,2017,Senegal,Portugal,7,0,0,7
3924,2017,Sierra Leone,Portugal,27,5,0,32
3925,2017,Somalia,Portugal,51,0,0,51
3926,2017,Sudan,Portugal,5,0,0,5
3927,2017,Syrian Arab Rep.,Portugal,307,0,0,307
3928,2017,Togo,Portugal,6,0,0,6
3929,2017,Türkiye,Portugal,5,0,0,5
3930,2017,Uganda,Portugal,5,0,0,5
3931,2017,Ukraine,Portugal,373,0,0,373
3933,2017,Egypt,Qatar,9,0,0,9
3934,2017,Eritrea,Qatar,0,5,0,5
3935,2017,Iraq,Qatar,137,103,0,240
3936,2017,Somalia,Qatar,8,0,0,8
3937,2017,Sudan,Qatar,0,15,0,15
3938,2017,Syrian Arab Rep.,Qatar,34,0,0,34
3940,2017,Afghanistan,Romania,152,111,0,263
3941,2017,Algeria,Romania,5,0,0,5
3942,2017,Angola,Romania,5,0,0,5
3943,2017,Egypt,Romania,19,0,0,19
3944,2017,Burundi,Romania,6,0,0,6
3945,2017,Bangladesh,Romania,5,5,0,10
3946,2017,Central African Rep.,Romania,10,0,0,10
3947,2017,China,Romania,0,5,0,5
3948,2017,Cameroon,Romania,24,0,0,24
3949,2017,Congo,Romania,7,0,0,7
3950,2017,Dem. Rep. of the Congo,Romania,23,5,0,28
3951,2017,Cuba,Romania,0,5,0,5
3952,2017,Eritrea,Romania,53,0,0,53
3953,2017,Ethiopia,Romania,5,0,0,5
3954,2017,Gambia,Romania,5,0,0,5
3955,2017,Palestinian,Romania,42,16,0,58
3956,2017,Georgia,Romania,5,0,0,5
3957,2017,Guinea,Romania,7,0,0,7
3958,2017,Cote d'Ivoire,Romania,5,0,0,5
3959,2017,India,Romania,0,10,0,10
3960,2017,Iran (Islamic Rep. of),Romania,66,89,0,155
3961,2017,Iraq,Romania,806,994,0,1800
3962,2017,Jordan,Romania,7,0,0,7
3963,2017,Liberia,Romania,5,0,0,5
3964,2017,Libya,Romania,6,0,0,6
3965,2017,Lebanon,Romania,6,0,0,6
3966,2017,Sri Lanka,Romania,0,7,0,7
3967,2017,Myanmar,Romania,29,0,0,29
3968,2017,Nigeria,Romania,5,0,0,5
3969,2017,Pakistan,Romania,40,46,0,86
3970,2017,Rwanda,Romania,8,0,0,8
3971,2017,Serbia and Kosovo: S/RES/1244 (1999),Romania,0,5,0,5
3972,2017,Sierra Leone,Romania,5,0,0,5
3973,2017,Somalia,Romania,43,11,0,54
3974,2017,Sudan,Romania,15,0,0,15
3975,2017,Syrian Arab Rep.,Romania,2282,167,0,2449
3976,2017,Türkiye,Romania,25,27,0,52
3977,2017,Ukraine,Romania,37,5,0,42
3978,2017,Yemen,Romania,27,0,0,27
3979,2017,Zimbabwe,Romania,8,0,0,8
3981,2017,Algeria,South Africa,0,12,0,12
3982,2017,Angola,South Africa,25,0,0,25
3983,2017,Burundi,South Africa,3000,5865,0,8865
3984,2017,Bangladesh,South Africa,319,26366,0,26685
3985,2017,China,South Africa,0,171,0,171
3986,2017,Cameroon,South Africa,392,1691,0,2083
3987,2017,Congo,South Africa,5261,8800,0,14061
3988,2017,Dem. Rep. of the Congo,South Africa,26043,32537,0,58580
3989,2017,Eritrea,South Africa,1924,704,0,2628
3990,2017,Ethiopia,South Africa,17562,49487,0,67049
3991,2017,Palestinian,South Africa,38,0,0,38
3992,2017,Ghana,South Africa,0,2601,0,2601
3993,2017,Cote d'Ivoire,South Africa,41,0,0,41
3994,2017,India,South Africa,0,4459,0,4459
3995,2017,Kenya,South Africa,155,1097,0,1252
3996,2017,Liberia,South Africa,60,0,0,60
3997,2017,Malawi,South Africa,0,2761,0,2761
3998,2017,Mozambique,South Africa,0,987,0,987
3999,2017,Niger,South Africa,0,894,0,894
4000,2017,Nigeria,South Africa,0,8877,0,8877
4001,2017,Pakistan,South Africa,0,9993,0,9993
4002,2017,Rwanda,South Africa,1295,902,0,2197
4003,2017,Senegal,South Africa,0,834,0,834
4004,2017,Somalia,South Africa,26977,4014,0,30991
4005,2017,Sudan,South Africa,112,0,0,112
4006,2017,Syrian Arab Rep.,South Africa,45,0,0,45
4007,2017,United Rep. of Tanzania,South Africa,37,664,0,701
4008,2017,Uganda,South Africa,549,4586,0,5135
4009,2017,Zambia,South Africa,64,0,0,64
4010,2017,Zimbabwe,South Africa,4558,19290,0,23848
4012,2017,Afghanistan,Russian Federation,661,167,0,828
4013,2017,Azerbaijan,Russian Federation,15,5,0,20
4014,2017,Bangladesh,Russian Federation,5,0,0,5
4015,2017,Belarus,Russian Federation,0,9,0,9
4016,2017,Bosnia and Herzegovina,Russian Federation,5,0,0,5
4017,2017,Dem. Rep. of the Congo,Russian Federation,5,6,0,11
4018,2017,Palestinian,Russian Federation,9,0,0,9
4019,2017,Georgia,Russian Federation,198,12,0,210
4020,2017,Germany,Russian Federation,10,5,0,15
4021,2017,Cote d'Ivoire,Russian Federation,5,5,0,10
4022,2017,Iran (Islamic Rep. of),Russian Federation,6,0,0,6
4023,2017,Iraq,Russian Federation,24,8,0,32
4024,2017,Kazakhstan,Russian Federation,5,6,0,11
4025,2017,Kyrgyzstan,Russian Federation,25,10,0,35
4026,2017,Dem. People's Rep. of Korea,Russian Federation,77,10,0,87
4027,2017,Lebanon,Russian Federation,6,0,0,6
4028,2017,Lithuania,Russian Federation,5,0,0,5
4029,2017,Latvia,Russian Federation,5,0,0,5
4030,2017,Rep. of Moldova,Russian Federation,21,7,0,28
4031,2017,Nigeria,Russian Federation,5,0,0,5
4032,2017,Pakistan,Russian Federation,5,5,0,10
4033,2017,Sudan,Russian Federation,6,5,0,11
4034,2017,Syrian Arab Rep.,Russian Federation,1130,303,0,1433
4035,2017,Tajikistan,Russian Federation,23,15,0,38
4036,2017,Turkmenistan,Russian Federation,5,5,0,10
4037,2017,Türkiye,Russian Federation,5,0,0,5
4038,2017,Ukraine,Russian Federation,123600,1512,0,125112
4039,2017,United States of America,Russian Federation,5,0,0,5
4040,2017,Uzbekistan,Russian Federation,79,32,0,111
4041,2017,Yemen,Russian Federation,54,24,0,78
4044,2017,Angola,Rwanda,5,0,0,5
4045,2017,Burundi,Rwanda,88209,116,0,88325
4046,2017,Chad,Rwanda,7,0,0,7
4047,2017,Dem. Rep. of the Congo,Rwanda,82750,314,0,83064
4048,2017,Eritrea,Rwanda,5,8,0,13
4049,2017,Ethiopia,Rwanda,5,0,0,5
4050,2017,Rwanda,Rwanda,0,0,0,0
4051,2017,Somalia,Rwanda,5,0,0,5
4052,2017,Uganda,Rwanda,5,0,0,5
4053,2017,Colombia,El Salvador,5,0,0,5
4054,2017,Honduras,El Salvador,14,5,0,19
4055,2017,Iraq,El Salvador,5,0,0,5
4056,2017,Mexico,El Salvador,5,0,0,5
4057,2017,Nicaragua,El Salvador,6,0,0,6
4058,2017,El Salvador,El Salvador,0,0,71500,0
4059,2017,Syrian Arab Rep.,El Salvador,5,0,0,5
4060,2017,Chad,Saudi Arabia,9,0,0,9
4061,2017,China,Saudi Arabia,14,5,0,19
4062,2017,Eritrea,Saudi Arabia,32,5,0,37
4063,2017,Palestinian,Saudi Arabia,9,0,0,9
4064,2017,Iraq,Saudi Arabia,32,28,0,60
4065,2017,Liberia,Saudi Arabia,7,0,0,7
4066,2017,Somalia,Saudi Arabia,16,0,0,16
4067,2017,Sudan,Saudi Arabia,5,5,0,10
4068,2017,Syrian Arab Rep.,Saudi Arabia,14,34,0,48
4069,2017,Tunisia,Saudi Arabia,6,0,0,6
4070,2017,Yemen,Saudi Arabia,9,5,0,14
4072,2017,Afghanistan,Serbia and Kosovo: S/RES/1244 (1999),2182,49,0,2231
4073,2017,Bosnia and Herzegovina,Serbia and Kosovo: S/RES/1244 (1999),8765,0,0,8765
4074,2017,Congo,Serbia and Kosovo: S/RES/1244 (1999),0,7,0,7
4075,2017,Cuba,Serbia and Kosovo: S/RES/1244 (1999),5,5,0,10
4076,2017,Ethiopia,Serbia and Kosovo: S/RES/1244 (1999),5,0,0,5
4077,2017,Ghana,Serbia and Kosovo: S/RES/1244 (1999),0,5,0,5
4078,2017,Croatia,Serbia and Kosovo: S/RES/1244 (1999),19043,0,0,19043
4079,2017,Iran (Islamic Rep. of),Serbia and Kosovo: S/RES/1244 (1999),376,16,0,392
4080,2017,Iraq,Serbia and Kosovo: S/RES/1244 (1999),513,0,0,513
4081,2017,Libya,Serbia and Kosovo: S/RES/1244 (1999),32,0,0,32
4082,2017,Nigeria,Serbia and Kosovo: S/RES/1244 (1999),0,11,0,11
4083,2017,Pakistan,Serbia and Kosovo: S/RES/1244 (1999),0,19,0,19
4084,2017,Serbia and Kosovo: S/RES/1244 (1999),Serbia and Kosovo: S/RES/1244 (1999),0,0,217453,0
4085,2017,Somalia,Serbia and Kosovo: S/RES/1244 (1999),5,17,0,22
4086,2017,Sudan,Serbia and Kosovo: S/RES/1244 (1999),5,0,0,5
4087,2017,Syrian Arab Rep.,Serbia and Kosovo: S/RES/1244 (1999),73,0,0,73
4088,2017,Türkiye,Serbia and Kosovo: S/RES/1244 (1999),0,7,0,7
4089,2017,Ukraine,Serbia and Kosovo: S/RES/1244 (1999),15,0,0,15
4092,2017,Algeria,Senegal,9,10,0,19
4093,2017,Angola,Senegal,0,12,0,12
4094,2017,Burundi,Senegal,55,25,0,80
4095,2017,Benin,Senegal,0,6,0,6
4096,2017,Burkina Faso,Senegal,0,5,0,5
4097,2017,Central African Rep.,Senegal,289,441,0,730
4098,2017,Chad,Senegal,18,55,0,73
4099,2017,Cameroon,Senegal,12,42,0,54
4100,2017,Congo,Senegal,19,275,0,294
4101,2017,Dem. Rep. of the Congo,Senegal,30,336,0,366
4102,2017,Ethiopia,Senegal,0,5,0,5
4103,2017,France,Senegal,0,5,0,5
4104,2017,Gambia,Senegal,44,342,0,386
4105,2017,Ghana,Senegal,0,32,0,32
4106,2017,Guinea-Bissau,Senegal,0,93,0,93
4107,2017,Guinea,Senegal,10,113,0,123
4108,2017,Haiti,Senegal,0,5,0,5
4109,2017,Cote d'Ivoire,Senegal,39,310,0,349
4110,2017,India,Senegal,0,5,0,5
4111,2017,Liberia,Senegal,61,391,0,452
4112,2017,Sri Lanka,Senegal,0,87,0,87
4113,2017,Mauritania,Senegal,13779,99,0,13878
4114,2017,Mali,Senegal,0,52,0,52
4115,2017,Niger,Senegal,0,5,0,5
4116,2017,Nigeria,Senegal,7,364,0,371
4117,2017,Rwanda,Senegal,274,11,0,285
4118,2017,Sierra Leone,Senegal,0,31,0,31
4119,2017,Somalia,Senegal,0,8,0,8
4120,2017,Syrian Arab Rep.,Senegal,0,21,0,21
4121,2017,United Rep. of Tanzania,Senegal,0,6,0,6
4122,2017,Togo,Senegal,0,88,0,88
4123,2017,Türkiye,Senegal,0,88,0,88
4124,2017,Cote d'Ivoire,Sierra Leone,17,0,0,17
4125,2017,Liberia,Sierra Leone,653,0,0,653
4126,2017,Sudan,Sierra Leone,8,0,0,8
4127,2017,Egypt,Somalia,0,16,0,16
4128,2017,Bangladesh,Somalia,6,0,0,6
4129,2017,Cameroon,Somalia,0,5,0,5
4130,2017,Dem. Rep. of the Congo,Somalia,0,5,0,5
4131,2017,Djibouti,Somalia,0,13,0,13
4132,2017,Eritrea,Somalia,49,37,0,86
4133,2017,Ethiopia,Somalia,3608,14456,0,18064
4134,2017,Palestinian,Somalia,15,0,0,15
4135,2017,Iraq,Somalia,5,0,0,5
4136,2017,Mozambique,Somalia,0,5,0,5
4137,2017,Nigeria,Somalia,0,5,0,5
4138,2017,Pakistan,Somalia,0,5,0,5
4139,2017,Somalia,Somalia,0,0,2116705,0
4140,2017,Sudan,Somalia,5,12,0,17
4141,2017,Syrian Arab Rep.,Somalia,172,5,0,177
4142,2017,United Rep. of Tanzania,Somalia,0,71,0,71
4143,2017,Yemen,Somalia,10705,71,0,10776
4144,2017,Afghanistan,Spain,287,148,0,435
4145,2017,Albania,Spain,0,47,0,47
4146,2017,Algeria,Spain,46,484,0,530
4147,2017,Angola,Spain,10,21,0,31
4148,2017,Egypt,Spain,14,21,0,35
4149,2017,Argentina,Spain,0,11,0,11
4150,2017,Armenia,Spain,23,173,0,196
4151,2017,Azerbaijan,Spain,32,36,0,68
4152,2017,Burundi,Spain,5,0,0,5
4153,2017,Benin,Spain,5,7,0,12
4154,2017,Bangladesh,Spain,20,167,0,187
4155,2017,Burkina Faso,Spain,0,20,0,20
4156,2017,Belarus,Spain,15,25,0,40
4157,2017,Bolivia (Plurinational State of),Spain,9,11,0,20
4158,2017,Brazil,Spain,0,47,0,47
4159,2017,Bosnia and Herzegovina,Spain,0,5,0,5
4160,2017,Bulgaria,Spain,0,5,0,5
4161,2017,Central African Rep.,Spain,42,148,0,190
4162,2017,China,Spain,21,402,0,423
4163,2017,Chile,Spain,0,14,0,14
4164,2017,Cameroon,Spain,47,839,0,886
4165,2017,Congo,Spain,10,211,0,221
4166,2017,Dem. Rep. of the Congo,Spain,74,248,0,322
4167,2017,Colombia,Spain,179,2483,0,2662
4168,2017,Costa Rica,Spain,0,13,0,13
4169,2017,Cuba,Spain,894,191,0,1085
4170,2017,Dominican Rep.,Spain,0,184,0,184
4171,2017,Ecuador,Spain,0,20,0,20
4172,2017,Equatorial Guinea,Spain,32,42,0,74
4173,2017,Eritrea,Spain,213,53,0,266
4174,2017,Ethiopia,Spain,60,12,0,72
4175,2017,Gabon,Spain,0,5,0,5
4176,2017,Gambia,Spain,12,140,0,152
4177,2017,Palestinian,Spain,862,1315,0,2177
4178,2017,Georgia,Spain,7,254,0,261
4179,2017,Ghana,Spain,0,52,0,52
4180,2017,Guinea-Bissau,Spain,0,16,0,16
4181,2017,Guatemala,Spain,12,87,0,99
4182,2017,Guinea,Spain,6,469,0,475
4183,2017,Haiti,Spain,21,5,0,26
4184,2017,Honduras,Spain,35,1373,0,1408
4185,2017,Cote d'Ivoire,Spain,193,402,0,595
4186,2017,India,Spain,6,40,0,46
4187,2017,Iran (Islamic Rep. of),Spain,88,63,0,151
4188,2017,Iraq,Spain,319,197,0,516
4189,2017,Jamaica,Spain,0,15,0,15
4190,2017,Jordan,Spain,29,15,0,44
4191,2017,Kazakhstan,Spain,10,10,0,20
4192,2017,Kenya,Spain,0,6,0,6
4193,2017,Kyrgyzstan,Spain,6,11,0,17
4194,2017,Liberia,Spain,6,16,0,22
4195,2017,Libya,Spain,24,50,0,74
4196,2017,Lebanon,Spain,25,109,0,134
4197,2017,Sri Lanka,Spain,100,51,0,151
4198,2017,Mauritania,Spain,0,37,0,37
4199,2017,North Macedonia,Spain,0,8,0,8
4200,2017,Rep. of Moldova,Spain,0,21,0,21
4201,2017,Mexico,Spain,16,56,0,72
4202,2017,Mali,Spain,30,211,0,241
4203,2017,Mongolia,Spain,0,8,0,8
4204,2017,Morocco,Spain,112,402,0,514
4205,2017,Mozambique,Spain,0,5,0,5
4206,2017,Myanmar,Spain,5,5,0,10
4207,2017,Niger,Spain,0,8,0,8
4208,2017,Nicaragua,Spain,11,47,0,58
4209,2017,Nigeria,Spain,47,623,0,670
4210,2017,Pakistan,Spain,365,342,0,707
4211,2017,Panama,Spain,0,6,0,6
4212,2017,Paraguay,Spain,0,21,0,21
4213,2017,Peru,Spain,0,133,0,133
4214,2017,South Africa,Spain,0,5,0,5
4215,2017,Russian Federation,Spain,139,446,0,585
4216,2017,Rwanda,Spain,0,5,0,5
4217,2017,El Salvador,Spain,7,1501,0,1508
4218,2017,Serbia and Kosovo: S/RES/1244 (1999),Spain,0,20,0,20
4219,2017,Senegal,Spain,6,155,0,161
4220,2017,Sierra Leone,Spain,11,35,0,46
4221,2017,Somalia,Spain,601,165,0,766
4222,2017,Viet Nam,Spain,0,30,0,30
4223,2017,Sudan,Spain,54,48,0,102
4224,2017,South Sudan,Spain,0,5,0,5
4225,2017,Syrian Arab Rep.,Spain,11752,2255,0,14007
4226,2017,Tajikistan,Spain,5,0,0,5
4227,2017,Turkmenistan,Spain,0,5,0,5
4228,2017,Togo,Spain,14,10,0,24
4229,2017,Tunisia,Spain,0,14,0,14
4230,2017,Türkiye,Spain,10,91,0,101
4231,2017,Uganda,Spain,0,5,0,5
4232,2017,Ukraine,Spain,368,4466,0,4834
4233,2017,Uruguay,Spain,0,13,0,13
4234,2017,United States of America,Spain,0,26,0,26
4235,2017,Uzbekistan,Spain,10,9,0,19
4236,2017,Venezuela (Bolivarian Republic of),Spain,44,12465,0,12509
4237,2017,Western Sahara,Spain,17,127,0,144
4238,2017,Yemen,Spain,21,210,0,231
4243,2017,Cuba,Saint Kitts and Nevis,0,5,0,5
4244,2017,Afghanistan,Sudan,0,0,0,0
4245,2017,Egypt,Sudan,7,25,0,32
4246,2017,Burundi,Sudan,15,10,0,25
4247,2017,Central African Rep.,Sudan,2277,10,0,2287
4248,2017,Chad,Sudan,7458,5,0,7463
4249,2017,Cameroon,Sudan,7,0,0,7
4250,2017,Congo,Sudan,0,6,0,6
4251,2017,Dem. Rep. of the Congo,Sudan,59,752,0,811
4252,2017,Eritrea,Sudan,108243,4901,0,113144
4253,2017,Ethiopia,Sudan,4273,9204,0,13477
4254,2017,Palestinian,Sudan,59,76,0,135
4255,2017,India,Sudan,0,5,0,5
4256,2017,Iraq,Sudan,16,23,0,39
4257,2017,Kuwait,Sudan,0,0,0,0
4258,2017,Nigeria,Sudan,0,10,0,10
4259,2017,Somalia,Sudan,208,146,0,354
4260,2017,Sudan,Sudan,0,0,1997022,0
4261,2017,South Sudan,Sudan,772715,0,0,772715
4262,2017,Syrian Arab Rep.,Sudan,11240,439,0,11679
4263,2017,Uganda,Sudan,5,0,0,5
4264,2017,Yemen,Sudan,0,2561,0,2561
4266,2017,Cuba,Suriname,29,62,0,91
4267,2017,Dominican Rep.,Suriname,0,5,0,5
4268,2017,Jamaica,Suriname,5,0,0,5
4269,2017,Burundi,South Sudan,5,274,0,279
4270,2017,Central African Rep.,South Sudan,1869,0,0,1869
4271,2017,Dem. Rep. of the Congo,South Sudan,14961,0,0,14961
4272,2017,Eritrea,South Sudan,32,1344,0,1376
4273,2017,Ethiopia,South Sudan,4555,241,0,4796
4274,2017,Somalia,South Sudan,0,28,0,28
4275,2017,Sudan,South Sudan,261983,8,0,261991
4276,2017,South Sudan,South Sudan,0,0,1903953,0
4277,2017,Afghanistan,Slovakia,246,0,0,246
4278,2017,Angola,Slovakia,24,0,0,24
4279,2017,Egypt,Slovakia,5,0,0,5
4280,2017,Armenia,Slovakia,34,0,0,34
4281,2017,Burundi,Slovakia,5,0,0,5
4282,2017,Bosnia and Herzegovina,Slovakia,36,0,0,36
4283,2017,Bulgaria,Slovakia,8,0,0,8
4284,2017,Cambodia,Slovakia,5,0,0,5
4285,2017,China,Slovakia,5,0,0,5
4286,2017,Cameroon,Slovakia,7,0,0,7
4287,2017,Dem. Rep. of the Congo,Slovakia,16,0,0,16
4288,2017,Cuba,Slovakia,40,0,0,40
4289,2017,Palestinian,Slovakia,7,0,0,7
4290,2017,Iran (Islamic Rep. of),Slovakia,28,0,0,28
4291,2017,Iraq,Slovakia,209,0,0,209
4292,2017,Liberia,Slovakia,5,0,0,5
4293,2017,Pakistan,Slovakia,6,0,0,6
4294,2017,Romania,Slovakia,37,0,0,37
4295,2017,Russian Federation,Slovakia,37,0,0,37
4296,2017,Serbia and Kosovo: S/RES/1244 (1999),Slovakia,46,0,0,46
4297,2017,Somalia,Slovakia,31,0,0,31
4298,2017,Viet Nam,Slovakia,16,0,0,16
4299,2017,Sudan,Slovakia,0,0,0,0
4300,2017,Syrian Arab Rep.,Slovakia,17,0,0,17
4301,2017,Uganda,Slovakia,5,0,0,5
4302,2017,Ukraine,Slovakia,23,0,0,23
4303,2017,Uzbekistan,Slovakia,5,0,0,5
4306,2017,Afghanistan,Slovenia,41,41,0,82
4307,2017,Algeria,Slovenia,0,58,0,58
4308,2017,Bosnia and Herzegovina,Slovenia,8,5,0,13
4309,2017,Cameroon,Slovenia,5,0,0,5
4310,2017,Dem. Rep. of the Congo,Slovenia,8,0,0,8
4311,2017,Eritrea,Slovenia,56,11,0,67
4312,2017,Palestinian,Slovenia,11,5,0,16
4313,2017,Iran (Islamic Rep. of),Slovenia,60,18,0,78
4314,2017,Iraq,Slovenia,39,5,0,44
4315,2017,Kazakhstan,Slovenia,19,0,0,19
4316,2017,Libya,Slovenia,0,8,0,8
4317,2017,Morocco,Slovenia,0,12,0,12
4318,2017,Pakistan,Slovenia,0,32,0,32
4319,2017,Russian Federation,Slovenia,15,0,0,15
4320,2017,Serbia and Kosovo: S/RES/1244 (1999),Slovenia,65,15,0,80
4321,2017,Sierra Leone,Slovenia,5,0,0,5
4322,2017,Somalia,Slovenia,48,0,0,48
4323,2017,Viet Nam,Slovenia,0,5,0,5
4324,2017,Sudan,Slovenia,6,0,0,6
4325,2017,Syrian Arab Rep.,Slovenia,215,9,0,224
4326,2017,Türkiye,Slovenia,0,40,0,40
4327,2017,Ukraine,Slovenia,5,0,0,5
4328,2017,Yemen,Slovenia,5,0,0,5
4330,2017,Angola,Eswatini,11,0,0,11
4331,2017,Burundi,Eswatini,160,84,0,244
4332,2017,Congo,Eswatini,5,45,0,50
4333,2017,Dem. Rep. of the Congo,Eswatini,355,148,0,503
4334,2017,Ethiopia,Eswatini,5,36,0,41
4335,2017,Guinea,Eswatini,5,0,0,5
4336,2017,Kenya,Eswatini,5,0,0,5
4337,2017,Sri Lanka,Eswatini,5,0,0,5
4338,2017,Rwanda,Eswatini,153,91,0,244
4339,2017,Somalia,Eswatini,73,140,0,213
4340,2017,Uganda,Eswatini,6,0,0,6
4341,2017,Zimbabwe,Eswatini,7,0,0,7
4342,2017,Afghanistan,Sweden,25645,17812,0,43457
4343,2017,Albania,Sweden,329,384,0,713
4344,2017,Algeria,Sweden,66,121,0,187
4345,2017,Angola,Sweden,38,29,0,67
4346,2017,Egypt,Sweden,347,384,0,731
4347,2017,Armenia,Sweden,474,281,0,755
4348,2017,Azerbaijan,Sweden,685,380,0,1065
4349,2017,Bahrain,Sweden,15,5,0,20
4350,2017,Burundi,Sweden,200,103,0,303
4351,2017,Benin,Sweden,5,5,0,10
4352,2017,Bangladesh,Sweden,229,312,0,541
4353,2017,Bhutan,Sweden,8,0,0,8
4354,2017,Burkina Faso,Sweden,5,6,0,11
4355,2017,Belarus,Sweden,134,154,0,288
4356,2017,Bolivia (Plurinational State of),Sweden,64,37,0,101
4357,2017,Brazil,Sweden,8,14,0,22
4358,2017,Bosnia and Herzegovina,Sweden,160,98,0,258
4359,2017,Bulgaria,Sweden,16,0,0,16
4360,2017,Chad,Sweden,19,6,0,25
4361,2017,China,Sweden,282,66,0,348
4362,2017,Chile,Sweden,19,18,0,37
4363,2017,Cameroon,Sweden,152,101,0,253
4364,2017,Congo,Sweden,50,27,0,77
4365,2017,Dem. Rep. of the Congo,Sweden,324,73,0,397
4366,2017,Comoros,Sweden,5,0,0,5
4367,2017,Colombia,Sweden,30,152,0,182
4368,2017,Cuba,Sweden,60,65,0,125
4369,2017,Djibouti,Sweden,21,33,0,54
4370,2017,Ecuador,Sweden,8,17,0,25
4371,2017,Equatorial Guinea,Sweden,0,5,0,5
4372,2017,Eritrea,Sweden,27153,931,0,28084
4373,2017,Ethiopia,Sweden,2005,1022,0,3027
4374,2017,France,Sweden,5,0,0,5
4375,2017,Gambia,Sweden,147,154,0,301
4376,2017,Palestinian,Sweden,983,442,0,1425
4377,2017,United Kingdom of Great Britain and Northern Ireland,Sweden,7,5,0,12
4378,2017,Georgia,Sweden,133,622,0,755
4379,2017,Germany,Sweden,5,0,0,5
4380,2017,Ghana,Sweden,56,66,0,122
4381,2017,Guinea-Bissau,Sweden,7,5,0,12
4382,2017,Greece,Sweden,18,0,0,18
4383,2017,Guatemala,Sweden,9,5,0,14
4384,2017,Guinea,Sweden,80,42,0,122
4385,2017,Honduras,Sweden,11,23,0,34
4386,2017,Croatia,Sweden,0,5,0,5
4387,2017,Hungary,Sweden,5,5,0,10
4388,2017,Cote d'Ivoire,Sweden,61,25,0,86
4389,2017,India,Sweden,29,64,0,93
4390,2017,Indonesia,Sweden,15,0,0,15
4391,2017,Iran (Islamic Rep. of),Sweden,5867,3116,0,8983
4392,2017,Iraq,Sweden,15524,7856,0,23380
4393,2017,Israel,Sweden,33,12,0,45
4394,2017,Italy,Sweden,5,5,0,10
4395,2017,Jordan,Sweden,344,290,0,634
4396,2017,Kazakhstan,Sweden,266,154,0,420
4397,2017,Kenya,Sweden,93,78,0,171
4398,2017,Kyrgyzstan,Sweden,177,137,0,314
4399,2017,Rep. of Korea,Sweden,6,0,0,6
4400,2017,Dem. People's Rep. of Korea,Sweden,5,10,0,15
4401,2017,Kuwait,Sweden,23,59,0,82
4402,2017,Liberia,Sweden,13,13,0,26
4403,2017,Libya,Sweden,404,167,0,571
4404,2017,Lebanon,Sweden,534,571,0,1105
4405,2017,Sri Lanka,Sweden,48,41,0,89
4406,2017,Lithuania,Sweden,5,7,0,12
4407,2017,Latvia,Sweden,8,0,0,8
4408,2017,Mauritania,Sweden,12,5,0,17
4409,2017,North Macedonia,Sweden,55,88,0,143
4410,2017,Rep. of Moldova,Sweden,8,5,0,13
4411,2017,Mexico,Sweden,0,5,0,5
4412,2017,Mali,Sweden,24,11,0,35
4413,2017,Malaysia,Sweden,8,5,0,13
4414,2017,Mongolia,Sweden,315,359,0,674
4415,2017,Morocco,Sweden,230,368,0,598
4416,2017,Montenegro,Sweden,40,31,0,71
4417,2017,Myanmar,Sweden,16,5,0,21
4418,2017,Nepal,Sweden,19,12,0,31
4419,2017,Niger,Sweden,5,0,0,5
4420,2017,Nicaragua,Sweden,9,59,0,68
4421,2017,Nigeria,Sweden,510,515,0,1025
4422,2017,Norway,Sweden,5,0,0,5
4423,2017,Pakistan,Sweden,461,433,0,894
4424,2017,Peru,Sweden,11,66,0,77
4425,2017,Philippines,Sweden,7,26,0,33
4426,2017,Poland,Sweden,5,0,0,5
4427,2017,Romania,Sweden,63,0,0,63
4428,2017,South Africa,Sweden,0,14,0,14
4429,2017,Russian Federation,Sweden,1628,635,0,2263
4430,2017,Rwanda,Sweden,38,36,0,74
4431,2017,El Salvador,Sweden,78,159,0,237
4432,2017,Saudi Arabia,Sweden,46,22,0,68
4433,2017,Serbia and Kosovo: S/RES/1244 (1999),Sweden,1455,389,0,1844
4434,2017,Senegal,Sweden,45,25,0,70
4435,2017,Sierra Leone,Sweden,69,34,0,103
4436,2017,Somalia,Sweden,21973,2326,0,24299
4437,2017,Viet Nam,Sweden,68,29,0,97
4438,2017,Sudan,Sweden,841,241,0,1082
4439,2017,South Sudan,Sweden,5,5,0,10
4440,2017,Slovakia,Sweden,6,0,0,6
4441,2017,Syrian Arab Rep.,Sweden,103614,3531,0,107145
4442,2017,United Rep. of Tanzania,Sweden,40,52,0,92
4443,2017,Thailand,Sweden,8,17,0,25
4444,2017,Tajikistan,Sweden,58,65,0,123
4445,2017,Turkmenistan,Sweden,13,10,0,23
4446,2017,Togo,Sweden,7,0,0,7
4447,2017,Tunisia,Sweden,55,98,0,153
4448,2017,Türkiye,Sweden,270,1342,0,1612
4449,2017,United Arab Emirates,Sweden,5,0,0,5
4450,2017,Uganda,Sweden,669,98,0,767
4451,2017,Ukraine,Sweden,208,387,0,595
4452,2017,United States of America,Sweden,20,6,0,26
4453,2017,Uzbekistan,Sweden,616,455,0,1071
4454,2017,Venezuela (Bolivarian Republic of),Sweden,6,91,0,97
4455,2017,Yemen,Sweden,1099,186,0,1285
4456,2017,Zambia,Sweden,11,5,0,16
4457,2017,Zimbabwe,Sweden,24,11,0,35
4460,2017,Afghanistan,Switzerland,8151,5620,0,13771
4461,2017,Albania,Switzerland,86,54,0,140
4462,2017,Algeria,Switzerland,160,148,0,308
4463,2017,Angola,Switzerland,774,42,0,816
4464,2017,Egypt,Switzerland,106,34,0,140
4465,2017,Armenia,Switzerland,132,104,0,236
4466,2017,Azerbaijan,Switzerland,80,85,0,165
4467,2017,Bahrain,Switzerland,5,0,0,5
4468,2017,Burundi,Switzerland,84,33,0,117
4469,2017,Benin,Switzerland,22,5,0,27
4470,2017,Bangladesh,Switzerland,62,19,0,81
4471,2017,Burkina Faso,Switzerland,19,7,0,26
4472,2017,Belarus,Switzerland,43,21,0,64
4473,2017,Brazil,Switzerland,14,5,0,19
4474,2017,Bosnia and Herzegovina,Switzerland,2026,23,0,2049
4475,2017,Bulgaria,Switzerland,9,8,0,17
4476,2017,Cambodia,Switzerland,322,0,0,322
4477,2017,Central African Rep.,Switzerland,13,6,0,19
4478,2017,Chad,Switzerland,49,11,0,60
4479,2017,China,Switzerland,2973,413,0,3386
4480,2017,Chile,Switzerland,12,0,0,12
4481,2017,Cameroon,Switzerland,188,69,0,257
4482,2017,Congo,Switzerland,67,5,0,72
4483,2017,Dem. Rep. of the Congo,Switzerland,1288,143,0,1431
4484,2017,Colombia,Switzerland,254,39,0,293
4485,2017,Cuba,Switzerland,40,5,0,45
4486,2017,Czechia,Switzerland,7,0,0,7
4487,2017,Djibouti,Switzerland,14,7,0,21
4488,2017,Ecuador,Switzerland,7,0,0,7
4489,2017,Eritrea,Switzerland,30935,4526,0,35461
4490,2017,Ethiopia,Switzerland,1418,671,0,2089
4491,2017,Gambia,Switzerland,46,50,0,96
4492,2017,Georgia,Switzerland,142,254,0,396
4493,2017,Ghana,Switzerland,17,20,0,37
4494,2017,Guinea-Bissau,Switzerland,60,16,0,76
4495,2017,Guatemala,Switzerland,6,0,0,6
4496,2017,Guinea,Switzerland,154,150,0,304
4497,2017,Croatia,Switzerland,33,0,0,33
4498,2017,Hungary,Switzerland,7,0,0,7
4499,2017,Cote d'Ivoire,Switzerland,169,69,0,238
4500,2017,India,Switzerland,39,7,0,46
4501,2017,Indonesia,Switzerland,0,5,0,5
4502,2017,Iran (Islamic Rep. of),Switzerland,1637,905,0,2542
4503,2017,Iraq,Switzerland,4015,1394,0,5409
4504,2017,Israel,Switzerland,5,0,0,5
4505,2017,Italy,Switzerland,5,0,0,5
4506,2017,Jordan,Switzerland,57,10,0,67
4507,2017,Kazakhstan,Switzerland,12,9,0,21
4508,2017,Kenya,Switzerland,43,0,0,43
4509,2017,Kyrgyzstan,Switzerland,18,7,0,25
4510,2017,Kuwait,Switzerland,0,8,0,8
4511,2017,Lao People's Dem. Rep.,Switzerland,127,0,0,127
4512,2017,Liberia,Switzerland,44,9,0,53
4513,2017,Libya,Switzerland,297,71,0,368
4514,2017,Lebanon,Switzerland,41,24,0,65
4515,2017,Sri Lanka,Switzerland,5581,1833,0,7414
4516,2017,Madagascar,Switzerland,5,0,0,5
4517,2017,Mauritania,Switzerland,6,7,0,13
4518,2017,North Macedonia,Switzerland,188,39,0,227
4519,2017,Rep. of Moldova,Switzerland,7,10,0,17
4520,2017,Mali,Switzerland,29,25,0,54
4521,2017,Mongolia,Switzerland,118,54,0,172
4522,2017,Morocco,Switzerland,62,101,0,163
4523,2017,Montenegro,Switzerland,45,7,0,52
4524,2017,Myanmar,Switzerland,40,0,0,40
4525,2017,Nepal,Switzerland,19,11,0,30
4526,2017,Niger,Switzerland,11,5,0,16
4527,2017,Nigeria,Switzerland,185,139,0,324
4528,2017,Pakistan,Switzerland,150,241,0,391
4529,2017,Paraguay,Switzerland,5,0,0,5
4530,2017,Peru,Switzerland,8,0,0,8
4531,2017,Philippines,Switzerland,6,6,0,12
4532,2017,Poland,Switzerland,5,0,0,5
4533,2017,Portugal,Switzerland,5,0,0,5
4534,2017,Romania,Switzerland,20,0,0,20
4535,2017,South Africa,Switzerland,14,5,0,19
4536,2017,Russian Federation,Switzerland,734,127,0,861
4537,2017,Rwanda,Switzerland,140,5,0,145
4538,2017,El Salvador,Switzerland,5,10,0,15
4539,2017,Saudi Arabia,Switzerland,5,13,0,18
4540,2017,Serbia and Kosovo: S/RES/1244 (1999),Switzerland,2777,159,0,2936
4541,2017,Senegal,Switzerland,42,31,0,73
4542,2017,Sierra Leone,Switzerland,34,13,0,47
4543,2017,Somalia,Switzerland,4574,874,0,5448
4544,2017,Viet Nam,Switzerland,996,0,0,996
4545,2017,Sudan,Switzerland,277,123,0,400
4546,2017,South Sudan,Switzerland,7,5,0,12
4547,2017,Syrian Arab Rep.,Switzerland,13639,3192,0,16831
4548,2017,United Rep. of Tanzania,Switzerland,15,0,0,15
4549,2017,Tajikistan,Switzerland,11,8,0,19
4550,2017,Turkmenistan,Switzerland,5,0,0,5
4551,2017,Togo,Switzerland,669,22,0,691
4552,2017,Tunisia,Switzerland,273,67,0,340
4553,2017,Türkiye,Switzerland,3440,932,0,4372
4554,2017,Uganda,Switzerland,40,18,0,58
4555,2017,Ukraine,Switzerland,42,84,0,126
4556,2017,Uzbekistan,Switzerland,50,12,0,62
4557,2017,Venezuela (Bolivarian Republic of),Switzerland,5,19,0,24
4558,2017,Western Sahara,Switzerland,7,5,0,12
4559,2017,Yemen,Switzerland,339,47,0,386
4560,2017,Zimbabwe,Switzerland,15,5,0,20
4563,2017,Afghanistan,Syrian Arab Rep.,1221,32,0,1253
4564,2017,Algeria,Syrian Arab Rep.,5,0,0,5
4565,2017,Egypt,Syrian Arab Rep.,35,12,0,47
4566,2017,Bahrain,Syrian Arab Rep.,0,5,0,5
4567,2017,Burkina Faso,Syrian Arab Rep.,0,5,0,5
4568,2017,Chad,Syrian Arab Rep.,8,5,0,13
4569,2017,Eritrea,Syrian Arab Rep.,23,5,0,28
4570,2017,Ethiopia,Syrian Arab Rep.,19,0,0,19
4571,2017,Guinea,Syrian Arab Rep.,51,5,0,56
4572,2017,Cote d'Ivoire,Syrian Arab Rep.,5,0,0,5
4573,2017,Iran (Islamic Rep. of),Syrian Arab Rep.,45,30,0,75
4574,2017,Iraq,Syrian Arab Rep.,16325,17673,0,33998
4575,2017,Jordan,Syrian Arab Rep.,25,13,0,38
4576,2017,Kuwait,Syrian Arab Rep.,5,0,0,5
4577,2017,Libya,Syrian Arab Rep.,14,0,0,14
4578,2017,Lebanon,Syrian Arab Rep.,24,0,0,24
4579,2017,Sri Lanka,Syrian Arab Rep.,0,5,0,5
4580,2017,Morocco,Syrian Arab Rep.,6,0,0,6
4581,2017,Pakistan,Syrian Arab Rep.,173,26,0,199
4582,2017,Saudi Arabia,Syrian Arab Rep.,11,0,0,11
4583,2017,Sierra Leone,Syrian Arab Rep.,19,0,0,19
4584,2017,Somalia,Syrian Arab Rep.,404,0,0,404
4585,2017,Sudan,Syrian Arab Rep.,762,89,0,851
4586,2017,South Sudan,Syrian Arab Rep.,110,0,0,110
4587,2017,Syrian Arab Rep.,Syrian Arab Rep.,0,0,6150005,0
4588,2017,United Rep. of Tanzania,Syrian Arab Rep.,0,5,0,5
4589,2017,Tunisia,Syrian Arab Rep.,5,5,0,10
4590,2017,Türkiye,Syrian Arab Rep.,7,9,0,16
4591,2017,Yemen,Syrian Arab Rep.,123,169,0,292
4593,2017,Burundi,United Rep. of Tanzania,251227,24455,0,275682
4594,2017,Dem. Rep. of the Congo,United Rep. of Tanzania,56906,19548,0,76454
4595,2017,Somalia,United Rep. of Tanzania,150,0,0,150
4597,2017,Cuba,Turks and Caicos Islands,5,0,0,5
4598,2017,Afghanistan,Thailand,88,5,0,93
4599,2017,Egypt,Thailand,16,13,0,29
4600,2017,Bangladesh,Thailand,0,5,0,5
4601,2017,Cambodia,Thailand,166,167,0,333
4602,2017,China,Thailand,179,27,0,206
4603,2017,Dem. Rep. of the Congo,Thailand,33,8,0,41
4604,2017,Eritrea,Thailand,8,0,0,8
4605,2017,Ethiopia,Thailand,13,25,0,38
4606,2017,Palestinian,Thailand,413,16,0,429
4607,2017,Guinea,Thailand,0,5,0,5
4608,2017,Cote d'Ivoire,Thailand,16,0,0,16
4609,2017,Iran (Islamic Rep. of),Thailand,57,77,0,134
4610,2017,Iraq,Thailand,305,26,0,331
4611,2017,Jordan,Thailand,5,0,0,5
4612,2017,Lao People's Dem. Rep.,Thailand,0,12,0,12
4613,2017,Sri Lanka,Thailand,156,55,0,211
4614,2017,Myanmar,Thailand,99982,254,0,100236
4615,2017,Nepal,Thailand,11,0,0,11
4616,2017,Nigeria,Thailand,0,5,0,5
4617,2017,Pakistan,Thailand,2075,722,0,2797
4618,2017,Russian Federation,Thailand,5,5,0,10
4619,2017,Somalia,Thailand,223,134,0,357
4620,2017,Viet Nam,Thailand,450,471,0,921
4621,2017,Sudan,Thailand,14,0,0,14
4622,2017,Syrian Arab Rep.,Thailand,327,9,0,336
4623,2017,United Rep. of Tanzania,Thailand,5,0,0,5
4624,2017,Togo,Thailand,5,0,0,5
4625,2017,Ukraine,Thailand,5,0,0,5
4626,2017,Uzbekistan,Thailand,0,5,0,5
4627,2017,Yemen,Thailand,40,0,0,40
4628,2017,Zimbabwe,Thailand,8,0,0,8
4630,2017,Afghanistan,Tajikistan,2516,440,0,2956
4631,2017,Iran (Islamic Rep. of),Tajikistan,5,0,0,5
4633,2017,Afghanistan,Turkmenistan,14,0,0,14
4634,2017,Azerbaijan,Turkmenistan,8,0,0,8
4636,2017,Burundi,Togo,5,0,0,5
4637,2017,Burkina Faso,Togo,0,5,0,5
4638,2017,Central African Rep.,Togo,349,172,0,521
4639,2017,Chad,Togo,18,9,0,27
4640,2017,Cameroon,Togo,0,8,0,8
4641,2017,Congo,Togo,27,12,0,39
4642,2017,Dem. Rep. of the Congo,Togo,99,79,0,178
4643,2017,Ghana,Togo,9695,0,0,9695
4644,2017,Cote d'Ivoire,Togo,1991,349,0,2340
4645,2017,Iraq,Togo,5,0,0,5
4646,2017,Lebanon,Togo,0,13,0,13
4647,2017,Sri Lanka,Togo,0,6,0,6
4648,2017,Mali,Togo,91,41,0,132
4649,2017,Nigeria,Togo,8,13,0,21
4650,2017,Rwanda,Togo,137,5,0,142
4651,2017,Sudan,Togo,0,5,0,5
4652,2017,Syrian Arab Rep.,Togo,0,9,0,9
4653,2017,Türkiye,Togo,0,18,0,18
4654,2017,Bangladesh,Trinidad and Tobago,10,56,0,66
4655,2017,Colombia,Trinidad and Tobago,14,13,0,27
4656,2017,Cuba,Trinidad and Tobago,108,728,0,836
4657,2017,Dominican Rep.,Trinidad and Tobago,0,5,0,5
4658,2017,Guyana,Trinidad and Tobago,5,5,0,10
4659,2017,Jamaica,Trinidad and Tobago,19,12,0,31
4660,2017,Sri Lanka,Trinidad and Tobago,5,0,0,5
4661,2017,Mexico,Trinidad and Tobago,6,0,0,6
4662,2017,Nigeria,Trinidad and Tobago,0,5,0,5
4663,2017,Pakistan,Trinidad and Tobago,10,11,0,21
4664,2017,Syrian Arab Rep.,Trinidad and Tobago,53,32,0,85
4665,2017,Trinidad and Tobago,Trinidad and Tobago,0,0,0,0
4666,2017,Saint Vincent and the Grenadines,Trinidad and Tobago,5,0,0,5
4667,2017,Venezuela (Bolivarian Republic of),Trinidad and Tobago,47,1108,0,1155
4668,2017,Algeria,Tunisia,7,0,0,7
4669,2017,Central African Rep.,Tunisia,5,0,0,5
4670,2017,Cameroon,Tunisia,5,0,0,5
4671,2017,Eritrea,Tunisia,5,0,0,5
4672,2017,Ethiopia,Tunisia,5,0,0,5
4673,2017,Palestinian,Tunisia,29,0,0,29
4674,2017,Cote d'Ivoire,Tunisia,5,0,0,5
4675,2017,Iran (Islamic Rep. of),Tunisia,6,0,0,6
4676,2017,Iraq,Tunisia,15,0,0,15
4677,2017,Rwanda,Tunisia,6,0,0,6
4678,2017,Somalia,Tunisia,9,0,0,9
4679,2017,Sudan,Tunisia,26,0,0,26
4680,2017,Syrian Arab Rep.,Tunisia,603,0,0,603
4681,2017,Türkiye,Tunisia,0,15,0,15
4682,2017,Yemen,Tunisia,0,21,0,21
4683,2017,Afghanistan,Türkiye,5603,157810,0,163413
4684,2017,Algeria,Türkiye,5,23,0,28
4685,2017,Angola,Türkiye,5,0,0,5
4686,2017,Egypt,Türkiye,51,253,0,304
4687,2017,Azerbaijan,Türkiye,5,0,0,5
4688,2017,Burundi,Türkiye,6,28,0,34
4689,2017,Bangladesh,Türkiye,0,161,0,161
4690,2017,Central African Rep.,Türkiye,0,15,0,15
4691,2017,China,Türkiye,13,383,0,396
4692,2017,Cameroon,Türkiye,11,70,0,81
4693,2017,Congo,Türkiye,6,113,0,119
4694,2017,Dem. Rep. of the Congo,Türkiye,51,416,0,467
4695,2017,Djibouti,Türkiye,0,6,0,6
4696,2017,Eritrea,Türkiye,75,99,0,174
4697,2017,Ethiopia,Türkiye,95,215,0,310
4698,2017,Gabon,Türkiye,0,9,0,9
4699,2017,Gambia,Türkiye,0,11,0,11
4700,2017,Palestinian,Türkiye,1147,646,0,1793
4701,2017,Ghana,Türkiye,0,12,0,12
4702,2017,Guinea,Türkiye,12,10,0,22
4703,2017,Cote d'Ivoire,Türkiye,15,18,0,33
4704,2017,India,Türkiye,0,5,0,5
4705,2017,Iran (Islamic Rep. of),Türkiye,8308,25615,0,33923
4706,2017,Iraq,Türkiye,37319,115657,0,152976
4707,2017,Jordan,Türkiye,35,72,0,107
4708,2017,Kazakhstan,Türkiye,0,40,0,40
4709,2017,Kenya,Türkiye,0,5,0,5
4710,2017,Kyrgyzstan,Türkiye,190,100,0,290
4711,2017,Kuwait,Türkiye,0,5,0,5
4712,2017,Liberia,Türkiye,5,5,0,10
4713,2017,Libya,Türkiye,23,63,0,86
4714,2017,Lebanon,Türkiye,13,33,0,46
4715,2017,Sri Lanka,Türkiye,15,6,0,21
4716,2017,Mauritania,Türkiye,8,0,0,8
4717,2017,Mali,Türkiye,0,24,0,24
4718,2017,Malaysia,Türkiye,0,5,0,5
4719,2017,Mongolia,Türkiye,0,80,0,80
4720,2017,Morocco,Türkiye,31,78,0,109
4721,2017,Myanmar,Türkiye,0,15,0,15
4722,2017,Nepal,Türkiye,0,5,0,5
4723,2017,Niger,Türkiye,0,5,0,5
4724,2017,Nigeria,Türkiye,11,79,0,90
4725,2017,Pakistan,Türkiye,56,1634,0,1690
4726,2017,Philippines,Türkiye,5,5,0,10
4727,2017,Russian Federation,Türkiye,5,0,0,5
4728,2017,Rwanda,Türkiye,0,5,0,5
4729,2017,Saudi Arabia,Türkiye,5,5,0,10
4730,2017,Senegal,Türkiye,5,17,0,22
4731,2017,Sierra Leone,Türkiye,5,13,0,18
4732,2017,Somalia,Türkiye,2219,2144,0,4363
4733,2017,Sudan,Türkiye,274,114,0,388
4734,2017,South Sudan,Türkiye,5,5,0,10
4735,2017,Syrian Arab Rep.,Türkiye,3424237,162,0,3424399
4736,2017,Tajikistan,Türkiye,8,262,0,270
4737,2017,Turkmenistan,Türkiye,6,591,0,597
4738,2017,Togo,Türkiye,0,5,0,5
4739,2017,Tunisia,Türkiye,14,31,0,45
4740,2017,United Arab Emirates,Türkiye,6,21,0,27
4741,2017,Uganda,Türkiye,24,487,0,511
4742,2017,Uzbekistan,Türkiye,51,615,0,666
4743,2017,Yemen,Türkiye,161,423,0,584
4744,2017,Zimbabwe,Türkiye,0,39,0,39
4746,2017,Afghanistan,United Arab Emirates,5,14,0,19
4747,2017,Ethiopia,United Arab Emirates,8,0,0,8
4748,2017,Palestinian,United Arab Emirates,5,143,0,148
4749,2017,Iran (Islamic Rep. of),United Arab Emirates,5,7,0,12
4750,2017,Iraq,United Arab Emirates,697,482,0,1179
4751,2017,Liberia,United Arab Emirates,0,5,0,5
4752,2017,Libya,United Arab Emirates,0,5,0,5
4753,2017,Lebanon,United Arab Emirates,6,0,0,6
4754,2017,Morocco,United Arab Emirates,0,0,0,0
4755,2017,Pakistan,United Arab Emirates,0,5,0,5
4756,2017,Philippines,United Arab Emirates,0,0,0,0
4757,2017,Saudi Arabia,United Arab Emirates,5,0,0,5
4758,2017,Somalia,United Arab Emirates,17,0,0,17
4759,2017,Sudan,United Arab Emirates,8,12,0,20
4760,2017,Syrian Arab Rep.,United Arab Emirates,128,1185,0,1313
4761,2017,Yemen,United Arab Emirates,0,24,0,24
4762,2017,Burundi,Uganda,38245,2389,0,40634
4763,2017,Central African Rep.,Uganda,21,5,0,26
4764,2017,Chad,Uganda,5,0,0,5
4765,2017,Dem. Rep. of the Congo,Uganda,226192,16214,0,242406
4766,2017,Eritrea,Uganda,4566,10026,0,14592
4767,2017,Ethiopia,Uganda,1944,1289,0,3233
4768,2017,Palestinian,Uganda,0,7,0,7
4769,2017,Kenya,Uganda,193,25,0,218
4770,2017,Mali,Uganda,0,5,0,5
4771,2017,Pakistan,Uganda,224,267,0,491
4772,2017,Rwanda,Uganda,14282,978,0,15260
4773,2017,Senegal,Uganda,5,0,0,5
4774,2017,Somalia,Uganda,25011,12182,0,37193
4775,2017,Sudan,Uganda,2355,745,0,3100
4776,2017,South Sudan,Uganda,1037412,486,0,1037898
4777,2017,Syrian Arab Rep.,Uganda,7,12,0,19
4778,2017,Uganda,Uganda,0,0,0,0
4779,2017,Yemen,Uganda,33,5,0,38
4780,2017,Afghanistan,Ukraine,1410,2808,0,4218
4781,2017,Algeria,Ukraine,0,15,0,15
4782,2017,Angola,Ukraine,26,9,0,35
4783,2017,Egypt,Ukraine,5,21,0,26
4784,2017,Armenia,Ukraine,192,28,0,220
4785,2017,Azerbaijan,Ukraine,149,46,0,195
4786,2017,Burundi,Ukraine,6,7,0,13
4787,2017,Bangladesh,Ukraine,0,140,0,140
4788,2017,Belarus,Ukraine,26,39,0,65
4789,2017,Cambodia,Ukraine,0,5,0,5
4790,2017,Chad,Ukraine,7,5,0,12
4791,2017,China,Ukraine,0,11,0,11
4792,2017,Cameroon,Ukraine,5,93,0,98
4793,2017,Congo,Ukraine,20,34,0,54
4794,2017,Dem. Rep. of the Congo,Ukraine,68,123,0,191
4795,2017,Cuba,Ukraine,0,11,0,11
4796,2017,Eritrea,Ukraine,16,24,0,40
4797,2017,Ethiopia,Ukraine,20,29,0,49
4798,2017,Palestinian,Ukraine,37,164,0,201
4799,2017,Georgia,Ukraine,48,100,0,148
4800,2017,Ghana,Ukraine,0,5,0,5
4801,2017,Guinea,Ukraine,7,117,0,124
4802,2017,Cote d'Ivoire,Ukraine,0,30,0,30
4803,2017,India,Ukraine,0,36,0,36
4804,2017,Iran (Islamic Rep. of),Ukraine,58,103,0,161
4805,2017,Iraq,Ukraine,91,264,0,355
4806,2017,Jordan,Ukraine,5,24,0,29
4807,2017,Kazakhstan,Ukraine,11,10,0,21
4808,2017,Kenya,Ukraine,0,6,0,6
4809,2017,Kyrgyzstan,Ukraine,12,142,0,154
4810,2017,Liberia,Ukraine,0,16,0,16
4811,2017,Libya,Ukraine,0,19,0,19
4812,2017,Lebanon,Ukraine,9,23,0,32
4813,2017,Sri Lanka,Ukraine,8,64,0,72
4814,2017,Rep. of Moldova,Ukraine,0,6,0,6
4815,2017,Mali,Ukraine,0,5,0,5
4816,2017,Myanmar,Ukraine,0,10,0,10
4817,2017,Nepal,Ukraine,0,19,0,19
4818,2017,Nigeria,Ukraine,5,68,0,73
4819,2017,Pakistan,Ukraine,9,191,0,200
4820,2017,Russian Federation,Ukraine,150,186,0,336
4821,2017,Rwanda,Ukraine,5,0,0,5
4822,2017,Serbia and Kosovo: S/RES/1244 (1999),Ukraine,5,0,0,5
4823,2017,Sierra Leone,Ukraine,5,7,0,12
4824,2017,Somalia,Ukraine,132,306,0,438
4825,2017,Viet Nam,Ukraine,0,35,0,35
4826,2017,Sudan,Ukraine,60,106,0,166
4827,2017,Syrian Arab Rep.,Ukraine,483,520,0,1003
4828,2017,Tajikistan,Ukraine,16,38,0,54
4829,2017,Turkmenistan,Ukraine,5,5,0,10
4830,2017,Togo,Ukraine,0,5,0,5
4831,2017,Tunisia,Ukraine,0,10,0,10
4832,2017,Türkiye,Ukraine,14,40,0,54
4833,2017,Uganda,Ukraine,0,5,0,5
4834,2017,Ukraine,Ukraine,0,0,1800000,0
4835,2017,Uzbekistan,Ukraine,60,60,0,120
4836,2017,Western Sahara,Ukraine,0,5,0,5
4837,2017,Yemen,Ukraine,5,6,0,11
4839,2017,Angola,Uruguay,0,20,0,20
4840,2017,Bolivia (Plurinational State of),Uruguay,5,0,0,5
4841,2017,Brazil,Uruguay,0,7,0,7
4842,2017,Cameroon,Uruguay,8,0,0,8
4843,2017,Congo,Uruguay,5,0,0,5
4844,2017,Colombia,Uruguay,141,23,0,164
4845,2017,Cuba,Uruguay,12,1968,0,1980
4846,2017,Dominican Rep.,Uruguay,0,5,0,5
4847,2017,Ecuador,Uruguay,7,0,0,7
4848,2017,France,Uruguay,0,5,0,5
4849,2017,Libya,Uruguay,5,0,0,5
4850,2017,Latvia,Uruguay,5,0,0,5
4851,2017,Mexico,Uruguay,5,0,0,5
4852,2017,Morocco,Uruguay,0,5,0,5
4853,2017,Nigeria,Uruguay,13,12,0,25
4854,2017,Paraguay,Uruguay,5,0,0,5
4855,2017,Peru,Uruguay,6,0,0,6
4856,2017,Russian Federation,Uruguay,12,0,0,12
4857,2017,El Salvador,Uruguay,18,0,0,18
4858,2017,Senegal,Uruguay,0,5,0,5
4859,2017,Somalia,Uruguay,5,0,0,5
4860,2017,Syrian Arab Rep.,Uruguay,61,0,0,61
4861,2017,Türkiye,Uruguay,5,6,0,11
4862,2017,Ukraine,Uruguay,11,0,0,11
4863,2017,Venezuela (Bolivarian Republic of),Uruguay,5,33,0,38
4864,2017,Afghanistan,United States of America,1564,810,0,2374
4865,2017,Albania,United States of America,1527,1636,0,3163
4866,2017,Algeria,United States of America,131,274,0,405
4867,2017,Angola,United States of America,157,1143,0,1300
4868,2017,Antigua and Barbuda,United States of America,5,10,0,15
4869,2017,Egypt,United States of America,11926,4599,0,16525
4870,2017,Argentina,United States of America,55,232,0,287
4871,2017,Armenia,United States of America,1663,2032,0,3695
4872,2017,Austria,United States of America,5,12,0,17
4873,2017,Azerbaijan,United States of America,298,875,0,1173
4874,2017,Bahrain,United States of America,45,29,0,74
4875,2017,Barbados,United States of America,0,10,0,10
4876,2017,Burundi,United States of America,747,693,0,1440
4877,2017,Belgium,United States of America,32,19,0,51
4878,2017,Benin,United States of America,97,186,0,283
4879,2017,Bangladesh,United States of America,1248,6225,0,7473
4880,2017,Bahamas,United States of America,179,61,0,240
4881,2017,Bhutan,United States of America,43,323,0,366
4882,2017,Burkina Faso,United States of America,1163,3388,0,4551
4883,2017,Belarus,United States of America,1537,1769,0,3306
4884,2017,Bolivia (Plurinational State of),United States of America,113,381,0,494
4885,2017,Botswana,United States of America,0,9,0,9
4886,2017,Brazil,United States of America,593,6052,0,6645
4887,2017,Bosnia and Herzegovina,United States of America,101,157,0,258
4888,2017,Bulgaria,United States of America,352,230,0,582
4889,2017,Belize,United States of America,43,194,0,237
4890,2017,Cambodia,United States of America,139,46,0,185
4891,2017,Canada,United States of America,42,40,0,82
4892,2017,Central African Rep.,United States of America,210,116,0,326
4893,2017,Cayman Islands,United States of America,6,0,0,6
4894,2017,Chad,United States of America,335,218,0,553
4895,2017,China,United States of America,74476,68414,0,142890
4896,2017,Chile,United States of America,27,161,0,188
4897,2017,Cameroon,United States of America,3992,4056,0,8048
4898,2017,Congo,United States of America,1331,1516,0,2847
4899,2017,Dem. Rep. of the Congo,United States of America,939,1324,0,2263
4900,2017,Comoros,United States of America,5,0,0,5
4901,2017,Colombia,United States of America,4264,7002,0,11266
4902,2017,Costa Rica,United States of America,170,443,0,613
4903,2017,Cuba,United States of America,431,1008,0,1439
4904,2017,Cabo Verde,United States of America,0,23,0,23
4905,2017,Czechia,United States of America,18,22,0,40
4906,2017,Denmark,United States of America,0,5,0,5
4907,2017,Djibouti,United States of America,282,535,0,817
4908,2017,Dominica,United States of America,10,32,0,42
4909,2017,Dominican Rep.,United States of America,179,936,0,1115
4910,2017,Ecuador,United States of America,948,17082,0,18030
4911,2017,Equatorial Guinea,United States of America,9,24,0,33
4912,2017,Eritrea,United States of America,5145,1697,0,6842
4913,2017,Estonia,United States of America,266,36,0,302
4914,2017,Ethiopia,United States of America,9987,5506,0,15493
4915,2017,French Guiana,United States of America,0,5,0,5
4916,2017,Fiji,United States of America,231,196,0,427
4917,2017,Finland,United States of America,5,0,0,5
4918,2017,France,United States of America,24,70,0,94
4919,2017,Gabon,United States of America,40,181,0,221
4920,2017,Gambia,United States of America,1503,903,0,2406
4921,2017,Palestinian,United States of America,5,57,0,62
4922,2017,United Kingdom of Great Britain and Northern Ireland,United States of America,39,108,0,147
4923,2017,Georgia,United States of America,382,1469,0,1851
4924,2017,Germany,United States of America,40,125,0,165
4925,2017,Ghana,United States of America,399,983,0,1382
4926,2017,Guinea-Bissau,United States of America,24,19,0,43
4927,2017,Greece,United States of America,15,48,0,63
4928,2017,Grenada,United States of America,24,36,0,60
4929,2017,Guatemala,United States of America,14971,71443,0,86414
4930,2017,Guinea,United States of America,2305,1223,0,3528
4931,2017,Guyana,United States of America,75,332,0,407
4932,2017,Haiti,United States of America,17055,15184,0,32239
4933,2017,"China, Hong Kong SAR",United States of America,0,17,0,17
4934,2017,Honduras,United States of America,10107,53905,0,64012
4935,2017,Croatia,United States of America,34,34,0,68
4936,2017,Hungary,United States of America,18,173,0,191
4937,2017,Cote d'Ivoire,United States of America,1263,1092,0,2355
4938,2017,India,United States of America,4836,23395,0,28231
4939,2017,Indonesia,United States of America,1834,1792,0,3626
4940,2017,Ireland,United States of America,0,30,0,30
4941,2017,Iran (Islamic Rep. of),United States of America,5536,3266,0,8802
4942,2017,Iraq,United States of America,6130,3869,0,9999
4943,2017,Israel,United States of America,138,437,0,575
4944,2017,Italy,United States of America,20,145,0,165
4945,2017,Jamaica,United States of America,697,915,0,1612
4946,2017,Jordan,United States of America,428,1820,0,2248
4947,2017,Japan,United States of America,6,78,0,84
4948,2017,Kazakhstan,United States of America,707,1558,0,2265
4949,2017,Kenya,United States of America,2087,2905,0,4992
4950,2017,Kyrgyzstan,United States of America,1270,1407,0,2677
4951,2017,Rep. of Korea,United States of America,29,166,0,195
4952,2017,Dem. People's Rep. of Korea,United States of America,12,25,0,37
4953,2017,Kuwait,United States of America,130,185,0,315
4954,2017,Lao People's Dem. Rep.,United States of America,108,174,0,282
4955,2017,Liberia,United States of America,1179,956,0,2135
4956,2017,Libya,United States of America,280,1041,0,1321
4957,2017,Saint Lucia,United States of America,9,21,0,30
4958,2017,Lebanon,United States of America,378,699,0,1077
4959,2017,Lesotho,United States of America,6,0,0,6
4960,2017,Sri Lanka,United States of America,1270,1545,0,2815
4961,2017,Lithuania,United States of America,20,51,0,71
4962,2017,Latvia,United States of America,19,86,0,105
4964,2017,Madagascar,United States of America,17,5,0,22
4965,2017,Mauritania,United States of America,944,858,0,1802
4966,2017,North Macedonia,United States of America,108,163,0,271
4967,2017,Monaco,United States of America,5,0,0,5
4968,2017,Rep. of Moldova,United States of America,1400,2204,0,3604
4969,2017,Maldives,United States of America,6,5,0,11
4970,2017,Mexico,United States of America,7709,83501,0,91210
4971,2017,Marshall Islands,United States of America,7,0,0,7
4972,2017,Mali,United States of America,1191,611,0,1802
4973,2017,Malaysia,United States of America,93,313,0,406
4974,2017,Malawi,United States of America,33,71,0,104
4975,2017,Mongolia,United States of America,766,1882,0,2648
4976,2017,Morocco,United States of America,114,198,0,312
4977,2017,Mozambique,United States of America,0,31,0,31
4978,2017,Montenegro,United States of America,109,206,0,315
4979,2017,Mauritius,United States of America,31,44,0,75
4980,2017,Myanmar,United States of America,1623,779,0,2402
4981,2017,Namibia,United States of America,45,6,0,51
4982,2017,Nepal,United States of America,6907,6872,0,13779
4983,2017,Netherlands,United States of America,13,41,0,54
4984,2017,Niger,United States of America,138,262,0,400
4985,2017,Nicaragua,United States of America,563,1815,0,2378
4986,2017,Nigeria,United States of America,1154,5486,0,6640
4987,2017,Niue,United States of America,19,5,0,24
4988,2017,Oman,United States of America,5,5,0,10
4989,2017,Pakistan,United States of America,3308,5173,0,8481
4990,2017,Panama,United States of America,15,77,0,92
4991,2017,Paraguay,United States of America,19,76,0,95
4992,2017,Peru,United States of America,528,2709,0,3237
4993,2017,Philippines,United States of America,145,1414,0,1559
4994,2017,Poland,United States of America,23,659,0,682
4995,2017,Portugal,United States of America,5,88,0,93
4996,2017,Qatar,United States of America,13,34,0,47
4997,2017,Romania,United States of America,371,2950,0,3321
4998,2017,South Africa,United States of America,40,294,0,334
4999,2017,Russian Federation,United States of America,5463,7980,0,13443
5000,2017,Rwanda,United States of America,1079,674,0,1753
5001,2017,El Salvador,United States of America,18763,91429,0,110192
5002,2017,Saudi Arabia,United States of America,391,752,0,1143
5003,2017,Serbia and Kosovo: S/RES/1244 (1999),United States of America,1039,606,0,1645
5004,2017,Senegal,United States of America,388,620,0,1008
5005,2017,Seychelles,United States of America,5,0,0,5
5006,2017,Singapore,United States of America,15,30,0,45
5007,2017,Sierra Leone,United States of America,523,290,0,813
5008,2017,Somalia,United States of America,2297,550,0,2847
5009,2017,Spain,United States of America,11,65,0,76
5010,2017,Viet Nam,United States of America,256,444,0,700
5011,2017,Saint Kitts and Nevis,United States of America,5,0,0,5
5012,2017,Sudan,United States of America,1382,903,0,2285
5013,2017,Suriname,United States of America,9,17,0,26
5014,2017,South Sudan,United States of America,7,28,0,35
5015,2017,Slovakia,United States of America,10,15,0,25
5016,2017,Slovenia,United States of America,5,5,0,10
5017,2017,Eswatini,United States of America,5,6,0,11
5018,2017,Sweden,United States of America,8,8,0,16
5019,2017,Switzerland,United States of America,5,10,0,15
5020,2017,Syrian Arab Rep.,United States of America,7282,3358,0,10640
5021,2017,United Rep. of Tanzania,United States of America,133,154,0,287
5022,2017,Turks and Caicos Islands,United States of America,14,0,0,14
5023,2017,Thailand,United States of America,29,465,0,494
5024,2017,Tajikistan,United States of America,283,404,0,687
5025,2017,Turkmenistan,United States of America,159,235,0,394
5026,2017,Togo,United States of America,604,494,0,1098
5027,2017,Tonga,United States of America,0,10,0,10
5028,2017,Trinidad and Tobago,United States of America,55,227,0,282
5029,2017,Tunisia,United States of America,54,204,0,258
5030,2017,Türkiye,United States of America,428,2646,0,3074
5031,2017,United Arab Emirates,United States of America,39,150,0,189
5032,2017,Uganda,United States of America,1301,1821,0,3122
5033,2017,Ukraine,United States of America,1812,7574,0,9386
5034,2017,Uruguay,United States of America,5,118,0,123
5035,2017,Uzbekistan,United States of America,1210,1614,0,2824
5036,2017,Saint Vincent and the Grenadines,United States of America,31,17,0,48
5037,2017,Venezuela (Bolivarian Republic of),United States of America,5402,58811,0,64213
5038,2017,Yemen,United States of America,549,908,0,1457
5039,2017,Zambia,United States of America,44,66,0,110
5040,2017,Zimbabwe,United States of America,1049,768,0,1817
5042,2017,Guadeloupe,United States of America,0,37,0,37
5043,2017,Curacao ,United States of America,35,0,0,35
5045,2017,Afghanistan,Uzbekistan,20,0,0,20
5047,2017,Afghanistan,Venezuela (Bolivarian Republic of),10,0,0,10
5048,2017,Chile,Venezuela (Bolivarian Republic of),10,0,0,10
5049,2017,Congo,Venezuela (Bolivarian Republic of),5,0,0,5
5050,2017,Colombia,Venezuela (Bolivarian Republic of),122677,904,0,123581
5051,2017,Palestinian,Venezuela (Bolivarian Republic of),7,0,0,7
5052,2017,Haiti,Venezuela (Bolivarian Republic of),7,0,0,7
5053,2017,Iraq,Venezuela (Bolivarian Republic of),18,0,0,18
5054,2017,Liberia,Venezuela (Bolivarian Republic of),9,0,0,9
5055,2017,Libya,Venezuela (Bolivarian Republic of),5,0,0,5
5056,2017,Lebanon,Venezuela (Bolivarian Republic of),12,0,0,12
5057,2017,Nigeria,Venezuela (Bolivarian Republic of),7,0,0,7
5058,2017,Peru,Venezuela (Bolivarian Republic of),5,0,0,5
5059,2017,Rwanda,Venezuela (Bolivarian Republic of),5,0,0,5
5060,2017,Sierra Leone,Venezuela (Bolivarian Republic of),5,0,0,5
5061,2017,Syrian Arab Rep.,Venezuela (Bolivarian Republic of),5,0,0,5
5062,2017,Türkiye,Venezuela (Bolivarian Republic of),6,0,0,6
5063,2017,Western Sahara,Venezuela (Bolivarian Republic of),11,0,0,11
5064,2017,Sri Lanka,Samoa,5,0,0,5
5065,2017,Egypt,Yemen,16,5,0,21
5066,2017,Dem. Rep. of the Congo,Yemen,5,0,0,5
5067,2017,Djibouti,Yemen,5,5,0,10
5068,2017,Eritrea,Yemen,1370,360,0,1730
5069,2017,Ethiopia,Yemen,6205,8317,0,14522
5070,2017,Palestinian,Yemen,625,162,0,787
5071,2017,Iran (Islamic Rep. of),Yemen,5,0,0,5
5072,2017,Iraq,Yemen,3351,28,0,3379
5073,2017,Jordan,Yemen,12,0,0,12
5074,2017,Lebanon,Yemen,0,6,0,6
5075,2017,Pakistan,Yemen,0,9,0,9
5076,2017,Somalia,Yemen,255894,0,0,255894
5077,2017,Viet Nam,Yemen,15,0,0,15
5078,2017,Sudan,Yemen,124,375,0,499
5079,2017,Syrian Arab Rep.,Yemen,3286,496,0,3782
5080,2017,United Rep. of Tanzania,Yemen,0,0,0,0
5081,2017,Yemen,Yemen,0,0,2014062,0
5082,2017,Angola,Zambia,0,0,0,0
5083,2017,Burundi,Zambia,3267,1134,0,4401
5084,2017,Congo,Zambia,0,5,0,5
5085,2017,Dem. Rep. of the Congo,Zambia,34928,2884,0,37812
5086,2017,Eritrea,Zambia,8,27,0,35
5087,2017,Ethiopia,Zambia,18,17,0,35
5088,2017,Palestinian,Zambia,10,0,0,10
5089,2017,Liberia,Zambia,6,0,0,6
5090,2017,South Africa,Zambia,7,0,0,7
5091,2017,Rwanda,Zambia,715,47,0,762
5092,2017,Sierra Leone,Zambia,0,5,0,5
5093,2017,Somalia,Zambia,2174,551,0,2725
5094,2017,Sudan,Zambia,24,0,0,24
5095,2017,Türkiye,Zambia,12,5,0,17
5096,2017,Uganda,Zambia,21,0,0,21
5097,2017,Zimbabwe,Zambia,5,0,0,5
5099,2017,Egypt,Zimbabwe,5,0,0,5
5100,2017,Burundi,Zimbabwe,622,17,0,639
5101,2017,Congo,Zimbabwe,13,0,0,13
5102,2017,Dem. Rep. of the Congo,Zimbabwe,6296,245,0,6541
5103,2017,Eritrea,Zimbabwe,20,5,0,25
5104,2017,Ethiopia,Zimbabwe,68,14,0,82
5105,2017,Cote d'Ivoire,Zimbabwe,10,0,0,10
5106,2017,Kenya,Zimbabwe,0,8,0,8
5107,2017,Mozambique,Zimbabwe,0,8059,0,8059
5108,2017,South Africa,Zimbabwe,0,9,0,9
5109,2017,Rwanda,Zimbabwe,500,13,0,513
5110,2017,Somalia,Zimbabwe,19,8,0,27
5111,2017,Sudan,Zimbabwe,5,9,0,14
5112,2017,Uganda,Zimbabwe,8,5,0,13
5113,2017,Zambia,Zimbabwe,0,0,0,0
5114,2017,Zimbabwe,Zimbabwe,0,0,0,0
5115,2017,Venezuela (Bolivarian Republic of),Aruba,0,147,0,147
5116,2017,Colombia,Curacao ,45,68,0,113
5117,2017,Cuba,Curacao ,6,6,0,12
5118,2017,Venezuela (Bolivarian Republic of),Curacao ,23,655,0,678
5119,2017,Iran (Islamic Rep. of),Sint Maarten (Dutch part),5,0,0,5
5120,2018,Afghanistan,Afghanistan,0,0,2106893,0
5121,2018,Bangladesh,Afghanistan,0,5,0,5
5122,2018,Iran (Islamic Rep. of),Afghanistan,34,9,0,43
5123,2018,Pakistan,Afghanistan,72194,121,0,72315
5124,2018,Tajikistan,Afghanistan,0,7,0,7
5125,2018,Türkiye,Afghanistan,0,139,0,139
5126,2018,Algeria,Albania,0,16,0,16
5127,2018,Egypt,Albania,5,0,0,5
5128,2018,China,Albania,12,0,0,12
5129,2018,Dem. Rep. of the Congo,Albania,5,0,0,5
5130,2018,Palestinian,Albania,14,8,0,22
5131,2018,Iran (Islamic Rep. of),Albania,12,5,0,17
5132,2018,Iraq,Albania,5,25,0,30
5133,2018,Libya,Albania,0,28,0,28
5134,2018,Morocco,Albania,0,28,0,28
5135,2018,Serbia and Kosovo: S/RES/1244 (1999),Albania,58,5,0,63
5136,2018,Syrian Arab Rep.,Albania,6,44,0,50
5137,2018,Türkiye,Albania,5,0,0,5
5138,2018,Uzbekistan,Albania,5,0,0,5
5139,2018,Venezuela (Bolivarian Republic of),Albania,5,0,0,5
5141,2018,Benin,Algeria,5,5,0,10
5142,2018,Burkina Faso,Algeria,0,5,0,5
5143,2018,Central African Rep.,Algeria,49,33,0,82
5144,2018,Chad,Algeria,6,11,0,17
5145,2018,Cameroon,Algeria,35,163,0,198
5146,2018,Dem. Rep. of the Congo,Algeria,59,80,0,139
5147,2018,Palestinian,Algeria,4013,128,0,4141
5148,2018,Ghana,Algeria,0,5,0,5
5149,2018,Guinea,Algeria,13,224,0,237
5150,2018,Cote d'Ivoire,Algeria,40,152,0,192
5151,2018,Iraq,Algeria,13,0,0,13
5152,2018,Liberia,Algeria,0,14,0,14
5153,2018,Libya,Algeria,19,13,0,32
5154,2018,Lebanon,Algeria,0,5,0,5
5155,2018,Mali,Algeria,55,179,0,234
5156,2018,Niger,Algeria,0,25,0,25
5157,2018,Nigeria,Algeria,0,119,0,119
5158,2018,Sierra Leone,Algeria,0,5,0,5
5159,2018,Somalia,Algeria,0,5,0,5
5160,2018,Sudan,Algeria,5,15,0,20
5161,2018,Syrian Arab Rep.,Algeria,14,7485,0,7499
5162,2018,Togo,Algeria,5,0,0,5
5163,2018,Western Sahara,Algeria,90000,0,0,90000
5164,2018,Yemen,Algeria,10,239,0,249
5165,2018,Burundi,Angola,18,94,0,112
5166,2018,Central African Rep.,Angola,7,76,0,83
5167,2018,Chad,Angola,191,779,0,970
5168,2018,Congo,Angola,65,58,0,123
5169,2018,Dem. Rep. of the Congo,Angola,37077,498,0,37575
5170,2018,Eritrea,Angola,17,1767,0,1784
5171,2018,Ethiopia,Angola,0,57,0,57
5172,2018,Guinea-Bissau,Angola,7,268,0,275
5173,2018,Guinea,Angola,84,9144,0,9228
5174,2018,Cote d'Ivoire,Angola,417,5940,0,6357
5175,2018,Liberia,Angola,164,478,0,642
5176,2018,Mauritania,Angola,324,5402,0,5726
5177,2018,Rwanda,Angola,501,67,0,568
5178,2018,Sierra Leone,Angola,413,1497,0,1910
5179,2018,Somalia,Angola,270,1731,0,2001
5180,2018,Sudan,Angola,280,1670,0,1950
5181,2018,United Rep. of Tanzania,Angola,5,0,0,5
5182,2018,Uganda,Angola,0,6,0,6
5183,2018,Western Sahara,Angola,16,596,0,612
5184,2018,Afghanistan,Egypt,20,23,0,43
5185,2018,Burundi,Egypt,27,43,0,70
5186,2018,Benin,Egypt,0,5,0,5
5187,2018,Bangladesh,Egypt,0,5,0,5
5188,2018,Central African Rep.,Egypt,22,25,0,47
5189,2018,Chad,Egypt,47,20,0,67
5190,2018,China,Egypt,0,69,0,69
5191,2018,Cameroon,Egypt,5,32,0,37
5192,2018,Congo,Egypt,5,23,0,28
5193,2018,Dem. Rep. of the Congo,Egypt,45,24,0,69
5194,2018,Djibouti,Egypt,5,10,0,15
5195,2018,Eritrea,Egypt,4340,11102,0,15442
5196,2018,Ethiopia,Egypt,3814,12117,0,15931
5197,2018,Gambia,Egypt,0,5,0,5
5198,2018,Palestinian,Egypt,70021,0,0,70021
5199,2018,Ghana,Egypt,0,9,0,9
5200,2018,Guinea,Egypt,5,41,0,46
5201,2018,Cote d'Ivoire,Egypt,109,5,0,114
5202,2018,India,Egypt,0,5,0,5
5203,2018,Iraq,Egypt,4346,2648,0,6994
5204,2018,Jordan,Egypt,5,12,0,17
5205,2018,Kenya,Egypt,6,5,0,11
5206,2018,Liberia,Egypt,0,13,0,13
5207,2018,Libya,Egypt,5,0,0,5
5208,2018,Mali,Egypt,5,6,0,11
5209,2018,Niger,Egypt,0,5,0,5
5210,2018,Nigeria,Egypt,18,343,0,361
5211,2018,Russian Federation,Egypt,7,52,0,59
5212,2018,Saudi Arabia,Egypt,0,6,0,6
5213,2018,Sierra Leone,Egypt,5,16,0,21
5214,2018,Somalia,Egypt,3588,3576,0,7164
5215,2018,Sudan,Egypt,19540,22231,0,41771
5216,2018,South Sudan,Egypt,7737,6885,0,14622
5217,2018,Syrian Arab Rep.,Egypt,132871,0,0,132871
5218,2018,Tajikistan,Egypt,12,37,0,49
5219,2018,Turkmenistan,Egypt,5,0,0,5
5220,2018,Togo,Egypt,0,7,0,7
5221,2018,Tunisia,Egypt,0,5,0,5
5222,2018,Türkiye,Egypt,0,401,0,401
5223,2018,Uganda,Egypt,11,19,0,30
5224,2018,Uzbekistan,Egypt,0,56,0,56
5225,2018,Yemen,Egypt,100,8222,0,8322
5226,2018,Zimbabwe,Egypt,15,55,0,70
5229,2018,Afghanistan,Argentina,5,8,0,13
5230,2018,Albania,Argentina,18,0,0,18
5231,2018,Algeria,Argentina,30,12,0,42
5232,2018,Angola,Argentina,14,14,0,28
5233,2018,Egypt,Argentina,5,8,0,13
5234,2018,Armenia,Argentina,77,187,0,264
5235,2018,Burundi,Argentina,5,0,0,5
5236,2018,Bangladesh,Argentina,5,79,0,84
5237,2018,Bolivia (Plurinational State of),Argentina,5,0,0,5
5238,2018,Brazil,Argentina,0,9,0,9
5239,2018,Bosnia and Herzegovina,Argentina,6,0,0,6
5240,2018,China,Argentina,0,103,0,103
5241,2018,Chile,Argentina,34,0,0,34
5242,2018,Cameroon,Argentina,6,39,0,45
5243,2018,Dem. Rep. of the Congo,Argentina,21,16,0,37
5244,2018,Colombia,Argentina,547,205,0,752
5245,2018,Costa Rica,Argentina,5,0,0,5
5246,2018,Cuba,Argentina,253,723,0,976
5247,2018,Cabo Verde,Argentina,0,5,0,5
5248,2018,Czechia,Argentina,0,5,0,5
5249,2018,Dominican Rep.,Argentina,0,447,0,447
5250,2018,Ecuador,Argentina,16,5,0,21
5251,2018,Ethiopia,Argentina,5,0,0,5
5252,2018,France,Argentina,0,5,0,5
5253,2018,Gambia,Argentina,0,5,0,5
5254,2018,Palestinian,Argentina,16,6,0,22
5255,2018,Georgia,Argentina,5,0,0,5
5256,2018,Ghana,Argentina,38,139,0,177
5257,2018,Guinea-Bissau,Argentina,8,5,0,13
5258,2018,Guatemala,Argentina,0,6,0,6
5259,2018,Guinea,Argentina,9,9,0,18
5260,2018,Haiti,Argentina,66,859,0,925
5261,2018,Honduras,Argentina,5,11,0,16
5262,2018,Hungary,Argentina,0,5,0,5
5263,2018,Cote d'Ivoire,Argentina,20,0,0,20
5264,2018,India,Argentina,22,116,0,138
5265,2018,Iran (Islamic Rep. of),Argentina,23,5,0,28
5266,2018,Iraq,Argentina,22,5,0,27
5267,2018,Jamaica,Argentina,6,5,0,11
5268,2018,Kazakhstan,Argentina,18,5,0,23
5269,2018,Kyrgyzstan,Argentina,5,0,0,5
5270,2018,Liberia,Argentina,44,0,0,44
5271,2018,Libya,Argentina,0,5,0,5
5272,2018,Sri Lanka,Argentina,36,0,0,36
5273,2018,Mauritania,Argentina,0,5,0,5
5274,2018,North Macedonia,Argentina,9,0,0,9
5275,2018,Mexico,Argentina,0,6,0,6
5276,2018,Mali,Argentina,9,5,0,14
5277,2018,Morocco,Argentina,0,10,0,10
5278,2018,Nepal,Argentina,0,5,0,5
5279,2018,Nicaragua,Argentina,0,14,0,14
5280,2018,Nigeria,Argentina,41,67,0,108
5281,2018,Pakistan,Argentina,32,25,0,57
5282,2018,Paraguay,Argentina,8,9,0,17
5283,2018,Peru,Argentina,545,34,0,579
5284,2018,Romania,Argentina,51,0,0,51
5285,2018,South Africa,Argentina,0,10,0,10
5286,2018,Russian Federation,Argentina,70,85,0,155
5287,2018,El Salvador,Argentina,23,42,0,65
5288,2018,Senegal,Argentina,42,1416,0,1458
5289,2018,Sierra Leone,Argentina,37,5,0,42
5290,2018,Somalia,Argentina,5,0,0,5
5291,2018,Spain,Argentina,0,5,0,5
5292,2018,Viet Nam,Argentina,0,5,0,5
5293,2018,Sudan,Argentina,5,0,0,5
5294,2018,Syrian Arab Rep.,Argentina,385,95,0,480
5295,2018,Türkiye,Argentina,10,0,0,10
5296,2018,Ukraine,Argentina,106,125,0,231
5297,2018,United States of America,Argentina,5,10,0,15
5298,2018,Venezuela (Bolivarian Republic of),Argentina,16,1015,0,1031
5299,2018,Yemen,Argentina,15,7,0,22
5302,2018,Afghanistan,Armenia,0,16,0,16
5303,2018,Azerbaijan,Armenia,1961,0,0,1961
5304,2018,Cuba,Armenia,0,5,0,5
5305,2018,Palestinian,Armenia,7,0,0,7
5306,2018,Georgia,Armenia,8,0,0,8
5307,2018,Cote d'Ivoire,Armenia,6,0,0,6
5308,2018,Iran (Islamic Rep. of),Armenia,36,41,0,77
5309,2018,Iraq,Armenia,1083,9,0,1092
5310,2018,Lebanon,Armenia,19,5,0,24
5311,2018,Nigeria,Armenia,5,0,0,5
5312,2018,Syrian Arab Rep.,Armenia,14701,8,0,14709
5313,2018,Türkiye,Armenia,5,16,0,21
5314,2018,Ukraine,Armenia,115,5,0,120
5315,2018,Yemen,Armenia,20,0,0,20
5317,2018,Afghanistan,Australia,11932,1600,0,13532
5318,2018,Albania,Australia,55,85,0,140
5319,2018,Algeria,Australia,8,16,0,24
5320,2018,Egypt,Australia,1564,283,0,1847
5321,2018,Argentina,Australia,0,21,0,21
5322,2018,Austria,Australia,0,5,0,5
5323,2018,Azerbaijan,Australia,9,15,0,24
5324,2018,Bahrain,Australia,95,21,0,116
5325,2018,Burundi,Australia,43,28,0,71
5326,2018,Bangladesh,Australia,412,1050,0,1462
5327,2018,Bhutan,Australia,5,10,0,15
5328,2018,Belarus,Australia,7,0,0,7
5329,2018,Brazil,Australia,5,54,0,59
5330,2018,Bosnia and Herzegovina,Australia,0,9,0,9
5331,2018,Cambodia,Australia,35,326,0,361
5332,2018,Canada,Australia,0,5,0,5
5333,2018,China,Australia,2304,13647,0,15951
5334,2018,Chile,Australia,0,17,0,17
5335,2018,Cameroon,Australia,30,56,0,86
5336,2018,Congo,Australia,13,13,0,26
5337,2018,Dem. Rep. of the Congo,Australia,60,53,0,113
5338,2018,Colombia,Australia,110,157,0,267
5339,2018,Czechia,Australia,0,5,0,5
5340,2018,Djibouti,Australia,5,0,0,5
5341,2018,Eritrea,Australia,127,26,0,153
5342,2018,Ethiopia,Australia,315,280,0,595
5343,2018,Fiji,Australia,400,1022,0,1422
5344,2018,France,Australia,0,5,0,5
5345,2018,Gambia,Australia,7,13,0,20
5346,2018,Palestinian,Australia,458,107,0,565
5347,2018,United Kingdom of Great Britain and Northern Ireland,Australia,5,64,0,69
5348,2018,Georgia,Australia,16,26,0,42
5349,2018,Germany,Australia,5,9,0,14
5350,2018,Ghana,Australia,27,168,0,195
5351,2018,Greece,Australia,6,26,0,32
5352,2018,Guinea,Australia,11,10,0,21
5353,2018,"China, Hong Kong SAR",Australia,5,0,0,5
5354,2018,Honduras,Australia,5,5,0,10
5355,2018,Croatia,Australia,0,5,0,5
5356,2018,Hungary,Australia,0,5,0,5
5357,2018,Cote d'Ivoire,Australia,5,0,0,5
5358,2018,India,Australia,423,3584,0,4007
5359,2018,Indonesia,Australia,255,1138,0,1393
5360,2018,Ireland,Australia,0,5,0,5
5361,2018,Iran (Islamic Rep. of),Australia,10702,4699,0,15401
5362,2018,Iraq,Australia,4911,1233,0,6144
5363,2018,Israel,Australia,12,20,0,32
5364,2018,Italy,Australia,5,23,0,28
5365,2018,Jamaica,Australia,5,0,0,5
5366,2018,Jordan,Australia,149,175,0,324
5367,2018,Japan,Australia,10,14,0,24
5368,2018,Kazakhstan,Australia,7,12,0,19
5369,2018,Kenya,Australia,105,167,0,272
5370,2018,Kyrgyzstan,Australia,13,18,0,31
5371,2018,Rep. of Korea,Australia,40,164,0,204
5372,2018,Dem. People's Rep. of Korea,Australia,19,0,0,19
5373,2018,Kuwait,Australia,55,0,0,55
5374,2018,Lao People's Dem. Rep.,Australia,5,116,0,121
5375,2018,Liberia,Australia,47,28,0,75
5376,2018,Libya,Australia,1081,186,0,1267
5377,2018,Lebanon,Australia,537,688,0,1225
5378,2018,Sri Lanka,Australia,4787,2505,0,7292
5379,2018,Latvia,Australia,0,5,0,5
5380,2018,North Macedonia,Australia,5,37,0,42
5381,2018,Maldives,Australia,10,15,0,25
5382,2018,Mexico,Australia,10,22,0,32
5383,2018,Malaysia,Australia,432,12995,0,13427
5384,2018,Malawi,Australia,0,7,0,7
5385,2018,Mongolia,Australia,24,106,0,130
5386,2018,Morocco,Australia,12,12,0,24
5387,2018,Mozambique,Australia,5,0,0,5
5388,2018,Mauritius,Australia,7,91,0,98
5389,2018,Myanmar,Australia,550,224,0,774
5390,2018,Nepal,Australia,159,442,0,601
5391,2018,Netherlands,Australia,0,5,0,5
5392,2018,Nigeria,Australia,201,440,0,641
5393,2018,New Zealand,Australia,26,14,0,40
5394,2018,Oman,Australia,5,0,0,5
5395,2018,Pakistan,Australia,5061,2618,0,7679
5396,2018,Peru,Australia,9,54,0,63
5397,2018,Philippines,Australia,45,565,0,610
5398,2018,Papua New Guinea,Australia,419,445,0,864
5399,2018,Poland,Australia,0,15,0,15
5400,2018,Portugal,Australia,0,5,0,5
5401,2018,Romania,Australia,7,6,0,13
5402,2018,South Africa,Australia,34,254,0,288
5403,2018,Russian Federation,Australia,54,62,0,116
5404,2018,Rwanda,Australia,75,66,0,141
5405,2018,El Salvador,Australia,10,25,0,35
5406,2018,Saudi Arabia,Australia,94,135,0,229
5407,2018,Serbia and Kosovo: S/RES/1244 (1999),Australia,5,24,0,29
5408,2018,Singapore,Australia,6,28,0,34
5409,2018,Sierra Leone,Australia,30,144,0,174
5410,2018,Solomon Islands,Australia,21,145,0,166
5411,2018,Somalia,Australia,475,135,0,610
5412,2018,Viet Nam,Australia,259,1659,0,1918
5413,2018,Sudan,Australia,484,192,0,676
5414,2018,South Sudan,Australia,8,29,0,37
5415,2018,Eswatini,Australia,0,16,0,16
5416,2018,Syrian Arab Rep.,Australia,582,100,0,682
5417,2018,United Rep. of Tanzania,Australia,13,18,0,31
5418,2018,Thailand,Australia,16,1741,0,1757
5419,2018,Timor-Leste,Australia,7,0,0,7
5420,2018,Togo,Australia,5,0,0,5
5421,2018,Tonga,Australia,32,164,0,196
5422,2018,Tunisia,Australia,5,12,0,17
5423,2018,Türkiye,Australia,603,570,0,1173
5424,2018,United Arab Emirates,Australia,7,0,0,7
5425,2018,Uganda,Australia,58,86,0,144
5426,2018,Ukraine,Australia,22,87,0,109
5427,2018,United States of America,Australia,16,29,0,45
5428,2018,Uzbekistan,Australia,29,16,0,45
5429,2018,Venezuela (Bolivarian Republic of),Australia,28,153,0,181
5430,2018,Samoa,Australia,0,42,0,42
5431,2018,Yemen,Australia,27,53,0,80
5432,2018,Zambia,Australia,8,28,0,36
5433,2018,Zimbabwe,Australia,851,173,0,1024
5437,2018,Afghanistan,Austria,33103,16093,0,49196
5438,2018,Albania,Austria,81,48,0,129
5439,2018,Algeria,Austria,42,130,0,172
5440,2018,Angola,Austria,77,15,0,92
5441,2018,Egypt,Austria,208,212,0,420
5442,2018,Armenia,Austria,509,462,0,971
5443,2018,Azerbaijan,Austria,265,176,0,441
5444,2018,Burundi,Austria,18,0,0,18
5445,2018,Benin,Austria,5,34,0,39
5446,2018,Bangladesh,Austria,308,393,0,701
5447,2018,Bhutan,Austria,5,0,0,5
5448,2018,Burkina Faso,Austria,9,0,0,9
5449,2018,Belarus,Austria,70,27,0,97
5450,2018,Bolivia (Plurinational State of),Austria,11,0,0,11
5451,2018,Bosnia and Herzegovina,Austria,94,18,0,112
5452,2018,Canada,Austria,5,0,0,5
5453,2018,Chad,Austria,5,0,0,5
5454,2018,China,Austria,610,218,0,828
5455,2018,Cameroon,Austria,221,71,0,292
5456,2018,Congo,Austria,122,20,0,142
5457,2018,Dem. Rep. of the Congo,Austria,401,85,0,486
5458,2018,Colombia,Austria,0,5,0,5
5459,2018,Cuba,Austria,12,14,0,26
5460,2018,Eritrea,Austria,362,73,0,435
5461,2018,Ethiopia,Austria,218,118,0,336
5462,2018,Gabon,Austria,5,0,0,5
5463,2018,Gambia,Austria,138,153,0,291
5464,2018,Georgia,Austria,478,581,0,1059
5465,2018,Ghana,Austria,25,51,0,76
5466,2018,Guinea-Bissau,Austria,5,7,0,12
5467,2018,Guatemala,Austria,5,0,0,5
5468,2018,Guinea,Austria,139,60,0,199
5469,2018,Croatia,Austria,5,0,0,5
5470,2018,Hungary,Austria,0,8,0,8
5471,2018,Cote d'Ivoire,Austria,70,33,0,103
5472,2018,India,Austria,56,390,0,446
5473,2018,Iran (Islamic Rep. of),Austria,5772,2490,0,8262
5474,2018,Iraq,Austria,8295,5769,0,14064
5475,2018,Israel,Austria,11,5,0,16
5476,2018,Jordan,Austria,76,28,0,104
5477,2018,Kazakhstan,Austria,107,79,0,186
5478,2018,Kenya,Austria,30,17,0,47
5479,2018,Kyrgyzstan,Austria,208,34,0,242
5480,2018,Kuwait,Austria,5,7,0,12
5481,2018,Liberia,Austria,16,14,0,30
5482,2018,Libya,Austria,92,83,0,175
5483,2018,Lebanon,Austria,105,134,0,239
5484,2018,Sri Lanka,Austria,71,25,0,96
5485,2018,Madagascar,Austria,5,0,0,5
5486,2018,Mauritania,Austria,5,5,0,10
5487,2018,North Macedonia,Austria,56,65,0,121
5488,2018,Rep. of Moldova,Austria,51,45,0,96
5489,2018,Mali,Austria,11,16,0,27
5490,2018,Mongolia,Austria,141,242,0,383
5491,2018,Morocco,Austria,34,112,0,146
5492,2018,Montenegro,Austria,5,5,0,10
5493,2018,Myanmar,Austria,32,12,0,44
5494,2018,Nepal,Austria,35,71,0,106
5495,2018,Niger,Austria,0,5,0,5
5496,2018,Nicaragua,Austria,5,0,0,5
5497,2018,Nigeria,Austria,422,994,0,1416
5498,2018,Pakistan,Austria,296,754,0,1050
5499,2018,Philippines,Austria,13,19,0,32
5500,2018,Romania,Austria,7,5,0,12
5501,2018,South Africa,Austria,5,0,0,5
5502,2018,Russian Federation,Austria,9946,1635,0,11581
5503,2018,Rwanda,Austria,25,9,0,34
5504,2018,Saudi Arabia,Austria,5,0,0,5
5505,2018,Serbia and Kosovo: S/RES/1244 (1999),Austria,912,280,0,1192
5506,2018,Senegal,Austria,14,13,0,27
5507,2018,Sierra Leone,Austria,24,29,0,53
5508,2018,Somalia,Austria,6949,1423,0,8372
5509,2018,Viet Nam,Austria,9,17,0,26
5510,2018,Sudan,Austria,321,73,0,394
5511,2018,South Sudan,Austria,6,5,0,11
5512,2018,Syrian Arab Rep.,Austria,49179,1538,0,50717
5513,2018,Tajikistan,Austria,220,82,0,302
5514,2018,Turkmenistan,Austria,8,0,0,8
5515,2018,Togo,Austria,12,6,0,18
5516,2018,Tunisia,Austria,6,54,0,60
5517,2018,Türkiye,Austria,622,474,0,1096
5518,2018,Uganda,Austria,28,13,0,41
5519,2018,Ukraine,Austria,282,537,0,819
5520,2018,United States of America,Austria,5,0,0,5
5521,2018,Uzbekistan,Austria,77,116,0,193
5522,2018,Venezuela (Bolivarian Republic of),Austria,5,25,0,30
5523,2018,Yemen,Austria,258,74,0,332
5524,2018,Zambia,Austria,5,0,0,5
5525,2018,Zimbabwe,Austria,14,5,0,19
5528,2018,Afghanistan,Azerbaijan,636,100,0,736
5529,2018,Azerbaijan,Azerbaijan,0,0,620423,0
5530,2018,Palestinian,Azerbaijan,5,0,0,5
5531,2018,Iran (Islamic Rep. of),Azerbaijan,43,9,0,52
5532,2018,Iraq,Azerbaijan,5,9,0,14
5533,2018,Libya,Azerbaijan,5,0,0,5
5534,2018,Nepal,Azerbaijan,0,7,0,7
5535,2018,Pakistan,Azerbaijan,15,44,0,59
5536,2018,Russian Federation,Azerbaijan,392,30,0,422
5537,2018,Syrian Arab Rep.,Azerbaijan,15,5,0,20
5538,2018,Ukraine,Azerbaijan,5,0,0,5
5539,2018,Yemen,Azerbaijan,9,5,0,14
5541,2018,Egypt,Bahrain,0,5,0,5
5542,2018,Iraq,Bahrain,253,48,0,301
5543,2018,Yemen,Bahrain,9,5,0,14
5544,2018,Trinidad and Tobago,Barbados,0,5,0,5
5545,2018,Angola,Burundi,0,5,0,5
5546,2018,Burundi,Burundi,0,0,31909,0
5547,2018,Benin,Burundi,0,0,0,0
5548,2018,Central African Rep.,Burundi,7,0,0,7
5549,2018,Dem. Rep. of the Congo,Burundi,70941,4847,0,75788
5550,2018,Mali,Burundi,14,0,0,14
5551,2018,Rwanda,Burundi,479,801,0,1280
5552,2018,Somalia,Burundi,23,0,0,23
5553,2018,United Rep. of Tanzania,Burundi,5,0,0,5
5554,2018,Türkiye,Burundi,21,5,0,26
5555,2018,Uganda,Burundi,11,0,0,11
5557,2018,Afghanistan,Belgium,3201,2105,0,5306
5558,2018,Albania,Belgium,534,395,0,929
5559,2018,Algeria,Belgium,46,125,0,171
5560,2018,Angola,Belgium,91,125,0,216
5561,2018,Egypt,Belgium,50,70,0,120
5562,2018,Armenia,Belgium,127,175,0,302
5563,2018,Azerbaijan,Belgium,75,60,0,135
5564,2018,Burundi,Belgium,454,325,0,779
5565,2018,Benin,Belgium,30,50,0,80
5566,2018,Bangladesh,Belgium,18,15,0,33
5567,2018,Burkina Faso,Belgium,76,85,0,161
5568,2018,Belarus,Belgium,41,30,0,71
5569,2018,Brazil,Belgium,0,20,0,20
5570,2018,Bosnia and Herzegovina,Belgium,50,25,0,75
5571,2018,Bulgaria,Belgium,14,10,0,24
5572,2018,Cambodia,Belgium,8,0,0,8
5573,2018,Central African Rep.,Belgium,41,25,0,66
5574,2018,Chad,Belgium,34,30,0,64
5575,2018,China,Belgium,1197,60,0,1257
5576,2018,Chile,Belgium,48,10,0,58
5577,2018,Cameroon,Belgium,404,480,0,884
5578,2018,Congo,Belgium,31,20,0,51
5579,2018,Dem. Rep. of the Congo,Belgium,1015,575,0,1590
5580,2018,Colombia,Belgium,33,170,0,203
5581,2018,Cuba,Belgium,8,0,0,8
5582,2018,Czechia,Belgium,6,0,0,6
5583,2018,Djibouti,Belgium,267,80,0,347
5584,2018,Ecuador,Belgium,0,5,0,5
5585,2018,Eritrea,Belgium,1000,500,0,1500
5586,2018,Ethiopia,Belgium,121,50,0,171
5587,2018,Gabon,Belgium,16,25,0,41
5588,2018,Gambia,Belgium,15,55,0,70
5589,2018,Palestinian,Belgium,117,2250,0,2367
5590,2018,Georgia,Belgium,49,235,0,284
5591,2018,Ghana,Belgium,36,25,0,61
5592,2018,Guinea-Bissau,Belgium,11,10,0,21
5593,2018,Guatemala,Belgium,6,10,0,16
5594,2018,Guinea,Belgium,2690,1275,0,3965
5595,2018,Haiti,Belgium,5,0,0,5
5596,2018,Honduras,Belgium,0,5,0,5
5597,2018,Croatia,Belgium,5,0,0,5
5598,2018,Hungary,Belgium,49,0,0,49
5599,2018,Cote d'Ivoire,Belgium,153,205,0,358
5600,2018,India,Belgium,20,25,0,45
5601,2018,Iran (Islamic Rep. of),Belgium,960,470,0,1430
5602,2018,Iraq,Belgium,4000,1555,0,5555
5603,2018,Israel,Belgium,13,0,0,13
5604,2018,Jordan,Belgium,24,45,0,69
5605,2018,Kazakhstan,Belgium,38,10,0,48
5606,2018,Kenya,Belgium,22,10,0,32
5607,2018,Kyrgyzstan,Belgium,64,30,0,94
5608,2018,Dem. People's Rep. of Korea,Belgium,36,0,0,36
5609,2018,Kuwait,Belgium,7,0,0,7
5610,2018,Lao People's Dem. Rep.,Belgium,13,0,0,13
5611,2018,Liberia,Belgium,15,15,0,30
5612,2018,Libya,Belgium,60,125,0,185
5613,2018,Lebanon,Belgium,99,125,0,224
5614,2018,Sri Lanka,Belgium,394,40,0,434
5615,2018,Lithuania,Belgium,7,5,0,12
5616,2018,Madagascar,Belgium,5,5,0,10
5617,2018,Mauritania,Belgium,206,130,0,336
5618,2018,North Macedonia,Belgium,113,95,0,208
5619,2018,Rep. of Moldova,Belgium,5,5,0,10
5620,2018,Mexico,Belgium,0,10,0,10
5621,2018,Mali,Belgium,61,65,0,126
5622,2018,Mongolia,Belgium,0,10,0,10
5623,2018,Morocco,Belgium,70,165,0,235
5624,2018,Montenegro,Belgium,0,5,0,5
5625,2018,Myanmar,Belgium,9,0,0,9
5626,2018,Namibia,Belgium,0,5,0,5
5627,2018,Nepal,Belgium,13,5,0,18
5628,2018,Niger,Belgium,91,115,0,206
5629,2018,Nicaragua,Belgium,0,35,0,35
5630,2018,Nigeria,Belgium,43,85,0,128
5631,2018,Pakistan,Belgium,222,115,0,337
5632,2018,Peru,Belgium,0,10,0,10
5633,2018,Poland,Belgium,154,0,0,154
5634,2018,Romania,Belgium,38,10,0,48
5635,2018,South Africa,Belgium,5,5,0,10
5636,2018,Russian Federation,Belgium,2558,665,0,3223
5637,2018,Rwanda,Belgium,803,370,0,1173
5638,2018,El Salvador,Belgium,7,145,0,152
5639,2018,Saudi Arabia,Belgium,5,0,0,5
5640,2018,Serbia and Kosovo: S/RES/1244 (1999),Belgium,155,290,0,445
5641,2018,Senegal,Belgium,435,245,0,680
5642,2018,Sierra Leone,Belgium,26,40,0,66
5643,2018,Somalia,Belgium,1280,370,0,1650
5644,2018,Viet Nam,Belgium,40,5,0,45
5645,2018,Sudan,Belgium,174,210,0,384
5646,2018,Suriname,Belgium,0,5,0,5
5647,2018,South Sudan,Belgium,0,5,0,5
5648,2018,Slovakia,Belgium,0,5,0,5
5649,2018,Syrian Arab Rep.,Belgium,9080,2005,0,11085
5650,2018,United Rep. of Tanzania,Belgium,50,30,0,80
5651,2018,Tajikistan,Belgium,10,5,0,15
5652,2018,Turkmenistan,Belgium,5,5,0,10
5653,2018,Togo,Belgium,176,110,0,286
5654,2018,Tunisia,Belgium,37,35,0,72
5655,2018,Türkiye,Belgium,587,810,0,1397
5656,2018,Uganda,Belgium,20,5,0,25
5657,2018,Ukraine,Belgium,166,185,0,351
5658,2018,United States of America,Belgium,0,10,0,10
5659,2018,Uzbekistan,Belgium,32,5,0,37
5660,2018,Venezuela (Bolivarian Republic of),Belgium,6,385,0,391
5661,2018,Yemen,Belgium,24,95,0,119
5662,2018,Zimbabwe,Belgium,0,5,0,5
5665,2018,Burundi,Benin,5,0,0,5
5666,2018,Central African Rep.,Benin,915,158,0,1073
5667,2018,Chad,Benin,5,18,0,23
5668,2018,Cameroon,Benin,0,25,0,25
5669,2018,Congo,Benin,0,6,0,6
5670,2018,Dem. Rep. of the Congo,Benin,11,26,0,37
5671,2018,Eritrea,Benin,5,0,0,5
5672,2018,Cote d'Ivoire,Benin,166,17,0,183
5673,2018,Liberia,Benin,0,5,0,5
5674,2018,Sri Lanka,Benin,7,0,0,7
5675,2018,Mali,Benin,20,0,0,20
5676,2018,Niger,Benin,0,5,0,5
5677,2018,Nigeria,Benin,0,9,0,9
5678,2018,Pakistan,Benin,5,0,0,5
5679,2018,Syrian Arab Rep.,Benin,12,0,0,12
5680,2018,Togo,Benin,0,34,0,34
5681,2018,Türkiye,Benin,8,0,0,8
5682,2018,Yemen,Benin,8,5,0,13
5683,2018,Myanmar,Bangladesh,906635,0,0,906635
5684,2018,Somalia,Bangladesh,5,15,0,20
5685,2018,Türkiye,Bangladesh,0,24,0,24
5687,2018,Colombia,Bahamas,5,0,0,5
5688,2018,Cuba,Bahamas,9,12,0,21
5689,2018,Haiti,Bahamas,0,5,0,5
5690,2018,South Africa,Bahamas,0,7,0,7
5691,2018,Burundi,Burkina Faso,28,0,0,28
5692,2018,Burkina Faso,Burkina Faso,0,0,47030,0
5693,2018,Central African Rep.,Burkina Faso,187,35,0,222
5694,2018,Chad,Burkina Faso,83,0,0,83
5695,2018,Cameroon,Burkina Faso,7,0,0,7
5696,2018,Congo,Burkina Faso,28,0,0,28
5697,2018,Dem. Rep. of the Congo,Burkina Faso,33,0,0,33
5698,2018,Cote d'Ivoire,Burkina Faso,5,0,0,5
5699,2018,Mali,Burkina Faso,24710,0,0,24710
5700,2018,Rwanda,Burkina Faso,20,0,0,20
5701,2018,Togo,Burkina Faso,14,0,0,14
5702,2018,Türkiye,Burkina Faso,5,5,0,10
5703,2018,Afghanistan,Belarus,208,31,0,239
5704,2018,Egypt,Belarus,5,0,0,5
5705,2018,Armenia,Belarus,5,0,0,5
5706,2018,Azerbaijan,Belarus,5,0,0,5
5707,2018,Cuba,Belarus,0,5,0,5
5708,2018,Ethiopia,Belarus,5,0,0,5
5709,2018,Georgia,Belarus,59,0,0,59
5710,2018,Iran (Islamic Rep. of),Belarus,6,0,0,6
5711,2018,Iraq,Belarus,13,5,0,18
5712,2018,Libya,Belarus,9,0,0,9
5713,2018,Syrian Arab Rep.,Belarus,66,5,0,71
5714,2018,Tajikistan,Belarus,12,0,0,12
5715,2018,Türkiye,Belarus,5,5,0,10
5716,2018,Ukraine,Belarus,1804,133,0,1937
5717,2018,Yemen,Belarus,23,0,0,23
5719,2018,Chile,Bolivia (Plurinational State of),8,0,0,8
5720,2018,Colombia,Bolivia (Plurinational State of),213,21,0,234
5721,2018,Cuba,Bolivia (Plurinational State of),9,0,0,9
5722,2018,Ecuador,Bolivia (Plurinational State of),5,0,0,5
5723,2018,Cote d'Ivoire,Bolivia (Plurinational State of),5,0,0,5
5724,2018,Iraq,Bolivia (Plurinational State of),16,0,0,16
5725,2018,Nigeria,Bolivia (Plurinational State of),0,5,0,5
5726,2018,Pakistan,Bolivia (Plurinational State of),5,0,0,5
5727,2018,Peru,Bolivia (Plurinational State of),515,0,0,515
5728,2018,Russian Federation,Bolivia (Plurinational State of),5,0,0,5
5729,2018,Syrian Arab Rep.,Bolivia (Plurinational State of),21,8,0,29
5730,2018,Angola,Botswana,0,0,0,0
5731,2018,Burundi,Botswana,50,34,0,84
5732,2018,Dem. Rep. of the Congo,Botswana,137,137,0,274
5733,2018,Eritrea,Botswana,10,0,0,10
5734,2018,Ethiopia,Botswana,5,0,0,5
5735,2018,Kenya,Botswana,5,0,0,5
5736,2018,Namibia,Botswana,846,15,0,861
5737,2018,Rwanda,Botswana,20,5,0,25
5738,2018,Somalia,Botswana,303,34,0,337
5739,2018,Sudan,Botswana,5,0,0,5
5740,2018,Uganda,Botswana,20,0,0,20
5741,2018,Zimbabwe,Botswana,643,43,0,686
5742,2018,Afghanistan,Brazil,121,178,0,299
5743,2018,Albania,Brazil,0,7,0,7
5744,2018,Algeria,Brazil,7,24,0,31
5745,2018,Angola,Brazil,1133,4737,0,5870
5746,2018,Egypt,Brazil,39,379,0,418
5747,2018,Argentina,Brazil,6,79,0,85
5748,2018,Armenia,Brazil,5,5,0,10
5749,2018,Burundi,Brazil,46,22,0,68
5750,2018,Belgium,Brazil,0,5,0,5
5751,2018,Benin,Brazil,0,244,0,244
5752,2018,Bangladesh,Brazil,11,4732,0,4743
5753,2018,Bhutan,Brazil,30,35,0,65
5754,2018,Burkina Faso,Brazil,5,257,0,262
5755,2018,Bolivia (Plurinational State of),Brazil,153,404,0,557
5756,2018,Bosnia and Herzegovina,Brazil,5,0,0,5
5757,2018,Bulgaria,Brazil,0,5,0,5
5758,2018,Canada,Brazil,0,5,0,5
5759,2018,Central African Rep.,Brazil,5,7,0,12
5760,2018,China,Brazil,7,3379,0,3386
5761,2018,Chile,Brazil,21,52,0,73
5762,2018,Cameroon,Brazil,61,492,0,553
5763,2018,Congo,Brazil,20,0,0,20
5764,2018,Dem. Rep. of the Congo,Brazil,1550,2734,0,4284
5765,2018,Colombia,Brazil,1297,1570,0,2867
5766,2018,Costa Rica,Brazil,0,10,0,10
5767,2018,Cuba,Brazil,199,6969,0,7168
5768,2018,Cabo Verde,Brazil,0,173,0,173
5769,2018,Czechia,Brazil,0,5,0,5
5770,2018,Denmark,Brazil,0,12,0,12
5771,2018,Djibouti,Brazil,0,11,0,11
5772,2018,Dominica,Brazil,0,14,0,14
5773,2018,Dominican Rep.,Brazil,5,1156,0,1161
5774,2018,Ecuador,Brazil,57,76,0,133
5775,2018,Equatorial Guinea,Brazil,0,6,0,6
5776,2018,Eritrea,Brazil,25,100,0,125
5777,2018,Ethiopia,Brazil,27,88,0,115
5778,2018,French Guiana,Brazil,0,18,0,18
5779,2018,Fiji,Brazil,0,17,0,17
5780,2018,France,Brazil,0,32,0,32
5781,2018,Gambia,Brazil,6,371,0,377
5782,2018,Palestinian,Brazil,545,321,0,866
5783,2018,United Kingdom of Great Britain and Northern Ireland,Brazil,0,6,0,6
5784,2018,Georgia,Brazil,10,0,0,10
5785,2018,Germany,Brazil,0,7,0,7
5786,2018,Ghana,Brazil,34,2320,0,2354
5787,2018,Guinea-Bissau,Brazil,21,1576,0,1597
5788,2018,Greece,Brazil,0,6,0,6
5789,2018,Guatemala,Brazil,0,14,0,14
5790,2018,Guinea,Brazil,94,862,0,956
5791,2018,Guyana,Brazil,5,75,0,80
5792,2018,Haiti,Brazil,8,13890,0,13898
5793,2018,Honduras,Brazil,0,14,0,14
5794,2018,Croatia,Brazil,5,0,0,5
5795,2018,Hungary,Brazil,0,5,0,5
5796,2018,Cote d'Ivoire,Brazil,51,180,0,231
5797,2018,India,Brazil,7,709,0,716
5798,2018,Indonesia,Brazil,0,7,0,7
5799,2018,Iran (Islamic Rep. of),Brazil,64,159,0,223
5800,2018,Iraq,Brazil,299,369,0,668
5801,2018,Israel,Brazil,0,30,0,30
5802,2018,Italy,Brazil,0,18,0,18
5803,2018,Jamaica,Brazil,0,11,0,11
5804,2018,Jordan,Brazil,10,82,0,92
5805,2018,Japan,Brazil,0,5,0,5
5806,2018,Kazakhstan,Brazil,0,5,0,5
5807,2018,Kenya,Brazil,0,80,0,80
5808,2018,Rep. of Korea,Brazil,0,119,0,119
5809,2018,Kuwait,Brazil,0,6,0,6
5810,2018,Liberia,Brazil,259,30,0,289
5811,2018,Libya,Brazil,5,40,0,45
5812,2018,Lebanon,Brazil,409,1767,0,2176
5813,2018,Lesotho,Brazil,0,5,0,5
5814,2018,Sri Lanka,Brazil,18,43,0,61
5815,2018,Lithuania,Brazil,0,5,0,5
5817,2018,Mauritania,Brazil,0,200,0,200
5818,2018,North Macedonia,Brazil,6,5,0,11
5819,2018,Mexico,Brazil,6,33,0,39
5820,2018,Mali,Brazil,78,423,0,501
5821,2018,Malaysia,Brazil,0,5,0,5
5822,2018,Morocco,Brazil,15,508,0,523
5823,2018,Mozambique,Brazil,0,70,0,70
5824,2018,Malta,Brazil,0,5,0,5
5825,2018,Myanmar,Brazil,0,8,0,8
5826,2018,Namibia,Brazil,0,36,0,36
5827,2018,Nepal,Brazil,10,264,0,274
5828,2018,Netherlands,Brazil,0,5,0,5
5829,2018,Niger,Brazil,0,6,0,6
5830,2018,Nicaragua,Brazil,0,26,0,26
5831,2018,Nigeria,Brazil,133,3166,0,3299
5832,2018,Norway,Brazil,0,6,0,6
5833,2018,Pakistan,Brazil,315,1656,0,1971
5834,2018,Panama,Brazil,0,5,0,5
5835,2018,Paraguay,Brazil,8,89,0,97
5836,2018,Peru,Brazil,45,120,0,165
5837,2018,Philippines,Brazil,0,452,0,452
5838,2018,Poland,Brazil,0,9,0,9
5839,2018,Portugal,Brazil,0,82,0,82
5840,2018,Romania,Brazil,0,15,0,15
5841,2018,South Africa,Brazil,5,382,0,387
5842,2018,Russian Federation,Brazil,13,29,0,42
5843,2018,Rwanda,Brazil,18,5,0,23
5844,2018,El Salvador,Brazil,15,24,0,39
5845,2018,Saudi Arabia,Brazil,0,16,0,16
5846,2018,Serbia and Kosovo: S/RES/1244 (1999),Brazil,92,5,0,97
5847,2018,Senegal,Brazil,14,6069,0,6083
5848,2018,Sierra Leone,Brazil,158,357,0,515
5849,2018,Somalia,Brazil,47,556,0,603
5850,2018,Spain,Brazil,0,42,0,42
5851,2018,Viet Nam,Brazil,5,0,0,5
5852,2018,Sao Tome and Principe,Brazil,0,25,0,25
5853,2018,Sudan,Brazil,73,116,0,189
5854,2018,Suriname,Brazil,0,12,0,12
5855,2018,Sweden,Brazil,0,5,0,5
5856,2018,Syrian Arab Rep.,Brazil,3455,4270,0,7725
5857,2018,United Rep. of Tanzania,Brazil,7,108,0,115
5858,2018,Thailand,Brazil,0,31,0,31
5859,2018,Togo,Brazil,36,587,0,623
5860,2018,Tunisia,Brazil,0,101,0,101
5861,2018,Türkiye,Brazil,6,199,0,205
5862,2018,Uganda,Brazil,5,26,0,31
5863,2018,Ukraine,Brazil,14,65,0,79
5864,2018,Uruguay,Brazil,0,23,0,23
5865,2018,United States of America,Brazil,0,38,0,38
5866,2018,Uzbekistan,Brazil,0,5,0,5
5867,2018,Vanuatu,Brazil,0,40,0,40
5868,2018,Venezuela (Bolivarian Republic of),Brazil,35,81001,0,81036
5869,2018,Yemen,Brazil,0,86,0,86
5870,2018,Zambia,Brazil,0,5,0,5
5871,2018,Zimbabwe,Brazil,5,10,0,15
5874,2018,Afghanistan,Bosnia and Herzegovina,0,246,0,246
5875,2018,Algeria,Bosnia and Herzegovina,0,5,0,5
5876,2018,Bosnia and Herzegovina,Bosnia and Herzegovina,0,0,96830,0
5877,2018,Palestinian,Bosnia and Herzegovina,5,11,0,16
5878,2018,Croatia,Bosnia and Herzegovina,5120,0,0,5120
5879,2018,India,Bosnia and Herzegovina,0,13,0,13
5880,2018,Iran (Islamic Rep. of),Bosnia and Herzegovina,0,316,0,316
5881,2018,Iraq,Bosnia and Herzegovina,5,65,0,70
5882,2018,Libya,Bosnia and Herzegovina,0,7,0,7
5883,2018,North Macedonia,Bosnia and Herzegovina,5,0,0,5
5884,2018,Morocco,Bosnia and Herzegovina,0,7,0,7
5885,2018,Nepal,Bosnia and Herzegovina,0,8,0,8
5886,2018,Pakistan,Bosnia and Herzegovina,0,196,0,196
5887,2018,Russian Federation,Bosnia and Herzegovina,0,5,0,5
5888,2018,Serbia and Kosovo: S/RES/1244 (1999),Bosnia and Herzegovina,62,0,0,62
5889,2018,Somalia,Bosnia and Herzegovina,0,6,0,6
5890,2018,Syrian Arab Rep.,Bosnia and Herzegovina,15,67,0,82
5891,2018,Türkiye,Bosnia and Herzegovina,15,37,0,52
5892,2018,Yemen,Bosnia and Herzegovina,0,14,0,14
5894,2018,Afghanistan,Bulgaria,205,584,0,789
5895,2018,Algeria,Bulgaria,0,20,0,20
5896,2018,Egypt,Bulgaria,15,5,0,20
5897,2018,Armenia,Bulgaria,15,13,0,28
5898,2018,Bangladesh,Bulgaria,9,14,0,23
5899,2018,China,Bulgaria,0,15,0,15
5900,2018,Congo,Bulgaria,9,0,0,9
5901,2018,Dem. Rep. of the Congo,Bulgaria,5,5,0,10
5902,2018,Eritrea,Bulgaria,13,0,0,13
5903,2018,Ethiopia,Bulgaria,13,0,0,13
5904,2018,Ghana,Bulgaria,0,7,0,7
5905,2018,Cote d'Ivoire,Bulgaria,5,5,0,10
5906,2018,India,Bulgaria,5,5,0,10
5907,2018,Iran (Islamic Rep. of),Bulgaria,64,84,0,148
5908,2018,Iraq,Bulgaria,1253,362,0,1615
5909,2018,Jordan,Bulgaria,7,0,0,7
5910,2018,Kyrgyzstan,Bulgaria,0,7,0,7
5911,2018,Lebanon,Bulgaria,24,5,0,29
5912,2018,Mali,Bulgaria,5,8,0,13
5913,2018,Morocco,Bulgaria,5,0,0,5
5914,2018,Myanmar,Bulgaria,0,5,0,5
5915,2018,Nigeria,Bulgaria,0,7,0,7
5916,2018,Pakistan,Bulgaria,20,87,0,107
5917,2018,Russian Federation,Bulgaria,0,26,0,26
5918,2018,Somalia,Bulgaria,50,5,0,55
5919,2018,Sudan,Bulgaria,16,0,0,16
5920,2018,Syrian Arab Rep.,Bulgaria,17161,215,0,17376
5921,2018,Tunisia,Bulgaria,5,0,0,5
5922,2018,Türkiye,Bulgaria,12,8,0,20
5923,2018,Ukraine,Bulgaria,0,40,0,40
5924,2018,Yemen,Bulgaria,12,0,0,12
5926,2018,Cuba,Belize,0,5,0,5
5927,2018,Guatemala,Belize,0,453,0,453
5928,2018,Honduras,Belize,5,617,0,622
5929,2018,Nicaragua,Belize,0,24,0,24
5930,2018,Peru,Belize,0,5,0,5
5931,2018,El Salvador,Belize,24,2201,0,2225
5934,2018,Afghanistan,Canada,3603,769,0,4372
5935,2018,Albania,Canada,911,239,0,1150
5936,2018,Algeria,Canada,443,557,0,1000
5937,2018,Angola,Canada,132,709,0,841
5938,2018,Antigua and Barbuda,Canada,97,42,0,139
5939,2018,Egypt,Canada,1764,1411,0,3175
5940,2018,Argentina,Canada,20,35,0,55
5941,2018,Armenia,Canada,83,21,0,104
5942,2018,Austria,Canada,0,5,0,5
5943,2018,Azerbaijan,Canada,427,373,0,800
5944,2018,Bahrain,Canada,59,20,0,79
5945,2018,Barbados,Canada,200,71,0,271
5946,2018,Burundi,Canada,2194,893,0,3087
5947,2018,Belgium,Canada,16,25,0,41
5948,2018,Benin,Canada,65,50,0,115
5949,2018,Bangladesh,Canada,1020,1098,0,2118
5950,2018,Bahamas,Canada,231,295,0,526
5951,2018,Bhutan,Canada,5,5,0,10
5952,2018,Burkina Faso,Canada,95,110,0,205
5953,2018,Belarus,Canada,94,11,0,105
5954,2018,Bolivia (Plurinational State of),Canada,43,17,0,60
5955,2018,Botswana,Canada,262,8,0,270
5956,2018,Brazil,Canada,75,392,0,467
5957,2018,Bosnia and Herzegovina,Canada,34,5,0,39
5958,2018,Bulgaria,Canada,141,68,0,209
5959,2018,Belize,Canada,19,10,0,29
5960,2018,Cambodia,Canada,71,33,0,104
5961,2018,Central African Rep.,Canada,73,31,0,104
5962,2018,Chad,Canada,458,439,0,897
5963,2018,China,Canada,7192,2378,0,9570
5964,2018,Chile,Canada,51,144,0,195
5965,2018,Cameroon,Canada,1116,491,0,1607
5966,2018,Congo,Canada,300,169,0,469
5967,2018,Dem. Rep. of the Congo,Canada,1846,1494,0,3340
5968,2018,Comoros,Canada,5,5,0,10
5969,2018,Colombia,Canada,7356,3206,0,10562
5970,2018,Costa Rica,Canada,15,17,0,32
5971,2018,Cuba,Canada,767,132,0,899
5972,2018,Cyprus,Canada,7,10,0,17
5973,2018,Czechia,Canada,414,174,0,588
5974,2018,Denmark,Canada,0,18,0,18
5975,2018,Djibouti,Canada,1083,291,0,1374
5976,2018,Dominica,Canada,8,10,0,18
5977,2018,Dominican Rep.,Canada,124,134,0,258
5978,2018,Ecuador,Canada,54,56,0,110
5979,2018,Equatorial Guinea,Canada,18,6,0,24
5980,2018,Eritrea,Canada,2715,789,0,3504
5981,2018,Estonia,Canada,5,0,0,5
5982,2018,Ethiopia,Canada,1900,920,0,2820
5983,2018,Fiji,Canada,54,5,0,59
5984,2018,Finland,Canada,0,5,0,5
5985,2018,France,Canada,10,49,0,59
5986,2018,Gabon,Canada,36,34,0,70
5987,2018,Gambia,Canada,91,96,0,187
5988,2018,Palestinian,Canada,1120,998,0,2118
5989,2018,United Kingdom of Great Britain and Northern Ireland,Canada,11,0,0,11
5990,2018,Georgia,Canada,345,301,0,646
5991,2018,Germany,Canada,0,25,0,25
5992,2018,Ghana,Canada,352,293,0,645
5993,2018,Guinea-Bissau,Canada,9,10,0,19
5994,2018,Greece,Canada,14,23,0,37
5995,2018,Grenada,Canada,54,5,0,59
5996,2018,Guatemala,Canada,540,217,0,757
5997,2018,Guinea,Canada,446,273,0,719
5998,2018,Guyana,Canada,138,78,0,216
5999,2018,Haiti,Canada,7141,7046,0,14187
6000,2018,"China, Hong Kong SAR",Canada,6,5,0,11
6001,2018,Honduras,Canada,996,334,0,1330
6002,2018,Croatia,Canada,282,27,0,309
6003,2018,Hungary,Canada,3524,569,0,4093
6004,2018,Iceland,Canada,0,5,0,5
6005,2018,Cote d'Ivoire,Canada,251,159,0,410
6006,2018,India,Canada,1457,5522,0,6979
6007,2018,Indonesia,Canada,130,52,0,182
6008,2018,Ireland,Canada,0,28,0,28
6009,2018,Iran (Islamic Rep. of),Canada,2538,2547,0,5085
6010,2018,Iraq,Canada,3025,858,0,3883
6011,2018,Israel,Canada,207,63,0,270
6012,2018,Italy,Canada,5,110,0,115
6013,2018,Jamaica,Canada,933,270,0,1203
6014,2018,Jordan,Canada,453,567,0,1020
6015,2018,Japan,Canada,0,8,0,8
6016,2018,Kazakhstan,Canada,173,46,0,219
6017,2018,Kenya,Canada,475,364,0,839
6018,2018,Kyrgyzstan,Canada,71,15,0,86
6019,2018,Rep. of Korea,Canada,98,20,0,118
6020,2018,Dem. People's Rep. of Korea,Canada,478,0,0,478
6021,2018,Kuwait,Canada,85,32,0,117
6022,2018,Lao People's Dem. Rep.,Canada,5,0,0,5
6023,2018,Liberia,Canada,91,56,0,147
6024,2018,Libya,Canada,1330,483,0,1813
6025,2018,Saint Lucia,Canada,994,25,0,1019
6026,2018,Lebanon,Canada,886,479,0,1365
6027,2018,Sri Lanka,Canada,3624,702,0,4326
6028,2018,Lithuania,Canada,21,5,0,26
6029,2018,Luxembourg,Canada,0,5,0,5
6030,2018,Latvia,Canada,77,6,0,83
6031,2018,Madagascar,Canada,19,16,0,35
6032,2018,Mauritania,Canada,159,186,0,345
6033,2018,North Macedonia,Canada,47,0,0,47
6034,2018,Rep. of Moldova,Canada,126,5,0,131
6035,2018,Mexico,Canada,3457,3813,0,7270
6036,2018,Mali,Canada,163,145,0,308
6037,2018,Malaysia,Canada,29,16,0,45
6038,2018,Malawi,Canada,18,33,0,51
6039,2018,Mongolia,Canada,160,45,0,205
6040,2018,Morocco,Canada,153,103,0,256
6041,2018,Mozambique,Canada,0,8,0,8
6042,2018,Malta,Canada,5,0,0,5
6043,2018,Montenegro,Canada,21,0,0,21
6044,2018,Mauritius,Canada,8,11,0,19
6045,2018,Myanmar,Canada,55,23,0,78
6046,2018,Namibia,Canada,376,5,0,381
6047,2018,Nepal,Canada,611,213,0,824
6048,2018,Netherlands,Canada,5,30,0,35
6049,2018,Niger,Canada,59,74,0,133
6050,2018,Nicaragua,Canada,83,348,0,431
6051,2018,Nigeria,Canada,5483,13049,0,18532
6052,2018,Norway,Canada,0,5,0,5
6053,2018,Oman,Canada,7,0,0,7
6054,2018,Pakistan,Canada,5607,2901,0,8508
6055,2018,Panama,Canada,20,24,0,44
6056,2018,Paraguay,Canada,14,7,0,21
6057,2018,Peru,Canada,224,185,0,409
6058,2018,Philippines,Canada,94,75,0,169
6059,2018,Papua New Guinea,Canada,5,0,0,5
6060,2018,Poland,Canada,129,113,0,242
6061,2018,Portugal,Canada,0,18,0,18
6062,2018,Qatar,Canada,12,0,0,12
6063,2018,Romania,Canada,216,1040,0,1256
6064,2018,South Africa,Canada,67,216,0,283
6065,2018,Russian Federation,Canada,904,222,0,1126
6066,2018,Rwanda,Canada,936,464,0,1400
6067,2018,El Salvador,Canada,1559,708,0,2267
6068,2018,Saudi Arabia,Canada,375,269,0,644
6069,2018,Serbia and Kosovo: S/RES/1244 (1999),Canada,322,64,0,386
6070,2018,Senegal,Canada,248,210,0,458
6071,2018,Seychelles,Canada,5,0,0,5
6072,2018,Singapore,Canada,14,5,0,19
6073,2018,Sierra Leone,Canada,82,38,0,120
6074,2018,Solomon Islands,Canada,6,0,0,6
6075,2018,Somalia,Canada,3245,766,0,4011
6076,2018,Spain,Canada,6,59,0,65
6077,2018,Viet Nam,Canada,53,58,0,111
6078,2018,Saint Kitts and Nevis,Canada,45,0,0,45
6079,2018,Sudan,Canada,1173,735,0,1908
6080,2018,Suriname,Canada,5,7,0,12
6081,2018,South Sudan,Canada,13,17,0,30
6082,2018,Slovakia,Canada,1004,365,0,1369
6083,2018,Slovenia,Canada,7,5,0,12
6084,2018,Eswatini,Canada,148,0,0,148
6085,2018,Sweden,Canada,0,14,0,14
6086,2018,Syrian Arab Rep.,Canada,3558,803,0,4361
6087,2018,United Rep. of Tanzania,Canada,162,121,0,283
6088,2018,Thailand,Canada,14,7,0,21
6089,2018,Tajikistan,Canada,52,20,0,72
6090,2018,Turkmenistan,Canada,19,8,0,27
6091,2018,Timor-Leste,Canada,0,5,0,5
6092,2018,Togo,Canada,121,73,0,194
6093,2018,Trinidad and Tobago,Canada,111,40,0,151
6094,2018,Tunisia,Canada,189,120,0,309
6095,2018,Türkiye,Canada,4241,1928,0,6169
6096,2018,United Arab Emirates,Canada,39,10,0,49
6097,2018,Uganda,Canada,559,518,0,1077
6098,2018,Ukraine,Canada,1319,298,0,1617
6099,2018,Uruguay,Canada,7,9,0,16
6100,2018,United States of America,Canada,63,2507,0,2570
6101,2018,Uzbekistan,Canada,181,32,0,213
6102,2018,Saint Vincent and the Grenadines,Canada,1191,21,0,1212
6103,2018,Venezuela (Bolivarian Republic of),Canada,1876,1674,0,3550
6104,2018,Yemen,Canada,1089,689,0,1778
6105,2018,Zambia,Canada,29,22,0,51
6106,2018,Zimbabwe,Canada,1018,249,0,1267
6109,2018,Angola,Central African Rep.,14,0,0,14
6110,2018,Burundi,Central African Rep.,25,0,0,25
6111,2018,Central African Rep.,Central African Rep.,0,0,640970,0
6112,2018,Chad,Central African Rep.,1695,37,0,1732
6113,2018,Cameroon,Central African Rep.,12,11,0,23
6114,2018,Congo,Central African Rep.,13,10,0,23
6115,2018,Dem. Rep. of the Congo,Central African Rep.,1547,301,0,1848
6116,2018,Guinea,Central African Rep.,7,0,0,7
6117,2018,Cote d'Ivoire,Central African Rep.,9,0,0,9
6118,2018,Liberia,Central African Rep.,9,5,0,14
6119,2018,Mali,Central African Rep.,5,0,0,5
6120,2018,Rwanda,Central African Rep.,199,0,0,199
6121,2018,Sudan,Central African Rep.,518,13,0,531
6122,2018,South Sudan,Central African Rep.,2573,5,0,2578
6123,2018,Togo,Central African Rep.,0,10,0,10
6124,2018,Türkiye,Central African Rep.,21,0,0,21
6125,2018,Uganda,Central African Rep.,5,5,0,10
6126,2018,Cuba,Cayman Islands,29,27,0,56
6127,2018,Mexico,Cayman Islands,5,0,0,5
6128,2018,Burundi,Chad,6,0,0,6
6129,2018,Central African Rep.,Chad,102087,1490,0,103577
6130,2018,Chad,Chad,0,0,165314,0
6131,2018,Cameroon,Chad,10,8,0,18
6132,2018,Congo,Chad,11,5,0,16
6133,2018,Dem. Rep. of the Congo,Chad,307,22,0,329
6134,2018,Eritrea,Chad,11,11,0,22
6135,2018,Ethiopia,Chad,24,14,0,38
6136,2018,Cote d'Ivoire,Chad,5,0,0,5
6137,2018,Libya,Chad,17,13,0,30
6138,2018,Niger,Chad,642,0,0,642
6139,2018,Nigeria,Chad,11310,23,0,11333
6140,2018,Rwanda,Chad,13,0,0,13
6141,2018,Somalia,Chad,10,0,0,10
6142,2018,Sudan,Chad,336674,1855,0,338529
6143,2018,South Sudan,Chad,8,7,0,15
6144,2018,Syrian Arab Rep.,Chad,57,14,0,71
6145,2018,Türkiye,Chad,6,0,0,6
6146,2018,Yemen,Chad,5,5,0,10
6147,2018,Afghanistan,China,9,23,0,32
6148,2018,Burundi,China,5,6,0,11
6149,2018,Cameroon,China,5,168,0,173
6150,2018,Dem. Rep. of the Congo,China,5,13,0,18
6151,2018,Eritrea,China,5,0,0,5
6152,2018,Palestinian,China,13,0,0,13
6153,2018,Ghana,China,5,12,0,17
6154,2018,Iraq,China,15,12,0,27
6155,2018,Kenya,China,0,60,0,60
6156,2018,Liberia,China,0,8,0,8
6157,2018,Mozambique,China,0,11,0,11
6158,2018,Nigeria,China,0,18,0,18
6159,2018,Pakistan,China,18,24,0,42
6160,2018,Rwanda,China,0,8,0,8
6161,2018,Sierra Leone,China,0,5,0,5
6162,2018,Somalia,China,100,17,0,117
6163,2018,Viet Nam,China,321502,0,0,321502
6164,2018,Syrian Arab Rep.,China,53,19,0,72
6165,2018,Türkiye,China,0,9,0,9
6166,2018,Uganda,China,5,55,0,60
6167,2018,Yemen,China,13,11,0,24
6168,2018,Zimbabwe,China,5,104,0,109
6169,2018,Afghanistan,Chile,13,13,0,26
6170,2018,Angola,Chile,0,8,0,8
6171,2018,Bangladesh,Chile,0,8,0,8
6172,2018,Bolivia (Plurinational State of),Chile,0,22,0,22
6173,2018,Brazil,Chile,0,5,0,5
6174,2018,Congo,Chile,8,5,0,13
6175,2018,Dem. Rep. of the Congo,Chile,5,0,0,5
6176,2018,Colombia,Chile,1218,5069,0,6287
6177,2018,Costa Rica,Chile,5,0,0,5
6178,2018,Cuba,Chile,18,3289,0,3307
6179,2018,Dominican Rep.,Chile,0,172,0,172
6180,2018,Ecuador,Chile,23,27,0,50
6181,2018,Palestinian,Chile,15,14,0,29
6182,2018,Ghana,Chile,0,10,0,10
6183,2018,Guatemala,Chile,0,5,0,5
6184,2018,Haiti,Chile,0,33,0,33
6185,2018,Honduras,Chile,5,0,0,5
6186,2018,Iraq,Chile,0,14,0,14
6187,2018,Kenya,Chile,5,0,0,5
6188,2018,Rep. of Korea,Chile,0,5,0,5
6189,2018,Sri Lanka,Chile,5,0,0,5
6190,2018,Mexico,Chile,0,5,0,5
6191,2018,Pakistan,Chile,0,7,0,7
6192,2018,Peru,Chile,113,19,0,132
6193,2018,Russian Federation,Chile,5,9,0,14
6194,2018,El Salvador,Chile,9,27,0,36
6195,2018,Senegal,Chile,5,5,0,10
6196,2018,Sierra Leone,Chile,0,5,0,5
6197,2018,Syrian Arab Rep.,Chile,107,36,0,143
6198,2018,Türkiye,Chile,26,5,0,31
6199,2018,United States of America,Chile,0,5,0,5
6200,2018,Venezuela (Bolivarian Republic of),Chile,9,3102,0,3111
6201,2018,Yemen,Chile,0,5,0,5
6203,2018,Angola,Cameroon,5,0,0,5
6204,2018,Burundi,Cameroon,70,25,0,95
6205,2018,Burkina Faso,Cameroon,0,23,0,23
6206,2018,Cambodia,Cameroon,5,0,0,5
6207,2018,Central African Rep.,Cameroon,274688,6533,0,281221
6208,2018,Chad,Cameroon,1567,458,0,2025
6209,2018,Cameroon,Cameroon,0,0,668494,0
6210,2018,Congo,Cameroon,54,21,0,75
6211,2018,Dem. Rep. of the Congo,Cameroon,534,176,0,710
6212,2018,Gambia,Cameroon,0,5,0,5
6213,2018,Guinea-Bissau,Cameroon,0,13,0,13
6214,2018,Guinea,Cameroon,12,176,0,188
6215,2018,Cote d'Ivoire,Cameroon,70,86,0,156
6216,2018,Iran (Islamic Rep. of),Cameroon,5,0,0,5
6217,2018,Liberia,Cameroon,9,0,0,9
6218,2018,Mauritania,Cameroon,5,0,0,5
6219,2018,Mali,Cameroon,0,162,0,162
6220,2018,Morocco,Cameroon,7,0,0,7
6221,2018,Niger,Cameroon,0,19,0,19
6222,2018,Nigeria,Cameroon,102287,37,0,102324
6223,2018,Rwanda,Cameroon,863,195,0,1058
6224,2018,Senegal,Cameroon,0,19,0,19
6225,2018,Sierra Leone,Cameroon,0,8,0,8
6226,2018,Sudan,Cameroon,94,39,0,133
6227,2018,South Sudan,Cameroon,13,0,0,13
6228,2018,Syrian Arab Rep.,Cameroon,22,6,0,28
6229,2018,Togo,Cameroon,17,11,0,28
6230,2018,Türkiye,Cameroon,0,80,0,80
6231,2018,Algeria,Congo,0,5,0,5
6232,2018,Angola,Congo,317,78,0,395
6233,2018,Burundi,Congo,94,12,0,106
6234,2018,Central African Rep.,Congo,24696,5507,0,30203
6235,2018,Chad,Congo,36,33,0,69
6236,2018,Cameroon,Congo,5,20,0,25
6237,2018,Congo,Congo,0,0,138000,0
6238,2018,Dem. Rep. of the Congo,Congo,11285,2737,0,14022
6239,2018,Guinea,Congo,0,8,0,8
6240,2018,Cote d'Ivoire,Congo,5,32,0,37
6241,2018,Liberia,Congo,0,10,0,10
6242,2018,Mauritania,Congo,5,94,0,99
6243,2018,Mali,Congo,5,11,0,16
6244,2018,Niger,Congo,0,5,0,5
6245,2018,Nigeria,Congo,5,0,0,5
6246,2018,Rwanda,Congo,991,529,0,1520
6247,2018,Sierra Leone,Congo,5,0,0,5
6248,2018,Sudan,Congo,30,58,0,88
6249,2018,South Sudan,Congo,0,13,0,13
6250,2018,Syrian Arab Rep.,Congo,12,19,0,31
6251,2018,Türkiye,Congo,0,5,0,5
6252,2018,Angola,Dem. Rep. of the Congo,490,13,0,503
6253,2018,Burundi,Dem. Rep. of the Congo,43010,529,0,43539
6254,2018,Central African Rep.,Dem. Rep. of the Congo,172011,619,0,172630
6255,2018,Chad,Dem. Rep. of the Congo,5,16,0,21
6256,2018,Cameroon,Dem. Rep. of the Congo,0,26,0,26
6257,2018,Congo,Dem. Rep. of the Congo,657,29,0,686
6258,2018,Dem. Rep. of the Congo,Dem. Rep. of the Congo,0,0,4516866,0
6259,2018,Eritrea,Dem. Rep. of the Congo,5,0,0,5
6260,2018,Cote d'Ivoire,Dem. Rep. of the Congo,5,7,0,12
6261,2018,Kenya,Dem. Rep. of the Congo,0,5,0,5
6262,2018,Liberia,Dem. Rep. of the Congo,5,19,0,24
6263,2018,Mali,Dem. Rep. of the Congo,0,15,0,15
6264,2018,Nepal,Dem. Rep. of the Congo,0,5,0,5
6265,2018,Niger,Dem. Rep. of the Congo,0,5,0,5
6266,2018,Rwanda,Dem. Rep. of the Congo,216986,171,0,217157
6267,2018,Somalia,Dem. Rep. of the Congo,14,52,0,66
6268,2018,Sudan,Dem. Rep. of the Congo,152,5,0,157
6269,2018,South Sudan,Dem. Rep. of the Congo,95704,4229,0,99933
6270,2018,Syrian Arab Rep.,Dem. Rep. of the Congo,5,20,0,25
6271,2018,Uganda,Dem. Rep. of the Congo,16,5,0,21
6272,2018,Afghanistan,Colombia,9,0,0,9
6273,2018,Bolivia (Plurinational State of),Colombia,5,0,0,5
6274,2018,Cameroon,Colombia,0,5,0,5
6275,2018,Colombia,Colombia,0,0,7816473,0
6276,2018,Cuba,Colombia,73,61,0,134
6277,2018,Ecuador,Colombia,8,0,0,8
6278,2018,Eritrea,Colombia,5,0,0,5
6279,2018,Ethiopia,Colombia,17,0,0,17
6280,2018,Palestinian,Colombia,0,5,0,5
6281,2018,Honduras,Colombia,5,0,0,5
6282,2018,Hungary,Colombia,6,0,0,6
6283,2018,Iraq,Colombia,9,0,0,9
6284,2018,Nicaragua,Colombia,14,0,0,14
6285,2018,Romania,Colombia,7,0,0,7
6286,2018,El Salvador,Colombia,11,0,0,11
6287,2018,Serbia and Kosovo: S/RES/1244 (1999),Colombia,7,0,0,7
6288,2018,Sierra Leone,Colombia,5,0,0,5
6289,2018,Somalia,Colombia,11,0,0,11
6290,2018,Syrian Arab Rep.,Colombia,8,8,0,16
6291,2018,Türkiye,Colombia,0,36,0,36
6292,2018,Venezuela (Bolivarian Republic of),Colombia,94,2729,0,2823
6293,2018,Yemen,Colombia,0,7,0,7
6295,2018,Angola,Costa Rica,0,15,0,15
6296,2018,Argentina,Costa Rica,0,14,0,14
6297,2018,Bangladesh,Costa Rica,0,16,0,16
6298,2018,Burkina Faso,Costa Rica,0,5,0,5
6299,2018,Brazil,Costa Rica,0,5,0,5
6300,2018,China,Costa Rica,0,11,0,11
6301,2018,Cameroon,Costa Rica,0,19,0,19
6302,2018,Congo,Costa Rica,0,57,0,57
6303,2018,Dem. Rep. of the Congo,Costa Rica,5,16,0,21
6304,2018,Colombia,Costa Rica,2258,898,0,3156
6305,2018,Cuba,Costa Rica,378,200,0,578
6306,2018,Ecuador,Costa Rica,0,13,0,13
6307,2018,Eritrea,Costa Rica,0,5,0,5
6308,2018,Ethiopia,Costa Rica,5,0,0,5
6309,2018,Gambia,Costa Rica,0,5,0,5
6310,2018,Germany,Costa Rica,0,5,0,5
6311,2018,Ghana,Costa Rica,0,58,0,58
6312,2018,Guatemala,Costa Rica,25,14,0,39
6313,2018,Haiti,Costa Rica,12,44,0,56
6314,2018,Honduras,Costa Rica,159,388,0,547
6315,2018,Cote d'Ivoire,Costa Rica,0,5,0,5
6316,2018,India,Costa Rica,5,0,0,5
6317,2018,Iran (Islamic Rep. of),Costa Rica,5,0,0,5
6318,2018,Israel,Costa Rica,0,5,0,5
6319,2018,Italy,Costa Rica,0,5,0,5
6320,2018,Mexico,Costa Rica,6,15,0,21
6321,2018,Nepal,Costa Rica,0,105,0,105
6322,2018,Niger,Costa Rica,0,5,0,5
6323,2018,Nicaragua,Costa Rica,456,22706,0,23162
6324,2018,Nigeria,Costa Rica,19,0,0,19
6325,2018,Pakistan,Costa Rica,0,11,0,11
6326,2018,Panama,Costa Rica,5,5,0,10
6327,2018,Peru,Costa Rica,15,0,0,15
6328,2018,Russian Federation,Costa Rica,19,5,0,24
6329,2018,El Salvador,Costa Rica,782,2310,0,3092
6330,2018,Senegal,Costa Rica,0,6,0,6
6331,2018,Somalia,Costa Rica,7,7,0,14
6332,2018,Spain,Costa Rica,0,8,0,8
6333,2018,Syrian Arab Rep.,Costa Rica,9,12,0,21
6334,2018,Ukraine,Costa Rica,17,0,0,17
6335,2018,United States of America,Costa Rica,0,26,0,26
6336,2018,Venezuela (Bolivarian Republic of),Costa Rica,344,5365,0,5709
6337,2018,Zimbabwe,Costa Rica,0,5,0,5
6340,2018,Afghanistan,Cuba,42,0,0,42
6341,2018,Eritrea,Cuba,17,0,0,17
6342,2018,Ethiopia,Cuba,5,0,0,5
6343,2018,Palestinian,Cuba,6,0,0,6
6344,2018,Iran (Islamic Rep. of),Cuba,17,12,0,29
6345,2018,Iraq,Cuba,5,0,0,5
6346,2018,Sudan,Cuba,0,7,0,7
6347,2018,Syrian Arab Rep.,Cuba,44,5,0,49
6348,2018,Western Sahara,Cuba,134,0,0,134
6349,2018,Yemen,Cuba,17,0,0,17
6351,2018,Afghanistan,Cyprus,14,5,0,19
6352,2018,Albania,Cyprus,0,5,0,5
6353,2018,Algeria,Cyprus,8,7,0,15
6354,2018,Egypt,Cyprus,110,706,0,816
6355,2018,Armenia,Cyprus,26,21,0,47
6356,2018,Bangladesh,Cyprus,5,750,0,755
6357,2018,Burkina Faso,Cyprus,0,5,0,5
6358,2018,Belarus,Cyprus,0,5,0,5
6359,2018,Bosnia and Herzegovina,Cyprus,15,0,0,15
6360,2018,China,Cyprus,5,7,0,12
6361,2018,Cameroon,Cyprus,59,660,0,719
6362,2018,Congo,Cyprus,6,32,0,38
6363,2018,Dem. Rep. of the Congo,Cyprus,21,120,0,141
6364,2018,Cuba,Cyprus,0,5,0,5
6365,2018,Eritrea,Cyprus,53,0,0,53
6366,2018,Ethiopia,Cyprus,10,13,0,23
6367,2018,Gambia,Cyprus,5,58,0,63
6368,2018,Palestinian,Cyprus,1997,294,0,2291
6369,2018,Georgia,Cyprus,85,475,0,560
6370,2018,Ghana,Cyprus,0,13,0,13
6371,2018,Guinea,Cyprus,5,15,0,20
6372,2018,Cote d'Ivoire,Cyprus,5,22,0,27
6373,2018,India,Cyprus,7,982,0,989
6374,2018,Iran (Islamic Rep. of),Cyprus,550,266,0,816
6375,2018,Iraq,Cyprus,890,445,0,1335
6376,2018,Jordan,Cyprus,38,70,0,108
6377,2018,Kazakhstan,Cyprus,5,0,0,5
6378,2018,Kyrgyzstan,Cyprus,5,0,0,5
6379,2018,Libya,Cyprus,0,9,0,9
6380,2018,Lebanon,Cyprus,52,45,0,97
6381,2018,Sri Lanka,Cyprus,25,364,0,389
6382,2018,Rep. of Moldova,Cyprus,18,5,0,23
6383,2018,Mali,Cyprus,0,5,0,5
6384,2018,Morocco,Cyprus,0,5,0,5
6385,2018,Nepal,Cyprus,0,205,0,205
6386,2018,Nigeria,Cyprus,12,192,0,204
6387,2018,Pakistan,Cyprus,17,590,0,607
6388,2018,Philippines,Cyprus,12,185,0,197
6389,2018,Russian Federation,Cyprus,77,45,0,122
6390,2018,Rwanda,Cyprus,5,0,0,5
6391,2018,Serbia and Kosovo: S/RES/1244 (1999),Cyprus,59,5,0,64
6392,2018,Senegal,Cyprus,0,23,0,23
6393,2018,Sierra Leone,Cyprus,24,5,0,29
6394,2018,Somalia,Cyprus,184,256,0,440
6395,2018,Viet Nam,Cyprus,0,529,0,529
6396,2018,Sudan,Cyprus,13,0,0,13
6397,2018,Syrian Arab Rep.,Cyprus,6259,2553,0,8812
6398,2018,Türkiye,Cyprus,210,111,0,321
6399,2018,Ukraine,Cyprus,30,120,0,150
6400,2018,Uzbekistan,Cyprus,5,5,0,10
6401,2018,Yemen,Cyprus,20,9,0,29
6402,2018,Zimbabwe,Cyprus,0,12,0,12
6405,2018,Afghanistan,Czechia,46,16,0,62
6406,2018,Algeria,Czechia,0,8,0,8
6407,2018,Egypt,Czechia,5,7,0,12
6408,2018,Armenia,Czechia,29,74,0,103
6409,2018,Azerbaijan,Czechia,18,32,0,50
6410,2018,Belarus,Czechia,232,16,0,248
6411,2018,Bosnia and Herzegovina,Czechia,5,0,0,5
6412,2018,China,Czechia,20,0,0,20
6413,2018,Cameroon,Czechia,5,5,0,10
6414,2018,Dem. Rep. of the Congo,Czechia,8,0,0,8
6415,2018,Cuba,Czechia,61,25,0,86
6416,2018,Eritrea,Czechia,13,0,0,13
6417,2018,Ethiopia,Czechia,5,0,0,5
6418,2018,Georgia,Czechia,16,45,0,61
6419,2018,Guinea,Czechia,5,0,0,5
6420,2018,India,Czechia,0,5,0,5
6421,2018,Iran (Islamic Rep. of),Czechia,8,8,0,16
6422,2018,Iraq,Czechia,172,21,0,193
6423,2018,Jordan,Czechia,0,5,0,5
6424,2018,Kazakhstan,Czechia,120,24,0,144
6425,2018,Kyrgyzstan,Czechia,14,18,0,32
6426,2018,Libya,Czechia,14,14,0,28
6427,2018,Lebanon,Czechia,5,0,0,5
6428,2018,Sri Lanka,Czechia,7,0,0,7
6429,2018,Rep. of Moldova,Czechia,19,7,0,26
6430,2018,Mongolia,Czechia,6,6,0,12
6431,2018,Morocco,Czechia,5,0,0,5
6432,2018,Myanmar,Czechia,145,0,0,145
6433,2018,Nigeria,Czechia,8,17,0,25
6434,2018,Pakistan,Czechia,13,23,0,36
6435,2018,Russian Federation,Czechia,148,53,0,201
6436,2018,Saudi Arabia,Czechia,5,0,0,5
6437,2018,Serbia and Kosovo: S/RES/1244 (1999),Czechia,9,0,0,9
6438,2018,Sierra Leone,Czechia,5,0,0,5
6439,2018,Somalia,Czechia,10,5,0,15
6440,2018,Viet Nam,Czechia,16,45,0,61
6441,2018,Sudan,Czechia,11,0,0,11
6442,2018,Syrian Arab Rep.,Czechia,448,8,0,456
6443,2018,Turkmenistan,Czechia,7,0,0,7
6444,2018,Togo,Czechia,5,0,0,5
6445,2018,Tunisia,Czechia,0,8,0,8
6446,2018,Türkiye,Czechia,5,20,0,25
6447,2018,Uganda,Czechia,5,0,0,5
6448,2018,Ukraine,Czechia,318,241,0,559
6449,2018,Uzbekistan,Czechia,72,52,0,124
6450,2018,Venezuela (Bolivarian Republic of),Czechia,5,5,0,10
6451,2018,Yemen,Czechia,15,5,0,20
6454,2018,Afghanistan,Denmark,2750,284,0,3034
6455,2018,Albania,Denmark,5,15,0,20
6456,2018,Algeria,Denmark,5,16,0,21
6457,2018,Egypt,Denmark,16,10,0,26
6458,2018,Armenia,Denmark,71,36,0,107
6459,2018,Azerbaijan,Denmark,41,16,0,57
6460,2018,Burundi,Denmark,5,5,0,10
6461,2018,Bangladesh,Denmark,20,6,0,26
6462,2018,Belarus,Denmark,5,18,0,23
6463,2018,Bosnia and Herzegovina,Denmark,5,0,0,5
6464,2018,China,Denmark,16,0,0,16
6465,2018,Cameroon,Denmark,6,17,0,23
6466,2018,Congo,Denmark,5,0,0,5
6467,2018,Dem. Rep. of the Congo,Denmark,84,15,0,99
6468,2018,Colombia,Denmark,5,35,0,40
6469,2018,Eritrea,Denmark,4610,322,0,4932
6470,2018,Ethiopia,Denmark,93,22,0,115
6471,2018,Gambia,Denmark,5,11,0,16
6472,2018,Palestinian,Denmark,20,0,0,20
6473,2018,Georgia,Denmark,5,145,0,150
6474,2018,Ghana,Denmark,5,10,0,15
6475,2018,Guinea-Bissau,Denmark,5,0,0,5
6476,2018,Guinea,Denmark,0,11,0,11
6477,2018,Cote d'Ivoire,Denmark,14,0,0,14
6478,2018,India,Denmark,5,9,0,14
6479,2018,Indonesia,Denmark,0,10,0,10
6480,2018,Iran (Islamic Rep. of),Denmark,3253,295,0,3548
6481,2018,Iraq,Denmark,446,172,0,618
6482,2018,Jordan,Denmark,5,13,0,18
6483,2018,Kenya,Denmark,6,9,0,15
6484,2018,Kyrgyzstan,Denmark,5,0,0,5
6485,2018,Dem. People's Rep. of Korea,Denmark,9,0,0,9
6486,2018,Libya,Denmark,11,13,0,24
6487,2018,Lebanon,Denmark,25,10,0,35
6488,2018,Sri Lanka,Denmark,61,28,0,89
6489,2018,North Macedonia,Denmark,0,9,0,9
6490,2018,Morocco,Denmark,8,51,0,59
6491,2018,Myanmar,Denmark,30,12,0,42
6492,2018,Nepal,Denmark,5,0,0,5
6493,2018,Nicaragua,Denmark,0,8,0,8
6494,2018,Nigeria,Denmark,12,40,0,52
6495,2018,Pakistan,Denmark,64,14,0,78
6496,2018,South Africa,Denmark,0,5,0,5
6497,2018,Russian Federation,Denmark,923,64,0,987
6498,2018,Rwanda,Denmark,17,0,0,17
6499,2018,El Salvador,Denmark,5,8,0,13
6500,2018,Serbia and Kosovo: S/RES/1244 (1999),Denmark,0,7,0,7
6501,2018,Senegal,Denmark,0,5,0,5
6502,2018,Sierra Leone,Denmark,0,5,0,5
6503,2018,Somalia,Denmark,1303,149,0,1452
6504,2018,Viet Nam,Denmark,0,14,0,14
6505,2018,Sudan,Denmark,71,6,0,77
6506,2018,Syrian Arab Rep.,Denmark,19698,292,0,19990
6507,2018,Thailand,Denmark,5,0,0,5
6508,2018,Tajikistan,Denmark,5,0,0,5
6509,2018,Tunisia,Denmark,0,9,0,9
6510,2018,Türkiye,Denmark,5,27,0,32
6511,2018,Uganda,Denmark,74,23,0,97
6512,2018,Ukraine,Denmark,27,46,0,73
6513,2018,Uzbekistan,Denmark,10,0,0,10
6514,2018,Venezuela (Bolivarian Republic of),Denmark,0,22,0,22
6515,2018,Yemen,Denmark,5,5,0,10
6516,2018,Zimbabwe,Denmark,10,0,0,10
6519,2018,Eritrea,Djibouti,382,478,0,860
6520,2018,Ethiopia,Djibouti,510,9902,0,10412
6521,2018,Iraq,Djibouti,14,5,0,19
6522,2018,Kenya,Djibouti,11,0,0,11
6523,2018,Mali,Djibouti,0,5,0,5
6524,2018,Philippines,Djibouti,5,0,0,5
6525,2018,Somalia,Djibouti,12660,84,0,12744
6526,2018,Sudan,Djibouti,7,0,0,7
6527,2018,South Sudan,Djibouti,0,5,0,5
6528,2018,Syrian Arab Rep.,Djibouti,10,0,0,10
6529,2018,Yemen,Djibouti,4694,0,0,4694
6530,2018,Afghanistan,Dominican Rep.,0,5,0,5
6531,2018,Colombia,Dominican Rep.,0,6,0,6
6532,2018,Cuba,Dominican Rep.,0,18,0,18
6533,2018,Haiti,Dominican Rep.,164,221,0,385
6534,2018,Honduras,Dominican Rep.,0,5,0,5
6535,2018,Venezuela (Bolivarian Republic of),Dominican Rep.,0,72,0,72
6536,2018,Afghanistan,Ecuador,141,9,0,150
6537,2018,Albania,Ecuador,6,0,0,6
6538,2018,Angola,Ecuador,5,39,0,44
6539,2018,Egypt,Ecuador,0,10,0,10
6540,2018,Bangladesh,Ecuador,5,11,0,16
6541,2018,Brazil,Ecuador,5,8,0,13
6542,2018,Canada,Ecuador,0,5,0,5
6543,2018,China,Ecuador,12,0,0,12
6544,2018,Chile,Ecuador,5,8,0,13
6545,2018,Cameroon,Ecuador,6,17,0,23
6546,2018,Congo,Ecuador,5,0,0,5
6547,2018,Dem. Rep. of the Congo,Ecuador,0,35,0,35
6548,2018,Colombia,Ecuador,50532,10029,0,60561
6549,2018,Cuba,Ecuador,212,80,0,292
6550,2018,Dominican Rep.,Ecuador,5,10,0,15
6551,2018,Eritrea,Ecuador,11,0,0,11
6552,2018,Ethiopia,Ecuador,5,0,0,5
6553,2018,Gambia,Ecuador,0,5,0,5
6554,2018,Palestinian,Ecuador,7,5,0,12
6555,2018,Ghana,Ecuador,5,5,0,10
6556,2018,Guinea,Ecuador,9,0,0,9
6557,2018,Haiti,Ecuador,21,10,0,31
6558,2018,Honduras,Ecuador,0,5,0,5
6559,2018,Cote d'Ivoire,Ecuador,0,5,0,5
6560,2018,India,Ecuador,0,10,0,10
6561,2018,Iran (Islamic Rep. of),Ecuador,41,37,0,78
6562,2018,Iraq,Ecuador,61,7,0,68
6563,2018,Liberia,Ecuador,5,5,0,10
6564,2018,Libya,Ecuador,5,5,0,10
6565,2018,Lebanon,Ecuador,5,5,0,10
6566,2018,Sri Lanka,Ecuador,18,6,0,24
6567,2018,North Macedonia,Ecuador,14,0,0,14
6568,2018,Mexico,Ecuador,0,5,0,5
6569,2018,Mali,Ecuador,5,0,0,5
6570,2018,Morocco,Ecuador,5,0,0,5
6571,2018,Nepal,Ecuador,5,0,0,5
6572,2018,Nicaragua,Ecuador,0,11,0,11
6573,2018,Nigeria,Ecuador,26,19,0,45
6574,2018,Pakistan,Ecuador,28,8,0,36
6575,2018,Peru,Ecuador,82,91,0,173
6576,2018,Philippines,Ecuador,0,6,0,6
6577,2018,Russian Federation,Ecuador,31,5,0,36
6578,2018,El Salvador,Ecuador,15,18,0,33
6579,2018,Saudi Arabia,Ecuador,5,8,0,13
6580,2018,Somalia,Ecuador,8,0,0,8
6581,2018,Spain,Ecuador,5,0,0,5
6582,2018,Viet Nam,Ecuador,5,0,0,5
6583,2018,Sudan,Ecuador,5,5,0,10
6584,2018,Syrian Arab Rep.,Ecuador,102,90,0,192
6585,2018,Turkmenistan,Ecuador,0,8,0,8
6586,2018,Türkiye,Ecuador,0,6,0,6
6587,2018,Ukraine,Ecuador,14,0,0,14
6588,2018,United States of America,Ecuador,7,0,0,7
6589,2018,Uzbekistan,Ecuador,5,0,0,5
6590,2018,Venezuela (Bolivarian Republic of),Ecuador,15,6292,0,6307
6591,2018,Western Sahara,Ecuador,5,0,0,5
6592,2018,Yemen,Ecuador,50,101,0,151
6593,2018,Zimbabwe,Ecuador,5,0,0,5
6595,2018,Eritrea,Eritrea,0,0,0,0
6596,2018,Ethiopia,Eritrea,26,0,0,26
6597,2018,Somalia,Eritrea,2148,0,0,2148
6598,2018,Sudan,Eritrea,70,0,0,70
6599,2018,South Sudan,Eritrea,8,0,0,8
6600,2018,Afghanistan,Estonia,8,0,0,8
6601,2018,Egypt,Estonia,0,5,0,5
6602,2018,Azerbaijan,Estonia,5,0,0,5
6603,2018,Eritrea,Estonia,5,0,0,5
6604,2018,Georgia,Estonia,5,0,0,5
6605,2018,Iran (Islamic Rep. of),Estonia,0,5,0,5
6606,2018,Iraq,Estonia,25,0,0,25
6607,2018,Sri Lanka,Estonia,6,0,0,6
6608,2018,Pakistan,Estonia,5,5,0,10
6609,2018,Russian Federation,Estonia,22,6,0,28
6610,2018,Serbia and Kosovo: S/RES/1244 (1999),Estonia,5,0,0,5
6611,2018,Sudan,Estonia,18,0,0,18
6612,2018,Syrian Arab Rep.,Estonia,146,0,0,146
6613,2018,Ukraine,Estonia,64,9,0,73
6614,2018,Yemen,Estonia,5,0,0,5
6616,2018,Egypt,Ethiopia,5,0,0,5
6617,2018,Burundi,Ethiopia,62,68,0,130
6618,2018,Dem. Rep. of the Congo,Ethiopia,552,297,0,849
6619,2018,Cuba,Ethiopia,5,0,0,5
6620,2018,Djibouti,Ethiopia,79,8,0,87
6621,2018,Eritrea,Ethiopia,173965,139,0,174104
6622,2018,Ethiopia,Ethiopia,0,0,2615800,0
6623,2018,Cote d'Ivoire,Ethiopia,5,0,0,5
6624,2018,Iraq,Ethiopia,10,0,0,10
6625,2018,Kenya,Ethiopia,3471,429,0,3900
6626,2018,Rwanda,Ethiopia,11,6,0,17
6627,2018,Somalia,Ethiopia,257199,84,0,257283
6628,2018,Sudan,Ethiopia,44003,437,0,44440
6629,2018,South Sudan,Ethiopia,422135,400,0,422535
6630,2018,Syrian Arab Rep.,Ethiopia,9,70,0,79
6631,2018,Uganda,Ethiopia,17,5,0,22
6632,2018,Yemen,Ethiopia,1698,193,0,1891
6633,2018,Afghanistan,Fiji,0,7,0,7
6634,2018,Bangladesh,Fiji,0,5,0,5
6635,2018,Pakistan,Fiji,0,5,0,5
6636,2018,Afghanistan,Finland,2944,187,0,3131
6637,2018,Albania,Finland,5,7,0,12
6638,2018,Algeria,Finland,15,10,0,25
6639,2018,Angola,Finland,111,16,0,127
6640,2018,Egypt,Finland,14,15,0,29
6641,2018,Armenia,Finland,0,5,0,5
6642,2018,Azerbaijan,Finland,43,12,0,55
6643,2018,Burundi,Finland,5,5,0,10
6644,2018,Bangladesh,Finland,22,16,0,38
6645,2018,Burkina Faso,Finland,5,0,0,5
6646,2018,Belarus,Finland,13,15,0,28
6647,2018,Brazil,Finland,5,5,0,10
6648,2018,Bulgaria,Finland,0,5,0,5
6649,2018,Cambodia,Finland,5,0,0,5
6650,2018,Central African Rep.,Finland,5,0,0,5
6651,2018,China,Finland,125,11,0,136
6652,2018,Cameroon,Finland,91,56,0,147
6653,2018,Congo,Finland,10,0,0,10
6654,2018,Dem. Rep. of the Congo,Finland,135,19,0,154
6655,2018,Cuba,Finland,5,8,0,13
6656,2018,Dominican Rep.,Finland,5,0,0,5
6657,2018,Ecuador,Finland,5,0,0,5
6658,2018,Eritrea,Finland,840,12,0,852
6659,2018,Ethiopia,Finland,149,25,0,174
6660,2018,Gambia,Finland,30,12,0,42
6661,2018,Georgia,Finland,5,19,0,24
6662,2018,Ghana,Finland,53,7,0,60
6663,2018,Guatemala,Finland,5,0,0,5
6664,2018,Guinea,Finland,20,5,0,25
6665,2018,Honduras,Finland,13,0,0,13
6666,2018,Cote d'Ivoire,Finland,11,0,0,11
6667,2018,India,Finland,5,5,0,10
6668,2018,Iran (Islamic Rep. of),Finland,871,228,0,1099
6669,2018,Iraq,Finland,8523,1044,0,9567
6670,2018,Jordan,Finland,0,10,0,10
6671,2018,Kazakhstan,Finland,13,5,0,18
6672,2018,Kenya,Finland,13,5,0,18
6673,2018,Kyrgyzstan,Finland,19,0,0,19
6674,2018,Liberia,Finland,5,0,0,5
6675,2018,Libya,Finland,26,5,0,31
6676,2018,Lebanon,Finland,12,5,0,17
6677,2018,Sri Lanka,Finland,67,12,0,79
6678,2018,Mauritania,Finland,5,0,0,5
6679,2018,Rep. of Moldova,Finland,6,0,0,6
6680,2018,Mexico,Finland,0,5,0,5
6681,2018,Mali,Finland,6,0,0,6
6682,2018,Morocco,Finland,37,12,0,49
6683,2018,Myanmar,Finland,30,5,0,35
6684,2018,Nicaragua,Finland,0,26,0,26
6685,2018,Nigeria,Finland,160,78,0,238
6686,2018,Pakistan,Finland,70,21,0,91
6687,2018,Russian Federation,Finland,730,597,0,1327
6688,2018,Rwanda,Finland,26,11,0,37
6689,2018,El Salvador,Finland,10,0,0,10
6690,2018,Serbia and Kosovo: S/RES/1244 (1999),Finland,72,8,0,80
6691,2018,Senegal,Finland,5,5,0,10
6692,2018,Sierra Leone,Finland,6,5,0,11
6693,2018,Somalia,Finland,3319,172,0,3491
6694,2018,Viet Nam,Finland,5,0,0,5
6695,2018,Sudan,Finland,39,0,0,39
6696,2018,South Sudan,Finland,8,0,0,8
6697,2018,Syrian Arab Rep.,Finland,2497,73,0,2570
6698,2018,United Rep. of Tanzania,Finland,5,8,0,13
6699,2018,Tajikistan,Finland,0,5,0,5
6700,2018,Togo,Finland,5,0,0,5
6701,2018,Tunisia,Finland,5,0,0,5
6702,2018,Türkiye,Finland,183,268,0,451
6703,2018,Uganda,Finland,31,8,0,39
6704,2018,Ukraine,Finland,8,38,0,46
6705,2018,Uzbekistan,Finland,6,0,0,6
6706,2018,Venezuela (Bolivarian Republic of),Finland,5,8,0,13
6707,2018,Yemen,Finland,182,46,0,228
6708,2018,Zimbabwe,Finland,5,0,0,5
6711,2018,Afghanistan,France,18534,8085,0,26619
6712,2018,Albania,France,5119,5019,0,10138
6713,2018,Algeria,France,1790,1395,0,3185
6714,2018,Angola,France,3541,942,0,4483
6715,2018,Egypt,France,980,413,0,1393
6716,2018,Argentina,France,5,5,0,10
6717,2018,Armenia,France,4197,1778,0,5975
6718,2018,Azerbaijan,France,2886,384,0,3270
6719,2018,Bahrain,France,10,0,0,10
6720,2018,Burundi,France,834,211,0,1045
6721,2018,Benin,France,49,46,0,95
6722,2018,Bangladesh,France,5631,3958,0,9589
6723,2018,Bhutan,France,123,5,0,128
6724,2018,Burkina Faso,France,236,231,0,467
6725,2018,Belarus,France,509,33,0,542
6726,2018,Bolivia (Plurinational State of),France,38,0,0,38
6727,2018,Brazil,France,15,0,0,15
6728,2018,Bosnia and Herzegovina,France,4099,448,0,4547
6729,2018,Bulgaria,France,70,0,0,70
6730,2018,Cambodia,France,11193,32,0,11225
6731,2018,Central African Rep.,France,2962,831,0,3793
6732,2018,Chad,France,1604,816,0,2420
6733,2018,China,France,5810,964,0,6774
6734,2018,Chile,France,69,0,0,69
6735,2018,Cameroon,France,1246,928,0,2174
6736,2018,Congo,France,3519,1058,0,4577
6737,2018,Dem. Rep. of the Congo,France,16484,3267,0,19751
6738,2018,Comoros,France,583,401,0,984
6739,2018,Colombia,France,527,211,0,738
6740,2018,Costa Rica,France,5,0,0,5
6741,2018,Cuba,France,179,28,0,207
6742,2018,Czechia,France,27,0,0,27
6743,2018,Djibouti,France,308,56,0,364
6744,2018,Dominican Rep.,France,56,0,0,56
6745,2018,Ecuador,France,25,0,0,25
6746,2018,Equatorial Guinea,France,32,17,0,49
6747,2018,Eritrea,France,5040,1092,0,6132
6748,2018,Estonia,France,7,0,0,7
6749,2018,Ethiopia,France,1423,774,0,2197
6750,2018,Gabon,France,179,365,0,544
6751,2018,Gambia,France,286,106,0,392
6752,2018,Palestinian,France,940,271,0,1211
6753,2018,Georgia,France,3233,4342,0,7575
6754,2018,Germany,France,5,0,0,5
6755,2018,Ghana,France,513,0,0,513
6756,2018,Guinea-Bissau,France,900,87,0,987
6757,2018,Guatemala,France,14,0,0,14
6758,2018,Guinea,France,9264,6076,0,15340
6759,2018,Guyana,France,17,0,0,17
6760,2018,Haiti,France,3567,1256,0,4823
6761,2018,Honduras,France,10,0,0,10
6762,2018,Croatia,France,59,0,0,59
6763,2018,Hungary,France,56,0,0,56
6764,2018,Cote d'Ivoire,France,4199,4794,0,8993
6765,2018,India,France,223,202,0,425
6766,2018,Indonesia,France,7,0,0,7
6767,2018,Iran (Islamic Rep. of),France,2757,647,0,3404
6768,2018,Iraq,France,8131,1521,0,9652
6769,2018,Israel,France,7,0,0,7
6770,2018,Jamaica,France,16,0,0,16
6771,2018,Jordan,France,31,5,0,36
6772,2018,Kazakhstan,France,584,181,0,765
6773,2018,Kenya,France,123,24,0,147
6774,2018,Kyrgyzstan,France,309,12,0,321
6775,2018,Rep. of Korea,France,0,7,0,7
6776,2018,Dem. People's Rep. of Korea,France,0,6,0,6
6777,2018,Kuwait,France,121,173,0,294
6778,2018,Lao People's Dem. Rep.,France,6617,5,0,6622
6779,2018,Liberia,France,239,35,0,274
6780,2018,Libya,France,721,792,0,1513
6781,2018,Lebanon,France,140,124,0,264
6782,2018,Sri Lanka,France,23918,1837,0,25755
6783,2018,Lithuania,France,9,0,0,9
6784,2018,Latvia,France,33,0,0,33
6785,2018,Madagascar,France,218,51,0,269
6786,2018,Mauritania,France,5419,959,0,6378
6787,2018,North Macedonia,France,351,666,0,1017
6788,2018,Rep. of Moldova,France,319,187,0,506
6789,2018,Maldives,France,5,0,0,5
6790,2018,Mexico,France,24,0,0,24
6791,2018,Mali,France,4773,2162,0,6935
6792,2018,Malaysia,France,11,0,0,11
6793,2018,Mongolia,France,445,193,0,638
6794,2018,Morocco,France,632,449,0,1081
6795,2018,Mozambique,France,11,5,0,16
6796,2018,Montenegro,France,89,32,0,121
6797,2018,Mauritius,France,26,5,0,31
6798,2018,Myanmar,France,321,28,0,349
6799,2018,Nepal,France,141,70,0,211
6800,2018,Niger,France,89,45,0,134
6801,2018,Nicaragua,France,8,5,0,13
6802,2018,Nigeria,France,2525,2880,0,5405
6803,2018,Pakistan,France,1639,1891,0,3530
6804,2018,Paraguay,France,6,0,0,6
6805,2018,Peru,France,315,33,0,348
6806,2018,Philippines,France,5,0,0,5
6807,2018,Poland,France,139,0,0,139
6808,2018,Romania,France,146,0,0,146
6809,2018,South Africa,France,42,0,0,42
6810,2018,Russian Federation,France,15898,2492,0,18390
6811,2018,Rwanda,France,2890,368,0,3258
6812,2018,El Salvador,France,55,14,0,69
6813,2018,Saudi Arabia,France,12,0,0,12
6814,2018,Serbia and Kosovo: S/RES/1244 (1999),France,13778,2454,0,16232
6815,2018,Senegal,France,1351,1196,0,2547
6816,2018,Sierra Leone,France,580,271,0,851
6817,2018,Somalia,France,3640,2483,0,6123
6818,2018,Viet Nam,France,7821,26,0,7847
6819,2018,Sao Tome and Principe,France,5,0,0,5
6820,2018,Sudan,France,14700,3949,0,18649
6821,2018,Suriname,France,5,0,0,5
6822,2018,South Sudan,France,40,0,0,40
6823,2018,Slovakia,France,113,0,0,113
6824,2018,Syrian Arab Rep.,France,15822,3352,0,19174
6825,2018,United Rep. of Tanzania,France,9,5,0,14
6826,2018,Thailand,France,6,0,0,6
6827,2018,Tajikistan,France,48,0,0,48
6828,2018,Turkmenistan,France,23,0,0,23
6829,2018,Togo,France,743,248,0,991
6830,2018,Tunisia,France,326,225,0,551
6831,2018,Türkiye,France,11196,1628,0,12824
6832,2018,Uganda,France,133,16,0,149
6833,2018,Ukraine,France,1715,703,0,2418
6834,2018,Uzbekistan,France,212,9,0,221
6835,2018,Venezuela (Bolivarian Republic of),France,304,403,0,707
6836,2018,Western Sahara,France,573,1097,0,1670
6837,2018,Yemen,France,338,196,0,534
6838,2018,Zambia,France,5,0,0,5
6839,2018,Zimbabwe,France,46,6,0,52
6842,2018,Burundi,Gabon,5,0,0,5
6843,2018,Central African Rep.,Gabon,38,9,0,47
6844,2018,Chad,Gabon,421,12,0,433
6845,2018,Cameroon,Gabon,5,0,0,5
6846,2018,Congo,Gabon,85,0,0,85
6847,2018,Dem. Rep. of the Congo,Gabon,74,56,0,130
6848,2018,Equatorial Guinea,Gabon,5,5,0,10
6849,2018,Mauritania,Gabon,7,0,0,7
6850,2018,Sao Tome and Principe,Gabon,26,0,0,26
6851,2018,Sudan,Gabon,5,0,0,5
6852,2018,Togo,Gabon,15,0,0,15
6853,2018,Central African Rep.,Gambia,0,15,0,15
6854,2018,Congo,Gambia,0,5,0,5
6855,2018,Dem. Rep. of the Congo,Gambia,48,6,0,54
6856,2018,Guinea-Bissau,Gambia,0,6,0,6
6857,2018,Guinea,Gambia,5,5,0,10
6858,2018,Cote d'Ivoire,Gambia,138,5,0,143
6859,2018,Liberia,Gambia,14,0,0,14
6860,2018,Senegal,Gambia,3709,296,0,4005
6861,2018,Sierra Leone,Gambia,106,11,0,117
6862,2018,Togo,Gambia,7,0,0,7
6863,2018,Afghanistan,United Kingdom of Great Britain and Northern Ireland,9839,2438,0,12277
6864,2018,Albania,United Kingdom of Great Britain and Northern Ireland,2617,4150,0,6767
6865,2018,Algeria,United Kingdom of Great Britain and Northern Ireland,337,257,0,594
6866,2018,Angola,United Kingdom of Great Britain and Northern Ireland,178,66,0,244
6867,2018,Antigua and Barbuda,United Kingdom of Great Britain and Northern Ireland,5,0,0,5
6868,2018,Egypt,United Kingdom of Great Britain and Northern Ireland,758,327,0,1085
6869,2018,Armenia,United Kingdom of Great Britain and Northern Ireland,59,10,0,69
6870,2018,Australia,United Kingdom of Great Britain and Northern Ireland,5,7,0,12
6871,2018,Azerbaijan,United Kingdom of Great Britain and Northern Ireland,134,56,0,190
6872,2018,Bahrain,United Kingdom of Great Britain and Northern Ireland,168,11,0,179
6873,2018,Barbados,United Kingdom of Great Britain and Northern Ireland,11,0,0,11
6874,2018,Burundi,United Kingdom of Great Britain and Northern Ireland,50,11,0,61
6875,2018,Benin,United Kingdom of Great Britain and Northern Ireland,7,15,0,22
6876,2018,Bangladesh,United Kingdom of Great Britain and Northern Ireland,1363,1483,0,2846
6877,2018,Bahamas,United Kingdom of Great Britain and Northern Ireland,5,5,0,10
6878,2018,Bhutan,United Kingdom of Great Britain and Northern Ireland,71,0,0,71
6879,2018,Burkina Faso,United Kingdom of Great Britain and Northern Ireland,7,5,0,12
6880,2018,Belarus,United Kingdom of Great Britain and Northern Ireland,131,17,0,148
6881,2018,Bolivia (Plurinational State of),United Kingdom of Great Britain and Northern Ireland,14,20,0,34
6882,2018,Botswana,United Kingdom of Great Britain and Northern Ireland,22,38,0,60
6883,2018,Brazil,United Kingdom of Great Britain and Northern Ireland,16,62,0,78
6884,2018,Bosnia and Herzegovina,United Kingdom of Great Britain and Northern Ireland,21,5,0,26
6885,2018,Belize,United Kingdom of Great Britain and Northern Ireland,5,0,0,5
6886,2018,Canada,United Kingdom of Great Britain and Northern Ireland,10,0,0,10
6887,2018,Central African Rep.,United Kingdom of Great Britain and Northern Ireland,10,0,0,10
6888,2018,Chad,United Kingdom of Great Britain and Northern Ireland,41,23,0,64
6889,2018,China,United Kingdom of Great Britain and Northern Ireland,1465,952,0,2417
6890,2018,Chile,United Kingdom of Great Britain and Northern Ireland,0,6,0,6
6891,2018,Cameroon,United Kingdom of Great Britain and Northern Ireland,633,189,0,822
6892,2018,Congo,United Kingdom of Great Britain and Northern Ireland,122,23,0,145
6893,2018,Dem. Rep. of the Congo,United Kingdom of Great Britain and Northern Ireland,1091,198,0,1289
6894,2018,Comoros,United Kingdom of Great Britain and Northern Ireland,5,5,0,10
6895,2018,Colombia,United Kingdom of Great Britain and Northern Ireland,31,21,0,52
6896,2018,Costa Rica,United Kingdom of Great Britain and Northern Ireland,0,5,0,5
6897,2018,Cuba,United Kingdom of Great Britain and Northern Ireland,12,0,0,12
6898,2018,Cabo Verde,United Kingdom of Great Britain and Northern Ireland,5,0,0,5
6899,2018,Cyprus,United Kingdom of Great Britain and Northern Ireland,0,5,0,5
6900,2018,Djibouti,United Kingdom of Great Britain and Northern Ireland,5,5,0,10
6901,2018,Dominica,United Kingdom of Great Britain and Northern Ireland,17,7,0,24
6902,2018,Ecuador,United Kingdom of Great Britain and Northern Ireland,9,9,0,18
6903,2018,Eritrea,United Kingdom of Great Britain and Northern Ireland,13041,1833,0,14874
6904,2018,Ethiopia,United Kingdom of Great Britain and Northern Ireland,1601,500,0,2101
6905,2018,Fiji,United Kingdom of Great Britain and Northern Ireland,8,0,0,8
6906,2018,Gabon,United Kingdom of Great Britain and Northern Ireland,5,0,0,5
6907,2018,Gambia,United Kingdom of Great Britain and Northern Ireland,1308,113,0,1421
6908,2018,Palestinian,United Kingdom of Great Britain and Northern Ireland,536,259,0,795
6909,2018,Georgia,United Kingdom of Great Britain and Northern Ireland,68,80,0,148
6910,2018,Germany,United Kingdom of Great Britain and Northern Ireland,0,5,0,5
6911,2018,Ghana,United Kingdom of Great Britain and Northern Ireland,315,260,0,575
6912,2018,Guinea-Bissau,United Kingdom of Great Britain and Northern Ireland,7,5,0,12
6913,2018,Greece,United Kingdom of Great Britain and Northern Ireland,5,0,0,5
6914,2018,Grenada,United Kingdom of Great Britain and Northern Ireland,20,16,0,36
6915,2018,Guatemala,United Kingdom of Great Britain and Northern Ireland,7,5,0,12
6916,2018,Guinea,United Kingdom of Great Britain and Northern Ireland,258,49,0,307
6917,2018,Guyana,United Kingdom of Great Britain and Northern Ireland,20,0,0,20
6918,2018,Haiti,United Kingdom of Great Britain and Northern Ireland,0,9,0,9
6919,2018,"China, Hong Kong SAR",United Kingdom of Great Britain and Northern Ireland,0,11,0,11
6920,2018,Honduras,United Kingdom of Great Britain and Northern Ireland,38,60,0,98
6921,2018,Cote d'Ivoire,United Kingdom of Great Britain and Northern Ireland,223,73,0,296
6922,2018,India,United Kingdom of Great Britain and Northern Ireland,396,1667,0,2063
6923,2018,Indonesia,United Kingdom of Great Britain and Northern Ireland,23,27,0,50
6924,2018,Iran (Islamic Rep. of),United Kingdom of Great Britain and Northern Ireland,17231,3276,0,20507
6925,2018,Iraq,United Kingdom of Great Britain and Northern Ireland,4708,3420,0,8128
6926,2018,Israel,United Kingdom of Great Britain and Northern Ireland,6,5,0,11
6927,2018,Jamaica,United Kingdom of Great Britain and Northern Ireland,376,138,0,514
6928,2018,Jordan,United Kingdom of Great Britain and Northern Ireland,70,56,0,126
6929,2018,Japan,United Kingdom of Great Britain and Northern Ireland,0,5,0,5
6930,2018,Kazakhstan,United Kingdom of Great Britain and Northern Ireland,19,35,0,54
6931,2018,Kenya,United Kingdom of Great Britain and Northern Ireland,289,195,0,484
6932,2018,Kyrgyzstan,United Kingdom of Great Britain and Northern Ireland,34,15,0,49
6933,2018,Rep. of Korea,United Kingdom of Great Britain and Northern Ireland,6,0,0,6
6934,2018,Dem. People's Rep. of Korea,United Kingdom of Great Britain and Northern Ireland,81,29,0,110
6935,2018,Kuwait,United Kingdom of Great Britain and Northern Ireland,583,424,0,1007
6936,2018,Lao People's Dem. Rep.,United Kingdom of Great Britain and Northern Ireland,5,0,0,5
6937,2018,Liberia,United Kingdom of Great Britain and Northern Ireland,31,11,0,42
6938,2018,Libya,United Kingdom of Great Britain and Northern Ireland,3003,815,0,3818
6939,2018,Saint Lucia,United Kingdom of Great Britain and Northern Ireland,22,19,0,41
6940,2018,Lebanon,United Kingdom of Great Britain and Northern Ireland,171,50,0,221
6941,2018,Lesotho,United Kingdom of Great Britain and Northern Ireland,0,5,0,5
6942,2018,Sri Lanka,United Kingdom of Great Britain and Northern Ireland,5711,1019,0,6730
6943,2018,Lithuania,United Kingdom of Great Britain and Northern Ireland,0,5,0,5
6944,2018,Mauritania,United Kingdom of Great Britain and Northern Ireland,6,5,0,11
6945,2018,North Macedonia,United Kingdom of Great Britain and Northern Ireland,20,0,0,20
6946,2018,Rep. of Moldova,United Kingdom of Great Britain and Northern Ireland,16,5,0,21
6947,2018,Maldives,United Kingdom of Great Britain and Northern Ireland,37,10,0,47
6948,2018,Mexico,United Kingdom of Great Britain and Northern Ireland,12,17,0,29
6949,2018,Mali,United Kingdom of Great Britain and Northern Ireland,19,11,0,30
6950,2018,Malaysia,United Kingdom of Great Britain and Northern Ireland,210,190,0,400
6951,2018,Malawi,United Kingdom of Great Britain and Northern Ireland,329,90,0,419
6952,2018,Mongolia,United Kingdom of Great Britain and Northern Ireland,76,37,0,113
6953,2018,Morocco,United Kingdom of Great Britain and Northern Ireland,198,114,0,312
6954,2018,Mozambique,United Kingdom of Great Britain and Northern Ireland,5,5,0,10
6955,2018,Mauritius,United Kingdom of Great Britain and Northern Ireland,48,81,0,129
6956,2018,Myanmar,United Kingdom of Great Britain and Northern Ireland,721,61,0,782
6957,2018,Namibia,United Kingdom of Great Britain and Northern Ireland,55,248,0,303
6958,2018,Nepal,United Kingdom of Great Britain and Northern Ireland,38,172,0,210
6959,2018,Niger,United Kingdom of Great Britain and Northern Ireland,6,5,0,11
6960,2018,Nicaragua,United Kingdom of Great Britain and Northern Ireland,0,35,0,35
6961,2018,Nigeria,United Kingdom of Great Britain and Northern Ireland,2535,1755,0,4290
6962,2018,Norway,United Kingdom of Great Britain and Northern Ireland,5,0,0,5
6963,2018,Oman,United Kingdom of Great Britain and Northern Ireland,16,11,0,27
6964,2018,Pakistan,United Kingdom of Great Britain and Northern Ireland,7742,2618,0,10360
6965,2018,Philippines,United Kingdom of Great Britain and Northern Ireland,30,105,0,135
6966,2018,Qatar,United Kingdom of Great Britain and Northern Ireland,5,0,0,5
6967,2018,Romania,United Kingdom of Great Britain and Northern Ireland,5,5,0,10
6968,2018,South Africa,United Kingdom of Great Britain and Northern Ireland,167,118,0,285
6969,2018,Russian Federation,United Kingdom of Great Britain and Northern Ireland,571,219,0,790
6970,2018,Rwanda,United Kingdom of Great Britain and Northern Ireland,116,26,0,142
6971,2018,El Salvador,United Kingdom of Great Britain and Northern Ireland,102,161,0,263
6972,2018,Saudi Arabia,United Kingdom of Great Britain and Northern Ireland,165,74,0,239
6973,2018,Serbia and Kosovo: S/RES/1244 (1999),United Kingdom of Great Britain and Northern Ireland,90,46,0,136
6974,2018,Senegal,United Kingdom of Great Britain and Northern Ireland,105,21,0,126
6975,2018,Seychelles,United Kingdom of Great Britain and Northern Ireland,5,0,0,5
6976,2018,Singapore,United Kingdom of Great Britain and Northern Ireland,5,5,0,10
6977,2018,Sierra Leone,United Kingdom of Great Britain and Northern Ireland,310,98,0,408
6978,2018,Somalia,United Kingdom of Great Britain and Northern Ireland,3920,396,0,4316
6979,2018,Viet Nam,United Kingdom of Great Britain and Northern Ireland,1416,1597,0,3013
6980,2018,Saint Kitts and Nevis,United Kingdom of Great Britain and Northern Ireland,8,11,0,19
6981,2018,Sudan,United Kingdom of Great Britain and Northern Ireland,8959,1705,0,10664
6982,2018,South Sudan,United Kingdom of Great Britain and Northern Ireland,44,22,0,66
6983,2018,Eswatini,United Kingdom of Great Britain and Northern Ireland,57,0,0,57
6984,2018,Syrian Arab Rep.,United Kingdom of Great Britain and Northern Ireland,9720,685,0,10405
6985,2018,United Rep. of Tanzania,United Kingdom of Great Britain and Northern Ireland,92,58,0,150
6986,2018,Thailand,United Kingdom of Great Britain and Northern Ireland,38,43,0,81
6987,2018,Tajikistan,United Kingdom of Great Britain and Northern Ireland,10,7,0,17
6988,2018,Turkmenistan,United Kingdom of Great Britain and Northern Ireland,15,17,0,32
6989,2018,Timor-Leste,United Kingdom of Great Britain and Northern Ireland,0,5,0,5
6990,2018,Togo,United Kingdom of Great Britain and Northern Ireland,18,9,0,27
6991,2018,Trinidad and Tobago,United Kingdom of Great Britain and Northern Ireland,81,33,0,114
6992,2018,Tunisia,United Kingdom of Great Britain and Northern Ireland,53,43,0,96
6993,2018,Türkiye,United Kingdom of Great Britain and Northern Ireland,1267,742,0,2009
6994,2018,United Arab Emirates,United Kingdom of Great Britain and Northern Ireland,20,8,0,28
6995,2018,Uganda,United Kingdom of Great Britain and Northern Ireland,1216,183,0,1399
6996,2018,Ukraine,United Kingdom of Great Britain and Northern Ireland,144,178,0,322
6997,2018,United States of America,United Kingdom of Great Britain and Northern Ireland,52,52,0,104
6998,2018,Uzbekistan,United Kingdom of Great Britain and Northern Ireland,71,22,0,93
6999,2018,Saint Vincent and the Grenadines,United Kingdom of Great Britain and Northern Ireland,26,10,0,36
7000,2018,Venezuela (Bolivarian Republic of),United Kingdom of Great Britain and Northern Ireland,41,21,0,62
7001,2018,Western Sahara,United Kingdom of Great Britain and Northern Ireland,11,5,0,16
7002,2018,Yemen,United Kingdom of Great Britain and Northern Ireland,624,168,0,792
7003,2018,Zambia,United Kingdom of Great Britain and Northern Ireland,82,28,0,110
7004,2018,Zimbabwe,United Kingdom of Great Britain and Northern Ireland,6772,273,0,7045
7007,2018,Afghanistan,Georgia,5,37,0,42
7008,2018,Egypt,Georgia,43,49,0,92
7009,2018,Armenia,Georgia,0,5,0,5
7010,2018,Azerbaijan,Georgia,6,14,0,20
7011,2018,Bangladesh,Georgia,0,19,0,19
7012,2018,Cameroon,Georgia,0,5,0,5
7013,2018,Congo,Georgia,0,8,0,8
7014,2018,Ethiopia,Georgia,0,5,0,5
7015,2018,Georgia,Georgia,0,0,282382,0
7016,2018,Ghana,Georgia,0,5,0,5
7017,2018,India,Georgia,0,23,0,23
7018,2018,Iran (Islamic Rep. of),Georgia,34,183,0,217
7019,2018,Iraq,Georgia,560,46,0,606
7020,2018,Lebanon,Georgia,6,5,0,11
7021,2018,Nigeria,Georgia,0,18,0,18
7022,2018,Pakistan,Georgia,11,14,0,25
7023,2018,South Africa,Georgia,0,6,0,6
7024,2018,Russian Federation,Georgia,235,21,0,256
7025,2018,Sierra Leone,Georgia,0,5,0,5
7026,2018,Somalia,Georgia,0,27,0,27
7027,2018,Sudan,Georgia,6,6,0,12
7028,2018,Syrian Arab Rep.,Georgia,428,24,0,452
7029,2018,Tajikistan,Georgia,5,0,0,5
7030,2018,Türkiye,Georgia,5,85,0,90
7031,2018,Ukraine,Georgia,617,10,0,627
7032,2018,Yemen,Georgia,20,35,0,55
7035,2018,Afghanistan,Germany,126018,65838,0,191856
7036,2018,Albania,Germany,1170,3146,0,4316
7037,2018,Algeria,Germany,589,1295,0,1884
7038,2018,Angola,Germany,846,370,0,1216
7039,2018,Egypt,Germany,2122,2589,0,4711
7040,2018,Argentina,Germany,14,11,0,25
7041,2018,Armenia,Germany,2474,7262,0,9736
7042,2018,Australia,Germany,5,0,0,5
7043,2018,Austria,Germany,5,0,0,5
7044,2018,Azerbaijan,Germany,3643,6195,0,9838
7045,2018,Bahrain,Germany,79,14,0,93
7046,2018,Burundi,Germany,106,55,0,161
7047,2018,Belgium,Germany,5,0,0,5
7048,2018,Benin,Germany,82,238,0,320
7049,2018,Bangladesh,Germany,706,1341,0,2047
7050,2018,Bhutan,Germany,22,5,0,27
7051,2018,Burkina Faso,Germany,82,192,0,274
7052,2018,Belarus,Germany,186,283,0,469
7053,2018,Bolivia (Plurinational State of),Germany,6,0,0,6
7054,2018,Botswana,Germany,5,5,0,10
7055,2018,Brazil,Germany,32,29,0,61
7056,2018,Bosnia and Herzegovina,Germany,1473,665,0,2138
7057,2018,Bulgaria,Germany,78,15,0,93
7058,2018,Cambodia,Germany,30,47,0,77
7059,2018,Canada,Germany,24,5,0,29
7060,2018,Central African Rep.,Germany,37,54,0,91
7061,2018,Chad,Germany,91,292,0,383
7062,2018,China,Germany,1620,972,0,2592
7063,2018,Chile,Germany,170,0,0,170
7064,2018,Cameroon,Germany,698,2990,0,3688
7065,2018,Congo,Germany,276,104,0,380
7066,2018,Dem. Rep. of the Congo,Germany,1650,655,0,2305
7067,2018,Comoros,Germany,0,16,0,16
7068,2018,Colombia,Germany,66,196,0,262
7069,2018,Cuba,Germany,93,68,0,161
7070,2018,Czechia,Germany,752,0,0,752
7071,2018,Djibouti,Germany,33,20,0,53
7072,2018,Dominican Rep.,Germany,8,6,0,14
7073,2018,Ecuador,Germany,13,5,0,18
7074,2018,Equatorial Guinea,Germany,23,8,0,31
7075,2018,Eritrea,Germany,55334,5914,0,61248
7076,2018,Estonia,Germany,5,0,0,5
7077,2018,Ethiopia,Germany,4780,6730,0,11510
7078,2018,France,Germany,15,0,0,15
7079,2018,Gabon,Germany,10,38,0,48
7080,2018,Gambia,Germany,899,7391,0,8290
7081,2018,United Kingdom of Great Britain and Northern Ireland,Germany,15,0,0,15
7082,2018,Georgia,Germany,633,4717,0,5350
7083,2018,Ghana,Germany,549,1742,0,2291
7084,2018,Guinea-Bissau,Germany,92,293,0,385
7085,2018,Greece,Germany,49,0,0,49
7086,2018,Guatemala,Germany,5,10,0,15
7087,2018,Guinea,Germany,2393,6167,0,8560
7088,2018,Haiti,Germany,17,9,0,26
7089,2018,Honduras,Germany,64,16,0,80
7090,2018,Croatia,Germany,299,5,0,304
7091,2018,Hungary,Germany,250,0,0,250
7092,2018,Iceland,Germany,5,0,0,5
7093,2018,Cote d'Ivoire,Germany,520,2046,0,2566
7094,2018,India,Germany,370,1313,0,1683
7095,2018,Indonesia,Germany,13,18,0,31
7096,2018,Iran (Islamic Rep. of),Germany,41150,21407,0,62557
7097,2018,Iraq,Germany,136463,41954,0,178417
7098,2018,Israel,Germany,41,36,0,77
7099,2018,Italy,Germany,27,25,0,52
7100,2018,Jamaica,Germany,55,38,0,93
7101,2018,Jordan,Germany,382,387,0,769
7102,2018,Japan,Germany,24,0,0,24
7103,2018,Kazakhstan,Germany,99,191,0,290
7104,2018,Kenya,Germany,183,645,0,828
7105,2018,Kyrgyzstan,Germany,167,310,0,477
7106,2018,Rep. of Korea,Germany,86,9,0,95
7107,2018,Dem. People's Rep. of Korea,Germany,34,57,0,91
7108,2018,Kuwait,Germany,27,51,0,78
7109,2018,Lao People's Dem. Rep.,Germany,41,0,0,41
7110,2018,Liberia,Germany,100,363,0,463
7111,2018,Libya,Germany,1732,1345,0,3077
7112,2018,Lebanon,Germany,1557,2820,0,4377
7113,2018,Sri Lanka,Germany,3820,1494,0,5314
7114,2018,Lithuania,Germany,5,0,0,5
7115,2018,Latvia,Germany,8,5,0,13
7116,2018,Madagascar,Germany,5,18,0,23
7117,2018,Mauritania,Germany,34,87,0,121
7118,2018,North Macedonia,Germany,669,1982,0,2651
7119,2018,Rep. of Moldova,Germany,106,979,0,1085
7120,2018,Mexico,Germany,22,154,0,176
7121,2018,Mali,Germany,272,933,0,1205
7122,2018,Malaysia,Germany,14,17,0,31
7123,2018,Malawi,Germany,5,13,0,18
7124,2018,Mongolia,Germany,130,717,0,847
7125,2018,Morocco,Germany,712,1310,0,2022
7126,2018,Mozambique,Germany,14,23,0,37
7127,2018,Montenegro,Germany,288,272,0,560
7128,2018,Mauritius,Germany,5,5,0,10
7129,2018,Myanmar,Germany,854,150,0,1004
7130,2018,Namibia,Germany,0,16,0,16
7131,2018,Nepal,Germany,56,129,0,185
7132,2018,Netherlands,Germany,25,0,0,25
7133,2018,Niger,Germany,55,169,0,224
7134,2018,Nicaragua,Germany,5,27,0,32
7135,2018,Nigeria,Germany,6435,21477,0,27912
7136,2018,New Zealand,Germany,8,0,0,8
7137,2018,Oman,Germany,9,6,0,15
7138,2018,Pakistan,Germany,7454,13645,0,21099
7139,2018,Peru,Germany,39,0,0,39
7140,2018,Philippines,Germany,33,37,0,70
7141,2018,Poland,Germany,636,5,0,641
7142,2018,Portugal,Germany,5,0,0,5
7143,2018,Romania,Germany,155,11,0,166
7144,2018,South Africa,Germany,17,50,0,67
7145,2018,Russian Federation,Germany,8119,18059,0,26178
7146,2018,Rwanda,Germany,239,159,0,398
7147,2018,El Salvador,Germany,42,5,0,47
7148,2018,Saudi Arabia,Germany,130,36,0,166
7149,2018,Serbia and Kosovo: S/RES/1244 (1999),Germany,9155,4404,0,13559
7150,2018,Senegal,Germany,157,575,0,732
7151,2018,Singapore,Germany,8,0,0,8
7152,2018,Sierra Leone,Germany,730,1582,0,2312
7153,2018,Solomon Islands,Germany,6,0,0,6
7154,2018,Somalia,Germany,23581,9853,0,33434
7155,2018,Spain,Germany,17,25,0,42
7156,2018,Viet Nam,Germany,1236,246,0,1482
7157,2018,Sudan,Germany,2436,1843,0,4279
7158,2018,South Sudan,Germany,76,79,0,155
7159,2018,Slovakia,Germany,87,0,0,87
7160,2018,Slovenia,Germany,6,0,0,6
7161,2018,Eswatini,Germany,5,0,0,5
7162,2018,Sweden,Germany,8,0,0,8
7163,2018,Syrian Arab Rep.,Germany,532065,52396,0,584461
7164,2018,United Rep. of Tanzania,Germany,60,210,0,270
7165,2018,Thailand,Germany,25,5,0,30
7166,2018,Tajikistan,Germany,666,1901,0,2567
7167,2018,Turkmenistan,Germany,84,199,0,283
7168,2018,Togo,Germany,1074,1086,0,2160
7169,2018,Trinidad and Tobago,Germany,5,0,0,5
7170,2018,Tunisia,Germany,197,599,0,796
7171,2018,Türkiye,Germany,24036,14704,0,38740
7172,2018,United Arab Emirates,Germany,33,5,0,38
7173,2018,Uganda,Germany,197,333,0,530
7174,2018,Ukraine,Germany,741,3149,0,3890
7175,2018,United States of America,Germany,133,26,0,159
7176,2018,Uzbekistan,Germany,107,124,0,231
7177,2018,Saint Vincent and the Grenadines,Germany,5,0,0,5
7178,2018,Venezuela (Bolivarian Republic of),Germany,183,468,0,651
7179,2018,Yemen,Germany,1809,873,0,2682
7180,2018,Zambia,Germany,8,12,0,20
7181,2018,Zimbabwe,Germany,204,288,0,492
7184,2018,Egypt,Ghana,0,16,0,16
7185,2018,Burundi,Ghana,12,13,0,25
7186,2018,Benin,Ghana,5,0,0,5
7187,2018,Central African Rep.,Ghana,117,90,0,207
7188,2018,Chad,Ghana,31,11,0,42
7189,2018,Cameroon,Ghana,6,127,0,133
7190,2018,Congo,Ghana,7,17,0,24
7191,2018,Dem. Rep. of the Congo,Ghana,46,36,0,82
7192,2018,Eritrea,Ghana,69,98,0,167
7193,2018,Ethiopia,Ghana,7,7,0,14
7194,2018,Palestinian,Ghana,14,6,0,20
7195,2018,Cote d'Ivoire,Ghana,6585,345,0,6930
7196,2018,Iraq,Ghana,11,0,0,11
7197,2018,Liberia,Ghana,735,0,0,735
7198,2018,Libya,Ghana,0,8,0,8
7199,2018,Lebanon,Ghana,8,0,0,8
7200,2018,Mali,Ghana,0,5,0,5
7201,2018,Nigeria,Ghana,9,19,0,28
7202,2018,Pakistan,Ghana,26,31,0,57
7203,2018,Rwanda,Ghana,36,0,0,36
7204,2018,Sierra Leone,Ghana,88,5,0,93
7205,2018,Somalia,Ghana,63,18,0,81
7206,2018,Sudan,Ghana,413,229,0,642
7207,2018,South Sudan,Ghana,6,5,0,11
7208,2018,Syrian Arab Rep.,Ghana,157,85,0,242
7209,2018,Togo,Ghana,3431,83,0,3514
7210,2018,Türkiye,Ghana,0,47,0,47
7211,2018,Uganda,Ghana,5,6,0,11
7212,2018,Uzbekistan,Ghana,9,0,0,9
7213,2018,Yemen,Ghana,0,5,0,5
7214,2018,Burundi,Guinea-Bissau,11,0,0,11
7215,2018,Congo,Guinea-Bissau,5,0,0,5
7216,2018,Dem. Rep. of the Congo,Guinea-Bissau,5,0,0,5
7217,2018,Comoros,Guinea-Bissau,15,6,0,21
7218,2018,Gambia,Guinea-Bissau,6,0,0,6
7219,2018,Guinea,Guinea-Bissau,10,0,0,10
7220,2018,Liberia,Guinea-Bissau,5,0,0,5
7221,2018,Nigeria,Guinea-Bissau,5,0,0,5
7222,2018,Senegal,Guinea-Bissau,3707,5,0,3712
7223,2018,Sierra Leone,Guinea-Bissau,12,5,0,17
7224,2018,Türkiye,Guinea-Bissau,0,5,0,5
7226,2018,Afghanistan,Greece,9291,13533,0,22824
7227,2018,Albania,Greece,156,3593,0,3749
7228,2018,Algeria,Greece,86,677,0,763
7229,2018,Angola,Greece,5,10,0,15
7230,2018,Egypt,Greece,264,1284,0,1548
7231,2018,Armenia,Greece,11,103,0,114
7232,2018,Azerbaijan,Greece,5,0,0,5
7233,2018,Burundi,Greece,30,24,0,54
7234,2018,Bangladesh,Greece,273,2311,0,2584
7235,2018,Burkina Faso,Greece,15,53,0,68
7236,2018,Belarus,Greece,5,13,0,18
7237,2018,Brazil,Greece,0,9,0,9
7238,2018,Bosnia and Herzegovina,Greece,0,5,0,5
7239,2018,Central African Rep.,Greece,12,5,0,17
7240,2018,Chad,Greece,5,8,0,13
7241,2018,China,Greece,71,590,0,661
7242,2018,Cameroon,Greece,278,970,0,1248
7243,2018,Congo,Greece,96,97,0,193
7244,2018,Dem. Rep. of the Congo,Greece,549,1699,0,2248
7245,2018,Comoros,Greece,6,7,0,13
7246,2018,Colombia,Greece,0,5,0,5
7247,2018,Cuba,Greece,0,8,0,8
7248,2018,Djibouti,Greece,0,5,0,5
7249,2018,Dominican Rep.,Greece,8,23,0,31
7250,2018,Equatorial Guinea,Greece,5,0,0,5
7251,2018,Eritrea,Greece,935,302,0,1237
7252,2018,Ethiopia,Greece,363,225,0,588
7253,2018,Gabon,Greece,0,10,0,10
7254,2018,Gambia,Greece,28,58,0,86
7255,2018,Palestinian,Greece,1290,1242,0,2532
7256,2018,Georgia,Greece,267,1700,0,1967
7257,2018,Ghana,Greece,52,200,0,252
7258,2018,Guinea,Greece,87,216,0,303
7259,2018,Haiti,Greece,8,16,0,24
7260,2018,Cote d'Ivoire,Greece,77,57,0,134
7261,2018,India,Greece,29,296,0,325
7262,2018,Indonesia,Greece,15,32,0,47
7263,2018,Iran (Islamic Rep. of),Greece,1532,1935,0,3467
7264,2018,Iraq,Greece,8828,9066,0,17894
7265,2018,Jordan,Greece,19,37,0,56
7266,2018,Kazakhstan,Greece,5,5,0,10
7267,2018,Kenya,Greece,28,10,0,38
7268,2018,Kuwait,Greece,85,60,0,145
7269,2018,Liberia,Greece,0,5,0,5
7270,2018,Libya,Greece,39,48,0,87
7271,2018,Lebanon,Greece,41,99,0,140
7272,2018,Sri Lanka,Greece,44,75,0,119
7273,2018,Mauritania,Greece,53,21,0,74
7274,2018,North Macedonia,Greece,0,5,0,5
7275,2018,Rep. of Moldova,Greece,13,41,0,54
7276,2018,Mali,Greece,47,84,0,131
7277,2018,Morocco,Greece,150,345,0,495
7278,2018,Myanmar,Greece,50,65,0,115
7279,2018,Nepal,Greece,10,138,0,148
7280,2018,Niger,Greece,5,5,0,10
7281,2018,Nigeria,Greece,285,274,0,559
7282,2018,Pakistan,Greece,902,9868,0,10770
7283,2018,Philippines,Greece,7,7,0,14
7284,2018,Russian Federation,Greece,12,67,0,79
7285,2018,Rwanda,Greece,10,10,0,20
7286,2018,El Salvador,Greece,10,5,0,15
7287,2018,Saudi Arabia,Greece,7,0,0,7
7288,2018,Serbia and Kosovo: S/RES/1244 (1999),Greece,22,7,0,29
7289,2018,Senegal,Greece,52,50,0,102
7290,2018,Sierra Leone,Greece,40,108,0,148
7291,2018,Somalia,Greece,664,668,0,1332
7292,2018,Viet Nam,Greece,5,22,0,27
7293,2018,Sudan,Greece,443,87,0,530
7294,2018,South Sudan,Greece,13,13,0,26
7295,2018,Syrian Arab Rep.,Greece,23931,14104,0,38035
7296,2018,United Rep. of Tanzania,Greece,13,11,0,24
7297,2018,Tajikistan,Greece,5,5,0,10
7298,2018,Turkmenistan,Greece,0,11,0,11
7299,2018,Togo,Greece,14,98,0,112
7300,2018,Tunisia,Greece,19,53,0,72
7301,2018,Türkiye,Greece,472,4913,0,5385
7302,2018,Uganda,Greece,24,53,0,77
7303,2018,Ukraine,Greece,145,117,0,262
7304,2018,United States of America,Greece,0,5,0,5
7305,2018,Uzbekistan,Greece,16,5,0,21
7306,2018,Venezuela (Bolivarian Republic of),Greece,6,34,0,40
7307,2018,Western Sahara,Greece,7,5,0,12
7308,2018,Yemen,Greece,369,178,0,547
7309,2018,Zimbabwe,Greece,6,15,0,21
7312,2018,Cameroon,Guatemala,0,5,0,5
7313,2018,Colombia,Guatemala,8,8,0,16
7314,2018,Honduras,Guatemala,39,33,0,72
7315,2018,Nicaragua,Guatemala,100,97,0,197
7316,2018,El Salvador,Guatemala,216,91,0,307
7317,2018,Venezuela (Bolivarian Republic of),Guatemala,17,17,0,34
7319,2018,Burundi,Guinea,5,0,0,5
7320,2018,Central African Rep.,Guinea,37,0,0,37
7321,2018,Congo,Guinea,12,0,0,12
7322,2018,Dem. Rep. of the Congo,Guinea,38,12,0,50
7323,2018,Gambia,Guinea,7,0,0,7
7324,2018,Cote d'Ivoire,Guinea,3597,10,0,3607
7325,2018,Liberia,Guinea,302,49,0,351
7326,2018,Sri Lanka,Guinea,8,0,0,8
7327,2018,Mali,Guinea,7,0,0,7
7328,2018,Nigeria,Guinea,7,0,0,7
7329,2018,Rwanda,Guinea,10,0,0,10
7330,2018,Sierra Leone,Guinea,245,1502,0,1747
7331,2018,Somalia,Guinea,6,0,0,6
7332,2018,Syrian Arab Rep.,Guinea,5,5,0,10
7333,2018,Togo,Guinea,8,0,0,8
7334,2018,Dem. Rep. of the Congo,Guyana,7,0,0,7
7335,2018,Cuba,Guyana,8,12,0,20
7336,2018,Pakistan,Guyana,5,0,0,5
7337,2018,Rwanda,Guyana,5,0,0,5
7338,2018,Venezuela (Bolivarian Republic of),Guyana,0,0,0,0
7339,2018,Yemen,Haiti,5,0,0,5
7341,2018,Egypt,"China, Hong Kong SAR",5,0,0,5
7342,2018,Burundi,"China, Hong Kong SAR",11,0,0,11
7343,2018,Bangladesh,"China, Hong Kong SAR",5,0,0,5
7344,2018,Central African Rep.,"China, Hong Kong SAR",5,0,0,5
7345,2018,Dem. Rep. of the Congo,"China, Hong Kong SAR",5,0,0,5
7346,2018,Indonesia,"China, Hong Kong SAR",6,0,0,6
7347,2018,Sri Lanka,"China, Hong Kong SAR",21,0,0,21
7348,2018,Pakistan,"China, Hong Kong SAR",8,0,0,8
7349,2018,Rwanda,"China, Hong Kong SAR",28,0,0,28
7350,2018,Somalia,"China, Hong Kong SAR",22,0,0,22
7351,2018,Yemen,"China, Hong Kong SAR",12,0,0,12
7352,2018,Honduras,Honduras,0,0,174001,0
7353,2018,Iran (Islamic Rep. of),Honduras,5,0,0,5
7354,2018,Nicaragua,Honduras,6,55,0,61
7355,2018,El Salvador,Honduras,11,0,0,11
7356,2018,Venezuela (Bolivarian Republic of),Honduras,6,0,0,6
7357,2018,Afghanistan,Croatia,53,21,0,74
7358,2018,Algeria,Croatia,0,19,0,19
7359,2018,Egypt,Croatia,7,0,0,7
7360,2018,Azerbaijan,Croatia,5,0,0,5
7361,2018,Bangladesh,Croatia,5,0,0,5
7362,2018,Belarus,Croatia,5,0,0,5
7363,2018,Bosnia and Herzegovina,Croatia,37,0,0,37
7364,2018,Congo,Croatia,5,0,0,5
7365,2018,Eritrea,Croatia,21,0,0,21
7366,2018,Palestinian,Croatia,5,5,0,10
7367,2018,Georgia,Croatia,5,0,0,5
7368,2018,Croatia,Croatia,0,0,0,0
7369,2018,Iran (Islamic Rep. of),Croatia,22,48,0,70
7370,2018,Iraq,Croatia,97,35,0,132
7371,2018,Kazakhstan,Croatia,5,0,0,5
7372,2018,Libya,Croatia,5,0,0,5
7373,2018,Mauritania,Croatia,5,0,0,5
7374,2018,Morocco,Croatia,0,5,0,5
7375,2018,Nigeria,Croatia,12,0,0,12
7376,2018,Pakistan,Croatia,7,5,0,12
7377,2018,Russian Federation,Croatia,15,5,0,20
7378,2018,Serbia and Kosovo: S/RES/1244 (1999),Croatia,0,5,0,5
7379,2018,Somalia,Croatia,26,0,0,26
7380,2018,Sudan,Croatia,5,0,0,5
7381,2018,Syrian Arab Rep.,Croatia,398,29,0,427
7382,2018,Türkiye,Croatia,17,11,0,28
7383,2018,Ukraine,Croatia,8,5,0,13
7384,2018,Uzbekistan,Croatia,5,0,0,5
7385,2018,Yemen,Croatia,7,0,0,7
7387,2018,Afghanistan,Hungary,1552,68,0,1620
7388,2018,Algeria,Hungary,15,0,0,15
7389,2018,Angola,Hungary,5,0,0,5
7390,2018,Egypt,Hungary,13,0,0,13
7391,2018,Armenia,Hungary,48,0,0,48
7392,2018,Azerbaijan,Hungary,16,0,0,16
7393,2018,Bangladesh,Hungary,9,0,0,9
7394,2018,China,Hungary,5,0,0,5
7395,2018,Cameroon,Hungary,42,0,0,42
7396,2018,Congo,Hungary,14,0,0,14
7397,2018,Dem. Rep. of the Congo,Hungary,22,0,0,22
7398,2018,Cuba,Hungary,82,0,0,82
7399,2018,Eritrea,Hungary,48,0,0,48
7400,2018,Ethiopia,Hungary,37,5,0,42
7401,2018,Palestinian,Hungary,93,0,0,93
7402,2018,Georgia,Hungary,62,0,0,62
7403,2018,Ghana,Hungary,7,0,0,7
7404,2018,Guinea,Hungary,5,0,0,5
7405,2018,Cote d'Ivoire,Hungary,15,0,0,15
7406,2018,India,Hungary,5,0,0,5
7407,2018,Iran (Islamic Rep. of),Hungary,176,8,0,184
7408,2018,Iraq,Hungary,672,22,0,694
7409,2018,Libya,Hungary,7,0,0,7
7410,2018,Lebanon,Hungary,7,0,0,7
7411,2018,Sri Lanka,Hungary,12,0,0,12
7412,2018,Rep. of Moldova,Hungary,5,0,0,5
7413,2018,Mali,Hungary,5,0,0,5
7414,2018,Myanmar,Hungary,5,0,0,5
7415,2018,Nepal,Hungary,11,0,0,11
7416,2018,Nigeria,Hungary,57,0,0,57
7417,2018,Pakistan,Hungary,60,7,0,67
7418,2018,Russian Federation,Hungary,36,0,0,36
7419,2018,Serbia and Kosovo: S/RES/1244 (1999),Hungary,56,0,0,56
7420,2018,Sierra Leone,Hungary,5,0,0,5
7421,2018,Somalia,Hungary,655,0,0,655
7422,2018,Sudan,Hungary,68,0,0,68
7423,2018,Syrian Arab Rep.,Hungary,971,5,0,976
7424,2018,Tunisia,Hungary,8,0,0,8
7425,2018,Türkiye,Hungary,34,5,0,39
7426,2018,Uganda,Hungary,7,0,0,7
7427,2018,Ukraine,Hungary,19,0,0,19
7428,2018,Uzbekistan,Hungary,7,0,0,7
7429,2018,Yemen,Hungary,18,0,0,18
7430,2018,Zimbabwe,Hungary,5,0,0,5
7433,2018,Afghanistan,Iceland,58,29,0,87
7434,2018,Albania,Iceland,6,0,0,6
7435,2018,Algeria,Iceland,0,5,0,5
7436,2018,Egypt,Iceland,0,9,0,9
7437,2018,China,Iceland,5,0,0,5
7438,2018,Colombia,Iceland,0,7,0,7
7439,2018,Eritrea,Iceland,10,0,0,10
7440,2018,Palestinian,Iceland,18,12,0,30
7441,2018,Georgia,Iceland,5,5,0,10
7442,2018,Ghana,Iceland,0,5,0,5
7443,2018,Iran (Islamic Rep. of),Iceland,46,33,0,79
7444,2018,Iraq,Iceland,146,96,0,242
7445,2018,Kazakhstan,Iceland,5,0,0,5
7446,2018,Kenya,Iceland,5,0,0,5
7447,2018,Libya,Iceland,5,5,0,10
7448,2018,North Macedonia,Iceland,5,0,0,5
7449,2018,Rep. of Moldova,Iceland,0,26,0,26
7450,2018,Morocco,Iceland,5,8,0,13
7451,2018,Mozambique,Iceland,0,5,0,5
7452,2018,Nigeria,Iceland,6,29,0,35
7453,2018,Pakistan,Iceland,18,26,0,44
7454,2018,Russian Federation,Iceland,10,10,0,20
7455,2018,El Salvador,Iceland,12,0,0,12
7456,2018,Serbia and Kosovo: S/RES/1244 (1999),Iceland,5,5,0,10
7457,2018,Somalia,Iceland,25,44,0,69
7458,2018,Sudan,Iceland,5,5,0,10
7459,2018,South Sudan,Iceland,5,0,0,5
7460,2018,Syrian Arab Rep.,Iceland,87,30,0,117
7461,2018,Tunisia,Iceland,0,7,0,7
7462,2018,Türkiye,Iceland,0,5,0,5
7463,2018,Uganda,Iceland,11,0,0,11
7464,2018,Ukraine,Iceland,17,24,0,41
7465,2018,Venezuela (Bolivarian Republic of),Iceland,7,7,0,14
7468,2018,Burundi,Cote d'Ivoire,34,0,0,34
7469,2018,Benin,Cote d'Ivoire,0,5,0,5
7470,2018,Burkina Faso,Cote d'Ivoire,0,5,0,5
7471,2018,Cambodia,Cote d'Ivoire,5,0,0,5
7472,2018,Central African Rep.,Cote d'Ivoire,462,34,0,496
7473,2018,Cameroon,Cote d'Ivoire,0,9,0,9
7474,2018,Congo,Cote d'Ivoire,53,13,0,66
7475,2018,Dem. Rep. of the Congo,Cote d'Ivoire,120,29,0,149
7476,2018,Eritrea,Cote d'Ivoire,5,0,0,5
7477,2018,Ethiopia,Cote d'Ivoire,5,5,0,10
7478,2018,Cote d'Ivoire,Cote d'Ivoire,0,0,0,0
7479,2018,Iran (Islamic Rep. of),Cote d'Ivoire,5,0,0,5
7480,2018,Iraq,Cote d'Ivoire,5,0,0,5
7481,2018,Liberia,Cote d'Ivoire,906,54,0,960
7482,2018,Sri Lanka,Cote d'Ivoire,5,0,0,5
7483,2018,Mauritania,Cote d'Ivoire,0,9,0,9
7484,2018,Mali,Cote d'Ivoire,6,5,0,11
7485,2018,Nigeria,Cote d'Ivoire,5,0,0,5
7486,2018,Rwanda,Cote d'Ivoire,46,0,0,46
7487,2018,Somalia,Cote d'Ivoire,5,0,0,5
7488,2018,Viet Nam,Cote d'Ivoire,5,0,0,5
7489,2018,Sudan,Cote d'Ivoire,9,0,0,9
7490,2018,Syrian Arab Rep.,Cote d'Ivoire,92,8,0,100
7491,2018,Togo,Cote d'Ivoire,15,14,0,29
7492,2018,Türkiye,Cote d'Ivoire,20,8,0,28
7494,2018,Afghanistan,India,6984,7864,0,14848
7495,2018,Egypt,India,0,5,0,5
7496,2018,Burundi,India,0,5,0,5
7497,2018,China,India,108008,0,0,108008
7498,2018,Cameroon,India,0,89,0,89
7499,2018,Congo,India,5,14,0,19
7500,2018,Dem. Rep. of the Congo,India,43,41,0,84
7501,2018,Eritrea,India,15,11,0,26
7502,2018,Ethiopia,India,20,22,0,42
7503,2018,Palestinian,India,73,5,0,78
7504,2018,Cote d'Ivoire,India,5,5,0,10
7505,2018,Iran (Islamic Rep. of),India,53,32,0,85
7506,2018,Iraq,India,277,99,0,376
7507,2018,Libya,India,0,7,0,7
7508,2018,Sri Lanka,India,60802,0,0,60802
7509,2018,Maldives,India,5,0,0,5
7510,2018,Myanmar,India,18813,2064,0,20877
7511,2018,Russian Federation,India,0,7,0,7
7512,2018,Rwanda,India,5,5,0,10
7513,2018,Saudi Arabia,India,5,0,0,5
7514,2018,Somalia,India,608,330,0,938
7515,2018,Sudan,India,78,66,0,144
7516,2018,South Sudan,India,5,85,0,90
7517,2018,Syrian Arab Rep.,India,83,17,0,100
7518,2018,United Rep. of Tanzania,India,0,5,0,5
7519,2018,Thailand,India,0,5,0,5
7520,2018,Tajikistan,India,0,8,0,8
7521,2018,Ukraine,India,0,7,0,7
7522,2018,Uzbekistan,India,0,6,0,6
7523,2018,Yemen,India,0,1134,0,1134
7524,2018,Afghanistan,Indonesia,6098,1635,0,7733
7525,2018,Algeria,Indonesia,0,5,0,5
7526,2018,Angola,Indonesia,0,7,0,7
7527,2018,Egypt,Indonesia,16,13,0,29
7528,2018,Bangladesh,Indonesia,0,10,0,10
7529,2018,China,Indonesia,12,5,0,17
7530,2018,Cameroon,Indonesia,0,9,0,9
7531,2018,Dem. Rep. of the Congo,Indonesia,5,11,0,16
7532,2018,Eritrea,Indonesia,39,186,0,225
7533,2018,Ethiopia,Indonesia,160,50,0,210
7534,2018,Palestinian,Indonesia,367,68,0,435
7535,2018,Cote d'Ivoire,Indonesia,0,5,0,5
7536,2018,Iran (Islamic Rep. of),Indonesia,308,41,0,349
7537,2018,Iraq,Indonesia,587,249,0,836
7538,2018,Jordan,Indonesia,5,0,0,5
7539,2018,Kuwait,Indonesia,10,0,0,10
7540,2018,Libya,Indonesia,14,5,0,19
7541,2018,Sri Lanka,Indonesia,409,35,0,444
7542,2018,Myanmar,Indonesia,713,113,0,826
7543,2018,Pakistan,Indonesia,340,27,0,367
7544,2018,Russian Federation,Indonesia,5,0,0,5
7545,2018,Somalia,Indonesia,1139,336,0,1475
7546,2018,Viet Nam,Indonesia,20,0,0,20
7547,2018,Sudan,Indonesia,400,78,0,478
7548,2018,Syrian Arab Rep.,Indonesia,29,18,0,47
7549,2018,Türkiye,Indonesia,0,41,0,41
7550,2018,Uganda,Indonesia,5,0,0,5
7551,2018,Yemen,Indonesia,105,249,0,354
7552,2018,Afghanistan,Ireland,289,148,0,437
7553,2018,Albania,Ireland,91,886,0,977
7554,2018,Algeria,Ireland,43,220,0,263
7555,2018,Angola,Ireland,50,25,0,75
7556,2018,Egypt,Ireland,19,68,0,87
7557,2018,Armenia,Ireland,9,6,0,15
7558,2018,Azerbaijan,Ireland,6,0,0,6
7559,2018,Burundi,Ireland,16,6,0,22
7560,2018,Benin,Ireland,5,0,0,5
7561,2018,Bangladesh,Ireland,34,298,0,332
7562,2018,Bhutan,Ireland,10,0,0,10
7563,2018,Belarus,Ireland,22,5,0,27
7564,2018,Bolivia (Plurinational State of),Ireland,7,34,0,41
7565,2018,Botswana,Ireland,0,26,0,26
7566,2018,Brazil,Ireland,0,146,0,146
7567,2018,Chad,Ireland,5,0,0,5
7568,2018,China,Ireland,54,86,0,140
7569,2018,Chile,Ireland,0,5,0,5
7570,2018,Cameroon,Ireland,73,53,0,126
7571,2018,Congo,Ireland,16,10,0,26
7572,2018,Dem. Rep. of the Congo,Ireland,302,278,0,580
7573,2018,Cuba,Ireland,5,0,0,5
7574,2018,Eritrea,Ireland,47,32,0,79
7575,2018,Ethiopia,Ireland,32,18,0,50
7576,2018,Gambia,Ireland,0,10,0,10
7577,2018,Palestinian,Ireland,78,46,0,124
7578,2018,Georgia,Ireland,66,648,0,714
7579,2018,Ghana,Ireland,22,64,0,86
7580,2018,Guatemala,Ireland,0,5,0,5
7581,2018,Guinea,Ireland,14,0,0,14
7582,2018,Guyana,Ireland,0,6,0,6
7583,2018,Honduras,Ireland,5,0,0,5
7584,2018,Cote d'Ivoire,Ireland,14,11,0,25
7585,2018,India,Ireland,0,116,0,116
7586,2018,Iran (Islamic Rep. of),Ireland,126,39,0,165
7587,2018,Iraq,Ireland,342,103,0,445
7588,2018,Israel,Ireland,5,5,0,10
7589,2018,Kazakhstan,Ireland,19,0,0,19
7590,2018,Kenya,Ireland,44,14,0,58
7591,2018,Kyrgyzstan,Ireland,5,7,0,12
7592,2018,Dem. People's Rep. of Korea,Ireland,7,0,0,7
7593,2018,Kuwait,Ireland,47,19,0,66
7594,2018,Liberia,Ireland,13,0,0,13
7595,2018,Libya,Ireland,150,67,0,217
7596,2018,Lebanon,Ireland,5,8,0,13
7597,2018,Lesotho,Ireland,0,5,0,5
7598,2018,Sri Lanka,Ireland,21,17,0,38
7599,2018,Rep. of Moldova,Ireland,55,7,0,62
7600,2018,Mexico,Ireland,0,12,0,12
7601,2018,Mali,Ireland,8,0,0,8
7602,2018,Malaysia,Ireland,0,25,0,25
7603,2018,Malawi,Ireland,75,176,0,251
7604,2018,Mongolia,Ireland,5,16,0,21
7605,2018,Morocco,Ireland,6,35,0,41
7606,2018,Mozambique,Ireland,5,5,0,10
7607,2018,Montenegro,Ireland,5,0,0,5
7608,2018,Mauritius,Ireland,8,50,0,58
7609,2018,Myanmar,Ireland,8,8,0,16
7610,2018,Nepal,Ireland,5,21,0,26
7611,2018,Niger,Ireland,5,0,0,5
7612,2018,Nicaragua,Ireland,0,8,0,8
7613,2018,Nigeria,Ireland,255,556,0,811
7614,2018,Pakistan,Ireland,185,1000,0,1185
7615,2018,Philippines,Ireland,0,5,0,5
7616,2018,South Africa,Ireland,55,347,0,402
7617,2018,Russian Federation,Ireland,70,35,0,105
7618,2018,Rwanda,Ireland,37,5,0,42
7619,2018,El Salvador,Ireland,0,5,0,5
7620,2018,Saudi Arabia,Ireland,9,7,0,16
7621,2018,Serbia and Kosovo: S/RES/1244 (1999),Ireland,58,27,0,85
7622,2018,Sierra Leone,Ireland,22,41,0,63
7623,2018,Somalia,Ireland,205,68,0,273
7624,2018,Viet Nam,Ireland,0,21,0,21
7625,2018,Sudan,Ireland,159,62,0,221
7626,2018,Eswatini,Ireland,13,17,0,30
7627,2018,Syrian Arab Rep.,Ireland,2126,66,0,2192
7628,2018,United Rep. of Tanzania,Ireland,0,7,0,7
7629,2018,Togo,Ireland,17,6,0,23
7630,2018,Tunisia,Ireland,0,14,0,14
7631,2018,Türkiye,Ireland,6,12,0,18
7632,2018,Uganda,Ireland,34,23,0,57
7633,2018,Ukraine,Ireland,78,53,0,131
7634,2018,United States of America,Ireland,0,9,0,9
7635,2018,Uzbekistan,Ireland,17,0,0,17
7636,2018,Venezuela (Bolivarian Republic of),Ireland,29,59,0,88
7637,2018,Yemen,Ireland,8,6,0,14
7638,2018,Zambia,Ireland,0,7,0,7
7639,2018,Zimbabwe,Ireland,319,652,0,971
7642,2018,Afghanistan,Iran (Islamic Rep. of),951142,0,0,951142
7643,2018,Iraq,Iran (Islamic Rep. of),28268,0,0,28268
7644,2018,Kuwait,Iran (Islamic Rep. of),8,0,0,8
7645,2018,Myanmar,Iran (Islamic Rep. of),0,33,0,33
7646,2018,Pakistan,Iran (Islamic Rep. of),10,0,0,10
7647,2018,Uzbekistan,Iran (Islamic Rep. of),7,0,0,7
7648,2018,Afghanistan,Iraq,12,66,0,78
7649,2018,Egypt,Iraq,0,24,0,24
7650,2018,Bahrain,Iraq,0,20,0,20
7651,2018,Eritrea,Iraq,5,24,0,29
7652,2018,Ethiopia,Iraq,0,5,0,5
7653,2018,Palestinian,Iraq,7944,140,0,8084
7654,2018,Indonesia,Iraq,0,5,0,5
7655,2018,Iran (Islamic Rep. of),Iraq,7026,6602,0,13628
7656,2018,Iraq,Iraq,0,0,1802832,0
7657,2018,Jordan,Iraq,9,5,0,14
7658,2018,Kyrgyzstan,Iraq,0,10,0,10
7659,2018,Kuwait,Iraq,0,174,0,174
7660,2018,Lebanon,Iraq,0,5,0,5
7661,2018,Pakistan,Iraq,0,26,0,26
7662,2018,Saudi Arabia,Iraq,0,5,0,5
7663,2018,Somalia,Iraq,6,5,0,11
7664,2018,Sudan,Iraq,85,822,0,907
7665,2018,South Sudan,Iraq,0,14,0,14
7666,2018,Syrian Arab Rep.,Iraq,252526,0,0,252526
7667,2018,Tunisia,Iraq,0,6,0,6
7668,2018,Türkiye,Iraq,15405,5936,0,21341
7669,2018,Uzbekistan,Iraq,0,5,0,5
7670,2018,Yemen,Iraq,0,114,0,114
7672,2018,Egypt,Israel,0,12,0,12
7673,2018,Armenia,Israel,0,51,0,51
7674,2018,Azerbaijan,Israel,0,46,0,46
7675,2018,Benin,Israel,0,5,0,5
7676,2018,Burkina Faso,Israel,0,5,0,5
7677,2018,Belarus,Israel,0,400,0,400
7678,2018,Botswana,Israel,0,5,0,5
7679,2018,Brazil,Israel,0,6,0,6
7680,2018,Bulgaria,Israel,0,5,0,5
7681,2018,Central African Rep.,Israel,0,18,0,18
7682,2018,Chad,Israel,5,6,0,11
7683,2018,China,Israel,0,55,0,55
7684,2018,Cameroon,Israel,0,43,0,43
7685,2018,Congo,Israel,0,29,0,29
7686,2018,Dem. Rep. of the Congo,Israel,209,216,0,425
7687,2018,Colombia,Israel,0,108,0,108
7688,2018,Ecuador,Israel,0,14,0,14
7689,2018,Eritrea,Israel,14516,9779,0,24295
7690,2018,Ethiopia,Israel,95,838,0,933
7691,2018,Georgia,Israel,5,2488,0,2493
7692,2018,Ghana,Israel,0,450,0,450
7693,2018,Greece,Israel,0,5,0,5
7694,2018,Guinea,Israel,0,28,0,28
7695,2018,Cote d'Ivoire,Israel,5,16,0,21
7696,2018,India,Israel,0,973,0,973
7697,2018,Iran (Islamic Rep. of),Israel,6,5,0,11
7698,2018,Iraq,Israel,10,0,0,10
7699,2018,Kazakhstan,Israel,0,186,0,186
7700,2018,Kenya,Israel,0,84,0,84
7701,2018,Kyrgyzstan,Israel,0,64,0,64
7702,2018,Dem. People's Rep. of Korea,Israel,5,0,0,5
7703,2018,Lesotho,Israel,0,6,0,6
7704,2018,Sri Lanka,Israel,0,1004,0,1004
7705,2018,Latvia,Israel,0,5,0,5
7706,2018,Rep. of Moldova,Israel,0,651,0,651
7707,2018,Mali,Israel,0,5,0,5
7708,2018,Malawi,Israel,0,38,0,38
7709,2018,Myanmar,Israel,0,23,0,23
7710,2018,Nepal,Israel,0,42,0,42
7711,2018,Nigeria,Israel,5,984,0,989
7712,2018,Philippines,Israel,0,9,0,9
7713,2018,Romania,Israel,0,45,0,45
7714,2018,South Africa,Israel,0,367,0,367
7715,2018,Russian Federation,Israel,0,2971,0,2971
7716,2018,Rwanda,Israel,0,5,0,5
7717,2018,Sierra Leone,Israel,5,14,0,19
7718,2018,Somalia,Israel,0,12,0,12
7719,2018,Sudan,Israel,3351,4631,0,7982
7720,2018,South Sudan,Israel,127,102,0,229
7721,2018,Thailand,Israel,0,5,0,5
7722,2018,Tajikistan,Israel,0,7,0,7
7723,2018,Turkmenistan,Israel,0,5,0,5
7724,2018,Togo,Israel,0,5,0,5
7725,2018,Türkiye,Israel,5,190,0,195
7726,2018,Uganda,Israel,0,97,0,97
7727,2018,Ukraine,Israel,0,7857,0,7857
7728,2018,Uzbekistan,Israel,0,455,0,455
7729,2018,Venezuela (Bolivarian Republic of),Israel,0,5,0,5
7730,2018,Zimbabwe,Israel,0,16,0,16
7733,2018,Afghanistan,Italy,16941,825,0,17766
7734,2018,Albania,Italy,684,1097,0,1781
7735,2018,Algeria,Italy,199,165,0,364
7736,2018,Angola,Italy,31,16,0,47
7737,2018,Egypt,Italy,2289,796,0,3085
7738,2018,Argentina,Italy,7,11,0,18
7739,2018,Armenia,Italy,319,222,0,541
7740,2018,Azerbaijan,Italy,74,37,0,111
7741,2018,Bahrain,Italy,5,0,0,5
7742,2018,Burundi,Italy,24,5,0,29
7743,2018,Benin,Italy,269,113,0,382
7744,2018,Bangladesh,Italy,8438,6116,0,14554
7745,2018,Bahamas,Italy,5,0,0,5
7746,2018,Burkina Faso,Italy,1121,495,0,1616
7747,2018,Belarus,Italy,38,39,0,77
7748,2018,Bolivia (Plurinational State of),Italy,13,8,0,21
7749,2018,Brazil,Italy,149,203,0,352
7750,2018,Bosnia and Herzegovina,Italy,657,133,0,790
7751,2018,Cambodia,Italy,5,0,0,5
7752,2018,Central African Rep.,Italy,103,43,0,146
7753,2018,Chad,Italy,456,97,0,553
7754,2018,China,Italy,184,844,0,1028
7755,2018,Chile,Italy,8,6,0,14
7756,2018,Cameroon,Italy,1802,1571,0,3373
7757,2018,Congo,Italy,421,93,0,514
7758,2018,Dem. Rep. of the Congo,Italy,589,130,0,719
7759,2018,Comoros,Italy,0,34,0,34
7760,2018,Colombia,Italy,450,523,0,973
7761,2018,Costa Rica,Italy,6,0,0,6
7762,2018,Cuba,Italy,207,166,0,373
7763,2018,Cabo Verde,Italy,5,5,0,10
7764,2018,Dominican Rep.,Italy,20,35,0,55
7765,2018,Ecuador,Italy,33,21,0,54
7766,2018,Equatorial Guinea,Italy,14,7,0,21
7767,2018,Eritrea,Italy,6975,13426,0,20401
7768,2018,Ethiopia,Italy,1271,225,0,1496
7769,2018,Gabon,Italy,37,17,0,54
7770,2018,Gambia,Italy,12549,3600,0,16149
7771,2018,Palestinian,Italy,1049,205,0,1254
7772,2018,Georgia,Italy,510,1235,0,1745
7773,2018,Ghana,Italy,5723,2894,0,8617
7774,2018,Guinea-Bissau,Italy,870,415,0,1285
7775,2018,Guatemala,Italy,5,15,0,20
7776,2018,Guinea,Italy,4571,4831,0,9402
7777,2018,Haiti,Italy,9,0,0,9
7778,2018,Honduras,Italy,116,249,0,365
7779,2018,Croatia,Italy,18,0,0,18
7780,2018,Cote d'Ivoire,Italy,7174,5436,0,12610
7781,2018,India,Italy,322,1039,0,1361
7782,2018,Indonesia,Italy,0,6,0,6
7783,2018,Iran (Islamic Rep. of),Italy,1907,274,0,2181
7784,2018,Iraq,Italy,6174,1011,0,7185
7785,2018,Israel,Italy,7,5,0,12
7786,2018,Jamaica,Italy,5,0,0,5
7787,2018,Jordan,Italy,35,15,0,50
7788,2018,Kazakhstan,Italy,21,8,0,29
7789,2018,Kenya,Italy,118,36,0,154
7790,2018,Kyrgyzstan,Italy,86,104,0,190
7791,2018,Rep. of Korea,Italy,5,0,0,5
7792,2018,Kuwait,Italy,8,0,0,8
7793,2018,Liberia,Italy,358,225,0,583
7794,2018,Libya,Italy,1142,367,0,1509
7795,2018,Lebanon,Italy,328,44,0,372
7796,2018,Lesotho,Italy,0,17,0,17
7797,2018,Sri Lanka,Italy,530,640,0,1170
7798,2018,Madagascar,Italy,22,7,0,29
7799,2018,Mauritania,Italy,347,37,0,384
7800,2018,North Macedonia,Italy,67,61,0,128
7801,2018,Rep. of Moldova,Italy,100,72,0,172
7802,2018,Mexico,Italy,5,16,0,21
7803,2018,Mali,Italy,15003,4806,0,19809
7804,2018,Malaysia,Italy,0,7,0,7
7805,2018,Malawi,Italy,5,0,0,5
7806,2018,Mongolia,Italy,0,5,0,5
7807,2018,Morocco,Italy,1076,2275,0,3351
7808,2018,Mozambique,Italy,5,0,0,5
7809,2018,Montenegro,Italy,84,12,0,96
7810,2018,Mauritius,Italy,18,9,0,27
7811,2018,Myanmar,Italy,43,14,0,57
7812,2018,Namibia,Italy,5,0,0,5
7813,2018,Nepal,Italy,114,127,0,241
7814,2018,Niger,Italy,573,332,0,905
7815,2018,Nicaragua,Italy,18,45,0,63
7816,2018,Nigeria,Italy,22319,17349,0,39668
7817,2018,Pakistan,Italy,18249,10501,0,28750
7818,2018,Paraguay,Italy,6,21,0,27
7819,2018,Peru,Italy,98,640,0,738
7820,2018,Philippines,Italy,67,166,0,233
7821,2018,South Africa,Italy,8,6,0,14
7822,2018,Russian Federation,Italy,269,232,0,501
7823,2018,Rwanda,Italy,12,6,0,18
7824,2018,El Salvador,Italy,1631,2576,0,4207
7825,2018,Saudi Arabia,Italy,11,11,0,22
7826,2018,Serbia and Kosovo: S/RES/1244 (1999),Italy,1181,804,0,1985
7827,2018,Senegal,Italy,7644,4984,0,12628
7828,2018,Sierra Leone,Italy,717,651,0,1368
7829,2018,Somalia,Italy,13373,830,0,14203
7830,2018,Viet Nam,Italy,8,5,0,13
7831,2018,Sudan,Italy,1579,492,0,2071
7832,2018,South Sudan,Italy,127,27,0,154
7833,2018,Eswatini,Italy,9,0,0,9
7834,2018,Syrian Arab Rep.,Italy,4652,1197,0,5849
7835,2018,United Rep. of Tanzania,Italy,29,10,0,39
7836,2018,Thailand,Italy,0,5,0,5
7837,2018,Tajikistan,Italy,11,6,0,17
7838,2018,Turkmenistan,Italy,5,5,0,10
7839,2018,Timor-Leste,Italy,5,0,0,5
7840,2018,Togo,Italy,932,405,0,1337
7841,2018,Tunisia,Italy,672,705,0,1377
7842,2018,Türkiye,Italy,2497,592,0,3089
7843,2018,Uganda,Italy,70,17,0,87
7844,2018,Ukraine,Italy,5861,4164,0,10025
7845,2018,Uruguay,Italy,0,5,0,5
7846,2018,United States of America,Italy,5,5,0,10
7847,2018,Uzbekistan,Italy,18,5,0,23
7848,2018,Venezuela (Bolivarian Republic of),Italy,563,1104,0,1667
7849,2018,Western Sahara,Italy,5,0,0,5
7850,2018,Yemen,Italy,141,54,0,195
7851,2018,Zimbabwe,Italy,25,6,0,31
7854,2018,Cuba,Jamaica,0,8,0,8
7855,2018,Haiti,Jamaica,8,0,0,8
7856,2018,South Africa,Jamaica,0,13,0,13
7857,2018,Syrian Arab Rep.,Jamaica,5,0,0,5
7858,2018,Afghanistan,Jordan,8,10,0,18
7859,2018,Algeria,Jordan,5,8,0,13
7860,2018,Egypt,Jordan,105,676,0,781
7861,2018,Bangladesh,Jordan,0,13,0,13
7862,2018,Burkina Faso,Jordan,0,5,0,5
7863,2018,Bosnia and Herzegovina,Jordan,9,0,0,9
7864,2018,Chad,Jordan,0,26,0,26
7865,2018,Comoros,Jordan,0,5,0,5
7866,2018,Eritrea,Jordan,29,24,0,53
7867,2018,Ethiopia,Jordan,10,56,0,66
7868,2018,Palestinian,Jordan,0,0,0,0
7869,2018,Ghana,Jordan,0,10,0,10
7870,2018,India,Jordan,0,7,0,7
7871,2018,Indonesia,Jordan,0,5,0,5
7872,2018,Iran (Islamic Rep. of),Jordan,7,5,0,12
7873,2018,Iraq,Jordan,34626,33384,0,68010
7874,2018,Jordan,Jordan,0,0,0,0
7875,2018,Kenya,Jordan,0,28,0,28
7876,2018,Kuwait,Jordan,10,0,0,10
7877,2018,Libya,Jordan,30,218,0,248
7878,2018,Lebanon,Jordan,9,109,0,118
7879,2018,Sri Lanka,Jordan,7,14,0,21
7880,2018,Rep. of Moldova,Jordan,0,5,0,5
7881,2018,Morocco,Jordan,0,17,0,17
7882,2018,Niger,Jordan,0,10,0,10
7883,2018,Nigeria,Jordan,0,95,0,95
7884,2018,Pakistan,Jordan,5,22,0,27
7885,2018,Philippines,Jordan,0,12,0,12
7886,2018,South Africa,Jordan,0,5,0,5
7887,2018,Russian Federation,Jordan,25,22,0,47
7888,2018,Saudi Arabia,Jordan,0,21,0,21
7889,2018,Serbia and Kosovo: S/RES/1244 (1999),Jordan,0,5,0,5
7890,2018,Senegal,Jordan,0,5,0,5
7891,2018,Somalia,Jordan,680,147,0,827
7892,2018,Sudan,Jordan,2788,3482,0,6270
7893,2018,Suriname,Jordan,0,7,0,7
7894,2018,South Sudan,Jordan,11,10,0,21
7895,2018,Syrian Arab Rep.,Jordan,676283,0,0,676283
7896,2018,Tajikistan,Jordan,0,10,0,10
7897,2018,Tunisia,Jordan,9,21,0,30
7898,2018,Türkiye,Jordan,0,8,0,8
7899,2018,Ukraine,Jordan,0,18,0,18
7900,2018,Yemen,Jordan,642,13835,0,14477
7902,2018,Afghanistan,Japan,55,0,0,55
7903,2018,Burundi,Japan,9,0,0,9
7904,2018,Bangladesh,Japan,27,0,0,27
7905,2018,China,Japan,73,0,0,73
7906,2018,Cameroon,Japan,17,0,0,17
7907,2018,Dem. Rep. of the Congo,Japan,20,0,0,20
7908,2018,Ethiopia,Japan,28,0,0,28
7909,2018,Iran (Islamic Rep. of),Japan,17,0,0,17
7910,2018,Iraq,Japan,13,0,0,13
7911,2018,Sri Lanka,Japan,53,0,0,53
7912,2018,Myanmar,Japan,1125,0,0,1125
7913,2018,Pakistan,Japan,34,0,0,34
7914,2018,Somalia,Japan,5,0,0,5
7915,2018,Sudan,Japan,15,0,0,15
7916,2018,Syrian Arab Rep.,Japan,69,0,0,69
7917,2018,Türkiye,Japan,39,0,0,39
7920,2018,Afghanistan,Kazakhstan,538,164,0,702
7921,2018,China,Kazakhstan,0,12,0,12
7922,2018,Syrian Arab Rep.,Kazakhstan,15,14,0,29
7923,2018,Uzbekistan,Kazakhstan,15,0,0,15
7925,2018,Afghanistan,Kenya,8,10,0,18
7926,2018,Angola,Kenya,0,5,0,5
7927,2018,Egypt,Kenya,0,9,0,9
7928,2018,Burundi,Kenya,4872,8448,0,13320
7929,2018,Central African Rep.,Kenya,0,5,0,5
7930,2018,Cameroon,Kenya,0,46,0,46
7931,2018,Congo,Kenya,59,94,0,153
7932,2018,Dem. Rep. of the Congo,Kenya,24586,16719,0,41305
7933,2018,Eritrea,Kenya,707,1099,0,1806
7934,2018,Ethiopia,Kenya,18115,9584,0,27699
7935,2018,Cote d'Ivoire,Kenya,0,6,0,6
7936,2018,India,Kenya,0,5,0,5
7937,2018,Iraq,Kenya,5,0,0,5
7938,2018,Sri Lanka,Kenya,9,0,0,9
7939,2018,Mozambique,Kenya,7,0,0,7
7940,2018,Nigeria,Kenya,6,15,0,21
7941,2018,Pakistan,Kenya,9,5,0,14
7942,2018,Rwanda,Kenya,648,1092,0,1740
7943,2018,Sierra Leone,Kenya,5,0,0,5
7944,2018,Somalia,Kenya,252498,4822,0,257320
7945,2018,Sudan,Kenya,3582,6524,0,10106
7946,2018,South Sudan,Kenya,115202,83,0,115285
7947,2018,Syrian Arab Rep.,Kenya,0,11,0,11
7948,2018,United Rep. of Tanzania,Kenya,11,28,0,39
7949,2018,Türkiye,Kenya,0,59,0,59
7950,2018,Uganda,Kenya,843,1569,0,2412
7951,2018,Yemen,Kenya,66,213,0,279
7952,2018,Zimbabwe,Kenya,5,7,0,12
7954,2018,Afghanistan,Kyrgyzstan,223,34,0,257
7955,2018,China,Kyrgyzstan,0,5,0,5
7956,2018,Iraq,Kyrgyzstan,5,5,0,10
7957,2018,Syrian Arab Rep.,Kyrgyzstan,77,14,0,91
7958,2018,Tajikistan,Kyrgyzstan,5,0,0,5
7959,2018,Türkiye,Kyrgyzstan,0,31,0,31
7960,2018,Ukraine,Kyrgyzstan,19,6,0,25
7961,2018,Uzbekistan,Kyrgyzstan,0,10,0,10
7963,2018,Afghanistan,Rep. of Korea,38,31,0,69
7964,2018,Algeria,Rep. of Korea,6,129,0,135
7965,2018,Angola,Rep. of Korea,5,59,0,64
7966,2018,Egypt,Rep. of Korea,26,1115,0,1141
7967,2018,Argentina,Rep. of Korea,0,5,0,5
7968,2018,Azerbaijan,Rep. of Korea,0,5,0,5
7969,2018,Burundi,Rep. of Korea,37,9,0,46
7970,2018,Benin,Rep. of Korea,0,5,0,5
7971,2018,Bangladesh,Rep. of Korea,108,845,0,953
7972,2018,Burkina Faso,Rep. of Korea,0,18,0,18
7973,2018,Bolivia (Plurinational State of),Rep. of Korea,0,5,0,5
7974,2018,Brazil,Rep. of Korea,0,5,0,5
7975,2018,Cambodia,Rep. of Korea,0,53,0,53
7976,2018,China,Rep. of Korea,43,1620,0,1663
7977,2018,Cameroon,Rep. of Korea,20,238,0,258
7978,2018,Congo,Rep. of Korea,0,7,0,7
7979,2018,Dem. Rep. of the Congo,Rep. of Korea,57,31,0,88
7980,2018,Colombia,Rep. of Korea,0,5,0,5
7981,2018,Ecuador,Rep. of Korea,0,5,0,5
7982,2018,Eritrea,Rep. of Korea,9,0,0,9
7983,2018,Ethiopia,Rep. of Korea,147,102,0,249
7984,2018,Gabon,Rep. of Korea,0,5,0,5
7985,2018,Gambia,Rep. of Korea,0,102,0,102
7986,2018,Palestinian,Rep. of Korea,5,5,0,10
7987,2018,Ghana,Rep. of Korea,7,294,0,301
7988,2018,Guinea-Bissau,Rep. of Korea,0,15,0,15
7989,2018,Guinea,Rep. of Korea,0,152,0,152
7990,2018,Haiti,Rep. of Korea,0,7,0,7
7991,2018,Cote d'Ivoire,Rep. of Korea,33,32,0,65
7992,2018,India,Rep. of Korea,0,1657,0,1657
7993,2018,Indonesia,Rep. of Korea,0,22,0,22
7994,2018,Iran (Islamic Rep. of),Rep. of Korea,55,90,0,145
7995,2018,Iraq,Rep. of Korea,27,18,0,45
7996,2018,Jordan,Rep. of Korea,7,8,0,15
7997,2018,Kazakhstan,Rep. of Korea,5,2942,0,2947
7998,2018,Kenya,Rep. of Korea,5,28,0,33
7999,2018,Kyrgyzstan,Rep. of Korea,0,151,0,151
8000,2018,Lao People's Dem. Rep.,Rep. of Korea,0,6,0,6
8001,2018,Liberia,Rep. of Korea,11,328,0,339
8002,2018,Libya,Rep. of Korea,6,7,0,13
8003,2018,Sri Lanka,Rep. of Korea,8,215,0,223
8004,2018,Mali,Rep. of Korea,7,102,0,109
8005,2018,Malaysia,Rep. of Korea,0,1452,0,1452
8006,2018,Mongolia,Rep. of Korea,0,523,0,523
8007,2018,Morocco,Rep. of Korea,5,362,0,367
8008,2018,Mozambique,Rep. of Korea,0,11,0,11
8009,2018,Myanmar,Rep. of Korea,328,27,0,355
8010,2018,Nepal,Rep. of Korea,5,226,0,231
8011,2018,Nicaragua,Rep. of Korea,0,5,0,5
8012,2018,Nigeria,Rep. of Korea,10,637,0,647
8013,2018,Pakistan,Rep. of Korea,102,1507,0,1609
8014,2018,Peru,Rep. of Korea,0,5,0,5
8015,2018,Philippines,Rep. of Korea,0,592,0,592
8016,2018,South Africa,Rep. of Korea,0,159,0,159
8017,2018,Russian Federation,Rep. of Korea,13,2010,0,2023
8018,2018,Rwanda,Rep. of Korea,0,20,0,20
8019,2018,Saudi Arabia,Rep. of Korea,0,6,0,6
8020,2018,Senegal,Rep. of Korea,0,164,0,164
8021,2018,Sierra Leone,Rep. of Korea,0,9,0,9
8022,2018,Somalia,Rep. of Korea,5,0,0,5
8023,2018,Viet Nam,Rep. of Korea,0,118,0,118
8024,2018,Sudan,Rep. of Korea,19,36,0,55
8025,2018,South Sudan,Rep. of Korea,0,6,0,6
8026,2018,Eswatini,Rep. of Korea,0,5,0,5
8027,2018,Syrian Arab Rep.,Rep. of Korea,1177,59,0,1236
8028,2018,United Rep. of Tanzania,Rep. of Korea,5,50,0,55
8029,2018,Thailand,Rep. of Korea,9,452,0,461
8030,2018,Tajikistan,Rep. of Korea,0,16,0,16
8031,2018,Togo,Rep. of Korea,0,13,0,13
8032,2018,Tunisia,Rep. of Korea,0,82,0,82
8033,2018,Türkiye,Rep. of Korea,0,178,0,178
8034,2018,Uganda,Rep. of Korea,34,78,0,112
8035,2018,Ukraine,Rep. of Korea,14,59,0,73
8036,2018,United States of America,Rep. of Korea,0,5,0,5
8037,2018,Uzbekistan,Rep. of Korea,9,150,0,159
8038,2018,Venezuela (Bolivarian Republic of),Rep. of Korea,0,8,0,8
8039,2018,Yemen,Rep. of Korea,483,308,0,791
8040,2018,Zimbabwe,Rep. of Korea,0,11,0,11
8042,2018,Egypt,Kuwait,0,18,0,18
8043,2018,Djibouti,Kuwait,0,5,0,5
8044,2018,Eritrea,Kuwait,0,29,0,29
8045,2018,Ethiopia,Kuwait,0,11,0,11
8046,2018,Palestinian,Kuwait,5,5,0,10
8047,2018,Iran (Islamic Rep. of),Kuwait,9,83,0,92
8048,2018,Iraq,Kuwait,351,283,0,634
8049,2018,Jordan,Kuwait,0,6,0,6
8050,2018,Lebanon,Kuwait,0,5,0,5
8051,2018,Sri Lanka,Kuwait,0,6,0,6
8052,2018,Pakistan,Kuwait,0,12,0,12
8053,2018,Philippines,Kuwait,0,5,0,5
8054,2018,Somalia,Kuwait,228,434,0,662
8055,2018,Sudan,Kuwait,0,17,0,17
8056,2018,Syrian Arab Rep.,Kuwait,73,50,0,123
8057,2018,Ukraine,Kuwait,0,5,0,5
8058,2018,Yemen,Kuwait,5,9,0,14
8060,2018,Dem. Rep. of the Congo,Liberia,10,13,0,23
8061,2018,Cote d'Ivoire,Liberia,9051,0,0,9051
8062,2018,Iraq,Liberia,0,5,0,5
8063,2018,Mali,Liberia,19,0,0,19
8064,2018,Nigeria,Liberia,0,7,0,7
8065,2018,Rwanda,Liberia,0,5,0,5
8066,2018,Sudan,Liberia,8,0,0,8
8067,2018,Syrian Arab Rep.,Liberia,10,5,0,15
8068,2018,Togo,Liberia,5,0,0,5
8069,2018,Türkiye,Liberia,0,5,0,5
8070,2018,Afghanistan,Libya,0,11,0,11
8071,2018,Algeria,Libya,5,0,0,5
8072,2018,Chad,Libya,15,47,0,62
8073,2018,Congo,Libya,0,5,0,5
8074,2018,Dem. Rep. of the Congo,Libya,10,8,0,18
8075,2018,Eritrea,Libya,509,7261,0,7770
8076,2018,Ethiopia,Libya,19,1157,0,1176
8077,2018,Palestinian,Libya,4555,1984,0,6539
8078,2018,Cote d'Ivoire,Libya,0,5,0,5
8079,2018,Iraq,Libya,1994,648,0,2642
8080,2018,Liberia,Libya,16,0,0,16
8081,2018,Libya,Libya,0,0,170491,0
8082,2018,Morocco,Libya,0,5,0,5
8083,2018,Somalia,Libya,161,3106,0,3267
8084,2018,Sudan,Libya,956,9834,0,10790
8085,2018,South Sudan,Libya,0,116,0,116
8086,2018,Syrian Arab Rep.,Libya,552,23173,0,23725
8087,2018,Yemen,Libya,0,43,0,43
8088,2018,Afghanistan,Lebanon,17,6,0,23
8089,2018,Algeria,Lebanon,0,0,0,0
8090,2018,Egypt,Lebanon,70,246,0,316
8091,2018,Armenia,Lebanon,0,0,0,0
8092,2018,Bahrain,Lebanon,25,12,0,37
8093,2018,Benin,Lebanon,0,5,0,5
8094,2018,Bangladesh,Lebanon,0,50,0,50
8095,2018,Cameroon,Lebanon,0,33,0,33
8096,2018,Congo,Lebanon,0,11,0,11
8097,2018,Dem. Rep. of the Congo,Lebanon,0,5,0,5
8098,2018,Eritrea,Lebanon,17,32,0,49
8099,2018,Ethiopia,Lebanon,39,486,0,525
8100,2018,Gambia,Lebanon,0,12,0,12
8101,2018,Palestinian,Lebanon,0,5,0,5
8102,2018,Cote d'Ivoire,Lebanon,0,13,0,13
8103,2018,India,Lebanon,0,8,0,8
8104,2018,Iran (Islamic Rep. of),Lebanon,25,30,0,55
8105,2018,Iraq,Lebanon,4458,13976,0,18434
8106,2018,Jordan,Lebanon,29,66,0,95
8107,2018,Kenya,Lebanon,0,20,0,20
8108,2018,Kuwait,Lebanon,0,9,0,9
8109,2018,Libya,Lebanon,9,13,0,22
8110,2018,Sri Lanka,Lebanon,0,7,0,7
8111,2018,Mali,Lebanon,0,5,0,5
8112,2018,Morocco,Lebanon,0,0,0,0
8113,2018,Nigeria,Lebanon,0,92,0,92
8114,2018,Pakistan,Lebanon,5,5,0,10
8115,2018,Philippines,Lebanon,0,28,0,28
8116,2018,Saudi Arabia,Lebanon,13,5,0,18
8117,2018,Somalia,Lebanon,18,9,0,27
8118,2018,Sudan,Lebanon,668,1060,0,1728
8119,2018,South Sudan,Lebanon,42,0,0,42
8120,2018,Syrian Arab Rep.,Lebanon,944181,5,0,944186
8121,2018,Tunisia,Lebanon,11,0,0,11
8122,2018,Türkiye,Lebanon,8,9,0,17
8123,2018,Ukraine,Lebanon,0,5,0,5
8124,2018,Yemen,Lebanon,18,136,0,154
8125,2018,Dem. Rep. of the Congo,Lesotho,41,36,0,77
8126,2018,Eritrea,Lesotho,5,0,0,5
8127,2018,Ethiopia,Lesotho,10,0,0,10
8128,2018,Afghanistan,Liechtenstein,5,0,0,5
8129,2018,Armenia,Liechtenstein,8,0,0,8
8130,2018,Belarus,Liechtenstein,0,5,0,5
8131,2018,China,Liechtenstein,28,6,0,34
8132,2018,Eritrea,Liechtenstein,12,5,0,17
8133,2018,Georgia,Liechtenstein,0,9,0,9
8134,2018,Iran (Islamic Rep. of),Liechtenstein,5,6,0,11
8135,2018,Iraq,Liechtenstein,7,0,0,7
8136,2018,North Macedonia,Liechtenstein,0,10,0,10
8137,2018,Nigeria,Liechtenstein,0,5,0,5
8138,2018,Serbia and Kosovo: S/RES/1244 (1999),Liechtenstein,36,10,0,46
8139,2018,Somalia,Liechtenstein,28,5,0,33
8140,2018,Syrian Arab Rep.,Liechtenstein,32,0,0,32
8141,2018,Ukraine,Liechtenstein,5,9,0,14
8142,2018,Afghanistan,Sri Lanka,146,34,0,180
8143,2018,Palestinian,Sri Lanka,9,0,0,9
8144,2018,Iran (Islamic Rep. of),Sri Lanka,18,12,0,30
8145,2018,Sri Lanka,Sri Lanka,0,0,35473,0
8146,2018,Maldives,Sri Lanka,6,5,0,11
8147,2018,Myanmar,Sri Lanka,33,0,0,33
8148,2018,Nigeria,Sri Lanka,0,7,0,7
8149,2018,Pakistan,Sri Lanka,558,676,0,1234
8150,2018,Sudan,Sri Lanka,0,5,0,5
8151,2018,Syrian Arab Rep.,Sri Lanka,14,0,0,14
8152,2018,Yemen,Sri Lanka,12,5,0,17
8153,2018,Afghanistan,Lithuania,222,20,0,242
8154,2018,Armenia,Lithuania,5,6,0,11
8155,2018,Azerbaijan,Lithuania,13,18,0,31
8156,2018,Belarus,Lithuania,35,5,0,40
8157,2018,Cameroon,Lithuania,5,0,0,5
8158,2018,Cuba,Lithuania,5,0,0,5
8159,2018,Eritrea,Lithuania,40,0,0,40
8160,2018,Ethiopia,Lithuania,5,0,0,5
8161,2018,Georgia,Lithuania,5,0,0,5
8162,2018,Iran (Islamic Rep. of),Lithuania,6,13,0,19
8163,2018,Iraq,Lithuania,59,23,0,82
8164,2018,Kyrgyzstan,Lithuania,0,12,0,12
8165,2018,Sri Lanka,Lithuania,10,14,0,24
8166,2018,Rep. of Moldova,Lithuania,0,5,0,5
8167,2018,Nigeria,Lithuania,5,7,0,12
8168,2018,Pakistan,Lithuania,5,0,0,5
8169,2018,Russian Federation,Lithuania,659,46,0,705
8170,2018,Somalia,Lithuania,22,0,0,22
8171,2018,Syrian Arab Rep.,Lithuania,435,10,0,445
8172,2018,Tajikistan,Lithuania,53,70,0,123
8173,2018,Türkiye,Lithuania,27,12,0,39
8174,2018,Ukraine,Lithuania,64,7,0,71
8175,2018,Uzbekistan,Lithuania,16,0,0,16
8177,2018,Afghanistan,Luxembourg,43,115,0,158
8178,2018,Albania,Luxembourg,82,25,0,107
8179,2018,Algeria,Luxembourg,0,40,0,40
8180,2018,Angola,Luxembourg,15,0,0,15
8181,2018,Egypt,Luxembourg,5,10,0,15
8182,2018,Armenia,Luxembourg,6,0,0,6
8183,2018,Azerbaijan,Luxembourg,15,0,0,15
8184,2018,Benin,Luxembourg,0,10,0,10
8185,2018,Bhutan,Luxembourg,5,0,0,5
8186,2018,Burkina Faso,Luxembourg,0,5,0,5
8187,2018,Belarus,Luxembourg,7,10,0,17
8188,2018,Bosnia and Herzegovina,Luxembourg,7,5,0,12
8189,2018,China,Luxembourg,5,0,0,5
8190,2018,Cameroon,Luxembourg,12,20,0,32
8191,2018,Congo,Luxembourg,5,0,0,5
8192,2018,Dem. Rep. of the Congo,Luxembourg,38,20,0,58
8193,2018,Eritrea,Luxembourg,79,300,0,379
8194,2018,Ethiopia,Luxembourg,43,25,0,68
8195,2018,Gabon,Luxembourg,5,0,0,5
8196,2018,Gambia,Luxembourg,6,5,0,11
8197,2018,Georgia,Luxembourg,0,40,0,40
8198,2018,Guinea,Luxembourg,10,40,0,50
8199,2018,Cote d'Ivoire,Luxembourg,6,20,0,26
8200,2018,Iran (Islamic Rep. of),Luxembourg,148,40,0,188
8201,2018,Iraq,Luxembourg,280,115,0,395
8202,2018,Jordan,Luxembourg,0,5,0,5
8203,2018,Dem. People's Rep. of Korea,Luxembourg,12,0,0,12
8204,2018,Kuwait,Luxembourg,0,5,0,5
8205,2018,Libya,Luxembourg,5,10,0,15
8206,2018,Lebanon,Luxembourg,0,5,0,5
8207,2018,Sri Lanka,Luxembourg,5,0,0,5
8208,2018,Mauritania,Luxembourg,0,5,0,5
8209,2018,North Macedonia,Luxembourg,0,10,0,10
8210,2018,Rep. of Moldova,Luxembourg,0,5,0,5
8211,2018,Mexico,Luxembourg,5,0,0,5
8212,2018,Mali,Luxembourg,0,10,0,10
8213,2018,Morocco,Luxembourg,0,50,0,50
8214,2018,Montenegro,Luxembourg,18,15,0,33
8215,2018,Niger,Luxembourg,0,5,0,5
8216,2018,Nigeria,Luxembourg,10,20,0,30
8217,2018,Pakistan,Luxembourg,0,5,0,5
8218,2018,Peru,Luxembourg,5,0,0,5
8219,2018,Russian Federation,Luxembourg,33,15,0,48
8220,2018,Rwanda,Luxembourg,19,0,0,19
8221,2018,Serbia and Kosovo: S/RES/1244 (1999),Luxembourg,265,55,0,320
8222,2018,Senegal,Luxembourg,0,10,0,10
8223,2018,Somalia,Luxembourg,44,20,0,64
8224,2018,Sudan,Luxembourg,0,60,0,60
8225,2018,Syrian Arab Rep.,Luxembourg,686,160,0,846
8226,2018,Turkmenistan,Luxembourg,5,0,0,5
8227,2018,Togo,Luxembourg,5,10,0,15
8228,2018,Tunisia,Luxembourg,5,60,0,65
8229,2018,Türkiye,Luxembourg,24,40,0,64
8230,2018,Ukraine,Luxembourg,6,20,0,26
8231,2018,Venezuela (Bolivarian Republic of),Luxembourg,0,10,0,10
8232,2018,Yemen,Luxembourg,0,10,0,10
8235,2018,Afghanistan,Latvia,67,0,0,67
8236,2018,Egypt,Latvia,5,7,0,12
8237,2018,Azerbaijan,Latvia,6,5,0,11
8238,2018,Cuba,Latvia,0,5,0,5
8239,2018,Eritrea,Latvia,37,0,0,37
8240,2018,Palestinian,Latvia,5,0,0,5
8241,2018,Iran (Islamic Rep. of),Latvia,23,0,0,23
8242,2018,Iraq,Latvia,38,5,0,43
8243,2018,Kazakhstan,Latvia,5,0,0,5
8244,2018,Kyrgyzstan,Latvia,8,0,0,8
8245,2018,Lebanon,Latvia,5,0,0,5
8246,2018,Sri Lanka,Latvia,5,0,0,5
8247,2018,Nigeria,Latvia,5,0,0,5
8248,2018,Russian Federation,Latvia,33,23,0,56
8249,2018,Somalia,Latvia,5,0,0,5
8250,2018,Syrian Arab Rep.,Latvia,384,0,0,384
8251,2018,Tajikistan,Latvia,5,0,0,5
8252,2018,Türkiye,Latvia,19,0,0,19
8253,2018,Uzbekistan,Latvia,9,0,0,9
8255,2018,Afghanistan,Madagascar,5,0,0,5
8256,2018,Dem. Rep. of the Congo,Madagascar,0,9,0,9
8257,2018,Pakistan,Madagascar,12,35,0,47
8258,2018,Somalia,Madagascar,0,5,0,5
8259,2018,Türkiye,Madagascar,0,20,0,20
8260,2018,Yemen,Madagascar,22,21,0,43
8261,2018,Afghanistan,Mauritania,0,8,0,8
8262,2018,Algeria,Mauritania,0,5,0,5
8263,2018,Benin,Mauritania,0,5,0,5
8264,2018,Burkina Faso,Mauritania,0,5,0,5
8265,2018,Central African Rep.,Mauritania,558,92,0,650
8266,2018,Chad,Mauritania,5,0,0,5
8267,2018,China,Mauritania,0,6,0,6
8268,2018,Cameroon,Mauritania,0,44,0,44
8269,2018,Congo,Mauritania,8,13,0,21
8270,2018,Dem. Rep. of the Congo,Mauritania,43,10,0,53
8271,2018,Ethiopia,Mauritania,6,0,0,6
8272,2018,Gabon,Mauritania,0,5,0,5
8273,2018,Gambia,Mauritania,0,10,0,10
8274,2018,Palestinian,Mauritania,29,34,0,63
8275,2018,Ghana,Mauritania,0,10,0,10
8276,2018,Guinea-Bissau,Mauritania,0,35,0,35
8277,2018,Guinea,Mauritania,9,98,0,107
8278,2018,Cote d'Ivoire,Mauritania,259,83,0,342
8279,2018,Iraq,Mauritania,24,0,0,24
8280,2018,Liberia,Mauritania,7,23,0,30
8281,2018,Lebanon,Mauritania,5,0,0,5
8282,2018,Mali,Mauritania,55785,28,0,55813
8283,2018,Morocco,Mauritania,0,6,0,6
8284,2018,Niger,Mauritania,0,7,0,7
8285,2018,Nigeria,Mauritania,11,75,0,86
8286,2018,Senegal,Mauritania,57,58,0,115
8287,2018,Sierra Leone,Mauritania,0,326,0,326
8288,2018,Sudan,Mauritania,11,17,0,28
8289,2018,South Sudan,Mauritania,5,0,0,5
8290,2018,Syrian Arab Rep.,Mauritania,332,47,0,379
8291,2018,Togo,Mauritania,24,40,0,64
8292,2018,Türkiye,Mauritania,0,24,0,24
8293,2018,Ukraine,Mauritania,5,0,0,5
8294,2018,Western Sahara,Mauritania,26000,0,0,26000
8295,2018,Yemen,Mauritania,0,12,0,12
8296,2018,Afghanistan,North Macedonia,5,0,0,5
8297,2018,Congo,North Macedonia,5,0,0,5
8298,2018,Iraq,North Macedonia,0,5,0,5
8299,2018,Pakistan,North Macedonia,5,0,0,5
8300,2018,Serbia and Kosovo: S/RES/1244 (1999),North Macedonia,381,0,0,381
8301,2018,Syrian Arab Rep.,North Macedonia,17,0,0,17
8304,2018,Afghanistan,Rep. of Moldova,18,6,0,24
8305,2018,Egypt,Rep. of Moldova,5,0,0,5
8306,2018,Armenia,Rep. of Moldova,19,5,0,24
8307,2018,Azerbaijan,Rep. of Moldova,5,0,0,5
8308,2018,Bangladesh,Rep. of Moldova,0,13,0,13
8309,2018,Palestinian,Rep. of Moldova,5,0,0,5
8310,2018,Iran (Islamic Rep. of),Rep. of Moldova,5,0,0,5
8311,2018,Iraq,Rep. of Moldova,22,0,0,22
8312,2018,Kyrgyzstan,Rep. of Moldova,11,0,0,11
8313,2018,Russian Federation,Rep. of Moldova,5,12,0,17
8314,2018,Sudan,Rep. of Moldova,9,0,0,9
8315,2018,Syrian Arab Rep.,Rep. of Moldova,213,5,0,218
8316,2018,Tajikistan,Rep. of Moldova,7,0,0,7
8317,2018,Türkiye,Rep. of Moldova,12,32,0,44
8318,2018,Ukraine,Rep. of Moldova,58,10,0,68
8319,2018,Uzbekistan,Rep. of Moldova,10,10,0,20
8320,2018,Yemen,Rep. of Moldova,5,0,0,5
8322,2018,Albania,Mexico,8,0,0,8
8323,2018,Angola,Mexico,5,0,0,5
8324,2018,Egypt,Mexico,5,0,0,5
8325,2018,Argentina,Mexico,5,5,0,10
8326,2018,Bangladesh,Mexico,5,0,0,5
8327,2018,Burkina Faso,Mexico,0,6,0,6
8328,2018,Belize,Mexico,0,5,0,5
8329,2018,Cambodia,Mexico,24,44,0,68
8330,2018,China,Mexico,5,5,0,10
8331,2018,Chile,Mexico,0,5,0,5
8332,2018,Congo,Mexico,20,7,0,27
8333,2018,Dem. Rep. of the Congo,Mexico,63,5,0,68
8334,2018,Colombia,Mexico,311,186,0,497
8335,2018,Costa Rica,Mexico,0,5,0,5
8336,2018,Cuba,Mexico,79,215,0,294
8337,2018,Dominican Rep.,Mexico,12,8,0,20
8338,2018,Ecuador,Mexico,0,14,0,14
8339,2018,Eritrea,Mexico,7,0,0,7
8340,2018,Ethiopia,Mexico,5,0,0,5
8341,2018,Palestinian,Mexico,5,0,0,5
8342,2018,Ghana,Mexico,7,28,0,35
8343,2018,Guatemala,Mexico,847,1039,0,1886
8344,2018,Guinea,Mexico,5,9,0,14
8345,2018,Haiti,Mexico,187,388,0,575
8346,2018,Honduras,Mexico,4656,10569,0,15225
8347,2018,Cote d'Ivoire,Mexico,5,0,0,5
8348,2018,India,Mexico,12,5,0,17
8349,2018,Iran (Islamic Rep. of),Mexico,38,0,0,38
8350,2018,Iraq,Mexico,43,5,0,48
8351,2018,Jamaica,Mexico,5,5,0,10
8352,2018,Sri Lanka,Mexico,20,15,0,35
8353,2018,Nicaragua,Mexico,100,1074,0,1174
8354,2018,Nigeria,Mexico,30,16,0,46
8355,2018,Pakistan,Mexico,9,5,0,14
8356,2018,Panama,Mexico,5,0,0,5
8357,2018,Peru,Mexico,12,7,0,19
8358,2018,Portugal,Mexico,5,0,0,5
8359,2018,Romania,Mexico,7,0,0,7
8360,2018,South Africa,Mexico,0,5,0,5
8361,2018,Russian Federation,Mexico,30,9,0,39
8362,2018,El Salvador,Mexico,5155,4527,0,9682
8363,2018,Somalia,Mexico,0,5,0,5
8364,2018,Spain,Mexico,0,5,0,5
8365,2018,Syrian Arab Rep.,Mexico,28,5,0,33
8366,2018,Türkiye,Mexico,7,0,0,7
8367,2018,Uganda,Mexico,0,15,0,15
8368,2018,Ukraine,Mexico,18,5,0,23
8369,2018,Uruguay,Mexico,0,5,0,5
8370,2018,United States of America,Mexico,7,33,0,40
8371,2018,Venezuela (Bolivarian Republic of),Mexico,4721,5523,0,10244
8372,2018,Yemen,Mexico,12,21,0,33
8375,2018,Burundi,Mali,7,7,0,14
8376,2018,Bangladesh,Mali,0,22,0,22
8377,2018,Burkina Faso,Mali,8457,0,0,8457
8378,2018,Central African Rep.,Mali,854,406,0,1260
8379,2018,Cameroon,Mali,0,5,0,5
8380,2018,Congo,Mali,24,5,0,29
8381,2018,Dem. Rep. of the Congo,Mali,234,69,0,303
8382,2018,Eritrea,Mali,5,0,0,5
8383,2018,Cote d'Ivoire,Mali,583,46,0,629
8384,2018,Mauritania,Mali,15319,0,0,15319
8385,2018,Mali,Mali,0,0,120298,0
8386,2018,Niger,Mali,1024,0,0,1024
8387,2018,Nigeria,Mali,0,5,0,5
8388,2018,Pakistan,Mali,0,9,0,9
8389,2018,Rwanda,Mali,8,0,0,8
8390,2018,Syrian Arab Rep.,Mali,9,330,0,339
8391,2018,Togo,Mali,14,8,0,22
8392,2018,Türkiye,Mali,0,5,0,5
8393,2018,Afghanistan,Malaysia,647,1070,0,1717
8394,2018,Egypt,Malaysia,8,23,0,31
8395,2018,Austria,Malaysia,5,0,0,5
8396,2018,Bangladesh,Malaysia,31,10,0,41
8397,2018,Cambodia,Malaysia,72,0,0,72
8398,2018,Central African Rep.,Malaysia,0,10,0,10
8399,2018,China,Malaysia,27,14,0,41
8400,2018,Cameroon,Malaysia,0,6,0,6
8401,2018,Congo,Malaysia,0,5,0,5
8402,2018,Dem. Rep. of the Congo,Malaysia,0,7,0,7
8403,2018,Eritrea,Malaysia,5,10,0,15
8404,2018,Ethiopia,Malaysia,10,5,0,15
8405,2018,Palestinian,Malaysia,226,531,0,757
8406,2018,United Kingdom of Great Britain and Northern Ireland,Malaysia,5,0,0,5
8407,2018,Guinea,Malaysia,0,11,0,11
8408,2018,Cote d'Ivoire,Malaysia,5,0,0,5
8409,2018,India,Malaysia,0,5,0,5
8410,2018,Indonesia,Malaysia,926,17,0,943
8411,2018,Iran (Islamic Rep. of),Malaysia,210,170,0,380
8412,2018,Iraq,Malaysia,458,966,0,1424
8413,2018,Jordan,Malaysia,10,5,0,15
8414,2018,Lao People's Dem. Rep.,Malaysia,0,5,0,5
8415,2018,Liberia,Malaysia,10,13,0,23
8416,2018,Libya,Malaysia,5,25,0,30
8417,2018,Lebanon,Malaysia,5,0,0,5
8418,2018,Sri Lanka,Malaysia,942,797,0,1739
8419,2018,Mali,Malaysia,5,0,0,5
8420,2018,Myanmar,Malaysia,114227,26448,0,140675
8421,2018,Nepal,Malaysia,10,0,0,10
8422,2018,Nigeria,Malaysia,5,10,0,15
8423,2018,Pakistan,Malaysia,1638,4310,0,5948
8424,2018,Philippines,Malaysia,20,0,0,20
8425,2018,Russian Federation,Malaysia,5,0,0,5
8426,2018,Sierra Leone,Malaysia,5,42,0,47
8427,2018,Somalia,Malaysia,1045,1872,0,2917
8428,2018,Sudan,Malaysia,102,171,0,273
8429,2018,South Sudan,Malaysia,11,27,0,38
8430,2018,Syrian Arab Rep.,Malaysia,421,2406,0,2827
8431,2018,Thailand,Malaysia,28,5,0,33
8432,2018,Togo,Malaysia,0,5,0,5
8433,2018,Türkiye,Malaysia,0,6,0,6
8434,2018,United Arab Emirates,Malaysia,0,5,0,5
8435,2018,Uganda,Malaysia,0,6,0,6
8436,2018,United States of America,Malaysia,8,0,0,8
8437,2018,Uzbekistan,Malaysia,0,9,0,9
8438,2018,Yemen,Malaysia,163,2769,0,2932
8439,2018,Zimbabwe,Malaysia,5,5,0,10
8441,2018,Burundi,Malawi,2514,5589,0,8103
8442,2018,Dem. Rep. of the Congo,Malawi,9187,13780,0,22967
8443,2018,Ethiopia,Malawi,5,42,0,47
8444,2018,Cote d'Ivoire,Malawi,5,0,0,5
8445,2018,Mozambique,Malawi,0,5,0,5
8446,2018,Rwanda,Malawi,2017,3597,0,5614
8447,2018,Somalia,Malawi,50,48,0,98
8448,2018,South Sudan,Malawi,5,0,0,5
8449,2018,United Rep. of Tanzania,Malawi,0,6,0,6
8450,2018,Türkiye,Malawi,0,48,0,48
8451,2018,Uganda,Malawi,0,13,0,13
8452,2018,Zimbabwe,Malawi,0,7,0,7
8453,2018,Afghanistan,Mongolia,5,0,0,5
8454,2018,Mongolia,Mongolia,0,0,0,0
8456,2018,Afghanistan,Morocco,5,5,0,10
8457,2018,Algeria,Morocco,6,10,0,16
8458,2018,Egypt,Morocco,0,5,0,5
8459,2018,Benin,Morocco,0,5,0,5
8460,2018,Burkina Faso,Morocco,0,6,0,6
8461,2018,Central African Rep.,Morocco,408,32,0,440
8462,2018,Chad,Morocco,5,5,0,10
8463,2018,Cameroon,Morocco,100,447,0,547
8464,2018,Congo,Morocco,20,45,0,65
8465,2018,Dem. Rep. of the Congo,Morocco,183,105,0,288
8466,2018,Eritrea,Morocco,9,5,0,14
8467,2018,Gabon,Morocco,0,5,0,5
8468,2018,Gambia,Morocco,5,5,0,10
8469,2018,Palestinian,Morocco,84,97,0,181
8470,2018,Ghana,Morocco,0,5,0,5
8471,2018,Guinea-Bissau,Morocco,0,5,0,5
8472,2018,Guinea,Morocco,35,393,0,428
8473,2018,Cote d'Ivoire,Morocco,320,203,0,523
8474,2018,Iraq,Morocco,153,5,0,158
8475,2018,Liberia,Morocco,5,25,0,30
8476,2018,Libya,Morocco,35,5,0,40
8477,2018,Lebanon,Morocco,0,10,0,10
8478,2018,Mauritania,Morocco,5,5,0,10
8479,2018,Mali,Morocco,19,69,0,88
8480,2018,Nigeria,Morocco,12,193,0,205
8481,2018,Pakistan,Morocco,9,5,0,14
8482,2018,Senegal,Morocco,79,75,0,154
8483,2018,Sierra Leone,Morocco,0,21,0,21
8484,2018,Somalia,Morocco,8,0,0,8
8485,2018,Sudan,Morocco,10,7,0,17
8486,2018,South Sudan,Morocco,159,0,0,159
8487,2018,Syrian Arab Rep.,Morocco,3506,0,0,3506
8488,2018,Togo,Morocco,0,11,0,11
8489,2018,Türkiye,Morocco,0,15,0,15
8490,2018,Yemen,Morocco,752,0,0,752
8491,2018,Angola,Mozambique,5,0,0,5
8492,2018,Burundi,Mozambique,1032,7176,0,8208
8493,2018,Central African Rep.,Mozambique,0,5,0,5
8494,2018,Congo,Mozambique,15,16,0,31
8495,2018,Dem. Rep. of the Congo,Mozambique,2907,6688,0,9595
8496,2018,Comoros,Mozambique,0,16,0,16
8497,2018,Eritrea,Mozambique,0,5,0,5
8498,2018,Ethiopia,Mozambique,7,11,0,18
8499,2018,Guinea,Mozambique,0,5,0,5
8500,2018,Mauritania,Mozambique,0,5,0,5
8501,2018,Rwanda,Mozambique,773,3162,0,3935
8502,2018,Somalia,Mozambique,161,3997,0,4158
8503,2018,Sudan,Mozambique,5,16,0,21
8504,2018,Uganda,Mozambique,5,31,0,36
8505,2018,Afghanistan,Malta,0,5,0,5
8506,2018,Algeria,Malta,0,7,0,7
8507,2018,Egypt,Malta,74,30,0,104
8508,2018,Armenia,Malta,0,5,0,5
8509,2018,Bangladesh,Malta,9,108,0,117
8510,2018,Burkina Faso,Malta,5,5,0,10
8511,2018,Belarus,Malta,9,0,0,9
8512,2018,Chad,Malta,8,10,0,18
8513,2018,China,Malta,17,0,0,17
8514,2018,Cameroon,Malta,10,6,0,16
8515,2018,Dem. Rep. of the Congo,Malta,5,0,0,5
8516,2018,Colombia,Malta,0,6,0,6
8517,2018,Eritrea,Malta,784,47,0,831
8518,2018,Ethiopia,Malta,174,32,0,206
8519,2018,Gambia,Malta,27,62,0,89
8520,2018,Palestinian,Malta,70,46,0,116
8521,2018,Georgia,Malta,5,10,0,15
8522,2018,Ghana,Malta,8,8,0,16
8523,2018,Guinea-Bissau,Malta,0,5,0,5
8524,2018,Guinea,Malta,0,23,0,23
8525,2018,Cote d'Ivoire,Malta,11,55,0,66
8526,2018,Iran (Islamic Rep. of),Malta,29,5,0,34
8527,2018,Iraq,Malta,78,6,0,84
8528,2018,Jordan,Malta,5,0,0,5
8529,2018,Liberia,Malta,6,5,0,11
8530,2018,Libya,Malta,2688,297,0,2985
8531,2018,Sri Lanka,Malta,7,10,0,17
8532,2018,North Macedonia,Malta,5,10,0,15
8533,2018,Mali,Malta,18,28,0,46
8534,2018,Morocco,Malta,29,17,0,46
8535,2018,Niger,Malta,0,21,0,21
8536,2018,Nigeria,Malta,124,30,0,154
8537,2018,Pakistan,Malta,57,46,0,103
8538,2018,Russian Federation,Malta,18,0,0,18
8539,2018,El Salvador,Malta,0,5,0,5
8540,2018,Saudi Arabia,Malta,5,0,0,5
8541,2018,Serbia and Kosovo: S/RES/1244 (1999),Malta,7,0,0,7
8542,2018,Senegal,Malta,5,24,0,29
8543,2018,Sierra Leone,Malta,5,10,0,15
8544,2018,Somalia,Malta,1770,168,0,1938
8545,2018,Sudan,Malta,194,186,0,380
8546,2018,South Sudan,Malta,22,0,0,22
8547,2018,Syrian Arab Rep.,Malta,1497,370,0,1867
8548,2018,Togo,Malta,5,8,0,13
8549,2018,Tunisia,Malta,12,7,0,19
8550,2018,Türkiye,Malta,5,13,0,18
8551,2018,Uganda,Malta,0,5,0,5
8552,2018,Ukraine,Malta,136,43,0,179
8553,2018,Uzbekistan,Malta,0,5,0,5
8554,2018,Venezuela (Bolivarian Republic of),Malta,5,61,0,66
8555,2018,Yemen,Malta,0,5,0,5
8556,2018,Zimbabwe,Malta,5,5,0,10
8559,2018,Algeria,Montenegro,0,19,0,19
8560,2018,Belarus,Montenegro,5,0,0,5
8561,2018,Bosnia and Herzegovina,Montenegro,20,0,0,20
8562,2018,Cuba,Montenegro,8,0,0,8
8563,2018,Palestinian,Montenegro,0,6,0,6
8564,2018,Ghana,Montenegro,5,0,0,5
8565,2018,Croatia,Montenegro,10,0,0,10
8566,2018,Iran (Islamic Rep. of),Montenegro,5,12,0,17
8567,2018,Iraq,Montenegro,0,7,0,7
8568,2018,Libya,Montenegro,0,24,0,24
8569,2018,Morocco,Montenegro,0,20,0,20
8570,2018,Nepal,Montenegro,0,5,0,5
8571,2018,Pakistan,Montenegro,0,22,0,22
8572,2018,Serbia and Kosovo: S/RES/1244 (1999),Montenegro,658,0,0,658
8573,2018,Syrian Arab Rep.,Montenegro,5,47,0,52
8574,2018,Yemen,Montenegro,11,0,0,11
8577,2018,Dem. Rep. of the Congo,Mauritius,11,0,0,11
8578,2018,Syrian Arab Rep.,Mauritius,5,0,0,5
8579,2018,Myanmar,Myanmar,0,0,370306,0
8581,2018,Burundi,Namibia,246,87,0,333
8582,2018,Central African Rep.,Namibia,0,18,0,18
8583,2018,Cameroon,Namibia,5,12,0,17
8584,2018,Congo,Namibia,5,0,0,5
8585,2018,Dem. Rep. of the Congo,Namibia,1942,1320,0,3262
8586,2018,Nigeria,Namibia,0,5,0,5
8587,2018,Rwanda,Namibia,127,21,0,148
8588,2018,Somalia,Namibia,5,0,0,5
8589,2018,Sudan,Namibia,5,0,0,5
8590,2018,Uganda,Namibia,5,5,0,10
8591,2018,Zimbabwe,Namibia,54,48,0,102
8592,2018,Afghanistan,Nepal,55,0,0,55
8593,2018,Bangladesh,Nepal,10,0,0,10
8594,2018,Bhutan,Nepal,6626,0,0,6626
8595,2018,India,Nepal,0,0,0,0
8596,2018,Iran (Islamic Rep. of),Nepal,5,0,0,5
8597,2018,Sri Lanka,Nepal,20,0,0,20
8598,2018,Myanmar,Nepal,332,34,0,366
8599,2018,Nepal,Nepal,0,0,0,0
8600,2018,Pakistan,Nepal,218,17,0,235
8601,2018,Somalia,Nepal,29,0,0,29
8603,2018,Afghanistan,Netherlands,6267,538,0,6805
8604,2018,Albania,Netherlands,6,24,0,30
8605,2018,Algeria,Netherlands,16,325,0,341
8606,2018,Angola,Netherlands,51,5,0,56
8607,2018,Egypt,Netherlands,242,109,0,351
8608,2018,Argentina,Netherlands,5,0,0,5
8609,2018,Armenia,Netherlands,399,37,0,436
8610,2018,Azerbaijan,Netherlands,235,113,0,348
8611,2018,Bahrain,Netherlands,8,0,0,8
8612,2018,Burundi,Netherlands,141,5,0,146
8613,2018,Benin,Netherlands,5,5,0,10
8614,2018,Bangladesh,Netherlands,40,20,0,60
8615,2018,Bhutan,Netherlands,152,0,0,152
8616,2018,Burkina Faso,Netherlands,14,0,0,14
8617,2018,Belarus,Netherlands,51,111,0,162
8618,2018,Bosnia and Herzegovina,Netherlands,5,0,0,5
8619,2018,Cambodia,Netherlands,17,0,0,17
8620,2018,Central African Rep.,Netherlands,7,0,0,7
8621,2018,Chad,Netherlands,5,19,0,24
8622,2018,China,Netherlands,1106,122,0,1228
8623,2018,Cameroon,Netherlands,71,14,0,85
8624,2018,Congo,Netherlands,428,21,0,449
8625,2018,Dem. Rep. of the Congo,Netherlands,183,0,0,183
8626,2018,Colombia,Netherlands,29,36,0,65
8627,2018,Cuba,Netherlands,19,16,0,35
8628,2018,Ecuador,Netherlands,8,0,0,8
8629,2018,Eritrea,Netherlands,14931,765,0,15696
8630,2018,Ethiopia,Netherlands,524,45,0,569
8631,2018,Gambia,Netherlands,34,156,0,190
8632,2018,Palestinian,Netherlands,162,39,0,201
8633,2018,Georgia,Netherlands,43,46,0,89
8634,2018,Ghana,Netherlands,6,23,0,29
8635,2018,Guinea-Bissau,Netherlands,0,5,0,5
8636,2018,Guinea,Netherlands,627,179,0,806
8637,2018,Honduras,Netherlands,7,0,0,7
8638,2018,Cote d'Ivoire,Netherlands,258,25,0,283
8639,2018,India,Netherlands,6,6,0,12
8640,2018,Indonesia,Netherlands,0,5,0,5
8641,2018,Iran (Islamic Rep. of),Netherlands,4918,1921,0,6839
8642,2018,Iraq,Netherlands,9259,819,0,10078
8643,2018,Jamaica,Netherlands,189,0,0,189
8644,2018,Jordan,Netherlands,16,49,0,65
8645,2018,Kazakhstan,Netherlands,40,11,0,51
8646,2018,Kenya,Netherlands,38,7,0,45
8647,2018,Kyrgyzstan,Netherlands,19,0,0,19
8648,2018,Dem. People's Rep. of Korea,Netherlands,46,0,0,46
8649,2018,Kuwait,Netherlands,5,0,0,5
8650,2018,Lao People's Dem. Rep.,Netherlands,33,0,0,33
8651,2018,Liberia,Netherlands,64,5,0,69
8652,2018,Libya,Netherlands,280,202,0,482
8653,2018,Lebanon,Netherlands,36,43,0,79
8654,2018,Sri Lanka,Netherlands,635,54,0,689
8655,2018,Mauritania,Netherlands,7,0,0,7
8656,2018,Rep. of Moldova,Netherlands,0,229,0,229
8657,2018,Mali,Netherlands,16,12,0,28
8658,2018,Malaysia,Netherlands,7,0,0,7
8659,2018,Malawi,Netherlands,5,0,0,5
8660,2018,Mongolia,Netherlands,38,0,0,38
8661,2018,Morocco,Netherlands,44,327,0,371
8662,2018,Myanmar,Netherlands,567,22,0,589
8663,2018,Namibia,Netherlands,5,0,0,5
8664,2018,Nepal,Netherlands,239,0,0,239
8665,2018,Niger,Netherlands,6,9,0,15
8666,2018,Nicaragua,Netherlands,0,20,0,20
8667,2018,Nigeria,Netherlands,303,377,0,680
8668,2018,Pakistan,Netherlands,479,250,0,729
8669,2018,Peru,Netherlands,9,0,0,9
8670,2018,Russian Federation,Netherlands,284,132,0,416
8671,2018,Rwanda,Netherlands,54,7,0,61
8672,2018,El Salvador,Netherlands,0,8,0,8
8673,2018,Saudi Arabia,Netherlands,13,0,0,13
8674,2018,Serbia and Kosovo: S/RES/1244 (1999),Netherlands,25,0,0,25
8675,2018,Senegal,Netherlands,30,19,0,49
8676,2018,Sierra Leone,Netherlands,437,65,0,502
8677,2018,Somalia,Netherlands,14011,133,0,14144
8678,2018,Viet Nam,Netherlands,5,5,0,10
8679,2018,Sudan,Netherlands,819,145,0,964
8680,2018,Syrian Arab Rep.,Netherlands,32092,1687,0,33779
8681,2018,United Rep. of Tanzania,Netherlands,6,0,0,6
8682,2018,Tajikistan,Netherlands,34,32,0,66
8683,2018,Turkmenistan,Netherlands,5,0,0,5
8684,2018,Togo,Netherlands,29,0,0,29
8685,2018,Trinidad and Tobago,Netherlands,75,7,0,82
8686,2018,Tunisia,Netherlands,16,64,0,80
8687,2018,Türkiye,Netherlands,844,1090,0,1934
8688,2018,Uganda,Netherlands,531,129,0,660
8689,2018,Ukraine,Netherlands,23,31,0,54
8690,2018,United States of America,Netherlands,6,14,0,20
8691,2018,Uzbekistan,Netherlands,42,0,0,42
8692,2018,Venezuela (Bolivarian Republic of),Netherlands,0,128,0,128
8693,2018,Yemen,Netherlands,376,399,0,775
8694,2018,Zambia,Netherlands,8,0,0,8
8695,2018,Zimbabwe,Netherlands,30,0,0,30
8698,2018,Central African Rep.,Niger,59,91,0,150
8699,2018,Chad,Niger,165,858,0,1023
8700,2018,Cameroon,Niger,7,83,0,90
8701,2018,Congo,Niger,5,0,0,5
8702,2018,Dem. Rep. of the Congo,Niger,74,14,0,88
8703,2018,Eritrea,Niger,493,297,0,790
8704,2018,Ethiopia,Niger,48,80,0,128
8705,2018,Ghana,Niger,0,5,0,5
8706,2018,Guinea,Niger,0,15,0,15
8707,2018,Cote d'Ivoire,Niger,36,10,0,46
8708,2018,Iraq,Niger,6,0,0,6
8709,2018,Libya,Niger,7,6,0,13
8710,2018,Mali,Niger,55540,37,0,55577
8711,2018,Niger,Niger,0,0,156137,0
8712,2018,Nigeria,Niger,118868,135,0,119003
8713,2018,Pakistan,Niger,0,9,0,9
8714,2018,Rwanda,Niger,18,0,0,18
8715,2018,Somalia,Niger,52,200,0,252
8716,2018,Sudan,Niger,19,1687,0,1706
8717,2018,South Sudan,Niger,5,8,0,13
8718,2018,Syrian Arab Rep.,Niger,11,5,0,16
8719,2018,Togo,Niger,0,7,0,7
8720,2018,Colombia,Nicaragua,6,0,0,6
8721,2018,Cuba,Nicaragua,15,0,0,15
8722,2018,Guatemala,Nicaragua,9,0,0,9
8723,2018,Honduras,Nicaragua,74,26,0,100
8724,2018,El Salvador,Nicaragua,217,100,0,317
8725,2018,Afghanistan,Nigeria,5,0,0,5
8726,2018,Benin,Nigeria,0,5,0,5
8727,2018,Central African Rep.,Nigeria,432,190,0,622
8728,2018,Chad,Nigeria,87,35,0,122
8729,2018,Cameroon,Nigeria,32751,271,0,33022
8730,2018,Congo,Nigeria,5,5,0,10
8731,2018,Dem. Rep. of the Congo,Nigeria,624,212,0,836
8732,2018,Eritrea,Nigeria,29,5,0,34
8733,2018,Ethiopia,Nigeria,6,0,0,6
8734,2018,Palestinian,Nigeria,10,0,0,10
8735,2018,Ghana,Nigeria,5,7,0,12
8736,2018,Guinea-Bissau,Nigeria,5,0,0,5
8737,2018,Guinea,Nigeria,17,5,0,22
8738,2018,Cote d'Ivoire,Nigeria,123,19,0,142
8739,2018,Liberia,Nigeria,9,5,0,14
8740,2018,Lebanon,Nigeria,0,9,0,9
8741,2018,Mali,Nigeria,137,33,0,170
8742,2018,Niger,Nigeria,6,0,0,6
8743,2018,Nigeria,Nigeria,0,0,2167925,0
8744,2018,Sierra Leone,Nigeria,21,5,0,26
8745,2018,Sudan,Nigeria,49,5,0,54
8746,2018,Syrian Arab Rep.,Nigeria,224,75,0,299
8747,2018,Togo,Nigeria,20,22,0,42
8748,2018,Türkiye,Nigeria,162,32,0,194
8749,2018,Afghanistan,Norway,6065,193,0,6258
8750,2018,Albania,Norway,19,37,0,56
8751,2018,Algeria,Norway,8,0,0,8
8752,2018,Angola,Norway,14,5,0,19
8753,2018,Egypt,Norway,59,5,0,64
8754,2018,Armenia,Norway,0,5,0,5
8755,2018,Azerbaijan,Norway,27,0,0,27
8756,2018,Burundi,Norway,63,0,0,63
8757,2018,Bangladesh,Norway,8,15,0,23
8758,2018,Bulgaria,Norway,8,0,0,8
8759,2018,Central African Rep.,Norway,6,0,0,6
8760,2018,Chad,Norway,5,0,0,5
8761,2018,China,Norway,594,10,0,604
8762,2018,Cameroon,Norway,25,5,0,30
8763,2018,Congo,Norway,6,0,0,6
8764,2018,Dem. Rep. of the Congo,Norway,181,12,0,193
8765,2018,Colombia,Norway,10,6,0,16
8766,2018,Cuba,Norway,7,0,0,7
8767,2018,Eritrea,Norway,15246,124,0,15370
8768,2018,Ethiopia,Norway,1951,67,0,2018
8769,2018,Gambia,Norway,17,0,0,17
8770,2018,Georgia,Norway,5,0,0,5
8771,2018,Ghana,Norway,8,0,0,8
8772,2018,Guinea-Bissau,Norway,5,0,0,5
8773,2018,Guatemala,Norway,7,0,0,7
8774,2018,Guinea,Norway,51,0,0,51
8775,2018,Honduras,Norway,5,0,0,5
8776,2018,Cote d'Ivoire,Norway,15,0,0,15
8777,2018,Iran (Islamic Rep. of),Norway,1966,180,0,2146
8778,2018,Iraq,Norway,1989,138,0,2127
8779,2018,Israel,Norway,11,0,0,11
8780,2018,Jordan,Norway,7,0,0,7
8781,2018,Kazakhstan,Norway,11,5,0,16
8782,2018,Kenya,Norway,6,5,0,11
8783,2018,Kyrgyzstan,Norway,17,0,0,17
8784,2018,Liberia,Norway,14,5,0,19
8785,2018,Libya,Norway,58,5,0,63
8786,2018,Lebanon,Norway,26,5,0,31
8787,2018,Sri Lanka,Norway,171,10,0,181
8788,2018,Rep. of Moldova,Norway,5,0,0,5
8789,2018,Mali,Norway,8,0,0,8
8790,2018,Malaysia,Norway,0,5,0,5
8791,2018,Mongolia,Norway,5,6,0,11
8792,2018,Morocco,Norway,27,10,0,37
8793,2018,Montenegro,Norway,5,0,0,5
8794,2018,Myanmar,Norway,128,10,0,138
8795,2018,Nepal,Norway,7,0,0,7
8796,2018,Nicaragua,Norway,0,13,0,13
8797,2018,Nigeria,Norway,166,16,0,182
8798,2018,Pakistan,Norway,96,11,0,107
8799,2018,Peru,Norway,0,5,0,5
8800,2018,Philippines,Norway,6,5,0,11
8801,2018,Russian Federation,Norway,766,55,0,821
8802,2018,Rwanda,Norway,36,0,0,36
8803,2018,El Salvador,Norway,0,10,0,10
8804,2018,Saudi Arabia,Norway,6,0,0,6
8805,2018,Serbia and Kosovo: S/RES/1244 (1999),Norway,85,0,0,85
8806,2018,Sierra Leone,Norway,12,0,0,12
8807,2018,Somalia,Norway,7183,69,0,7252
8808,2018,Viet Nam,Norway,42,0,0,42
8809,2018,Sudan,Norway,1938,32,0,1970
8810,2018,South Sudan,Norway,14,5,0,19
8811,2018,Syrian Arab Rep.,Norway,13914,235,0,14149
8812,2018,United Rep. of Tanzania,Norway,5,0,0,5
8813,2018,Tajikistan,Norway,6,0,0,6
8814,2018,Turkmenistan,Norway,8,5,0,13
8815,2018,Tunisia,Norway,5,5,0,10
8816,2018,Türkiye,Norway,249,744,0,993
8817,2018,United Arab Emirates,Norway,0,5,0,5
8818,2018,Uganda,Norway,116,10,0,126
8819,2018,Ukraine,Norway,10,14,0,24
8820,2018,Uzbekistan,Norway,208,11,0,219
8821,2018,Venezuela (Bolivarian Republic of),Norway,7,24,0,31
8822,2018,Yemen,Norway,235,7,0,242
8823,2018,Zimbabwe,Norway,14,0,0,14
8825,2018,Afghanistan,Nauru,81,5,0,86
8826,2018,Bangladesh,Nauru,9,33,0,42
8827,2018,India,Nauru,11,11,0,22
8828,2018,Indonesia,Nauru,5,5,0,10
8829,2018,Iran (Islamic Rep. of),Nauru,316,203,0,519
8830,2018,Iraq,Nauru,43,13,0,56
8831,2018,Kuwait,Nauru,5,0,0,5
8832,2018,Lebanon,Nauru,14,0,0,14
8833,2018,Sri Lanka,Nauru,101,55,0,156
8834,2018,Malaysia,Nauru,5,5,0,10
8835,2018,Myanmar,Nauru,115,13,0,128
8836,2018,Nepal,Nauru,5,14,0,19
8837,2018,Pakistan,Nauru,120,26,0,146
8838,2018,Somalia,Nauru,56,9,0,65
8839,2018,Sudan,Nauru,13,0,0,13
8840,2018,Syrian Arab Rep.,Nauru,0,5,0,5
8842,2018,Afghanistan,New Zealand,47,5,0,52
8843,2018,Algeria,New Zealand,5,0,0,5
8844,2018,Egypt,New Zealand,28,0,0,28
8845,2018,Bahrain,New Zealand,24,0,0,24
8846,2018,Bangladesh,New Zealand,7,10,0,17
8847,2018,China,New Zealand,192,77,0,269
8848,2018,Chile,New Zealand,5,0,0,5
8849,2018,Cameroon,New Zealand,5,0,0,5
8850,2018,Congo,New Zealand,5,0,0,5
8851,2018,Dem. Rep. of the Congo,New Zealand,5,0,0,5
8852,2018,Colombia,New Zealand,26,7,0,33
8853,2018,Czechia,New Zealand,17,8,0,25
8854,2018,Eritrea,New Zealand,7,0,0,7
8855,2018,Ethiopia,New Zealand,10,5,0,15
8856,2018,Fiji,New Zealand,28,0,0,28
8857,2018,Palestinian,New Zealand,16,0,0,16
8858,2018,Hungary,New Zealand,8,0,0,8
8859,2018,India,New Zealand,8,34,0,42
8860,2018,Indonesia,New Zealand,5,0,0,5
8861,2018,Iran (Islamic Rep. of),New Zealand,144,15,0,159
8862,2018,Iraq,New Zealand,94,0,0,94
8863,2018,Jordan,New Zealand,8,0,0,8
8864,2018,Kuwait,New Zealand,7,0,0,7
8865,2018,Libya,New Zealand,22,0,0,22
8866,2018,Sri Lanka,New Zealand,62,31,0,93
8867,2018,Madagascar,New Zealand,5,0,0,5
8868,2018,Maldives,New Zealand,5,0,0,5
8869,2018,Mexico,New Zealand,5,0,0,5
8870,2018,Malaysia,New Zealand,5,9,0,14
8871,2018,Myanmar,New Zealand,7,5,0,12
8872,2018,Nepal,New Zealand,5,0,0,5
8873,2018,Pakistan,New Zealand,61,16,0,77
8874,2018,Philippines,New Zealand,0,5,0,5
8875,2018,South Africa,New Zealand,10,5,0,15
8876,2018,Russian Federation,New Zealand,19,7,0,26
8877,2018,El Salvador,New Zealand,5,0,0,5
8878,2018,Saudi Arabia,New Zealand,60,20,0,80
8879,2018,Somalia,New Zealand,16,0,0,16
8880,2018,Viet Nam,New Zealand,9,0,0,9
8881,2018,Sudan,New Zealand,5,5,0,10
8882,2018,Syrian Arab Rep.,New Zealand,68,0,0,68
8883,2018,Türkiye,New Zealand,53,7,0,60
8884,2018,Uganda,New Zealand,5,0,0,5
8885,2018,Uruguay,New Zealand,0,5,0,5
8886,2018,Yemen,New Zealand,8,0,0,8
8887,2018,Zimbabwe,New Zealand,23,6,0,29
8889,2018,Iraq,Oman,298,254,0,552
8890,2018,Pakistan,Oman,5,0,0,5
8891,2018,Syrian Arab Rep.,Oman,7,0,0,7
8892,2018,Afghanistan,Pakistan,1403521,5012,0,1408533
8893,2018,Algeria,Pakistan,22,0,0,22
8894,2018,Palestinian,Pakistan,21,0,0,21
8895,2018,Iran (Islamic Rep. of),Pakistan,38,19,0,57
8896,2018,Iraq,Pakistan,22,7,0,29
8897,2018,Myanmar,Pakistan,22,31,0,53
8898,2018,Pakistan,Pakistan,0,0,96384,0
8899,2018,Russian Federation,Pakistan,7,0,0,7
8900,2018,Somalia,Pakistan,181,13,0,194
8901,2018,Syrian Arab Rep.,Pakistan,29,6,0,35
8902,2018,Tajikistan,Pakistan,6,0,0,6
8903,2018,Türkiye,Pakistan,11,51,0,62
8904,2018,Yemen,Pakistan,128,31,0,159
8905,2018,Afghanistan,Panama,5,6,0,11
8906,2018,Armenia,Panama,0,6,0,6
8907,2018,Bangladesh,Panama,0,18,0,18
8908,2018,Belarus,Panama,7,5,0,12
8909,2018,Brazil,Panama,0,6,0,6
8910,2018,Bosnia and Herzegovina,Panama,5,0,0,5
8911,2018,Cameroon,Panama,8,5,0,13
8912,2018,Dem. Rep. of the Congo,Panama,5,0,0,5
8913,2018,Colombia,Panama,1691,1796,0,3487
8914,2018,Costa Rica,Panama,0,5,0,5
8915,2018,Cuba,Panama,120,1740,0,1860
8916,2018,Dominican Rep.,Panama,5,28,0,33
8917,2018,Ecuador,Panama,0,19,0,19
8918,2018,Eritrea,Panama,0,39,0,39
8919,2018,Guatemala,Panama,12,14,0,26
8920,2018,Haiti,Panama,19,0,0,19
8921,2018,Honduras,Panama,0,46,0,46
8922,2018,Croatia,Panama,5,0,0,5
8923,2018,Cote d'Ivoire,Panama,0,5,0,5
8924,2018,India,Panama,0,5,0,5
8925,2018,Iran (Islamic Rep. of),Panama,5,0,0,5
8926,2018,Italy,Panama,0,5,0,5
8927,2018,Kenya,Panama,0,7,0,7
8928,2018,Liberia,Panama,5,0,0,5
8929,2018,Sri Lanka,Panama,0,8,0,8
8930,2018,Mexico,Panama,5,0,0,5
8931,2018,Nepal,Panama,0,14,0,14
8932,2018,Nicaragua,Panama,173,3291,0,3464
8933,2018,Nigeria,Panama,10,35,0,45
8934,2018,Peru,Panama,23,5,0,28
8935,2018,El Salvador,Panama,342,1306,0,1648
8936,2018,Sierra Leone,Panama,5,0,0,5
8937,2018,Somalia,Panama,0,103,0,103
8938,2018,Sudan,Panama,5,0,0,5
8939,2018,Syrian Arab Rep.,Panama,0,12,0,12
8940,2018,Ukraine,Panama,0,5,0,5
8941,2018,Venezuela (Bolivarian Republic of),Panama,46,5068,0,5114
8942,2018,Bolivia (Plurinational State of),Paraguay,17,0,0,17
8943,2018,Colombia,Paraguay,35,5,0,40
8944,2018,Cuba,Paraguay,81,229,0,310
8945,2018,Iraq,Paraguay,6,0,0,6
8946,2018,Lebanon,Paraguay,0,5,0,5
8947,2018,Nigeria,Paraguay,0,5,0,5
8948,2018,Russian Federation,Paraguay,8,0,0,8
8949,2018,El Salvador,Paraguay,5,5,0,10
8950,2018,Viet Nam,Paraguay,6,0,0,6
8951,2018,Syrian Arab Rep.,Paraguay,63,22,0,85
8952,2018,Türkiye,Paraguay,5,0,0,5
8953,2018,Venezuela (Bolivarian Republic of),Paraguay,34,79,0,113
8954,2018,Angola,Peru,0,5,0,5
8955,2018,Argentina,Peru,0,11,0,11
8956,2018,Bangladesh,Peru,20,0,0,20
8957,2018,Bolivia (Plurinational State of),Peru,12,12,0,24
8958,2018,Brazil,Peru,5,5,0,10
8959,2018,Bosnia and Herzegovina,Peru,5,0,0,5
8960,2018,China,Peru,0,8,0,8
8961,2018,Chile,Peru,0,6,0,6
8962,2018,Cameroon,Peru,13,0,0,13
8963,2018,Congo,Peru,0,9,0,9
8964,2018,Dem. Rep. of the Congo,Peru,5,0,0,5
8965,2018,Colombia,Peru,623,780,0,1403
8966,2018,Costa Rica,Peru,0,5,0,5
8967,2018,Cuba,Peru,676,2254,0,2930
8968,2018,Dominican Rep.,Peru,16,35,0,51
8969,2018,Ecuador,Peru,5,69,0,74
8970,2018,Ethiopia,Peru,5,0,0,5
8971,2018,Gambia,Peru,5,0,0,5
8972,2018,Palestinian,Peru,37,8,0,45
8973,2018,Ghana,Peru,5,0,0,5
8974,2018,Haiti,Peru,69,73,0,142
8975,2018,Honduras,Peru,0,5,0,5
8976,2018,Hungary,Peru,6,0,0,6
8977,2018,India,Peru,6,0,0,6
8978,2018,Iran (Islamic Rep. of),Peru,10,5,0,15
8979,2018,Iraq,Peru,17,0,0,17
8980,2018,Italy,Peru,0,5,0,5
8981,2018,Sri Lanka,Peru,0,6,0,6
8982,2018,Mexico,Peru,0,5,0,5
8983,2018,Nepal,Peru,0,5,0,5
8984,2018,Nicaragua,Peru,0,12,0,12
8985,2018,Nigeria,Peru,16,9,0,25
8986,2018,Pakistan,Peru,0,11,0,11
8987,2018,Panama,Peru,0,8,0,8
8988,2018,Paraguay,Peru,0,5,0,5
8989,2018,Philippines,Peru,0,27,0,27
8990,2018,Poland,Peru,5,5,0,10
8991,2018,Portugal,Peru,0,11,0,11
8992,2018,Russian Federation,Peru,16,5,0,21
8993,2018,El Salvador,Peru,5,5,0,10
8994,2018,Serbia and Kosovo: S/RES/1244 (1999),Peru,64,0,0,64
8995,2018,Spain,Peru,0,12,0,12
8996,2018,Syrian Arab Rep.,Peru,44,7,0,51
8997,2018,Türkiye,Peru,55,44,0,99
8998,2018,Ukraine,Peru,16,0,0,16
8999,2018,Uruguay,Peru,0,5,0,5
9000,2018,United States of America,Peru,0,5,0,5
9001,2018,Uzbekistan,Peru,5,0,0,5
9002,2018,Venezuela (Bolivarian Republic of),Peru,735,227325,0,228060
9003,2018,Yemen,Peru,0,38,0,38
9005,2018,Afghanistan,Philippines,14,6,0,20
9006,2018,Burundi,Philippines,13,0,0,13
9007,2018,Bangladesh,Philippines,0,5,0,5
9008,2018,Cambodia,Philippines,6,10,0,16
9009,2018,China,Philippines,5,5,0,10
9010,2018,Cameroon,Philippines,12,12,0,24
9011,2018,Congo,Philippines,0,5,0,5
9012,2018,Dem. Rep. of the Congo,Philippines,6,0,0,6
9013,2018,Eritrea,Philippines,17,5,0,22
9014,2018,Ethiopia,Philippines,5,0,0,5
9015,2018,Palestinian,Philippines,55,6,0,61
9016,2018,Ghana,Philippines,5,0,0,5
9017,2018,Guinea,Philippines,0,5,0,5
9018,2018,Cote d'Ivoire,Philippines,24,22,0,46
9019,2018,Iran (Islamic Rep. of),Philippines,69,10,0,79
9020,2018,Iraq,Philippines,52,9,0,61
9021,2018,Liberia,Philippines,5,0,0,5
9022,2018,Lebanon,Philippines,5,0,0,5
9023,2018,Sri Lanka,Philippines,20,0,0,20
9024,2018,Myanmar,Philippines,10,0,0,10
9025,2018,Nigeria,Philippines,5,10,0,15
9026,2018,Pakistan,Philippines,91,12,0,103
9027,2018,Philippines,Philippines,0,0,77651,0
9028,2018,Rwanda,Philippines,19,0,0,19
9029,2018,Saudi Arabia,Philippines,7,5,0,12
9030,2018,Somalia,Philippines,29,11,0,40
9031,2018,Viet Nam,Philippines,8,0,0,8
9032,2018,Sudan,Philippines,6,10,0,16
9033,2018,Syrian Arab Rep.,Philippines,105,33,0,138
9034,2018,Türkiye,Philippines,23,37,0,60
9035,2018,Yemen,Philippines,10,12,0,22
9038,2018,Afghanistan,Papua New Guinea,118,7,0,125
9039,2018,Bangladesh,Papua New Guinea,20,5,0,25
9040,2018,India,Papua New Guinea,0,5,0,5
9041,2018,Indonesia,Papua New Guinea,9368,0,0,9368
9042,2018,Iran (Islamic Rep. of),Papua New Guinea,159,124,0,283
9043,2018,Iraq,Papua New Guinea,47,5,0,52
9044,2018,Sri Lanka,Papua New Guinea,21,0,0,21
9045,2018,Myanmar,Papua New Guinea,0,5,0,5
9046,2018,Pakistan,Papua New Guinea,96,0,0,96
9047,2018,Somalia,Papua New Guinea,39,0,0,39
9048,2018,Sudan,Papua New Guinea,75,0,0,75
9050,2018,Afghanistan,Poland,110,15,0,125
9051,2018,Algeria,Poland,5,6,0,11
9052,2018,Egypt,Poland,65,15,0,80
9053,2018,Armenia,Poland,78,36,0,114
9054,2018,Azerbaijan,Poland,5,5,0,10
9055,2018,Bangladesh,Poland,8,8,0,16
9056,2018,Belarus,Poland,199,25,0,224
9057,2018,Central African Rep.,Poland,5,0,0,5
9058,2018,China,Poland,18,0,0,18
9059,2018,Cameroon,Poland,11,0,0,11
9060,2018,Congo,Poland,7,0,0,7
9061,2018,Dem. Rep. of the Congo,Poland,6,0,0,6
9062,2018,Cuba,Poland,17,0,0,17
9063,2018,Eritrea,Poland,31,0,0,31
9064,2018,Ethiopia,Poland,5,0,0,5
9065,2018,Palestinian,Poland,17,5,0,22
9066,2018,Georgia,Poland,71,62,0,133
9067,2018,India,Poland,5,5,0,10
9068,2018,Iran (Islamic Rep. of),Poland,35,17,0,52
9069,2018,Iraq,Poland,255,27,0,282
9070,2018,Jordan,Poland,0,5,0,5
9071,2018,Kazakhstan,Poland,64,26,0,90
9072,2018,Kenya,Poland,5,0,0,5
9073,2018,Kyrgyzstan,Poland,57,30,0,87
9074,2018,Libya,Poland,31,5,0,36
9075,2018,Sri Lanka,Poland,49,0,0,49
9076,2018,Rep. of Moldova,Poland,5,5,0,10
9077,2018,Mongolia,Poland,19,0,0,19
9078,2018,Nepal,Poland,8,0,0,8
9079,2018,Nigeria,Poland,10,5,0,15
9080,2018,Pakistan,Poland,32,20,0,52
9081,2018,Russian Federation,Poland,9893,2246,0,12139
9082,2018,Rwanda,Poland,5,0,0,5
9083,2018,Serbia and Kosovo: S/RES/1244 (1999),Poland,5,0,0,5
9084,2018,Senegal,Poland,5,0,0,5
9085,2018,Somalia,Poland,47,0,0,47
9086,2018,Viet Nam,Poland,16,9,0,25
9087,2018,Sudan,Poland,5,0,0,5
9088,2018,Syrian Arab Rep.,Poland,531,20,0,551
9089,2018,Tajikistan,Poland,73,95,0,168
9090,2018,Turkmenistan,Poland,42,0,0,42
9091,2018,Türkiye,Poland,43,37,0,80
9092,2018,Uganda,Poland,6,0,0,6
9093,2018,Ukraine,Poland,464,309,0,773
9094,2018,Uzbekistan,Poland,20,5,0,25
9095,2018,Yemen,Poland,9,8,0,17
9097,2018,Afghanistan,Portugal,16,5,0,21
9098,2018,Angola,Portugal,0,25,0,25
9099,2018,Armenia,Portugal,5,0,0,5
9100,2018,Bangladesh,Portugal,5,0,0,5
9101,2018,Belarus,Portugal,16,0,0,16
9102,2018,Brazil,Portugal,0,5,0,5
9103,2018,Bosnia and Herzegovina,Portugal,11,0,0,11
9104,2018,Central African Rep.,Portugal,8,0,0,8
9105,2018,Cameroon,Portugal,13,0,0,13
9106,2018,Congo,Portugal,7,0,0,7
9107,2018,Dem. Rep. of the Congo,Portugal,60,5,0,65
9108,2018,Colombia,Portugal,58,0,0,58
9109,2018,Cuba,Portugal,5,0,0,5
9110,2018,Eritrea,Portugal,188,0,0,188
9111,2018,Ethiopia,Portugal,6,0,0,6
9112,2018,Gambia,Portugal,5,5,0,10
9113,2018,Palestinian,Portugal,5,5,0,10
9114,2018,Georgia,Portugal,5,0,0,5
9115,2018,Guinea-Bissau,Portugal,9,5,0,14
9116,2018,Guinea,Portugal,98,5,0,103
9117,2018,Cote d'Ivoire,Portugal,32,0,0,32
9118,2018,Iran (Islamic Rep. of),Portugal,37,0,0,37
9119,2018,Iraq,Portugal,162,0,0,162
9120,2018,Kenya,Portugal,6,0,0,6
9121,2018,Libya,Portugal,14,0,0,14
9122,2018,Sri Lanka,Portugal,41,0,0,41
9123,2018,Mauritania,Portugal,5,0,0,5
9124,2018,Mali,Portugal,13,0,0,13
9125,2018,Morocco,Portugal,9,0,0,9
9126,2018,Nigeria,Portugal,24,0,0,24
9127,2018,Pakistan,Portugal,65,5,0,70
9128,2018,Russian Federation,Portugal,16,0,0,16
9129,2018,Rwanda,Portugal,5,0,0,5
9130,2018,Senegal,Portugal,7,0,0,7
9131,2018,Sierra Leone,Portugal,26,0,0,26
9132,2018,Somalia,Portugal,37,5,0,42
9133,2018,Sudan,Portugal,23,0,0,23
9134,2018,South Sudan,Portugal,15,0,0,15
9135,2018,Syrian Arab Rep.,Portugal,602,0,0,602
9136,2018,Togo,Portugal,6,0,0,6
9137,2018,Türkiye,Portugal,5,0,0,5
9138,2018,Uganda,Portugal,5,0,0,5
9139,2018,Ukraine,Portugal,423,15,0,438
9140,2018,Yemen,Portugal,7,0,0,7
9142,2018,Egypt,Qatar,9,0,0,9
9143,2018,Eritrea,Qatar,0,5,0,5
9144,2018,Iraq,Qatar,138,73,0,211
9145,2018,Somalia,Qatar,8,0,0,8
9146,2018,Sudan,Qatar,0,13,0,13
9147,2018,Syrian Arab Rep.,Qatar,34,0,0,34
9149,2018,Afghanistan,Romania,155,74,0,229
9150,2018,Algeria,Romania,5,0,0,5
9151,2018,Angola,Romania,5,0,0,5
9152,2018,Egypt,Romania,21,0,0,21
9153,2018,Burundi,Romania,7,0,0,7
9154,2018,Bangladesh,Romania,5,19,0,24
9155,2018,Central African Rep.,Romania,8,0,0,8
9156,2018,Cameroon,Romania,24,8,0,32
9157,2018,Congo,Romania,8,5,0,13
9158,2018,Dem. Rep. of the Congo,Romania,15,5,0,20
9159,2018,Eritrea,Romania,59,5,0,64
9160,2018,Ethiopia,Romania,7,0,0,7
9161,2018,Palestinian,Romania,53,5,0,58
9162,2018,Guinea,Romania,6,5,0,11
9163,2018,India,Romania,0,15,0,15
9164,2018,Iran (Islamic Rep. of),Romania,93,88,0,181
9165,2018,Iraq,Romania,968,969,0,1937
9166,2018,Jordan,Romania,8,0,0,8
9167,2018,Liberia,Romania,5,0,0,5
9168,2018,Libya,Romania,5,0,0,5
9169,2018,Lebanon,Romania,5,0,0,5
9170,2018,Morocco,Romania,0,5,0,5
9171,2018,Myanmar,Romania,29,5,0,34
9172,2018,Nigeria,Romania,5,6,0,11
9173,2018,Pakistan,Romania,42,47,0,89
9174,2018,Rwanda,Romania,7,0,0,7
9175,2018,Sierra Leone,Romania,5,0,0,5
9176,2018,Somalia,Romania,60,5,0,65
9177,2018,Sudan,Romania,16,0,0,16
9178,2018,Syrian Arab Rep.,Romania,2292,150,0,2442
9179,2018,Türkiye,Romania,25,39,0,64
9180,2018,Ukraine,Romania,28,7,0,35
9181,2018,Yemen,Romania,33,9,0,42
9182,2018,Zimbabwe,Romania,8,0,0,8
9184,2018,Algeria,South Africa,0,9,0,9
9185,2018,Angola,South Africa,25,0,0,25
9186,2018,Egypt,South Africa,0,9,0,9
9187,2018,Burundi,South Africa,3033,6171,0,9204
9188,2018,Bangladesh,South Africa,319,26431,0,26750
9189,2018,China,South Africa,0,134,0,134
9190,2018,Cameroon,South Africa,392,1592,0,1984
9191,2018,Congo,South Africa,5273,8694,0,13967
9192,2018,Dem. Rep. of the Congo,South Africa,26263,33217,0,59480
9193,2018,Eritrea,South Africa,1943,817,0,2760
9194,2018,Ethiopia,South Africa,17726,49347,0,67073
9195,2018,Palestinian,South Africa,38,0,0,38
9196,2018,Ghana,South Africa,0,2131,0,2131
9197,2018,Cote d'Ivoire,South Africa,41,0,0,41
9198,2018,India,South Africa,0,4329,0,4329
9199,2018,Kenya,South Africa,157,1072,0,1229
9200,2018,Liberia,South Africa,60,0,0,60
9201,2018,Sri Lanka,South Africa,0,7,0,7
9202,2018,Malawi,South Africa,0,2344,0,2344
9203,2018,Mozambique,South Africa,0,785,0,785
9204,2018,Niger,South Africa,0,861,0,861
9205,2018,Nigeria,South Africa,0,7763,0,7763
9206,2018,Pakistan,South Africa,0,9834,0,9834
9207,2018,Rwanda,South Africa,1297,927,0,2224
9208,2018,Senegal,South Africa,0,846,0,846
9209,2018,Somalia,South Africa,27113,3969,0,31082
9210,2018,Sudan,South Africa,112,0,0,112
9211,2018,Syrian Arab Rep.,South Africa,45,7,0,52
9212,2018,United Rep. of Tanzania,South Africa,37,614,0,651
9213,2018,Türkiye,South Africa,0,5,0,5
9214,2018,Uganda,South Africa,549,4549,0,5098
9215,2018,Yemen,South Africa,0,6,0,6
9216,2018,Zambia,South Africa,64,0,0,64
9217,2018,Zimbabwe,South Africa,4561,14261,0,18822
9219,2018,Afghanistan,Russian Federation,789,226,0,1015
9220,2018,Argentina,Russian Federation,5,0,0,5
9221,2018,Armenia,Russian Federation,0,5,0,5
9222,2018,Azerbaijan,Russian Federation,12,6,0,18
9223,2018,Belgium,Russian Federation,0,15,0,15
9224,2018,Bangladesh,Russian Federation,5,5,0,10
9225,2018,Bosnia and Herzegovina,Russian Federation,5,0,0,5
9226,2018,China,Russian Federation,5,0,0,5
9227,2018,Dem. Rep. of the Congo,Russian Federation,12,5,0,17
9228,2018,Eritrea,Russian Federation,0,5,0,5
9229,2018,Palestinian,Russian Federation,12,5,0,17
9230,2018,Georgia,Russian Federation,155,7,0,162
9231,2018,Germany,Russian Federation,9,0,0,9
9232,2018,Cote d'Ivoire,Russian Federation,5,0,0,5
9233,2018,Iran (Islamic Rep. of),Russian Federation,5,0,0,5
9234,2018,Iraq,Russian Federation,17,5,0,22
9235,2018,Kazakhstan,Russian Federation,10,7,0,17
9236,2018,Kyrgyzstan,Russian Federation,20,7,0,27
9237,2018,Dem. People's Rep. of Korea,Russian Federation,57,14,0,71
9238,2018,Lebanon,Russian Federation,6,0,0,6
9239,2018,Lithuania,Russian Federation,5,0,0,5
9240,2018,Latvia,Russian Federation,5,0,0,5
9241,2018,Rep. of Moldova,Russian Federation,30,9,0,39
9242,2018,Nigeria,Russian Federation,0,5,0,5
9243,2018,Pakistan,Russian Federation,5,0,0,5
9244,2018,Somalia,Russian Federation,0,5,0,5
9245,2018,Sudan,Russian Federation,7,5,0,12
9246,2018,Syrian Arab Rep.,Russian Federation,828,174,0,1002
9247,2018,Tajikistan,Russian Federation,25,13,0,38
9248,2018,Turkmenistan,Russian Federation,7,0,0,7
9249,2018,Türkiye,Russian Federation,6,0,0,6
9250,2018,Ukraine,Russian Federation,75146,795,0,75941
9251,2018,United States of America,Russian Federation,5,0,0,5
9252,2018,Uzbekistan,Russian Federation,70,19,0,89
9253,2018,Venezuela (Bolivarian Republic of),Russian Federation,0,5,0,5
9254,2018,Yemen,Russian Federation,92,9,0,101
9257,2018,Angola,Rwanda,8,0,0,8
9258,2018,Burundi,Rwanda,68280,95,0,68375
9259,2018,Chad,Rwanda,5,0,0,5
9260,2018,Dem. Rep. of the Congo,Rwanda,77044,318,0,77362
9261,2018,Eritrea,Rwanda,5,5,0,10
9262,2018,Ethiopia,Rwanda,5,0,0,5
9263,2018,Rwanda,Rwanda,0,0,0,0
9264,2018,Somalia,Rwanda,5,0,0,5
9265,2018,South Sudan,Rwanda,7,5,0,12
9266,2018,Colombia,El Salvador,5,5,0,10
9267,2018,Honduras,El Salvador,17,0,0,17
9268,2018,Iraq,El Salvador,5,0,0,5
9269,2018,Mexico,El Salvador,5,0,0,5
9270,2018,Nicaragua,El Salvador,7,11,0,18
9271,2018,El Salvador,El Salvador,0,0,71501,0
9272,2018,Syrian Arab Rep.,El Salvador,5,0,0,5
9273,2018,Chad,Saudi Arabia,9,0,0,9
9274,2018,China,Saudi Arabia,14,14,0,28
9275,2018,Eritrea,Saudi Arabia,31,6,0,37
9276,2018,Palestinian,Saudi Arabia,9,13,0,22
9277,2018,Iraq,Saudi Arabia,36,24,0,60
9278,2018,Liberia,Saudi Arabia,7,0,0,7
9279,2018,Somalia,Saudi Arabia,16,0,0,16
9280,2018,Sudan,Saudi Arabia,0,5,0,5
9281,2018,South Sudan,Saudi Arabia,5,0,0,5
9282,2018,Syrian Arab Rep.,Saudi Arabia,103,2063,0,2166
9283,2018,Tunisia,Saudi Arabia,6,0,0,6
9284,2018,Yemen,Saudi Arabia,27,42,0,69
9286,2018,Afghanistan,Serbia and Kosovo: S/RES/1244 (1999),1726,18,0,1744
9287,2018,Bangladesh,Serbia and Kosovo: S/RES/1244 (1999),133,0,0,133
9288,2018,Bosnia and Herzegovina,Serbia and Kosovo: S/RES/1244 (1999),8271,0,0,8271
9289,2018,Bulgaria,Serbia and Kosovo: S/RES/1244 (1999),0,5,0,5
9290,2018,Congo,Serbia and Kosovo: S/RES/1244 (1999),0,7,0,7
9291,2018,Cuba,Serbia and Kosovo: S/RES/1244 (1999),5,0,0,5
9292,2018,Ethiopia,Serbia and Kosovo: S/RES/1244 (1999),5,0,0,5
9293,2018,Croatia,Serbia and Kosovo: S/RES/1244 (1999),18237,0,0,18237
9294,2018,India,Serbia and Kosovo: S/RES/1244 (1999),0,5,0,5
9295,2018,Iran (Islamic Rep. of),Serbia and Kosovo: S/RES/1244 (1999),1231,136,0,1367
9296,2018,Iraq,Serbia and Kosovo: S/RES/1244 (1999),288,0,0,288
9297,2018,Libya,Serbia and Kosovo: S/RES/1244 (1999),42,0,0,42
9298,2018,Nigeria,Serbia and Kosovo: S/RES/1244 (1999),0,9,0,9
9299,2018,Pakistan,Serbia and Kosovo: S/RES/1244 (1999),596,0,0,596
9300,2018,Russian Federation,Serbia and Kosovo: S/RES/1244 (1999),0,6,0,6
9301,2018,Serbia and Kosovo: S/RES/1244 (1999),Serbia and Kosovo: S/RES/1244 (1999),0,0,215794,0
9302,2018,Somalia,Serbia and Kosovo: S/RES/1244 (1999),5,16,0,21
9303,2018,Sudan,Serbia and Kosovo: S/RES/1244 (1999),5,0,0,5
9304,2018,Syrian Arab Rep.,Serbia and Kosovo: S/RES/1244 (1999),74,7,0,81
9305,2018,Türkiye,Serbia and Kosovo: S/RES/1244 (1999),63,10,0,73
9306,2018,Ukraine,Serbia and Kosovo: S/RES/1244 (1999),15,0,0,15
9309,2018,Afghanistan,Senegal,0,9,0,9
9310,2018,Burundi,Senegal,5,7,0,12
9311,2018,Benin,Senegal,0,5,0,5
9312,2018,Burkina Faso,Senegal,0,5,0,5
9313,2018,Central African Rep.,Senegal,173,388,0,561
9314,2018,Chad,Senegal,6,25,0,31
9315,2018,Cameroon,Senegal,0,23,0,23
9316,2018,Congo,Senegal,0,73,0,73
9317,2018,Dem. Rep. of the Congo,Senegal,10,162,0,172
9318,2018,Eritrea,Senegal,0,13,0,13
9319,2018,Gambia,Senegal,10,327,0,337
9320,2018,Guinea-Bissau,Senegal,0,5,0,5
9321,2018,Guinea,Senegal,0,100,0,100
9322,2018,Haiti,Senegal,0,5,0,5
9323,2018,Cote d'Ivoire,Senegal,17,163,0,180
9324,2018,Liberia,Senegal,5,63,0,68
9325,2018,Sri Lanka,Senegal,0,6,0,6
9326,2018,Mauritania,Senegal,14120,61,0,14181
9327,2018,Mali,Senegal,0,60,0,60
9328,2018,Nigeria,Senegal,0,44,0,44
9329,2018,Rwanda,Senegal,13,7,0,20
9330,2018,Sierra Leone,Senegal,0,34,0,34
9331,2018,Sudan,Senegal,0,7,0,7
9332,2018,Syrian Arab Rep.,Senegal,0,14,0,14
9333,2018,Togo,Senegal,0,29,0,29
9334,2018,Türkiye,Senegal,0,64,0,64
9336,2018,Cote d'Ivoire,Sierra Leone,17,0,0,17
9337,2018,Liberia,Sierra Leone,565,0,0,565
9338,2018,Sudan,Sierra Leone,9,0,0,9
9339,2018,Indonesia,Solomon Islands,0,5,0,5
9340,2018,Egypt,Somalia,0,24,0,24
9341,2018,Bangladesh,Somalia,6,0,0,6
9342,2018,Cameroon,Somalia,0,5,0,5
9343,2018,Djibouti,Somalia,0,12,0,12
9344,2018,Eritrea,Somalia,50,40,0,90
9345,2018,Ethiopia,Somalia,3981,16067,0,20048
9346,2018,Palestinian,Somalia,19,0,0,19
9347,2018,Iraq,Somalia,21,0,0,21
9348,2018,Mozambique,Somalia,0,5,0,5
9349,2018,Nigeria,Somalia,0,5,0,5
9350,2018,Pakistan,Somalia,0,5,0,5
9351,2018,Somalia,Somalia,0,0,2648001,0
9352,2018,Sudan,Somalia,5,12,0,17
9353,2018,Syrian Arab Rep.,Somalia,206,14,0,220
9354,2018,United Rep. of Tanzania,Somalia,0,118,0,118
9355,2018,Yemen,Somalia,12450,54,0,12504
9356,2018,Afghanistan,Spain,338,195,0,533
9357,2018,Albania,Spain,0,95,0,95
9358,2018,Algeria,Spain,48,1215,0,1263
9359,2018,Angola,Spain,6,45,0,51
9360,2018,Egypt,Spain,15,65,0,80
9361,2018,Argentina,Spain,0,50,0,50
9362,2018,Armenia,Spain,29,325,0,354
9363,2018,Azerbaijan,Spain,46,45,0,91
9364,2018,Burundi,Spain,0,10,0,10
9365,2018,Benin,Spain,5,10,0,15
9366,2018,Bangladesh,Spain,20,265,0,285
9367,2018,Burkina Faso,Spain,0,95,0,95
9368,2018,Belarus,Spain,13,55,0,68
9369,2018,Bolivia (Plurinational State of),Spain,9,40,0,49
9370,2018,Brazil,Spain,0,185,0,185
9371,2018,Central African Rep.,Spain,72,110,0,182
9372,2018,Chad,Spain,0,15,0,15
9373,2018,China,Spain,20,600,0,620
9374,2018,Chile,Spain,0,45,0,45
9375,2018,Cameroon,Spain,63,1065,0,1128
9376,2018,Congo,Spain,10,265,0,275
9377,2018,Dem. Rep. of the Congo,Spain,62,380,0,442
9378,2018,Comoros,Spain,0,5,0,5
9379,2018,Colombia,Spain,208,10385,0,10593
9380,2018,Costa Rica,Spain,0,15,0,15
9381,2018,Cuba,Spain,885,615,0,1500
9382,2018,Dominican Rep.,Spain,0,240,0,240
9383,2018,Ecuador,Spain,0,70,0,70
9384,2018,Equatorial Guinea,Spain,22,75,0,97
9385,2018,Eritrea,Spain,264,55,0,319
9386,2018,Ethiopia,Spain,53,20,0,73
9387,2018,Gabon,Spain,0,10,0,10
9388,2018,Gambia,Spain,17,225,0,242
9389,2018,Palestinian,Spain,1051,2510,0,3561
9390,2018,Georgia,Spain,8,1245,0,1253
9391,2018,Ghana,Spain,0,200,0,200
9392,2018,Guinea-Bissau,Spain,0,45,0,45
9393,2018,Guatemala,Spain,14,215,0,229
9394,2018,Guinea,Spain,12,1080,0,1092
9395,2018,Haiti,Spain,17,15,0,32
9396,2018,Honduras,Spain,42,3690,0,3732
9397,2018,Cote d'Ivoire,Spain,193,820,0,1013
9398,2018,India,Spain,6,65,0,71
9399,2018,Iran (Islamic Rep. of),Spain,85,165,0,250
9400,2018,Iraq,Spain,324,150,0,474
9401,2018,Jamaica,Spain,0,40,0,40
9402,2018,Jordan,Spain,28,20,0,48
9403,2018,Kazakhstan,Spain,10,20,0,30
9404,2018,Kenya,Spain,0,15,0,15
9405,2018,Kyrgyzstan,Spain,6,10,0,16
9406,2018,Liberia,Spain,6,40,0,46
9407,2018,Libya,Spain,24,145,0,169
9408,2018,Lebanon,Spain,24,130,0,154
9409,2018,Sri Lanka,Spain,108,45,0,153
9410,2018,Mauritania,Spain,0,95,0,95
9411,2018,North Macedonia,Spain,0,20,0,20
9412,2018,Rep. of Moldova,Spain,0,20,0,20
9413,2018,Mexico,Spain,21,75,0,96
9414,2018,Mali,Spain,39,780,0,819
9415,2018,Mongolia,Spain,5,20,0,25
9416,2018,Morocco,Spain,173,1060,0,1233
9417,2018,Myanmar,Spain,5,5,0,10
9418,2018,Nepal,Spain,0,5,0,5
9419,2018,Niger,Spain,0,20,0,20
9420,2018,Nicaragua,Spain,15,1380,0,1395
9421,2018,Nigeria,Spain,52,1250,0,1302
9422,2018,Pakistan,Spain,392,690,0,1082
9423,2018,Panama,Spain,0,15,0,15
9424,2018,Paraguay,Spain,0,65,0,65
9425,2018,Peru,Spain,0,630,0,630
9426,2018,Philippines,Spain,0,5,0,5
9427,2018,South Africa,Spain,0,10,0,10
9428,2018,Russian Federation,Spain,154,1035,0,1189
9429,2018,Rwanda,Spain,0,5,0,5
9430,2018,El Salvador,Spain,7,3685,0,3692
9431,2018,Saudi Arabia,Spain,0,5,0,5
9432,2018,Serbia and Kosovo: S/RES/1244 (1999),Spain,5,30,0,35
9433,2018,Senegal,Spain,7,385,0,392
9434,2018,Sierra Leone,Spain,9,80,0,89
9435,2018,Somalia,Spain,682,75,0,757
9436,2018,Viet Nam,Spain,0,85,0,85
9437,2018,Sudan,Spain,52,130,0,182
9438,2018,South Sudan,Spain,0,10,0,10
9439,2018,Syrian Arab Rep.,Spain,13765,2320,0,16085
9440,2018,Tajikistan,Spain,5,5,0,10
9441,2018,Turkmenistan,Spain,0,5,0,5
9442,2018,Togo,Spain,14,30,0,44
9443,2018,Trinidad and Tobago,Spain,0,5,0,5
9444,2018,Tunisia,Spain,0,100,0,100
9445,2018,Türkiye,Spain,25,350,0,375
9446,2018,Uganda,Spain,5,10,0,15
9447,2018,Ukraine,Spain,562,4300,0,4862
9448,2018,Uruguay,Spain,0,35,0,35
9449,2018,United States of America,Spain,0,35,0,35
9450,2018,Uzbekistan,Spain,14,5,0,19
9451,2018,Venezuela (Bolivarian Republic of),Spain,72,31620,0,31692
9452,2018,Western Sahara,Spain,19,95,0,114
9453,2018,Yemen,Spain,103,500,0,603
9454,2018,Zimbabwe,Spain,0,5,0,5
9459,2018,Cuba,Saint Kitts and Nevis,5,0,0,5
9460,2018,Afghanistan,Sudan,6,0,0,6
9461,2018,Egypt,Sudan,17,25,0,42
9462,2018,Burundi,Sudan,16,10,0,26
9463,2018,Central African Rep.,Sudan,6995,5,0,7000
9464,2018,Chad,Sudan,3373,10,0,3383
9465,2018,Cameroon,Sudan,7,0,0,7
9466,2018,Congo,Sudan,0,6,0,6
9467,2018,Dem. Rep. of the Congo,Sudan,154,683,0,837
9468,2018,Eritrea,Sudan,114545,6428,0,120973
9469,2018,Ethiopia,Sudan,6045,7517,0,13562
9470,2018,Palestinian,Sudan,54,74,0,128
9471,2018,Iraq,Sudan,16,23,0,39
9472,2018,Jordan,Sudan,0,0,0,0
9473,2018,Nigeria,Sudan,0,10,0,10
9474,2018,Somalia,Sudan,432,196,0,628
9475,2018,Sudan,Sudan,0,0,1864195,0
9476,2018,South Sudan,Sudan,852080,0,0,852080
9477,2018,Syrian Arab Rep.,Sudan,93502,0,0,93502
9478,2018,Uganda,Sudan,5,0,0,5
9479,2018,Yemen,Sudan,1013,2619,0,3632
9481,2018,Cuba,Suriname,30,158,0,188
9482,2018,Dominican Rep.,Suriname,0,14,0,14
9483,2018,Jamaica,Suriname,5,0,0,5
9484,2018,Venezuela (Bolivarian Republic of),Suriname,6,34,0,40
9485,2018,Burundi,South Sudan,5,281,0,286
9486,2018,Central African Rep.,South Sudan,2006,0,0,2006
9487,2018,Dem. Rep. of the Congo,South Sudan,15617,6,0,15623
9488,2018,Eritrea,South Sudan,83,1899,0,1982
9489,2018,Ethiopia,South Sudan,4203,310,0,4513
9490,2018,Somalia,South Sudan,0,30,0,30
9491,2018,Sudan,South Sudan,269924,9,0,269933
9492,2018,South Sudan,South Sudan,0,0,1878154,0
9493,2018,Afghanistan,Slovakia,260,0,0,260
9494,2018,Angola,Slovakia,24,0,0,24
9495,2018,Egypt,Slovakia,5,0,0,5
9496,2018,Armenia,Slovakia,34,0,0,34
9497,2018,Burundi,Slovakia,5,0,0,5
9498,2018,Bosnia and Herzegovina,Slovakia,36,0,0,36
9499,2018,Bulgaria,Slovakia,8,0,0,8
9500,2018,Cambodia,Slovakia,5,0,0,5
9501,2018,China,Slovakia,5,0,0,5
9502,2018,Cameroon,Slovakia,7,0,0,7
9503,2018,Dem. Rep. of the Congo,Slovakia,16,0,0,16
9504,2018,Cuba,Slovakia,32,0,0,32
9505,2018,Palestinian,Slovakia,7,0,0,7
9506,2018,Iran (Islamic Rep. of),Slovakia,28,0,0,28
9507,2018,Iraq,Slovakia,213,0,0,213
9508,2018,Liberia,Slovakia,5,0,0,5
9509,2018,Pakistan,Slovakia,6,0,0,6
9510,2018,Romania,Slovakia,37,0,0,37
9511,2018,Russian Federation,Slovakia,37,0,0,37
9512,2018,Serbia and Kosovo: S/RES/1244 (1999),Slovakia,46,0,0,46
9513,2018,Somalia,Slovakia,31,0,0,31
9514,2018,Viet Nam,Slovakia,16,0,0,16
9515,2018,Syrian Arab Rep.,Slovakia,14,0,0,14
9516,2018,Uganda,Slovakia,5,0,0,5
9517,2018,Ukraine,Slovakia,23,0,0,23
9518,2018,Uzbekistan,Slovakia,5,0,0,5
9519,2018,Yemen,Slovakia,19,0,0,19
9522,2018,Afghanistan,Slovenia,48,29,0,77
9523,2018,Algeria,Slovenia,0,24,0,24
9524,2018,Azerbaijan,Slovenia,0,5,0,5
9525,2018,Bosnia and Herzegovina,Slovenia,8,5,0,13
9526,2018,Cameroon,Slovenia,5,0,0,5
9527,2018,Dem. Rep. of the Congo,Slovenia,8,5,0,13
9528,2018,Eritrea,Slovenia,82,23,0,105
9529,2018,Palestinian,Slovenia,12,5,0,17
9530,2018,Iran (Islamic Rep. of),Slovenia,66,35,0,101
9531,2018,Iraq,Slovenia,42,15,0,57
9532,2018,Kazakhstan,Slovenia,19,0,0,19
9533,2018,Morocco,Slovenia,0,11,0,11
9534,2018,Nigeria,Slovenia,0,5,0,5
9535,2018,Pakistan,Slovenia,0,14,0,14
9536,2018,Russian Federation,Slovenia,17,8,0,25
9537,2018,Serbia and Kosovo: S/RES/1244 (1999),Slovenia,65,11,0,76
9538,2018,Sierra Leone,Slovenia,5,0,0,5
9539,2018,Somalia,Slovenia,50,0,0,50
9540,2018,Sudan,Slovenia,6,0,0,6
9541,2018,Syrian Arab Rep.,Slovenia,290,23,0,313
9542,2018,Türkiye,Slovenia,13,21,0,34
9543,2018,Ukraine,Slovenia,5,0,0,5
9544,2018,Yemen,Slovenia,5,0,0,5
9547,2018,Angola,Eswatini,11,0,0,11
9548,2018,Burundi,Eswatini,181,103,0,284
9549,2018,Congo,Eswatini,14,80,0,94
9550,2018,Dem. Rep. of the Congo,Eswatini,372,213,0,585
9551,2018,Eritrea,Eswatini,0,5,0,5
9552,2018,Ethiopia,Eswatini,9,50,0,59
9553,2018,Guinea,Eswatini,5,0,0,5
9554,2018,Kenya,Eswatini,5,0,0,5
9555,2018,Sri Lanka,Eswatini,5,0,0,5
9556,2018,Rwanda,Eswatini,168,96,0,264
9557,2018,Somalia,Eswatini,91,192,0,283
9558,2018,Uganda,Eswatini,6,0,0,6
9559,2018,Zimbabwe,Eswatini,7,0,0,7
9560,2018,Afghanistan,Sweden,28204,8614,0,36818
9561,2018,Albania,Sweden,331,415,0,746
9562,2018,Algeria,Sweden,60,87,0,147
9563,2018,Angola,Sweden,29,26,0,55
9564,2018,Egypt,Sweden,362,572,0,934
9565,2018,Argentina,Sweden,0,5,0,5
9566,2018,Armenia,Sweden,413,271,0,684
9567,2018,Azerbaijan,Sweden,648,510,0,1158
9568,2018,Bahrain,Sweden,15,5,0,20
9569,2018,Burundi,Sweden,211,143,0,354
9570,2018,Benin,Sweden,7,5,0,12
9571,2018,Bangladesh,Sweden,230,345,0,575
9572,2018,Bhutan,Sweden,5,0,0,5
9573,2018,Burkina Faso,Sweden,0,5,0,5
9574,2018,Belarus,Sweden,123,124,0,247
9575,2018,Bolivia (Plurinational State of),Sweden,59,37,0,96
9576,2018,Brazil,Sweden,8,20,0,28
9577,2018,Bosnia and Herzegovina,Sweden,119,92,0,211
9578,2018,Bulgaria,Sweden,16,0,0,16
9579,2018,Canada,Sweden,0,5,0,5
9580,2018,Central African Rep.,Sweden,70,0,0,70
9581,2018,Chad,Sweden,22,0,0,22
9582,2018,China,Sweden,282,69,0,351
9583,2018,Chile,Sweden,13,31,0,44
9584,2018,Cameroon,Sweden,165,175,0,340
9585,2018,Congo,Sweden,46,27,0,73
9586,2018,Dem. Rep. of the Congo,Sweden,917,122,0,1039
9587,2018,Comoros,Sweden,5,0,0,5
9588,2018,Colombia,Sweden,32,294,0,326
9589,2018,Cuba,Sweden,49,42,0,91
9590,2018,Djibouti,Sweden,22,28,0,50
9591,2018,Ecuador,Sweden,6,17,0,23
9592,2018,Equatorial Guinea,Sweden,5,10,0,15
9593,2018,Eritrea,Sweden,27653,768,0,28421
9594,2018,Ethiopia,Sweden,2360,870,0,3230
9595,2018,France,Sweden,5,0,0,5
9596,2018,Gambia,Sweden,158,156,0,314
9597,2018,Palestinian,Sweden,1060,574,0,1634
9598,2018,United Kingdom of Great Britain and Northern Ireland,Sweden,7,0,0,7
9599,2018,Georgia,Sweden,123,604,0,727
9600,2018,Ghana,Sweden,59,79,0,138
9601,2018,Guinea-Bissau,Sweden,9,5,0,14
9602,2018,Greece,Sweden,18,0,0,18
9603,2018,Guatemala,Sweden,10,5,0,15
9604,2018,Guinea,Sweden,76,62,0,138
9605,2018,Honduras,Sweden,13,31,0,44
9606,2018,Croatia,Sweden,0,5,0,5
9607,2018,Hungary,Sweden,5,0,0,5
9608,2018,Cote d'Ivoire,Sweden,54,15,0,69
9609,2018,India,Sweden,24,91,0,115
9610,2018,Indonesia,Sweden,16,0,0,16
9611,2018,Iran (Islamic Rep. of),Sweden,6485,2954,0,9439
9612,2018,Iraq,Sweden,12693,5060,0,17753
9613,2018,Israel,Sweden,29,27,0,56
9614,2018,Italy,Sweden,5,0,0,5
9615,2018,Jamaica,Sweden,0,5,0,5
9616,2018,Jordan,Sweden,294,271,0,565
9617,2018,Kazakhstan,Sweden,256,179,0,435
9618,2018,Kenya,Sweden,96,66,0,162
9619,2018,Kyrgyzstan,Sweden,179,190,0,369
9620,2018,Rep. of Korea,Sweden,6,5,0,11
9621,2018,Dem. People's Rep. of Korea,Sweden,5,5,0,10
9622,2018,Kuwait,Sweden,25,55,0,80
9623,2018,Liberia,Sweden,12,21,0,33
9624,2018,Libya,Sweden,397,115,0,512
9625,2018,Lebanon,Sweden,528,478,0,1006
9626,2018,Sri Lanka,Sweden,35,52,0,87
9627,2018,Lithuania,Sweden,0,7,0,7
9628,2018,Mauritania,Sweden,14,0,0,14
9629,2018,North Macedonia,Sweden,51,49,0,100
9630,2018,Rep. of Moldova,Sweden,8,5,0,13
9631,2018,Mexico,Sweden,0,5,0,5
9632,2018,Mali,Sweden,45,5,0,50
9633,2018,Malaysia,Sweden,10,0,0,10
9634,2018,Mongolia,Sweden,300,339,0,639
9635,2018,Morocco,Sweden,240,318,0,558
9636,2018,Mozambique,Sweden,0,8,0,8
9637,2018,Montenegro,Sweden,30,33,0,63
9638,2018,Myanmar,Sweden,15,11,0,26
9639,2018,Nepal,Sweden,16,20,0,36
9640,2018,Niger,Sweden,5,0,0,5
9641,2018,Nicaragua,Sweden,9,243,0,252
9642,2018,Nigeria,Sweden,539,571,0,1110
9643,2018,Pakistan,Sweden,503,535,0,1038
9644,2018,Peru,Sweden,10,105,0,115
9645,2018,Philippines,Sweden,7,24,0,31
9646,2018,Poland,Sweden,5,0,0,5
9647,2018,Romania,Sweden,59,0,0,59
9648,2018,South Africa,Sweden,0,10,0,10
9649,2018,Russian Federation,Sweden,1554,692,0,2246
9650,2018,Rwanda,Sweden,37,47,0,84
9651,2018,El Salvador,Sweden,94,224,0,318
9652,2018,Saudi Arabia,Sweden,50,15,0,65
9653,2018,Serbia and Kosovo: S/RES/1244 (1999),Sweden,1105,373,0,1478
9654,2018,Senegal,Sweden,55,25,0,80
9655,2018,Sierra Leone,Sweden,68,29,0,97
9656,2018,Somalia,Sweden,21032,1611,0,22643
9657,2018,Spain,Sweden,0,5,0,5
9658,2018,Viet Nam,Sweden,55,52,0,107
9659,2018,Sudan,Sweden,1075,205,0,1280
9660,2018,South Sudan,Sweden,61,0,0,61
9661,2018,Slovakia,Sweden,6,5,0,11
9662,2018,Syrian Arab Rep.,Sweden,109343,2353,0,111696
9663,2018,United Rep. of Tanzania,Sweden,46,68,0,114
9664,2018,Thailand,Sweden,6,18,0,24
9665,2018,Tajikistan,Sweden,58,106,0,164
9666,2018,Turkmenistan,Sweden,8,10,0,18
9667,2018,Togo,Sweden,5,0,0,5
9668,2018,Tunisia,Sweden,53,104,0,157
9669,2018,Türkiye,Sweden,846,920,0,1766
9670,2018,United Arab Emirates,Sweden,5,0,0,5
9671,2018,Uganda,Sweden,696,123,0,819
9672,2018,Ukraine,Sweden,215,445,0,660
9673,2018,United States of America,Sweden,20,15,0,35
9674,2018,Uzbekistan,Sweden,586,823,0,1409
9675,2018,Venezuela (Bolivarian Republic of),Sweden,8,146,0,154
9676,2018,Yemen,Sweden,1343,228,0,1571
9677,2018,Zambia,Sweden,11,10,0,21
9678,2018,Zimbabwe,Sweden,21,7,0,28
9681,2018,Afghanistan,Switzerland,12282,1793,0,14075
9682,2018,Albania,Switzerland,92,66,0,158
9683,2018,Algeria,Switzerland,162,194,0,356
9684,2018,Angola,Switzerland,750,72,0,822
9685,2018,Egypt,Switzerland,110,19,0,129
9686,2018,Armenia,Switzerland,152,76,0,228
9687,2018,Azerbaijan,Switzerland,96,145,0,241
9688,2018,Bahrain,Switzerland,5,0,0,5
9689,2018,Burundi,Switzerland,103,35,0,138
9690,2018,Benin,Switzerland,25,6,0,31
9691,2018,Bangladesh,Switzerland,60,13,0,73
9692,2018,Burkina Faso,Switzerland,20,10,0,30
9693,2018,Belarus,Switzerland,46,21,0,67
9694,2018,Brazil,Switzerland,14,5,0,19
9695,2018,Bosnia and Herzegovina,Switzerland,1854,12,0,1866
9696,2018,Bulgaria,Switzerland,8,0,0,8
9697,2018,Cambodia,Switzerland,307,0,0,307
9698,2018,Central African Rep.,Switzerland,15,7,0,22
9699,2018,Chad,Switzerland,46,11,0,57
9700,2018,China,Switzerland,2957,274,0,3231
9701,2018,Chile,Switzerland,12,0,0,12
9702,2018,Cameroon,Switzerland,177,59,0,236
9703,2018,Congo,Switzerland,58,5,0,63
9704,2018,Dem. Rep. of the Congo,Switzerland,1250,142,0,1392
9705,2018,Colombia,Switzerland,228,59,0,287
9706,2018,Cuba,Switzerland,35,5,0,40
9707,2018,Czechia,Switzerland,5,0,0,5
9708,2018,Djibouti,Switzerland,15,0,0,15
9709,2018,Dominican Rep.,Switzerland,0,6,0,6
9710,2018,Ecuador,Switzerland,6,0,0,6
9711,2018,Equatorial Guinea,Switzerland,5,0,0,5
9712,2018,Eritrea,Switzerland,34072,2259,0,36331
9713,2018,Ethiopia,Switzerland,1563,449,0,2012
9714,2018,France,Switzerland,5,0,0,5
9715,2018,Gambia,Switzerland,52,27,0,79
9716,2018,United Kingdom of Great Britain and Northern Ireland,Switzerland,5,0,0,5
9717,2018,Georgia,Switzerland,164,262,0,426
9718,2018,Ghana,Switzerland,19,8,0,27
9719,2018,Guinea-Bissau,Switzerland,57,10,0,67
9720,2018,Guatemala,Switzerland,7,0,0,7
9721,2018,Guinea,Switzerland,173,89,0,262
9722,2018,Croatia,Switzerland,28,0,0,28
9723,2018,Hungary,Switzerland,5,0,0,5
9724,2018,Cote d'Ivoire,Switzerland,167,57,0,224
9725,2018,India,Switzerland,33,9,0,42
9726,2018,Indonesia,Switzerland,0,5,0,5
9727,2018,Iran (Islamic Rep. of),Switzerland,1687,1001,0,2688
9728,2018,Iraq,Switzerland,4476,854,0,5330
9729,2018,Israel,Switzerland,5,5,0,10
9730,2018,Italy,Switzerland,5,0,0,5
9731,2018,Jordan,Switzerland,66,5,0,71
9732,2018,Kazakhstan,Switzerland,12,10,0,22
9733,2018,Kenya,Switzerland,42,5,0,47
9734,2018,Kyrgyzstan,Switzerland,19,6,0,25
9735,2018,Kuwait,Switzerland,0,5,0,5
9736,2018,Lao People's Dem. Rep.,Switzerland,122,0,0,122
9737,2018,Liberia,Switzerland,41,5,0,46
9738,2018,Libya,Switzerland,303,66,0,369
9739,2018,Lebanon,Switzerland,36,23,0,59
9740,2018,Sri Lanka,Switzerland,5744,1579,0,7323
9741,2018,Madagascar,Switzerland,5,0,0,5
9742,2018,Mauritania,Switzerland,9,0,0,9
9743,2018,North Macedonia,Switzerland,175,25,0,200
9744,2018,Rep. of Moldova,Switzerland,8,0,0,8
9745,2018,Mali,Switzerland,37,9,0,46
9746,2018,Malaysia,Switzerland,0,5,0,5
9747,2018,Mongolia,Switzerland,137,19,0,156
9748,2018,Morocco,Switzerland,67,96,0,163
9749,2018,Montenegro,Switzerland,50,0,0,50
9750,2018,Myanmar,Switzerland,36,0,0,36
9751,2018,Nepal,Switzerland,19,8,0,27
9752,2018,Niger,Switzerland,12,0,0,12
9753,2018,Nicaragua,Switzerland,0,8,0,8
9754,2018,Nigeria,Switzerland,208,113,0,321
9755,2018,Pakistan,Switzerland,206,206,0,412
9756,2018,Paraguay,Switzerland,5,0,0,5
9757,2018,Peru,Switzerland,8,5,0,13
9758,2018,Philippines,Switzerland,7,6,0,13
9759,2018,Portugal,Switzerland,5,0,0,5
9760,2018,Romania,Switzerland,19,0,0,19
9761,2018,South Africa,Switzerland,14,0,0,14
9762,2018,Russian Federation,Switzerland,749,119,0,868
9763,2018,Rwanda,Switzerland,138,6,0,144
9764,2018,El Salvador,Switzerland,5,9,0,14
9765,2018,Saudi Arabia,Switzerland,7,11,0,18
9766,2018,Serbia and Kosovo: S/RES/1244 (1999),Switzerland,2595,114,0,2709
9767,2018,Senegal,Switzerland,53,12,0,65
9768,2018,Sierra Leone,Switzerland,32,9,0,41
9769,2018,Somalia,Switzerland,4595,517,0,5112
9770,2018,Spain,Switzerland,5,0,0,5
9771,2018,Viet Nam,Switzerland,930,0,0,930
9772,2018,Sudan,Switzerland,297,63,0,360
9773,2018,South Sudan,Switzerland,10,6,0,16
9774,2018,Syrian Arab Rep.,Switzerland,16565,1789,0,18354
9775,2018,United Rep. of Tanzania,Switzerland,19,0,0,19
9776,2018,Tajikistan,Switzerland,18,7,0,25
9777,2018,Turkmenistan,Switzerland,5,0,0,5
9778,2018,Togo,Switzerland,638,30,0,668
9779,2018,Tunisia,Switzerland,246,34,0,280
9780,2018,Türkiye,Switzerland,3539,1360,0,4899
9781,2018,United Arab Emirates,Switzerland,0,68,0,68
9782,2018,Uganda,Switzerland,36,22,0,58
9783,2018,Ukraine,Switzerland,56,0,0,56
9784,2018,United States of America,Switzerland,0,5,0,5
9785,2018,Uzbekistan,Switzerland,55,6,0,61
9786,2018,Venezuela (Bolivarian Republic of),Switzerland,6,39,0,45
9787,2018,Western Sahara,Switzerland,9,0,0,9
9788,2018,Yemen,Switzerland,336,20,0,356
9789,2018,Zimbabwe,Switzerland,15,0,0,15
9792,2018,Afghanistan,Syrian Arab Rep.,1229,10,0,1239
9793,2018,Algeria,Syrian Arab Rep.,5,0,0,5
9794,2018,Egypt,Syrian Arab Rep.,35,5,0,40
9795,2018,Bahrain,Syrian Arab Rep.,0,5,0,5
9796,2018,Chad,Syrian Arab Rep.,8,5,0,13
9797,2018,Eritrea,Syrian Arab Rep.,23,0,0,23
9798,2018,Ethiopia,Syrian Arab Rep.,17,0,0,17
9799,2018,Guinea,Syrian Arab Rep.,52,0,0,52
9800,2018,Cote d'Ivoire,Syrian Arab Rep.,5,0,0,5
9801,2018,Iran (Islamic Rep. of),Syrian Arab Rep.,46,0,0,46
9802,2018,Iraq,Syrian Arab Rep.,15699,18339,0,34038
9803,2018,Jordan,Syrian Arab Rep.,19,0,0,19
9804,2018,Kuwait,Syrian Arab Rep.,5,0,0,5
9805,2018,Libya,Syrian Arab Rep.,12,0,0,12
9806,2018,Lebanon,Syrian Arab Rep.,24,6,0,30
9807,2018,Sri Lanka,Syrian Arab Rep.,0,5,0,5
9808,2018,Morocco,Syrian Arab Rep.,5,0,0,5
9809,2018,Pakistan,Syrian Arab Rep.,186,20,0,206
9810,2018,Saudi Arabia,Syrian Arab Rep.,11,0,0,11
9811,2018,Sierra Leone,Syrian Arab Rep.,19,0,0,19
9812,2018,Somalia,Syrian Arab Rep.,371,22,0,393
9813,2018,Sudan,Syrian Arab Rep.,769,61,0,830
9814,2018,South Sudan,Syrian Arab Rep.,106,0,0,106
9815,2018,Syrian Arab Rep.,Syrian Arab Rep.,0,0,6183920,0
9816,2018,United Rep. of Tanzania,Syrian Arab Rep.,0,5,0,5
9817,2018,Tunisia,Syrian Arab Rep.,5,0,0,5
9818,2018,Türkiye,Syrian Arab Rep.,7,13,0,20
9819,2018,Yemen,Syrian Arab Rep.,159,135,0,294
9821,2018,Burundi,United Rep. of Tanzania,221354,18382,0,239736
9822,2018,Dem. Rep. of the Congo,United Rep. of Tanzania,56561,21122,0,77683
9823,2018,Somalia,United Rep. of Tanzania,150,0,0,150
9825,2018,Cuba,Turks and Caicos Islands,5,0,0,5
9826,2018,Afghanistan,Thailand,136,11,0,147
9827,2018,Egypt,Thailand,15,6,0,21
9828,2018,Cambodia,Thailand,203,135,0,338
9829,2018,China,Thailand,186,14,0,200
9830,2018,Cameroon,Thailand,0,10,0,10
9831,2018,Dem. Rep. of the Congo,Thailand,21,5,0,26
9832,2018,Eritrea,Thailand,7,0,0,7
9833,2018,Ethiopia,Thailand,13,13,0,26
9834,2018,Palestinian,Thailand,377,6,0,383
9835,2018,Guinea,Thailand,0,5,0,5
9836,2018,Cote d'Ivoire,Thailand,15,0,0,15
9837,2018,Iran (Islamic Rep. of),Thailand,63,43,0,106
9838,2018,Iraq,Thailand,248,26,0,274
9839,2018,Jordan,Thailand,5,0,0,5
9840,2018,Lao People's Dem. Rep.,Thailand,5,0,0,5
9841,2018,Sri Lanka,Thailand,137,31,0,168
9842,2018,Myanmar,Thailand,97603,0,0,97603
9843,2018,Nepal,Thailand,10,0,0,10
9844,2018,Pakistan,Thailand,1942,114,0,2056
9845,2018,Russian Federation,Thailand,5,6,0,11
9846,2018,Somalia,Thailand,230,39,0,269
9847,2018,Viet Nam,Thailand,682,448,0,1130
9848,2018,Sudan,Thailand,12,5,0,17
9849,2018,Syrian Arab Rep.,Thailand,276,7,0,283
9850,2018,United Rep. of Tanzania,Thailand,5,0,0,5
9851,2018,Togo,Thailand,6,0,0,6
9852,2018,Türkiye,Thailand,0,5,0,5
9853,2018,Uzbekistan,Thailand,0,5,0,5
9854,2018,Yemen,Thailand,32,0,0,32
9856,2018,Afghanistan,Tajikistan,2649,315,0,2964
9857,2018,Iran (Islamic Rep. of),Tajikistan,5,0,0,5
9859,2018,Afghanistan,Turkmenistan,14,0,0,14
9860,2018,Azerbaijan,Turkmenistan,7,0,0,7
9862,2018,Burundi,Togo,5,0,0,5
9863,2018,Burkina Faso,Togo,0,5,0,5
9864,2018,Central African Rep.,Togo,361,140,0,501
9865,2018,Chad,Togo,17,12,0,29
9866,2018,Cameroon,Togo,6,10,0,16
9867,2018,Congo,Togo,29,12,0,41
9868,2018,Dem. Rep. of the Congo,Togo,107,81,0,188
9869,2018,Ghana,Togo,9747,5,0,9752
9870,2018,Cote d'Ivoire,Togo,1793,330,0,2123
9871,2018,Iraq,Togo,5,0,0,5
9872,2018,Lebanon,Togo,0,13,0,13
9873,2018,Sri Lanka,Togo,0,5,0,5
9874,2018,Mali,Togo,91,35,0,126
9875,2018,Nigeria,Togo,8,13,0,21
9876,2018,Rwanda,Togo,139,0,0,139
9877,2018,Sudan,Togo,0,5,0,5
9878,2018,Syrian Arab Rep.,Togo,0,9,0,9
9879,2018,Türkiye,Togo,27,19,0,46
9880,2018,Egypt,Trinidad and Tobago,0,5,0,5
9881,2018,Bangladesh,Trinidad and Tobago,10,78,0,88
9882,2018,Cameroon,Trinidad and Tobago,0,6,0,6
9883,2018,Colombia,Trinidad and Tobago,15,29,0,44
9884,2018,Cuba,Trinidad and Tobago,154,1852,0,2006
9885,2018,Dominican Rep.,Trinidad and Tobago,0,75,0,75
9886,2018,Ghana,Trinidad and Tobago,0,21,0,21
9887,2018,Guyana,Trinidad and Tobago,5,16,0,21
9888,2018,Haiti,Trinidad and Tobago,0,9,0,9
9889,2018,Jamaica,Trinidad and Tobago,16,25,0,41
9890,2018,Sri Lanka,Trinidad and Tobago,5,0,0,5
9891,2018,Mexico,Trinidad and Tobago,6,0,0,6
9892,2018,Nicaragua,Trinidad and Tobago,0,5,0,5
9893,2018,Nigeria,Trinidad and Tobago,5,100,0,105
9894,2018,Pakistan,Trinidad and Tobago,9,15,0,24
9895,2018,Syrian Arab Rep.,Trinidad and Tobago,57,37,0,94
9896,2018,Tajikistan,Trinidad and Tobago,0,5,0,5
9897,2018,Trinidad and Tobago,Trinidad and Tobago,0,0,0,0
9898,2018,Saint Vincent and the Grenadines,Trinidad and Tobago,5,0,0,5
9899,2018,Venezuela (Bolivarian Republic of),Trinidad and Tobago,497,7659,0,8156
9900,2018,Algeria,Tunisia,8,5,0,13
9901,2018,Central African Rep.,Tunisia,7,6,0,13
9902,2018,Cameroon,Tunisia,5,16,0,21
9903,2018,Dem. Rep. of the Congo,Tunisia,0,11,0,11
9904,2018,Eritrea,Tunisia,5,44,0,49
9905,2018,Palestinian,Tunisia,37,5,0,42
9906,2018,Ghana,Tunisia,0,5,0,5
9907,2018,Guinea,Tunisia,0,13,0,13
9908,2018,Cote d'Ivoire,Tunisia,5,64,0,69
9909,2018,Iran (Islamic Rep. of),Tunisia,5,0,0,5
9910,2018,Iraq,Tunisia,19,5,0,24
9911,2018,Libya,Tunisia,0,5,0,5
9912,2018,Lebanon,Tunisia,6,0,0,6
9913,2018,Nigeria,Tunisia,0,13,0,13
9914,2018,Rwanda,Tunisia,6,0,0,6
9915,2018,Sierra Leone,Tunisia,0,5,0,5
9916,2018,Somalia,Tunisia,5,0,0,5
9917,2018,Sudan,Tunisia,26,6,0,32
9918,2018,Syrian Arab Rep.,Tunisia,927,0,0,927
9919,2018,Türkiye,Tunisia,0,15,0,15
9920,2018,Yemen,Tunisia,0,32,0,32
9921,2018,Afghanistan,Türkiye,6606,164913,0,171519
9922,2018,Algeria,Türkiye,5,24,0,29
9923,2018,Angola,Türkiye,5,15,0,20
9924,2018,Egypt,Türkiye,59,317,0,376
9925,2018,Azerbaijan,Türkiye,5,0,0,5
9926,2018,Burundi,Türkiye,5,33,0,38
9927,2018,Bangladesh,Türkiye,0,171,0,171
9928,2018,Central African Rep.,Türkiye,0,19,0,19
9929,2018,China,Türkiye,13,417,0,430
9930,2018,Cameroon,Türkiye,6,61,0,67
9931,2018,Congo,Türkiye,6,92,0,98
9932,2018,Dem. Rep. of the Congo,Türkiye,45,614,0,659
9933,2018,Djibouti,Türkiye,0,39,0,39
9934,2018,Eritrea,Türkiye,64,183,0,247
9935,2018,Ethiopia,Türkiye,73,266,0,339
9936,2018,Gabon,Türkiye,0,8,0,8
9937,2018,Gambia,Türkiye,0,11,0,11
9938,2018,Palestinian,Türkiye,1226,570,0,1796
9939,2018,Ghana,Türkiye,0,11,0,11
9940,2018,Guinea,Türkiye,10,17,0,27
9941,2018,Cote d'Ivoire,Türkiye,10,14,0,24
9942,2018,India,Türkiye,0,5,0,5
9943,2018,Iran (Islamic Rep. of),Türkiye,8731,30489,0,39220
9944,2018,Iraq,Türkiye,39088,103640,0,142728
9945,2018,Jordan,Türkiye,36,97,0,133
9946,2018,Kazakhstan,Türkiye,0,21,0,21
9947,2018,Kenya,Türkiye,0,5,0,5
9948,2018,Kyrgyzstan,Türkiye,175,93,0,268
9949,2018,Kuwait,Türkiye,0,5,0,5
9950,2018,Liberia,Türkiye,5,5,0,10
9951,2018,Libya,Türkiye,27,87,0,114
9952,2018,Lebanon,Türkiye,13,29,0,42
9953,2018,Sri Lanka,Türkiye,15,9,0,24
9954,2018,Mauritania,Türkiye,8,0,0,8
9955,2018,Mali,Türkiye,0,21,0,21
9956,2018,Malaysia,Türkiye,0,5,0,5
9957,2018,Mongolia,Türkiye,0,110,0,110
9958,2018,Morocco,Türkiye,33,75,0,108
9959,2018,Myanmar,Türkiye,0,26,0,26
9960,2018,Nepal,Türkiye,0,5,0,5
9961,2018,Niger,Türkiye,0,5,0,5
9962,2018,Nigeria,Türkiye,10,85,0,95
9963,2018,Pakistan,Türkiye,51,2303,0,2354
9964,2018,Philippines,Türkiye,5,7,0,12
9965,2018,Russian Federation,Türkiye,5,0,0,5
9966,2018,Rwanda,Türkiye,0,5,0,5
9967,2018,Saudi Arabia,Türkiye,5,11,0,16
9968,2018,Senegal,Türkiye,5,13,0,18
9969,2018,Sierra Leone,Türkiye,5,7,0,12
9970,2018,Somalia,Türkiye,2220,3536,0,5756
9971,2018,Sudan,Türkiye,266,148,0,414
9972,2018,South Sudan,Türkiye,5,5,0,10
9973,2018,Syrian Arab Rep.,Türkiye,3622366,111,0,3622477
9974,2018,United Rep. of Tanzania,Türkiye,0,5,0,5
9975,2018,Tajikistan,Türkiye,8,283,0,291
9976,2018,Turkmenistan,Türkiye,6,721,0,727
9977,2018,Togo,Türkiye,0,6,0,6
9978,2018,Tunisia,Türkiye,13,38,0,51
9979,2018,United Arab Emirates,Türkiye,6,21,0,27
9980,2018,Uganda,Türkiye,15,470,0,485
9981,2018,Uzbekistan,Türkiye,45,664,0,709
9982,2018,Yemen,Türkiye,169,608,0,777
9983,2018,Zimbabwe,Türkiye,6,59,0,65
9985,2018,Afghanistan,United Arab Emirates,5,20,0,25
9986,2018,Egypt,United Arab Emirates,0,0,0,0
9987,2018,Eritrea,United Arab Emirates,5,6,0,11
9988,2018,Ethiopia,United Arab Emirates,10,0,0,10
9989,2018,Palestinian,United Arab Emirates,5,40,0,45
9990,2018,Iran (Islamic Rep. of),United Arab Emirates,8,8,0,16
9991,2018,Iraq,United Arab Emirates,778,556,0,1334
9992,2018,Jordan,United Arab Emirates,0,0,0,0
9993,2018,Kuwait,United Arab Emirates,5,0,0,5
9994,2018,Libya,United Arab Emirates,0,5,0,5
9995,2018,Lebanon,United Arab Emirates,15,0,0,15
9996,2018,Morocco,United Arab Emirates,0,0,0,0
9997,2018,Pakistan,United Arab Emirates,5,0,0,5
9998,2018,Philippines,United Arab Emirates,0,0,0,0
9999,2018,Saudi Arabia,United Arab Emirates,5,0,0,5
10000,2018,Somalia,United Arab Emirates,21,0,0,21
10001,2018,Sudan,United Arab Emirates,8,12,0,20
10002,2018,Syrian Arab Rep.,United Arab Emirates,287,5820,0,6107
10003,2018,Uganda,United Arab Emirates,5,0,0,5
10004,2018,Yemen,United Arab Emirates,5,33,0,38
10005,2018,Egypt,Uganda,0,5,0,5
10006,2018,Burundi,Uganda,32518,2463,0,34981
10007,2018,Central African Rep.,Uganda,23,5,0,28
10008,2018,Chad,Uganda,7,0,0,7
10009,2018,Congo,Uganda,6,0,0,6
10010,2018,Dem. Rep. of the Congo,Uganda,303092,9607,0,312699
10011,2018,Eritrea,Uganda,3373,6149,0,9522
10012,2018,Ethiopia,Uganda,1708,675,0,2383
10013,2018,Kenya,Uganda,194,20,0,214
10014,2018,Liberia,Uganda,5,0,0,5
10015,2018,Mali,Uganda,0,5,0,5
10016,2018,Nigeria,Uganda,10,0,0,10
10017,2018,Pakistan,Uganda,220,91,0,311
10018,2018,Rwanda,Uganda,14024,589,0,14613
10019,2018,Senegal,Uganda,11,0,0,11
10020,2018,Somalia,Uganda,18764,4869,0,23633
10021,2018,Sudan,Uganda,2802,347,0,3149
10022,2018,South Sudan,Uganda,788848,439,0,789287
10023,2018,Syrian Arab Rep.,Uganda,5,5,0,10
10024,2018,United Rep. of Tanzania,Uganda,8,0,0,8
10025,2018,Türkiye,Uganda,8,0,0,8
10026,2018,Uganda,Uganda,0,0,0,0
10027,2018,Yemen,Uganda,20,0,0,20
10028,2018,Afghanistan,Ukraine,1013,2905,0,3918
10029,2018,Algeria,Ukraine,0,13,0,13
10030,2018,Angola,Ukraine,24,10,0,34
10031,2018,Egypt,Ukraine,5,22,0,27
10032,2018,Armenia,Ukraine,189,28,0,217
10033,2018,Azerbaijan,Ukraine,116,42,0,158
10034,2018,Burundi,Ukraine,0,7,0,7
10035,2018,Bangladesh,Ukraine,0,158,0,158
10036,2018,Bahamas,Ukraine,0,5,0,5
10037,2018,Belarus,Ukraine,23,39,0,62
10038,2018,Cambodia,Ukraine,0,5,0,5
10039,2018,Chad,Ukraine,7,5,0,12
10040,2018,China,Ukraine,0,12,0,12
10041,2018,Cameroon,Ukraine,0,98,0,98
10042,2018,Congo,Ukraine,18,39,0,57
10043,2018,Dem. Rep. of the Congo,Ukraine,53,125,0,178
10044,2018,Cuba,Ukraine,0,11,0,11
10045,2018,Eritrea,Ukraine,12,22,0,34
10046,2018,Ethiopia,Ukraine,28,30,0,58
10047,2018,Gambia,Ukraine,0,5,0,5
10048,2018,Palestinian,Ukraine,18,168,0,186
10049,2018,Georgia,Ukraine,48,98,0,146
10050,2018,Ghana,Ukraine,0,5,0,5
10051,2018,Guinea,Ukraine,5,123,0,128
10052,2018,Cote d'Ivoire,Ukraine,0,27,0,27
10053,2018,India,Ukraine,8,32,0,40
10054,2018,Iran (Islamic Rep. of),Ukraine,55,115,0,170
10055,2018,Iraq,Ukraine,79,268,0,347
10056,2018,Jordan,Ukraine,5,25,0,30
10057,2018,Kazakhstan,Ukraine,7,11,0,18
10058,2018,Kenya,Ukraine,0,6,0,6
10059,2018,Kyrgyzstan,Ukraine,6,148,0,154
10060,2018,Liberia,Ukraine,0,16,0,16
10061,2018,Libya,Ukraine,0,24,0,24
10062,2018,Lebanon,Ukraine,9,22,0,31
10063,2018,Sri Lanka,Ukraine,7,66,0,73
10064,2018,Rep. of Moldova,Ukraine,0,5,0,5
10065,2018,Mali,Ukraine,0,5,0,5
10066,2018,Morocco,Ukraine,0,5,0,5
10067,2018,Myanmar,Ukraine,0,13,0,13
10068,2018,Nepal,Ukraine,0,19,0,19
10069,2018,Nigeria,Ukraine,5,65,0,70
10070,2018,Pakistan,Ukraine,9,195,0,204
10071,2018,Russian Federation,Ukraine,137,200,0,337
10072,2018,Rwanda,Ukraine,5,0,0,5
10073,2018,Serbia and Kosovo: S/RES/1244 (1999),Ukraine,5,0,0,5
10074,2018,Sierra Leone,Ukraine,5,10,0,15
10075,2018,Somalia,Ukraine,98,300,0,398
10076,2018,Viet Nam,Ukraine,0,34,0,34
10077,2018,Sudan,Ukraine,29,115,0,144
10078,2018,Syrian Arab Rep.,Ukraine,457,489,0,946
10079,2018,Tajikistan,Ukraine,20,45,0,65
10080,2018,Turkmenistan,Ukraine,7,5,0,12
10081,2018,Togo,Ukraine,0,5,0,5
10082,2018,Tunisia,Ukraine,0,10,0,10
10083,2018,Türkiye,Ukraine,12,37,0,49
10084,2018,Uganda,Ukraine,0,5,0,5
10085,2018,Ukraine,Ukraine,0,0,1500002,0
10086,2018,Uzbekistan,Ukraine,30,73,0,103
10087,2018,Western Sahara,Ukraine,0,5,0,5
10088,2018,Yemen,Ukraine,5,6,0,11
10090,2018,Angola,Uruguay,9,6,0,15
10091,2018,Egypt,Uruguay,0,5,0,5
10092,2018,Argentina,Uruguay,0,6,0,6
10093,2018,Bolivia (Plurinational State of),Uruguay,5,0,0,5
10094,2018,Brazil,Uruguay,0,8,0,8
10095,2018,Cameroon,Uruguay,9,0,0,9
10096,2018,Congo,Uruguay,5,0,0,5
10097,2018,Colombia,Uruguay,149,19,0,168
10098,2018,Cuba,Uruguay,15,6183,0,6198
10099,2018,Dominican Rep.,Uruguay,0,14,0,14
10100,2018,Ecuador,Uruguay,7,0,0,7
10101,2018,Haiti,Uruguay,0,5,0,5
10102,2018,Libya,Uruguay,5,0,0,5
10103,2018,Latvia,Uruguay,5,0,0,5
10104,2018,Mexico,Uruguay,5,0,0,5
10105,2018,Morocco,Uruguay,0,10,0,10
10106,2018,Nicaragua,Uruguay,0,12,0,12
10107,2018,Nigeria,Uruguay,17,17,0,34
10108,2018,Paraguay,Uruguay,5,0,0,5
10109,2018,Peru,Uruguay,6,0,0,6
10110,2018,Russian Federation,Uruguay,12,6,0,18
10111,2018,El Salvador,Uruguay,26,22,0,48
10112,2018,Senegal,Uruguay,0,27,0,27
10113,2018,Somalia,Uruguay,5,0,0,5
10114,2018,Spain,Uruguay,0,5,0,5
10115,2018,Syrian Arab Rep.,Uruguay,61,0,0,61
10116,2018,Türkiye,Uruguay,5,8,0,13
10117,2018,Ukraine,Uruguay,11,0,0,11
10118,2018,Venezuela (Bolivarian Republic of),Uruguay,17,51,0,68
10119,2018,Afghanistan,United States of America,1599,765,0,2364
10120,2018,Albania,United States of America,1516,1717,0,3233
10121,2018,Algeria,United States of America,147,333,0,480
10122,2018,Angola,United States of America,207,1416,0,1623
10123,2018,Antigua and Barbuda,United States of America,5,5,0,10
10124,2018,Egypt,United States of America,13163,4677,0,17840
10125,2018,Argentina,United States of America,45,231,0,276
10126,2018,Armenia,United States of America,1639,2456,0,4095
10127,2018,Australia,United States of America,0,10,0,10
10128,2018,Austria,United States of America,14,0,0,14
10129,2018,Azerbaijan,United States of America,386,1003,0,1389
10130,2018,Bahrain,United States of America,47,28,0,75
10131,2018,Barbados,United States of America,0,10,0,10
10132,2018,Burundi,United States of America,789,655,0,1444
10133,2018,Belgium,United States of America,29,34,0,63
10134,2018,Benin,United States of America,95,202,0,297
10135,2018,Bangladesh,United States of America,1628,6444,0,8072
10136,2018,Bahamas,United States of America,180,86,0,266
10137,2018,Bhutan,United States of America,41,330,0,371
10138,2018,Burkina Faso,United States of America,1300,3303,0,4603
10139,2018,Belarus,United States of America,1634,1970,0,3604
10140,2018,Bolivia (Plurinational State of),United States of America,105,405,0,510
10141,2018,Botswana,United States of America,0,7,0,7
10142,2018,Brazil,United States of America,709,7378,0,8087
10143,2018,Bosnia and Herzegovina,United States of America,100,192,0,292
10144,2018,Bulgaria,United States of America,277,254,0,531
10145,2018,Belize,United States of America,44,204,0,248
10146,2018,Cambodia,United States of America,148,64,0,212
10147,2018,Canada,United States of America,42,54,0,96
10148,2018,Central African Rep.,United States of America,215,106,0,321
10149,2018,Cayman Islands,United States of America,6,0,0,6
10150,2018,Chad,United States of America,309,212,0,521
10151,2018,China,United States of America,77710,66561,0,144271
10152,2018,Chile,United States of America,25,179,0,204
10153,2018,Cameroon,United States of America,4300,4414,0,8714
10154,2018,Congo,United States of America,1247,270,0,1517
10155,2018,Dem. Rep. of the Congo,United States of America,1232,2819,0,4051
10156,2018,Comoros,United States of America,5,0,0,5
10157,2018,Colombia,United States of America,3292,9398,0,12690
10158,2018,Costa Rica,United States of America,171,486,0,657
10159,2018,Cuba,United States of America,611,1398,0,2009
10160,2018,Cabo Verde,United States of America,0,23,0,23
10161,2018,Cyprus,United States of America,0,5,0,5
10162,2018,Czechia,United States of America,15,27,0,42
10163,2018,Denmark,United States of America,0,5,0,5
10164,2018,Djibouti,United States of America,302,525,0,827
10165,2018,Dominica,United States of America,11,25,0,36
10166,2018,Dominican Rep.,United States of America,208,1003,0,1211
10167,2018,Ecuador,United States of America,1144,17302,0,18446
10168,2018,Equatorial Guinea,United States of America,11,42,0,53
10169,2018,Eritrea,United States of America,5725,1372,0,7097
10170,2018,Estonia,United States of America,264,37,0,301
10171,2018,Ethiopia,United States of America,9635,5679,0,15314
10172,2018,French Guiana,United States of America,0,5,0,5
10173,2018,Fiji,United States of America,185,253,0,438
10174,2018,Finland,United States of America,5,0,0,5
10175,2018,France,United States of America,24,128,0,152
10176,2018,Gabon,United States of America,49,217,0,266
10177,2018,Gambia,United States of America,1521,836,0,2357
10178,2018,Palestinian,United States of America,5,77,0,82
10179,2018,United Kingdom of Great Britain and Northern Ireland,United States of America,36,114,0,150
10180,2018,Georgia,United States of America,411,1581,0,1992
10181,2018,Germany,United States of America,42,125,0,167
10182,2018,Ghana,United States of America,429,935,0,1364
10183,2018,Guinea-Bissau,United States of America,23,20,0,43
10184,2018,Greece,United States of America,15,68,0,83
10185,2018,Grenada,United States of America,22,38,0,60
10186,2018,Guatemala,United States of America,17610,84848,0,102458
10187,2018,Guinea,United States of America,2146,1126,0,3272
10188,2018,Guyana,United States of America,98,376,0,474
10189,2018,Haiti,United States of America,16192,17073,0,33265
10190,2018,"China, Hong Kong SAR",United States of America,0,6,0,6
10191,2018,Honduras,United States of America,12578,60417,0,72995
10192,2018,Croatia,United States of America,32,37,0,69
10193,2018,Hungary,United States of America,18,212,0,230
10194,2018,Cote d'Ivoire,United States of America,1233,1157,0,2390
10195,2018,India,United States of America,6110,28489,0,34599
10196,2018,Indonesia,United States of America,1379,2036,0,3415
10197,2018,Ireland,United States of America,0,26,0,26
10198,2018,Iran (Islamic Rep. of),United States of America,5648,3158,0,8806
10199,2018,Iraq,United States of America,5947,3626,0,9573
10200,2018,Israel,United States of America,138,477,0,615
10201,2018,Italy,United States of America,22,190,0,212
10202,2018,Jamaica,United States of America,832,958,0,1790
10203,2018,Jordan,United States of America,557,2045,0,2602
10204,2018,Japan,United States of America,8,82,0,90
10205,2018,Kazakhstan,United States of America,843,1809,0,2652
10206,2018,Kenya,United States of America,1987,3836,0,5823
10207,2018,Kyrgyzstan,United States of America,1412,1430,0,2842
10208,2018,Rep. of Korea,United States of America,33,207,0,240
10209,2018,Dem. People's Rep. of Korea,United States of America,8,35,0,43
10210,2018,Kuwait,United States of America,148,195,0,343
10211,2018,Lao People's Dem. Rep.,United States of America,97,162,0,259
10212,2018,Liberia,United States of America,1252,985,0,2237
10213,2018,Libya,United States of America,361,1034,0,1395
10214,2018,Saint Lucia,United States of America,9,21,0,30
10215,2018,Lebanon,United States of America,396,732,0,1128
10216,2018,Lesotho,United States of America,6,0,0,6
10217,2018,Sri Lanka,United States of America,1281,1624,0,2905
10218,2018,Lithuania,United States of America,19,62,0,81
10219,2018,Latvia,United States of America,24,82,0,106
10220,2018,Madagascar,United States of America,14,14,0,28
10221,2018,Mauritania,United States of America,983,810,0,1793
10222,2018,North Macedonia,United States of America,123,179,0,302
10223,2018,Monaco,United States of America,5,0,0,5
10224,2018,Rep. of Moldova,United States of America,1502,2214,0,3716
10225,2018,Maldives,United States of America,6,5,0,11
10226,2018,Mexico,United States of America,9271,85596,0,94867
10227,2018,Marshall Islands,United States of America,7,0,0,7
10228,2018,Mali,United States of America,1191,574,0,1765
10229,2018,Malaysia,United States of America,94,301,0,395
10230,2018,Malawi,United States of America,35,99,0,134
10231,2018,Mongolia,United States of America,758,1995,0,2753
10232,2018,Morocco,United States of America,111,215,0,326
10233,2018,Mozambique,United States of America,5,37,0,42
10234,2018,Malta,United States of America,0,5,0,5
10235,2018,Montenegro,United States of America,120,259,0,379
10236,2018,Mauritius,United States of America,36,42,0,78
10237,2018,Myanmar,United States of America,1553,956,0,2509
10238,2018,Namibia,United States of America,44,7,0,51
10239,2018,Nepal,United States of America,7053,6724,0,13777
10240,2018,Netherlands,United States of America,11,51,0,62
10241,2018,Niger,United States of America,137,290,0,427
10242,2018,Nicaragua,United States of America,672,2721,0,3393
10243,2018,Nigeria,United States of America,1703,8685,0,10388
10244,2018,Niue,United States of America,19,5,0,24
10245,2018,Oman,United States of America,5,11,0,16
10246,2018,Pakistan,United States of America,3722,5334,0,9056
10247,2018,Panama,United States of America,14,84,0,98
10248,2018,Paraguay,United States of America,21,82,0,103
10249,2018,Peru,United States of America,501,2942,0,3443
10250,2018,Philippines,United States of America,166,1457,0,1623
10251,2018,Poland,United States of America,17,765,0,782
10252,2018,Portugal,United States of America,5,129,0,134
10253,2018,Qatar,United States of America,13,33,0,46
10254,2018,Romania,United States of America,401,3116,0,3517
10255,2018,South Africa,United States of America,47,419,0,466
10256,2018,Russian Federation,United States of America,5813,8901,0,14714
10257,2018,Rwanda,United States of America,1152,788,0,1940
10258,2018,El Salvador,United States of America,22152,101000,0,123152
10259,2018,Saudi Arabia,United States of America,482,770,0,1252
10260,2018,Serbia and Kosovo: S/RES/1244 (1999),United States of America,918,664,0,1582
10261,2018,Senegal,United States of America,406,603,0,1009
10262,2018,Seychelles,United States of America,5,0,0,5
10263,2018,Singapore,United States of America,13,32,0,45
10264,2018,Sierra Leone,United States of America,492,308,0,800
10265,2018,Somalia,United States of America,2231,423,0,2654
10266,2018,Spain,United States of America,13,72,0,85
10267,2018,Viet Nam,United States of America,275,571,0,846
10268,2018,Saint Kitts and Nevis,United States of America,5,0,0,5
10269,2018,Sudan,United States of America,1411,883,0,2294
10270,2018,Suriname,United States of America,12,26,0,38
10271,2018,South Sudan,United States of America,24,34,0,58
10272,2018,Slovakia,United States of America,8,15,0,23
10273,2018,Slovenia,United States of America,6,5,0,11
10274,2018,Eswatini,United States of America,5,10,0,15
10275,2018,Sweden,United States of America,8,10,0,18
10276,2018,Switzerland,United States of America,5,13,0,18
10277,2018,Syrian Arab Rep.,United States of America,7998,3057,0,11055
10278,2018,United Rep. of Tanzania,United States of America,131,174,0,305
10279,2018,Turks and Caicos Islands,United States of America,14,0,0,14
10280,2018,Thailand,United States of America,36,475,0,511
10281,2018,Tajikistan,United States of America,316,415,0,731
10282,2018,Turkmenistan,United States of America,193,260,0,453
10283,2018,Togo,United States of America,588,530,0,1118
10284,2018,Tonga,United States of America,0,6,0,6
10285,2018,Trinidad and Tobago,United States of America,51,215,0,266
10286,2018,Tunisia,United States of America,82,228,0,310
10287,2018,Türkiye,United States of America,1127,3390,0,4517
10288,2018,United Arab Emirates,United States of America,59,150,0,209
10289,2018,Uganda,United States of America,1560,2403,0,3963
10290,2018,Ukraine,United States of America,2270,7661,0,9931
10291,2018,Uruguay,United States of America,0,116,0,116
10292,2018,Uzbekistan,United States of America,1246,1893,0,3139
10293,2018,Vanuatu,United States of America,0,12,0,12
10294,2018,Saint Vincent and the Grenadines,United States of America,31,25,0,56
10295,2018,Venezuela (Bolivarian Republic of),United States of America,11259,81800,0,93059
10296,2018,Yemen,United States of America,606,800,0,1406
10297,2018,Zambia,United States of America,46,142,0,188
10298,2018,Zimbabwe,United States of America,916,783,0,1699
10300,2018,Guadeloupe,United States of America,0,11,0,11
10301,2018,Curacao ,United States of America,35,0,0,35
10303,2018,Afghanistan,Uzbekistan,13,0,0,13
10305,2018,Afghanistan,Venezuela (Bolivarian Republic of),10,0,0,10
10306,2018,Chile,Venezuela (Bolivarian Republic of),10,0,0,10
10307,2018,Congo,Venezuela (Bolivarian Republic of),5,0,0,5
10308,2018,Colombia,Venezuela (Bolivarian Republic of),67156,142,0,67298
10309,2018,Palestinian,Venezuela (Bolivarian Republic of),7,0,0,7
10310,2018,Haiti,Venezuela (Bolivarian Republic of),7,0,0,7
10311,2018,Iraq,Venezuela (Bolivarian Republic of),18,0,0,18
10312,2018,Liberia,Venezuela (Bolivarian Republic of),9,0,0,9
10313,2018,Libya,Venezuela (Bolivarian Republic of),5,0,0,5
10314,2018,Lebanon,Venezuela (Bolivarian Republic of),12,0,0,12
10315,2018,Nigeria,Venezuela (Bolivarian Republic of),7,0,0,7
10316,2018,Peru,Venezuela (Bolivarian Republic of),5,0,0,5
10317,2018,Rwanda,Venezuela (Bolivarian Republic of),5,0,0,5
10318,2018,Sierra Leone,Venezuela (Bolivarian Republic of),5,0,0,5
10319,2018,Syrian Arab Rep.,Venezuela (Bolivarian Republic of),5,0,0,5
10320,2018,Türkiye,Venezuela (Bolivarian Republic of),6,0,0,6
10321,2018,Western Sahara,Venezuela (Bolivarian Republic of),11,0,0,11
10322,2018,Sri Lanka,Samoa,5,0,0,5
10323,2018,Algeria,Yemen,0,5,0,5
10324,2018,Egypt,Yemen,16,5,0,21
10325,2018,Dem. Rep. of the Congo,Yemen,5,0,0,5
10326,2018,Djibouti,Yemen,0,5,0,5
10327,2018,Eritrea,Yemen,1389,381,0,1770
10328,2018,Ethiopia,Yemen,6448,7213,0,13661
10329,2018,Palestinian,Yemen,619,227,0,846
10330,2018,Iran (Islamic Rep. of),Yemen,5,0,0,5
10331,2018,Iraq,Yemen,3330,53,0,3383
10332,2018,Jordan,Yemen,12,0,0,12
10333,2018,Lebanon,Yemen,0,6,0,6
10334,2018,Pakistan,Yemen,0,9,0,9
10335,2018,Somalia,Yemen,248955,62,0,249017
10336,2018,Viet Nam,Yemen,15,0,0,15
10337,2018,Sudan,Yemen,119,433,0,552
10338,2018,Syrian Arab Rep.,Yemen,3446,406,0,3852
10339,2018,United Rep. of Tanzania,Yemen,0,0,0,0
10340,2018,Yemen,Yemen,0,0,2144719,0
10341,2018,Angola,Zambia,0,0,0,0
10342,2018,Burundi,Zambia,4483,1110,0,5593
10343,2018,Congo,Zambia,7,0,0,7
10344,2018,Dem. Rep. of the Congo,Zambia,41490,1790,0,43280
10345,2018,Eritrea,Zambia,22,21,0,43
10346,2018,Ethiopia,Zambia,27,16,0,43
10347,2018,Palestinian,Zambia,12,0,0,12
10348,2018,Liberia,Zambia,7,0,0,7
10349,2018,Nigeria,Zambia,0,5,0,5
10350,2018,South Africa,Zambia,6,0,0,6
10351,2018,Rwanda,Zambia,755,64,0,819
10352,2018,Sierra Leone,Zambia,5,5,0,10
10353,2018,Somalia,Zambia,2891,274,0,3165
10354,2018,Sudan,Zambia,26,0,0,26
10355,2018,Syrian Arab Rep.,Zambia,8,9,0,17
10356,2018,Türkiye,Zambia,39,0,0,39
10357,2018,Uganda,Zambia,28,6,0,34
10359,2018,Burundi,Zimbabwe,608,115,0,723
10360,2018,Central African Rep.,Zimbabwe,0,5,0,5
10361,2018,Dem. Rep. of the Congo,Zimbabwe,6489,1963,0,8452
10362,2018,Eritrea,Zimbabwe,16,0,0,16
10363,2018,Ethiopia,Zimbabwe,67,9,0,76
10364,2018,Cote d'Ivoire,Zimbabwe,11,8,0,19
10365,2018,Kenya,Zimbabwe,0,8,0,8
10366,2018,Mali,Zimbabwe,5,17,0,22
10367,2018,Mozambique,Zimbabwe,0,7994,0,7994
10368,2018,South Africa,Zimbabwe,0,0,0,0
10369,2018,Rwanda,Zimbabwe,572,43,0,615
10370,2018,Somalia,Zimbabwe,12,12,0,24
10371,2018,Sudan,Zimbabwe,0,28,0,28
10372,2018,South Sudan,Zimbabwe,8,0,0,8
10373,2018,Uganda,Zimbabwe,7,5,0,12
10374,2018,Zimbabwe,Zimbabwe,0,0,0,0
10375,2018,Colombia,Aruba,0,9,0,9
10376,2018,Venezuela (Bolivarian Republic of),Aruba,0,398,0,398
10377,2018,Colombia,Curacao ,53,57,0,110
10378,2018,Cuba,Curacao ,6,6,0,12
10379,2018,Jamaica,Curacao ,5,0,0,5
10380,2018,Venezuela (Bolivarian Republic of),Curacao ,35,279,0,314
10381,2018,Iran (Islamic Rep. of),Sint Maarten (Dutch part),5,0,0,5
10382,2019,Afghanistan,Afghanistan,0,0,2553390,0
10383,2019,Benin,Afghanistan,0,5,0,5
10384,2019,Iran (Islamic Rep. of),Afghanistan,36,25,0,61
10385,2019,Pakistan,Afghanistan,72191,138,0,72329
10386,2019,Türkiye,Afghanistan,0,79,0,79
10387,2019,Algeria,Albania,0,0,0,0
10388,2019,Egypt,Albania,5,0,0,5
10389,2019,China,Albania,12,0,0,12
10390,2019,Palestinian,Albania,7,5,0,12
10391,2019,Iraq,Albania,8,0,0,8
10392,2019,Morocco,Albania,0,0,0,0
10393,2019,Serbia and Kosovo: S/RES/1244 (1999),Albania,65,0,0,65
10394,2019,Syrian Arab Rep.,Albania,13,0,0,13
10395,2019,Türkiye,Albania,0,0,0,0
10396,2019,Uzbekistan,Albania,5,0,0,5
10397,2019,Venezuela (Bolivarian Republic of),Albania,5,0,0,5
10399,2019,Benin,Algeria,0,15,0,15
10400,2019,Burkina Faso,Algeria,0,13,0,13
10401,2019,Central African Rep.,Algeria,67,29,0,96
10402,2019,Chad,Algeria,0,18,0,18
10403,2019,Cameroon,Algeria,72,285,0,357
10404,2019,Congo,Algeria,0,5,0,5
10405,2019,Dem. Rep. of the Congo,Algeria,59,104,0,163
10406,2019,Eritrea,Algeria,0,6,0,6
10407,2019,Palestinian,Algeria,173,0,0,173
10408,2019,Ghana,Algeria,0,5,0,5
10409,2019,Guinea,Algeria,28,227,0,255
10410,2019,Cote d'Ivoire,Algeria,63,162,0,225
10411,2019,Iraq,Algeria,12,5,0,17
10412,2019,Liberia,Algeria,0,36,0,36
10413,2019,Libya,Algeria,19,16,0,35
10414,2019,Mali,Algeria,74,356,0,430
10415,2019,Niger,Algeria,5,92,0,97
10416,2019,Nigeria,Algeria,5,196,0,201
10417,2019,Senegal,Algeria,0,9,0,9
10418,2019,Sierra Leone,Algeria,0,15,0,15
10419,2019,Sudan,Algeria,8,26,0,34
10420,2019,Syrian Arab Rep.,Algeria,7757,0,0,7757
10421,2019,Togo,Algeria,0,14,0,14
10422,2019,Türkiye,Algeria,0,13,0,13
10423,2019,Western Sahara,Algeria,90000,0,0,90000
10424,2019,Yemen,Algeria,257,0,0,257
10425,2019,Angola,Angola,0,0,0,0
10426,2019,Burundi,Angola,18,99,0,117
10427,2019,Central African Rep.,Angola,7,76,0,83
10428,2019,Chad,Angola,190,779,0,969
10429,2019,Congo,Angola,65,58,0,123
10430,2019,Dem. Rep. of the Congo,Angola,22905,500,0,23405
10431,2019,Eritrea,Angola,78,1774,0,1852
10432,2019,Ethiopia,Angola,0,57,0,57
10433,2019,Guinea-Bissau,Angola,7,268,0,275
10434,2019,Guinea,Angola,128,9145,0,9273
10435,2019,Cote d'Ivoire,Angola,417,5940,0,6357
10436,2019,Liberia,Angola,164,478,0,642
10437,2019,Mauritania,Angola,323,5402,0,5725
10438,2019,Rwanda,Angola,507,67,0,574
10439,2019,Sierra Leone,Angola,413,1497,0,1910
10440,2019,Somalia,Angola,270,1731,0,2001
10441,2019,Sudan,Angola,280,1670,0,1950
10442,2019,United Rep. of Tanzania,Angola,5,0,0,5
10443,2019,Türkiye,Angola,0,35,0,35
10444,2019,Uganda,Angola,0,6,0,6
10445,2019,Western Sahara,Angola,16,596,0,612
10446,2019,Afghanistan,Egypt,28,36,0,64
10447,2019,Burundi,Egypt,51,52,0,103
10448,2019,Central African Rep.,Egypt,37,30,0,67
10449,2019,Chad,Egypt,48,35,0,83
10450,2019,China,Egypt,0,71,0,71
10451,2019,Cameroon,Egypt,15,31,0,46
10452,2019,Congo,Egypt,13,20,0,33
10453,2019,Dem. Rep. of the Congo,Egypt,52,26,0,78
10454,2019,Djibouti,Egypt,12,9,0,21
10455,2019,Eritrea,Egypt,8858,9374,0,18232
10456,2019,Ethiopia,Egypt,4599,11657,0,16256
10457,2019,Palestinian,Egypt,70010,0,0,70010
10458,2019,Guinea,Egypt,7,51,0,58
10459,2019,Cote d'Ivoire,Egypt,99,6,0,105
10460,2019,Iraq,Egypt,4426,2345,0,6771
10461,2019,Jordan,Egypt,11,11,0,22
10462,2019,Kenya,Egypt,7,5,0,12
10463,2019,Liberia,Egypt,0,8,0,8
10464,2019,Libya,Egypt,5,0,0,5
10465,2019,Mali,Egypt,0,9,0,9
10466,2019,Nigeria,Egypt,21,135,0,156
10467,2019,Russian Federation,Egypt,8,24,0,32
10468,2019,Rwanda,Egypt,5,0,0,5
10469,2019,Saudi Arabia,Egypt,5,17,0,22
10470,2019,Sierra Leone,Egypt,5,9,0,14
10471,2019,Somalia,Egypt,3973,2729,0,6702
10472,2019,Sudan,Egypt,21861,25902,0,47763
10473,2019,South Sudan,Egypt,14832,4181,0,19013
10474,2019,Syrian Arab Rep.,Egypt,129210,0,0,129210
10475,2019,Tajikistan,Egypt,12,27,0,39
10476,2019,Turkmenistan,Egypt,5,0,0,5
10477,2019,Togo,Egypt,0,7,0,7
10478,2019,Tunisia,Egypt,5,0,0,5
10479,2019,Türkiye,Egypt,0,389,0,389
10480,2019,Uganda,Egypt,13,19,0,32
10481,2019,Uzbekistan,Egypt,0,21,0,21
10482,2019,Yemen,Egypt,126,9032,0,9158
10483,2019,Zimbabwe,Egypt,27,36,0,63
10486,2019,Afghanistan,Argentina,12,0,0,12
10487,2019,Albania,Argentina,18,0,0,18
10488,2019,Algeria,Argentina,30,22,0,52
10489,2019,Angola,Argentina,14,14,0,28
10490,2019,Egypt,Argentina,5,19,0,24
10491,2019,Armenia,Argentina,77,175,0,252
10492,2019,Burundi,Argentina,5,0,0,5
10493,2019,Bangladesh,Argentina,5,84,0,89
10494,2019,Bolivia (Plurinational State of),Argentina,5,56,0,61
10495,2019,Brazil,Argentina,0,7,0,7
10496,2019,Bosnia and Herzegovina,Argentina,6,0,0,6
10497,2019,China,Argentina,0,121,0,121
10498,2019,Chile,Argentina,34,5,0,39
10499,2019,Cameroon,Argentina,7,42,0,49
10500,2019,Dem. Rep. of the Congo,Argentina,25,27,0,52
10501,2019,Colombia,Argentina,558,191,0,749
10502,2019,Costa Rica,Argentina,5,0,0,5
10503,2019,Cuba,Argentina,257,815,0,1072
10504,2019,Cabo Verde,Argentina,0,5,0,5
10505,2019,Czechia,Argentina,0,5,0,5
10506,2019,Dominican Rep.,Argentina,0,568,0,568
10507,2019,Ecuador,Argentina,16,9,0,25
10508,2019,Ethiopia,Argentina,5,0,0,5
10509,2019,Gambia,Argentina,0,10,0,10
10510,2019,Palestinian,Argentina,18,11,0,29
10511,2019,Georgia,Argentina,5,0,0,5
10512,2019,Ghana,Argentina,38,152,0,190
10513,2019,Guinea-Bissau,Argentina,8,5,0,13
10514,2019,Guatemala,Argentina,6,0,0,6
10515,2019,Guinea,Argentina,10,9,0,19
10516,2019,Haiti,Argentina,72,754,0,826
10517,2019,Honduras,Argentina,5,17,0,22
10518,2019,Hungary,Argentina,0,5,0,5
10519,2019,Cote d'Ivoire,Argentina,20,0,0,20
10520,2019,India,Argentina,23,129,0,152
10521,2019,Iran (Islamic Rep. of),Argentina,24,8,0,32
10522,2019,Iraq,Argentina,22,0,0,22
10523,2019,Jamaica,Argentina,11,5,0,16
10524,2019,Jordan,Argentina,0,5,0,5
10525,2019,Kazakhstan,Argentina,18,10,0,28
10526,2019,Kyrgyzstan,Argentina,5,0,0,5
10527,2019,Liberia,Argentina,42,0,0,42
10528,2019,Libya,Argentina,0,8,0,8
10529,2019,Sri Lanka,Argentina,36,0,0,36
10530,2019,North Macedonia,Argentina,9,0,0,9
10531,2019,Mexico,Argentina,0,6,0,6
10532,2019,Mali,Argentina,9,0,0,9
10533,2019,Morocco,Argentina,0,13,0,13
10534,2019,Nepal,Argentina,0,5,0,5
10535,2019,Nicaragua,Argentina,8,21,0,29
10536,2019,Nigeria,Argentina,41,66,0,107
10537,2019,Pakistan,Argentina,38,19,0,57
10538,2019,Paraguay,Argentina,9,8,0,17
10539,2019,Peru,Argentina,544,39,0,583
10540,2019,Romania,Argentina,51,0,0,51
10541,2019,South Africa,Argentina,0,16,0,16
10542,2019,Russian Federation,Argentina,79,82,0,161
10543,2019,El Salvador,Argentina,32,42,0,74
10544,2019,Senegal,Argentina,41,1419,0,1460
10545,2019,Sierra Leone,Argentina,37,5,0,42
10546,2019,Somalia,Argentina,5,0,0,5
10547,2019,Spain,Argentina,0,7,0,7
10548,2019,Sudan,Argentina,5,0,0,5
10549,2019,Syrian Arab Rep.,Argentina,401,73,0,474
10550,2019,Türkiye,Argentina,7,0,0,7
10551,2019,Ukraine,Argentina,117,91,0,208
10552,2019,United States of America,Argentina,5,10,0,15
10553,2019,Venezuela (Bolivarian Republic of),Argentina,309,2717,0,3026
10554,2019,Yemen,Argentina,19,5,0,24
10556,2019,Afghanistan,Armenia,5,0,0,5
10557,2019,Egypt,Armenia,5,0,0,5
10558,2019,Azerbaijan,Armenia,1888,5,0,1893
10559,2019,Cuba,Armenia,0,23,0,23
10560,2019,Palestinian,Armenia,7,0,0,7
10561,2019,Georgia,Armenia,8,5,0,13
10562,2019,Cote d'Ivoire,Armenia,6,0,0,6
10563,2019,Iran (Islamic Rep. of),Armenia,68,84,0,152
10564,2019,Iraq,Armenia,1087,0,0,1087
10565,2019,Lebanon,Armenia,24,0,0,24
10566,2019,Nigeria,Armenia,5,0,0,5
10567,2019,Russian Federation,Armenia,0,5,0,5
10568,2019,Syrian Arab Rep.,Armenia,14730,16,0,14746
10569,2019,Türkiye,Armenia,9,15,0,24
10570,2019,Ukraine,Armenia,116,5,0,121
10571,2019,Yemen,Armenia,22,0,0,22
10573,2019,Afghanistan,Australia,11585,1710,0,13295
10574,2019,Albania,Australia,46,89,0,135
10575,2019,Algeria,Australia,7,29,0,36
10576,2019,Egypt,Australia,1531,346,0,1877
10577,2019,Argentina,Australia,0,24,0,24
10578,2019,Australia,Australia,0,32,0,32
10579,2019,Azerbaijan,Australia,9,15,0,24
10580,2019,Bahrain,Australia,92,22,0,114
10581,2019,Burundi,Australia,38,36,0,74
10582,2019,Belgium,Australia,0,9,0,9
10583,2019,Bangladesh,Australia,404,1195,0,1599
10584,2019,Bhutan,Australia,5,14,0,19
10585,2019,Belarus,Australia,7,0,0,7
10586,2019,Botswana,Australia,0,8,0,8
10587,2019,Brazil,Australia,5,119,0,124
10588,2019,Brunei Darussalam,Australia,0,10,0,10
10589,2019,Bosnia and Herzegovina,Australia,0,8,0,8
10590,2019,Cambodia,Australia,50,444,0,494
10591,2019,China,Australia,2016,17668,0,19684
10592,2019,Chile,Australia,0,33,0,33
10593,2019,Cameroon,Australia,27,69,0,96
10594,2019,Congo,Australia,7,55,0,62
10595,2019,Dem. Rep. of the Congo,Australia,63,15,0,78
10596,2019,Colombia,Australia,102,243,0,345
10597,2019,Cyprus,Australia,0,8,0,8
10598,2019,Czechia,Australia,0,5,0,5
10599,2019,Djibouti,Australia,5,0,0,5
10600,2019,Eritrea,Australia,121,18,0,139
10601,2019,Ethiopia,Australia,306,275,0,581
10602,2019,Fiji,Australia,382,2024,0,2406
10603,2019,France,Australia,0,7,0,7
10604,2019,Gambia,Australia,6,13,0,19
10605,2019,Palestinian,Australia,512,93,0,605
10606,2019,United Kingdom of Great Britain and Northern Ireland,Australia,5,91,0,96
10607,2019,Georgia,Australia,15,32,0,47
10608,2019,Germany,Australia,5,9,0,14
10609,2019,Ghana,Australia,26,215,0,241
10610,2019,Greece,Australia,6,31,0,37
10611,2019,Guinea,Australia,9,6,0,15
10612,2019,"China, Hong Kong SAR",Australia,5,172,0,177
10613,2019,Honduras,Australia,5,8,0,13
10614,2019,Hungary,Australia,0,5,0,5
10615,2019,India,Australia,473,5718,0,6191
10616,2019,Indonesia,Australia,233,1766,0,1999
10617,2019,Ireland,Australia,0,20,0,20
10618,2019,Iran (Islamic Rep. of),Australia,11866,4124,0,15990
10619,2019,Iraq,Australia,4946,1183,0,6129
10620,2019,Israel,Australia,10,21,0,31
10621,2019,Italy,Australia,5,21,0,26
10622,2019,Jamaica,Australia,5,0,0,5
10623,2019,Jordan,Australia,133,197,0,330
10624,2019,Japan,Australia,10,5,0,15
10625,2019,Kazakhstan,Australia,7,12,0,19
10626,2019,Kenya,Australia,93,250,0,343
10627,2019,Kyrgyzstan,Australia,13,19,0,32
10628,2019,Rep. of Korea,Australia,37,168,0,205
10629,2019,Dem. People's Rep. of Korea,Australia,18,10,0,28
10630,2019,Kuwait,Australia,51,8,0,59
10631,2019,Lao People's Dem. Rep.,Australia,5,223,0,228
10632,2019,Liberia,Australia,43,25,0,68
10633,2019,Libya,Australia,1160,122,0,1282
10634,2019,Lebanon,Australia,513,872,0,1385
10635,2019,Sri Lanka,Australia,4585,2666,0,7251
10636,2019,North Macedonia,Australia,5,56,0,61
10637,2019,Maldives,Australia,15,6,0,21
10638,2019,Mexico,Australia,14,24,0,38
10639,2019,Malaysia,Australia,494,18180,0,18674
10640,2019,Malawi,Australia,0,10,0,10
10641,2019,Mongolia,Australia,19,244,0,263
10642,2019,Morocco,Australia,12,15,0,27
10643,2019,Mozambique,Australia,5,0,0,5
10644,2019,Mauritius,Australia,7,101,0,108
10645,2019,Myanmar,Australia,506,223,0,729
10646,2019,Nepal,Australia,143,553,0,696
10647,2019,Nigeria,Australia,193,546,0,739
10648,2019,Norway,Australia,0,5,0,5
10649,2019,Nauru,Australia,0,15,0,15
10650,2019,New Zealand,Australia,26,22,0,48
10651,2019,Oman,Australia,5,0,0,5
10652,2019,Pakistan,Australia,5333,2754,0,8087
10653,2019,Peru,Australia,20,57,0,77
10654,2019,Philippines,Australia,48,1279,0,1327
10655,2019,Papua New Guinea,Australia,470,544,0,1014
10656,2019,Poland,Australia,0,23,0,23
10657,2019,Portugal,Australia,0,15,0,15
10658,2019,Romania,Australia,5,9,0,14
10659,2019,South Africa,Australia,31,444,0,475
10660,2019,Russian Federation,Australia,49,66,0,115
10661,2019,Rwanda,Australia,79,66,0,145
10662,2019,El Salvador,Australia,8,26,0,34
10663,2019,Saudi Arabia,Australia,143,126,0,269
10664,2019,Serbia and Kosovo: S/RES/1244 (1999),Australia,5,32,0,37
10665,2019,Singapore,Australia,6,34,0,40
10666,2019,Sierra Leone,Australia,25,154,0,179
10667,2019,Solomon Islands,Australia,21,227,0,248
10668,2019,Somalia,Australia,526,101,0,627
10669,2019,Spain,Australia,0,5,0,5
10670,2019,Viet Nam,Australia,277,2511,0,2788
10671,2019,Sudan,Australia,543,151,0,694
10672,2019,South Sudan,Australia,8,40,0,48
10673,2019,Eswatini,Australia,0,16,0,16
10674,2019,Sweden,Australia,0,6,0,6
10675,2019,Syrian Arab Rep.,Australia,613,79,0,692
10676,2019,United Rep. of Tanzania,Australia,12,30,0,42
10677,2019,Thailand,Australia,14,2435,0,2449
10678,2019,Timor-Leste,Australia,7,11,0,18
10679,2019,Tonga,Australia,32,406,0,438
10680,2019,Tunisia,Australia,5,9,0,14
10681,2019,Türkiye,Australia,765,524,0,1289
10682,2019,United Arab Emirates,Australia,6,0,0,6
10683,2019,Uganda,Australia,54,101,0,155
10684,2019,Ukraine,Australia,24,118,0,142
10685,2019,United States of America,Australia,15,46,0,61
10686,2019,Uzbekistan,Australia,28,32,0,60
10687,2019,Vanuatu,Australia,0,16,0,16
10688,2019,Venezuela (Bolivarian Republic of),Australia,72,274,0,346
10689,2019,Samoa,Australia,0,84,0,84
10690,2019,Yemen,Australia,59,129,0,188
10691,2019,Zambia,Australia,9,28,0,37
10692,2019,Zimbabwe,Australia,584,226,0,810
10696,2019,Afghanistan,Austria,37276,10326,0,47602
10697,2019,Albania,Austria,72,45,0,117
10698,2019,Algeria,Austria,37,117,0,154
10699,2019,Angola,Austria,65,10,0,75
10700,2019,Egypt,Austria,220,151,0,371
10701,2019,Armenia,Austria,442,358,0,800
10702,2019,Azerbaijan,Austria,240,179,0,419
10703,2019,Burundi,Austria,16,0,0,16
10704,2019,Benin,Austria,5,28,0,33
10705,2019,Bangladesh,Austria,325,339,0,664
10706,2019,Bhutan,Austria,5,0,0,5
10707,2019,Burkina Faso,Austria,9,5,0,14
10708,2019,Belarus,Austria,49,20,0,69
10709,2019,Bolivia (Plurinational State of),Austria,11,0,0,11
10710,2019,Bosnia and Herzegovina,Austria,80,10,0,90
10711,2019,Canada,Austria,5,0,0,5
10712,2019,China,Austria,651,157,0,808
10713,2019,Cameroon,Austria,204,47,0,251
10714,2019,Congo,Austria,110,11,0,121
10715,2019,Dem. Rep. of the Congo,Austria,374,87,0,461
10716,2019,Colombia,Austria,0,11,0,11
10717,2019,Cuba,Austria,14,12,0,26
10718,2019,Eritrea,Austria,408,41,0,449
10719,2019,Ethiopia,Austria,228,77,0,305
10720,2019,Gabon,Austria,5,0,0,5
10721,2019,Gambia,Austria,133,114,0,247
10722,2019,Georgia,Austria,392,392,0,784
10723,2019,Ghana,Austria,19,36,0,55
10724,2019,Guinea-Bissau,Austria,5,5,0,10
10725,2019,Guatemala,Austria,6,0,0,6
10726,2019,Guinea,Austria,148,39,0,187
10727,2019,Cote d'Ivoire,Austria,71,21,0,92
10728,2019,India,Austria,44,325,0,369
10729,2019,Iran (Islamic Rep. of),Austria,6393,2024,0,8417
10730,2019,Iraq,Austria,8568,4733,0,13301
10731,2019,Israel,Austria,12,0,0,12
10732,2019,Jordan,Austria,78,26,0,104
10733,2019,Kazakhstan,Austria,113,44,0,157
10734,2019,Kenya,Austria,27,13,0,40
10735,2019,Kyrgyzstan,Austria,171,32,0,203
10736,2019,Kuwait,Austria,9,0,0,9
10737,2019,Liberia,Austria,11,9,0,20
10738,2019,Libya,Austria,124,48,0,172
10739,2019,Lebanon,Austria,107,125,0,232
10740,2019,Sri Lanka,Austria,68,22,0,90
10741,2019,Madagascar,Austria,5,0,0,5
10742,2019,Mauritania,Austria,5,5,0,10
10743,2019,North Macedonia,Austria,24,39,0,63
10744,2019,Rep. of Moldova,Austria,41,26,0,67
10745,2019,Mali,Austria,13,13,0,26
10746,2019,Mongolia,Austria,125,207,0,332
10747,2019,Morocco,Austria,36,111,0,147
10748,2019,Montenegro,Austria,5,5,0,10
10749,2019,Myanmar,Austria,34,7,0,41
10750,2019,Nepal,Austria,26,60,0,86
10751,2019,Nicaragua,Austria,5,0,0,5
10752,2019,Nigeria,Austria,430,607,0,1037
10753,2019,Pakistan,Austria,312,612,0,924
10754,2019,Philippines,Austria,16,13,0,29
10755,2019,Romania,Austria,5,5,0,10
10756,2019,South Africa,Austria,5,0,0,5
10757,2019,Russian Federation,Austria,8664,1194,0,9858
10758,2019,Rwanda,Austria,19,7,0,26
10759,2019,Saudi Arabia,Austria,6,0,0,6
10760,2019,Serbia and Kosovo: S/RES/1244 (1999),Austria,725,217,0,942
10761,2019,Senegal,Austria,14,12,0,26
10762,2019,Sierra Leone,Austria,25,15,0,40
10763,2019,Somalia,Austria,7636,911,0,8547
10764,2019,Viet Nam,Austria,6,10,0,16
10765,2019,Sudan,Austria,344,33,0,377
10766,2019,South Sudan,Austria,6,0,0,6
10767,2019,Syrian Arab Rep.,Austria,51955,1304,0,53259
10768,2019,Tajikistan,Austria,244,35,0,279
10769,2019,Turkmenistan,Austria,7,0,0,7
10770,2019,Togo,Austria,6,5,0,11
10771,2019,Tunisia,Austria,7,40,0,47
10772,2019,Türkiye,Austria,594,415,0,1009
10773,2019,Uganda,Austria,28,12,0,40
10774,2019,Ukraine,Austria,265,313,0,578
10775,2019,United States of America,Austria,5,0,0,5
10776,2019,Uzbekistan,Austria,60,65,0,125
10777,2019,Venezuela (Bolivarian Republic of),Austria,31,29,0,60
10778,2019,Yemen,Austria,311,70,0,381
10779,2019,Zambia,Austria,5,0,0,5
10780,2019,Zimbabwe,Austria,11,0,0,11
10783,2019,Afghanistan,Azerbaijan,627,94,0,721
10784,2019,Egypt,Azerbaijan,0,5,0,5
10785,2019,Azerbaijan,Azerbaijan,0,0,652326,0
10786,2019,Palestinian,Azerbaijan,5,0,0,5
10787,2019,Iran (Islamic Rep. of),Azerbaijan,43,7,0,50
10788,2019,Iraq,Azerbaijan,5,6,0,11
10789,2019,Libya,Azerbaijan,5,0,0,5
10790,2019,Sri Lanka,Azerbaijan,0,5,0,5
10791,2019,Pakistan,Azerbaijan,16,34,0,50
10792,2019,Russian Federation,Azerbaijan,372,30,0,402
10793,2019,Syrian Arab Rep.,Azerbaijan,20,0,0,20
10794,2019,Ukraine,Azerbaijan,5,0,0,5
10795,2019,Yemen,Azerbaijan,11,0,0,11
10797,2019,Egypt,Bahrain,0,5,0,5
10798,2019,Iraq,Bahrain,242,48,0,290
10799,2019,Yemen,Bahrain,9,5,0,14
10800,2019,Trinidad and Tobago,Barbados,0,5,0,5
10801,2019,Venezuela (Bolivarian Republic of),Barbados,0,5,0,5
10802,2019,Angola,Burundi,0,5,0,5
10803,2019,Burundi,Burundi,0,0,33256,0
10804,2019,Benin,Burundi,0,0,0,0
10805,2019,Central African Rep.,Burundi,8,0,0,8
10806,2019,Dem. Rep. of the Congo,Burundi,77807,8204,0,86011
10807,2019,Kenya,Burundi,0,0,0,0
10808,2019,Mali,Burundi,13,0,0,13
10809,2019,Oman,Burundi,0,0,0,0
10810,2019,Rwanda,Burundi,575,776,0,1351
10811,2019,Somalia,Burundi,23,0,0,23
10812,2019,United Rep. of Tanzania,Burundi,5,0,0,5
10813,2019,Türkiye,Burundi,21,5,0,26
10814,2019,Uganda,Burundi,13,5,0,18
10815,2019,United States of America,Burundi,0,0,0,0
10817,2019,Afghanistan,Belgium,5070,1035,0,6105
10818,2019,Albania,Belgium,712,208,0,920
10819,2019,Algeria,Belgium,75,78,0,153
10820,2019,Angola,Belgium,92,82,0,174
10821,2019,Egypt,Belgium,115,27,0,142
10822,2019,Armenia,Belgium,156,80,0,236
10823,2019,Azerbaijan,Belgium,97,37,0,134
10824,2019,Burundi,Belgium,1179,238,0,1417
10825,2019,Benin,Belgium,43,28,0,71
10826,2019,Bangladesh,Belgium,24,5,0,29
10827,2019,Burkina Faso,Belgium,106,62,0,168
10828,2019,Belarus,Belgium,45,6,0,51
10829,2019,Brazil,Belgium,8,7,0,15
10830,2019,Bosnia and Herzegovina,Belgium,61,11,0,72
10831,2019,Bulgaria,Belgium,18,0,0,18
10832,2019,Cambodia,Belgium,10,0,0,10
10833,2019,Central African Rep.,Belgium,60,9,0,69
10834,2019,Chad,Belgium,36,14,0,50
10835,2019,China,Belgium,1283,17,0,1300
10836,2019,Chile,Belgium,42,0,0,42
10837,2019,Cameroon,Belgium,498,319,0,817
10838,2019,Congo,Belgium,27,10,0,37
10839,2019,Dem. Rep. of the Congo,Belgium,1490,292,0,1782
10840,2019,Colombia,Belgium,73,124,0,197
10841,2019,Cuba,Belgium,9,0,0,9
10842,2019,Czechia,Belgium,6,0,0,6
10843,2019,Djibouti,Belgium,369,68,0,437
10844,2019,Ecuador,Belgium,0,5,0,5
10845,2019,Eritrea,Belgium,2254,210,0,2464
10846,2019,Ethiopia,Belgium,170,25,0,195
10847,2019,Gabon,Belgium,26,23,0,49
10848,2019,Gambia,Belgium,27,24,0,51
10849,2019,Palestinian,Belgium,844,877,0,1721
10850,2019,Georgia,Belgium,98,40,0,138
10851,2019,Ghana,Belgium,31,21,0,52
10852,2019,Guinea-Bissau,Belgium,10,5,0,15
10853,2019,Guatemala,Belgium,34,12,0,46
10854,2019,Guinea,Belgium,3561,677,0,4238
10855,2019,Haiti,Belgium,5,0,0,5
10856,2019,Honduras,Belgium,17,0,0,17
10857,2019,Croatia,Belgium,5,0,0,5
10858,2019,Hungary,Belgium,36,0,0,36
10859,2019,Cote d'Ivoire,Belgium,192,112,0,304
10860,2019,India,Belgium,18,15,0,33
10861,2019,Iran (Islamic Rep. of),Belgium,1700,207,0,1907
10862,2019,Iraq,Belgium,5602,879,0,6481
10863,2019,Israel,Belgium,5,0,0,5
10864,2019,Italy,Belgium,0,5,0,5
10865,2019,Jamaica,Belgium,5,0,0,5
10866,2019,Jordan,Belgium,26,31,0,57
10867,2019,Kazakhstan,Belgium,52,7,0,59
10868,2019,Kenya,Belgium,22,5,0,27
10869,2019,Kyrgyzstan,Belgium,66,5,0,71
10870,2019,Dem. People's Rep. of Korea,Belgium,34,0,0,34
10871,2019,Kuwait,Belgium,6,0,0,6
10872,2019,Lao People's Dem. Rep.,Belgium,10,0,0,10
10873,2019,Liberia,Belgium,14,11,0,25
10874,2019,Libya,Belgium,81,55,0,136
10875,2019,Lebanon,Belgium,121,81,0,202
10876,2019,Sri Lanka,Belgium,366,34,0,400
10877,2019,Lithuania,Belgium,5,0,0,5
10878,2019,Madagascar,Belgium,5,0,0,5
10879,2019,Mauritania,Belgium,271,80,0,351
10880,2019,North Macedonia,Belgium,156,45,0,201
10881,2019,Rep. of Moldova,Belgium,5,5,0,10
10882,2019,Mexico,Belgium,0,5,0,5
10883,2019,Mali,Belgium,99,52,0,151
10884,2019,Mongolia,Belgium,0,5,0,5
10885,2019,Morocco,Belgium,145,109,0,254
10886,2019,Montenegro,Belgium,11,0,0,11
10887,2019,Myanmar,Belgium,8,0,0,8
10888,2019,Nepal,Belgium,8,5,0,13
10889,2019,Niger,Belgium,131,68,0,199
10890,2019,Nicaragua,Belgium,9,17,0,26
10891,2019,Nigeria,Belgium,66,62,0,128
10892,2019,Pakistan,Belgium,325,34,0,359
10893,2019,Peru,Belgium,0,7,0,7
10894,2019,Poland,Belgium,117,0,0,117
10895,2019,Romania,Belgium,37,0,0,37
10896,2019,South Africa,Belgium,5,0,0,5
10897,2019,Russian Federation,Belgium,2772,223,0,2995
10898,2019,Rwanda,Belgium,864,255,0,1119
10899,2019,El Salvador,Belgium,389,162,0,551
10900,2019,Saudi Arabia,Belgium,8,0,0,8
10901,2019,Serbia and Kosovo: S/RES/1244 (1999),Belgium,308,104,0,412
10902,2019,Senegal,Belgium,431,174,0,605
10903,2019,Sierra Leone,Belgium,27,32,0,59
10904,2019,Somalia,Belgium,2097,310,0,2407
10905,2019,Viet Nam,Belgium,30,0,0,30
10906,2019,Sudan,Belgium,265,131,0,396
10907,2019,South Sudan,Belgium,5,5,0,10
10908,2019,Syrian Arab Rep.,Belgium,16604,1019,0,17623
10909,2019,United Rep. of Tanzania,Belgium,57,26,0,83
10910,2019,Tajikistan,Belgium,13,0,0,13
10911,2019,Turkmenistan,Belgium,5,0,0,5
10912,2019,Togo,Belgium,191,40,0,231
10913,2019,Tunisia,Belgium,54,24,0,78
10914,2019,Türkiye,Belgium,2007,443,0,2450
10915,2019,United Arab Emirates,Belgium,5,0,0,5
10916,2019,Uganda,Belgium,23,5,0,28
10917,2019,Ukraine,Belgium,254,105,0,359
10918,2019,United States of America,Belgium,0,5,0,5
10919,2019,Uzbekistan,Belgium,40,5,0,45
10920,2019,Venezuela (Bolivarian Republic of),Belgium,273,322,0,595
10921,2019,Yemen,Belgium,51,56,0,107
10924,2019,Burundi,Benin,7,0,0,7
10925,2019,Central African Rep.,Benin,953,154,0,1107
10926,2019,Chad,Benin,8,25,0,33
10927,2019,Cameroon,Benin,16,47,0,63
10928,2019,Congo,Benin,0,7,0,7
10929,2019,Dem. Rep. of the Congo,Benin,11,29,0,40
10930,2019,Eritrea,Benin,5,0,0,5
10931,2019,Guinea,Benin,0,8,0,8
10932,2019,Cote d'Ivoire,Benin,164,19,0,183
10933,2019,Liberia,Benin,0,5,0,5
10934,2019,Sri Lanka,Benin,5,0,0,5
10935,2019,Mali,Benin,25,15,0,40
10936,2019,Niger,Benin,0,5,0,5
10937,2019,Nigeria,Benin,0,23,0,23
10938,2019,Pakistan,Benin,5,0,0,5
10939,2019,Sudan,Benin,6,0,0,6
10940,2019,Syrian Arab Rep.,Benin,12,13,0,25
10941,2019,Togo,Benin,0,23,0,23
10942,2019,Türkiye,Benin,10,0,0,10
10943,2019,Yemen,Benin,11,0,0,11
10944,2019,Myanmar,Bangladesh,854764,0,0,854764
10945,2019,Somalia,Bangladesh,10,14,0,24
10946,2019,Türkiye,Bangladesh,0,20,0,20
10947,2019,Yemen,Bangladesh,5,0,0,5
10949,2019,Colombia,Bahamas,5,0,0,5
10950,2019,Cuba,Bahamas,5,5,0,10
10951,2019,South Africa,Bahamas,0,8,0,8
10952,2019,Burundi,Burkina Faso,29,0,0,29
10953,2019,Burkina Faso,Burkina Faso,0,0,560033,0
10954,2019,Central African Rep.,Burkina Faso,194,24,0,218
10955,2019,Chad,Burkina Faso,83,0,0,83
10956,2019,Cameroon,Burkina Faso,7,0,0,7
10957,2019,Congo,Burkina Faso,28,0,0,28
10958,2019,Dem. Rep. of the Congo,Burkina Faso,33,0,0,33
10959,2019,Cote d'Ivoire,Burkina Faso,5,0,0,5
10960,2019,Mali,Burkina Faso,25442,0,0,25442
10961,2019,Rwanda,Burkina Faso,16,0,0,16
10962,2019,South Sudan,Burkina Faso,0,5,0,5
10963,2019,Syrian Arab Rep.,Burkina Faso,5,0,0,5
10964,2019,Togo,Burkina Faso,14,0,0,14
10965,2019,Türkiye,Burkina Faso,13,0,0,13
10966,2019,Afghanistan,Belarus,213,13,0,226
10967,2019,Egypt,Belarus,5,0,0,5
10968,2019,Armenia,Belarus,5,0,0,5
10969,2019,Azerbaijan,Belarus,5,0,0,5
10970,2019,Bangladesh,Belarus,0,5,0,5
10971,2019,Cuba,Belarus,0,5,0,5
10972,2019,Ethiopia,Belarus,5,0,0,5
10973,2019,Palestinian,Belarus,0,5,0,5
10974,2019,Georgia,Belarus,57,0,0,57
10975,2019,Iran (Islamic Rep. of),Belarus,6,0,0,6
10976,2019,Iraq,Belarus,12,0,0,12
10977,2019,Libya,Belarus,8,0,0,8
10978,2019,Syrian Arab Rep.,Belarus,68,0,0,68
10979,2019,Tajikistan,Belarus,12,0,0,12
10980,2019,Türkiye,Belarus,5,0,0,5
10981,2019,Ukraine,Belarus,2300,98,0,2398
10982,2019,Yemen,Belarus,24,5,0,29
10984,2019,Argentina,Bolivia (Plurinational State of),13,0,0,13
10985,2019,Colombia,Bolivia (Plurinational State of),201,7,0,208
10986,2019,Cuba,Bolivia (Plurinational State of),48,0,0,48
10987,2019,Ecuador,Bolivia (Plurinational State of),5,0,0,5
10988,2019,Cote d'Ivoire,Bolivia (Plurinational State of),5,0,0,5
10989,2019,Iraq,Bolivia (Plurinational State of),16,0,0,16
10990,2019,Niger,Bolivia (Plurinational State of),5,0,0,5
10991,2019,Pakistan,Bolivia (Plurinational State of),5,0,0,5
10992,2019,Peru,Bolivia (Plurinational State of),515,0,0,515
10993,2019,Russian Federation,Bolivia (Plurinational State of),14,0,0,14
10994,2019,Syrian Arab Rep.,Bolivia (Plurinational State of),21,0,0,21
10995,2019,Ukraine,Bolivia (Plurinational State of),5,0,0,5
10996,2019,Uruguay,Bolivia (Plurinational State of),10,0,0,10
10997,2019,Venezuela (Bolivarian Republic of),Bolivia (Plurinational State of),0,235,0,235
10998,2019,Angola,Botswana,0,0,0,0
10999,2019,Burundi,Botswana,71,0,0,71
11000,2019,Dem. Rep. of the Congo,Botswana,120,67,0,187
11001,2019,Eritrea,Botswana,5,0,0,5
11002,2019,Ethiopia,Botswana,5,0,0,5
11003,2019,Kenya,Botswana,5,0,0,5
11004,2019,Namibia,Botswana,7,0,0,7
11005,2019,Rwanda,Botswana,14,5,0,19
11006,2019,Somalia,Botswana,299,36,0,335
11007,2019,Sudan,Botswana,5,0,0,5
11008,2019,Uganda,Botswana,18,0,0,18
11009,2019,Zimbabwe,Botswana,564,42,0,606
11010,2019,Afghanistan,Brazil,132,185,0,317
11011,2019,Albania,Brazil,0,6,0,6
11012,2019,Algeria,Brazil,7,27,0,34
11013,2019,Angola,Brazil,1139,5016,0,6155
11014,2019,Egypt,Brazil,48,446,0,494
11015,2019,Argentina,Brazil,6,144,0,150
11016,2019,Armenia,Brazil,5,5,0,10
11017,2019,Burundi,Brazil,46,22,0,68
11018,2019,Belgium,Brazil,0,6,0,6
11019,2019,Benin,Brazil,0,263,0,263
11020,2019,Bangladesh,Brazil,14,5370,0,5384
11021,2019,Bhutan,Brazil,30,36,0,66
11022,2019,Burkina Faso,Brazil,5,296,0,301
11023,2019,Bolivia (Plurinational State of),Brazil,154,426,0,580
11024,2019,Bosnia and Herzegovina,Brazil,5,0,0,5
11025,2019,Bulgaria,Brazil,0,5,0,5
11026,2019,Cambodia,Brazil,0,5,0,5
11027,2019,Canada,Brazil,0,6,0,6
11028,2019,Central African Rep.,Brazil,5,7,0,12
11029,2019,China,Brazil,9,4616,0,4625
11030,2019,Chile,Brazil,21,120,0,141
11031,2019,Cameroon,Brazil,67,586,0,653
11032,2019,Congo,Brazil,20,72,0,92
11033,2019,Dem. Rep. of the Congo,Brazil,1636,2739,0,4375
11034,2019,Colombia,Brazil,1295,1835,0,3130
11035,2019,Costa Rica,Brazil,0,14,0,14
11036,2019,Cuba,Brazil,238,14560,0,14798
11037,2019,Cabo Verde,Brazil,0,197,0,197
11038,2019,Cyprus,Brazil,0,5,0,5
11039,2019,Czechia,Brazil,0,6,0,6
11040,2019,Denmark,Brazil,0,12,0,12
11041,2019,Djibouti,Brazil,0,11,0,11
11042,2019,Dominica,Brazil,0,16,0,16
11043,2019,Dominican Rep.,Brazil,5,1269,0,1274
11044,2019,Ecuador,Brazil,58,88,0,146
11045,2019,Equatorial Guinea,Brazil,0,11,0,11
11046,2019,Eritrea,Brazil,25,116,0,141
11047,2019,Ethiopia,Brazil,27,92,0,119
11048,2019,French Guiana,Brazil,0,19,0,19
11049,2019,Fiji,Brazil,0,20,0,20
11050,2019,France,Brazil,0,40,0,40
11051,2019,Gambia,Brazil,6,360,0,366
11052,2019,Palestinian,Brazil,565,368,0,933
11053,2019,United Kingdom of Great Britain and Northern Ireland,Brazil,0,11,0,11
11054,2019,Georgia,Brazil,10,5,0,15
11055,2019,Germany,Brazil,0,10,0,10
11056,2019,Ghana,Brazil,34,2425,0,2459
11057,2019,Guinea-Bissau,Brazil,21,1671,0,1692
11058,2019,Greece,Brazil,0,6,0,6
11059,2019,Guatemala,Brazil,0,21,0,21
11060,2019,Guinea,Brazil,103,896,0,999
11061,2019,Guyana,Brazil,5,137,0,142
11062,2019,Haiti,Brazil,8,32788,0,32796
11063,2019,Honduras,Brazil,5,17,0,22
11064,2019,Croatia,Brazil,5,0,0,5
11065,2019,Hungary,Brazil,5,5,0,10
11066,2019,Cote d'Ivoire,Brazil,54,185,0,239
11067,2019,India,Brazil,7,1010,0,1017
11068,2019,Indonesia,Brazil,0,8,0,8
11069,2019,Iran (Islamic Rep. of),Brazil,67,180,0,247
11070,2019,Iraq,Brazil,302,412,0,714
11071,2019,Israel,Brazil,0,33,0,33
11072,2019,Italy,Brazil,0,25,0,25
11073,2019,Jamaica,Brazil,0,11,0,11
11074,2019,Jordan,Brazil,10,90,0,100
11075,2019,Japan,Brazil,0,6,0,6
11076,2019,Kazakhstan,Brazil,0,6,0,6
11077,2019,Kenya,Brazil,8,79,0,87
11078,2019,Rep. of Korea,Brazil,0,245,0,245
11079,2019,Kuwait,Brazil,0,6,0,6
11080,2019,Liberia,Brazil,259,32,0,291
11081,2019,Libya,Brazil,5,46,0,51
11082,2019,Lebanon,Brazil,410,1869,0,2279
11083,2019,Lesotho,Brazil,0,5,0,5
11084,2019,Sri Lanka,Brazil,18,59,0,77
11085,2019,Lithuania,Brazil,0,7,0,7
11087,2019,Mauritania,Brazil,21,252,0,273
11088,2019,North Macedonia,Brazil,6,5,0,11
11089,2019,Mexico,Brazil,6,42,0,48
11090,2019,Mali,Brazil,91,425,0,516
11091,2019,Malaysia,Brazil,0,5,0,5
11092,2019,Morocco,Brazil,17,675,0,692
11093,2019,Mozambique,Brazil,0,82,0,82
11094,2019,Malta,Brazil,0,5,0,5
11095,2019,Myanmar,Brazil,0,6,0,6
11096,2019,Namibia,Brazil,0,39,0,39
11097,2019,Nepal,Brazil,11,373,0,384
11098,2019,Netherlands,Brazil,0,5,0,5
11099,2019,Niger,Brazil,0,6,0,6
11100,2019,Nicaragua,Brazil,0,37,0,37
11101,2019,Nigeria,Brazil,135,3370,0,3505
11102,2019,Norway,Brazil,0,6,0,6
11103,2019,New Zealand,Brazil,0,5,0,5
11104,2019,Pakistan,Brazil,329,1765,0,2094
11105,2019,Panama,Brazil,0,9,0,9
11106,2019,Paraguay,Brazil,5,140,0,145
11107,2019,Peru,Brazil,46,165,0,211
11108,2019,Philippines,Brazil,0,550,0,550
11109,2019,Poland,Brazil,0,12,0,12
11110,2019,Portugal,Brazil,0,92,0,92
11111,2019,Romania,Brazil,0,15,0,15
11112,2019,South Africa,Brazil,5,424,0,429
11113,2019,Russian Federation,Brazil,13,46,0,59
11114,2019,Rwanda,Brazil,18,5,0,23
11115,2019,El Salvador,Brazil,60,0,0,60
11116,2019,Saudi Arabia,Brazil,0,17,0,17
11117,2019,Serbia and Kosovo: S/RES/1244 (1999),Brazil,92,7,0,99
11118,2019,Senegal,Brazil,14,6253,0,6267
11119,2019,Sierra Leone,Brazil,159,374,0,533
11120,2019,Somalia,Brazil,48,570,0,618
11121,2019,Spain,Brazil,0,43,0,43
11122,2019,Viet Nam,Brazil,5,0,0,5
11123,2019,Sao Tome and Principe,Brazil,0,24,0,24
11124,2019,Sudan,Brazil,73,132,0,205
11125,2019,Suriname,Brazil,0,17,0,17
11126,2019,Sweden,Brazil,0,5,0,5
11127,2019,Switzerland,Brazil,0,5,0,5
11128,2019,Syrian Arab Rep.,Brazil,3761,4242,0,8003
11129,2019,United Rep. of Tanzania,Brazil,7,117,0,124
11130,2019,Thailand,Brazil,0,40,0,40
11131,2019,Togo,Brazil,39,640,0,679
11132,2019,Trinidad and Tobago,Brazil,0,7,0,7
11133,2019,Tunisia,Brazil,5,123,0,128
11134,2019,Türkiye,Brazil,6,255,0,261
11135,2019,Uganda,Brazil,5,33,0,38
11136,2019,Ukraine,Brazil,17,79,0,96
11137,2019,Uruguay,Brazil,0,31,0,31
11138,2019,United States of America,Brazil,0,47,0,47
11139,2019,Uzbekistan,Brazil,0,5,0,5
11140,2019,Vanuatu,Brazil,0,50,0,50
11141,2019,Holy See,Brazil,0,5,0,5
11142,2019,Venezuela (Bolivarian Republic of),Brazil,20941,103657,0,124598
11143,2019,Yemen,Brazil,0,124,0,124
11144,2019,Zambia,Brazil,0,7,0,7
11145,2019,Zimbabwe,Brazil,5,10,0,15
11149,2019,Afghanistan,Bosnia and Herzegovina,0,134,0,134
11150,2019,Algeria,Bosnia and Herzegovina,0,5,0,5
11151,2019,Egypt,Bosnia and Herzegovina,0,5,0,5
11152,2019,Azerbaijan,Bosnia and Herzegovina,0,5,0,5
11153,2019,Bangladesh,Bosnia and Herzegovina,0,0,0,0
11154,2019,Bosnia and Herzegovina,Bosnia and Herzegovina,0,0,96421,0
11155,2019,Eritrea,Bosnia and Herzegovina,0,0,0,0
11156,2019,Palestinian,Bosnia and Herzegovina,0,5,0,5
11157,2019,Croatia,Bosnia and Herzegovina,5116,0,0,5116
11158,2019,India,Bosnia and Herzegovina,0,11,0,11
11159,2019,Iran (Islamic Rep. of),Bosnia and Herzegovina,5,121,0,126
11160,2019,Iraq,Bosnia and Herzegovina,0,205,0,205
11161,2019,Libya,Bosnia and Herzegovina,0,5,0,5
11162,2019,Lebanon,Bosnia and Herzegovina,0,0,0,0
11163,2019,Sri Lanka,Bosnia and Herzegovina,0,0,0,0
11164,2019,North Macedonia,Bosnia and Herzegovina,5,5,0,10
11165,2019,Morocco,Bosnia and Herzegovina,0,0,0,0
11166,2019,Nepal,Bosnia and Herzegovina,0,5,0,5
11167,2019,Pakistan,Bosnia and Herzegovina,0,89,0,89
11168,2019,Serbia and Kosovo: S/RES/1244 (1999),Bosnia and Herzegovina,60,0,0,60
11169,2019,Somalia,Bosnia and Herzegovina,0,7,0,7
11170,2019,Sudan,Bosnia and Herzegovina,0,0,0,0
11171,2019,Syrian Arab Rep.,Bosnia and Herzegovina,21,46,0,67
11172,2019,Tunisia,Bosnia and Herzegovina,0,5,0,5
11173,2019,Türkiye,Bosnia and Herzegovina,34,62,0,96
11174,2019,Western Sahara,Bosnia and Herzegovina,0,0,0,0
11175,2019,Yemen,Bosnia and Herzegovina,0,10,0,10
11177,2019,Afghanistan,Bulgaria,243,300,0,543
11178,2019,Algeria,Bulgaria,0,21,0,21
11179,2019,Egypt,Bulgaria,15,6,0,21
11180,2019,Armenia,Bulgaria,15,14,0,29
11181,2019,Bangladesh,Bulgaria,9,13,0,22
11182,2019,China,Bulgaria,0,15,0,15
11183,2019,Congo,Bulgaria,9,0,0,9
11184,2019,Dem. Rep. of the Congo,Bulgaria,5,5,0,10
11185,2019,Eritrea,Bulgaria,13,0,0,13
11186,2019,Ethiopia,Bulgaria,13,0,0,13
11187,2019,Ghana,Bulgaria,0,6,0,6
11188,2019,Guinea,Bulgaria,5,0,0,5
11189,2019,Cote d'Ivoire,Bulgaria,5,6,0,11
11190,2019,India,Bulgaria,5,5,0,10
11191,2019,Iran (Islamic Rep. of),Bulgaria,85,80,0,165
11192,2019,Iraq,Bulgaria,1300,82,0,1382
11193,2019,Jordan,Bulgaria,7,0,0,7
11194,2019,Kyrgyzstan,Bulgaria,0,7,0,7
11195,2019,Lebanon,Bulgaria,28,5,0,33
11196,2019,Mali,Bulgaria,5,5,0,10
11197,2019,Morocco,Bulgaria,5,0,0,5
11198,2019,Nigeria,Bulgaria,0,7,0,7
11199,2019,Pakistan,Bulgaria,24,68,0,92
11200,2019,Russian Federation,Bulgaria,0,28,0,28
11201,2019,Somalia,Bulgaria,50,5,0,55
11202,2019,Sudan,Bulgaria,17,0,0,17
11203,2019,Syrian Arab Rep.,Bulgaria,17551,297,0,17848
11204,2019,Tunisia,Bulgaria,5,0,0,5
11205,2019,Türkiye,Bulgaria,12,7,0,19
11206,2019,Ukraine,Bulgaria,0,40,0,40
11207,2019,Yemen,Bulgaria,13,5,0,18
11209,2019,Cuba,Belize,0,5,0,5
11210,2019,Guatemala,Belize,0,422,0,422
11211,2019,Honduras,Belize,5,448,0,453
11212,2019,Nicaragua,Belize,0,5,0,5
11213,2019,Peru,Belize,0,5,0,5
11214,2019,El Salvador,Belize,24,1259,0,1283
11216,2019,Viet Nam,Cambodia,0,27,0,27
11218,2019,Afghanistan,Canada,2447,620,0,3067
11219,2019,Albania,Canada,783,289,0,1072
11220,2019,Algeria,Canada,449,909,0,1358
11221,2019,Angola,Canada,226,1223,0,1449
11222,2019,Antigua and Barbuda,Canada,104,44,0,148
11223,2019,Egypt,Canada,2520,1172,0,3692
11224,2019,Argentina,Canada,0,47,0,47
11225,2019,Armenia,Canada,52,22,0,74
11226,2019,Australia,Canada,0,5,0,5
11227,2019,Austria,Canada,0,10,0,10
11228,2019,Azerbaijan,Canada,548,250,0,798
11229,2019,Bahrain,Canada,56,28,0,84
11230,2019,Barbados,Canada,230,106,0,336
11231,2019,Burundi,Canada,2486,654,0,3140
11232,2019,Belgium,Canada,5,30,0,35
11233,2019,Benin,Canada,51,63,0,114
11234,2019,Bangladesh,Canada,1149,1399,0,2548
11235,2019,Bahamas,Canada,310,418,0,728
11236,2019,Bhutan,Canada,0,5,0,5
11237,2019,Burkina Faso,Canada,93,153,0,246
11238,2019,Belarus,Canada,54,23,0,77
11239,2019,Bolivia (Plurinational State of),Canada,31,26,0,57
11240,2019,Botswana,Canada,180,10,0,190
11241,2019,Brazil,Canada,102,515,0,617
11242,2019,Bosnia and Herzegovina,Canada,5,7,0,12
11243,2019,Bulgaria,Canada,127,64,0,191
11244,2019,Belize,Canada,19,10,0,29
11245,2019,Cambodia,Canada,47,31,0,78
11246,2019,Central African Rep.,Canada,51,39,0,90
11247,2019,Chad,Canada,477,534,0,1011
11248,2019,China,Canada,6060,2873,0,8933
11249,2019,Chile,Canada,71,221,0,292
11250,2019,Cameroon,Canada,946,709,0,1655
11251,2019,Congo,Canada,259,199,0,458
11252,2019,Dem. Rep. of the Congo,Canada,1033,2368,0,3401
11253,2019,Comoros,Canada,5,5,0,10
11254,2019,Colombia,Canada,4982,4801,0,9783
11255,2019,Costa Rica,Canada,13,46,0,59
11256,2019,Cuba,Canada,598,246,0,844
11257,2019,Cyprus,Canada,0,11,0,11
11258,2019,Czechia,Canada,370,127,0,497
11259,2019,Denmark,Canada,5,20,0,25
11260,2019,Djibouti,Canada,1130,159,0,1289
11261,2019,Dominica,Canada,8,5,0,13
11262,2019,Dominican Rep.,Canada,113,165,0,278
11263,2019,Ecuador,Canada,44,110,0,154
11264,2019,Equatorial Guinea,Canada,19,7,0,26
11265,2019,Eritrea,Canada,2052,506,0,2558
11266,2019,Estonia,Canada,5,5,0,10
11267,2019,Ethiopia,Canada,1236,902,0,2138
11268,2019,Fiji,Canada,19,7,0,26
11269,2019,Finland,Canada,0,5,0,5
11270,2019,France,Canada,0,65,0,65
11271,2019,Gabon,Canada,33,44,0,77
11272,2019,Gambia,Canada,85,124,0,209
11273,2019,Palestinian,Canada,1470,1083,0,2553
11274,2019,United Kingdom of Great Britain and Northern Ireland,Canada,0,5,0,5
11275,2019,Georgia,Canada,335,312,0,647
11276,2019,Germany,Canada,0,26,0,26
11277,2019,Ghana,Canada,326,326,0,652
11278,2019,Guinea-Bissau,Canada,9,5,0,14
11279,2019,Greece,Canada,0,20,0,20
11280,2019,Grenada,Canada,31,15,0,46
11281,2019,Guatemala,Canada,444,263,0,707
11282,2019,Guinea,Canada,368,382,0,750
11283,2019,Guyana,Canada,126,68,0,194
11284,2019,Haiti,Canada,6563,5365,0,11928
11285,2019,"China, Hong Kong SAR",Canada,0,19,0,19
11286,2019,Honduras,Canada,864,476,0,1340
11287,2019,Croatia,Canada,268,22,0,290
11288,2019,Hungary,Canada,3632,409,0,4041
11289,2019,Iceland,Canada,0,5,0,5
11290,2019,Cote d'Ivoire,Canada,158,253,0,411
11291,2019,India,Canada,1374,9567,0,10941
11292,2019,Indonesia,Canada,111,68,0,179
11293,2019,Ireland,Canada,0,41,0,41
11294,2019,Iran (Islamic Rep. of),Canada,3846,3370,0,7216
11295,2019,Iraq,Canada,5,580,0,585
11296,2019,Israel,Canada,190,70,0,260
11297,2019,Italy,Canada,5,109,0,114
11298,2019,Jamaica,Canada,879,342,0,1221
11299,2019,Jordan,Canada,264,742,0,1006
11300,2019,Japan,Canada,0,7,0,7
11301,2019,Kazakhstan,Canada,153,71,0,224
11302,2019,Kenya,Canada,161,584,0,745
11303,2019,Kyrgyzstan,Canada,68,16,0,84
11304,2019,Rep. of Korea,Canada,58,31,0,89
11305,2019,Dem. People's Rep. of Korea,Canada,412,0,0,412
11306,2019,Kuwait,Canada,0,45,0,45
11307,2019,Lao People's Dem. Rep.,Canada,5,0,0,5
11308,2019,Liberia,Canada,38,159,0,197
11309,2019,Libya,Canada,1552,428,0,1980
11310,2019,Saint Lucia,Canada,805,31,0,836
11311,2019,Lebanon,Canada,683,582,0,1265
11312,2019,Sri Lanka,Canada,2302,1075,0,3377
11313,2019,Lithuania,Canada,21,0,0,21
11314,2019,Latvia,Canada,73,7,0,80
11315,2019,Madagascar,Canada,19,28,0,47
11316,2019,Mauritania,Canada,144,210,0,354
11317,2019,North Macedonia,Canada,19,6,0,25
11318,2019,Rep. of Moldova,Canada,107,10,0,117
11319,2019,Mexico,Canada,3051,6984,0,10035
11320,2019,Mali,Canada,172,177,0,349
11321,2019,Malaysia,Canada,0,18,0,18
11322,2019,Malawi,Canada,10,93,0,103
11323,2019,Mongolia,Canada,151,54,0,205
11324,2019,Morocco,Canada,124,158,0,282
11325,2019,Mozambique,Canada,0,11,0,11
11326,2019,Malta,Canada,5,5,0,10
11327,2019,Mauritius,Canada,11,18,0,29
11328,2019,Myanmar,Canada,0,14,0,14
11329,2019,Namibia,Canada,292,10,0,302
11330,2019,Nepal,Canada,31,257,0,288
11331,2019,Netherlands,Canada,8,36,0,44
11332,2019,Niger,Canada,65,109,0,174
11333,2019,Nicaragua,Canada,203,514,0,717
11334,2019,Nigeria,Canada,6640,12828,0,19468
11335,2019,Oman,Canada,0,5,0,5
11336,2019,Pakistan,Canada,5498,3244,0,8742
11337,2019,Panama,Canada,22,18,0,40
11338,2019,Paraguay,Canada,20,6,0,26
11339,2019,Peru,Canada,173,291,0,464
11340,2019,Philippines,Canada,64,131,0,195
11341,2019,Papua New Guinea,Canada,5,0,0,5
11342,2019,Poland,Canada,76,125,0,201
11343,2019,Portugal,Canada,5,23,0,28
11344,2019,Qatar,Canada,5,0,0,5
11345,2019,Romania,Canada,390,727,0,1117
11346,2019,South Africa,Canada,0,220,0,220
11347,2019,Russian Federation,Canada,735,207,0,942
11348,2019,Rwanda,Canada,800,709,0,1509
11349,2019,El Salvador,Canada,1547,700,0,2247
11350,2019,Saudi Arabia,Canada,344,179,0,523
11351,2019,Serbia and Kosovo: S/RES/1244 (1999),Canada,240,64,0,304
11352,2019,Senegal,Canada,203,337,0,540
11353,2019,Seychelles,Canada,5,0,0,5
11354,2019,Singapore,Canada,12,10,0,22
11355,2019,Sierra Leone,Canada,40,62,0,102
11356,2019,Somalia,Canada,2253,621,0,2874
11357,2019,Spain,Canada,11,54,0,65
11358,2019,Viet Nam,Canada,0,93,0,93
11359,2019,Saint Kitts and Nevis,Canada,44,0,0,44
11360,2019,Sudan,Canada,1399,856,0,2255
11361,2019,Suriname,Canada,0,7,0,7
11362,2019,South Sudan,Canada,6,23,0,29
11363,2019,Slovakia,Canada,1147,214,0,1361
11364,2019,Slovenia,Canada,7,5,0,12
11365,2019,Eswatini,Canada,120,9,0,129
11366,2019,Sweden,Canada,0,6,0,6
11367,2019,Syrian Arab Rep.,Canada,5,303,0,308
11368,2019,United Rep. of Tanzania,Canada,117,198,0,315
11369,2019,Thailand,Canada,0,5,0,5
11370,2019,Tajikistan,Canada,39,27,0,66
11371,2019,Turkmenistan,Canada,23,6,0,29
11372,2019,Timor-Leste,Canada,5,5,0,10
11373,2019,Togo,Canada,87,110,0,197
11374,2019,Trinidad and Tobago,Canada,87,53,0,140
11375,2019,Tunisia,Canada,171,149,0,320
11376,2019,Türkiye,Canada,5876,1390,0,7266
11377,2019,United Arab Emirates,Canada,0,14,0,14
11378,2019,Uganda,Canada,536,756,0,1292
11379,2019,Ukraine,Canada,1199,307,0,1506
11380,2019,Uruguay,Canada,0,12,0,12
11381,2019,United States of America,Canada,0,2445,0,2445
11382,2019,Uzbekistan,Canada,155,19,0,174
11383,2019,Saint Vincent and the Grenadines,Canada,902,36,0,938
11384,2019,Venezuela (Bolivarian Republic of),Canada,3067,1388,0,4455
11385,2019,Yemen,Canada,1711,371,0,2082
11386,2019,Zambia,Canada,6,31,0,37
11387,2019,Zimbabwe,Canada,728,382,0,1110
11390,2019,Angola,Central African Rep.,13,0,0,13
11391,2019,Burundi,Central African Rep.,22,0,0,22
11392,2019,Central African Rep.,Central African Rep.,0,0,669906,0
11393,2019,Chad,Central African Rep.,1694,19,0,1713
11394,2019,Cameroon,Central African Rep.,18,23,0,41
11395,2019,Congo,Central African Rep.,15,8,0,23
11396,2019,Dem. Rep. of the Congo,Central African Rep.,2529,242,0,2771
11397,2019,Guinea,Central African Rep.,6,0,0,6
11398,2019,Cote d'Ivoire,Central African Rep.,7,0,0,7
11399,2019,Liberia,Central African Rep.,5,0,0,5
11400,2019,Rwanda,Central African Rep.,209,0,0,209
11401,2019,Sudan,Central African Rep.,405,12,0,417
11402,2019,South Sudan,Central African Rep.,2235,0,0,2235
11403,2019,Türkiye,Central African Rep.,5,0,0,5
11404,2019,Uganda,Central African Rep.,7,5,0,12
11405,2019,Cuba,Cayman Islands,34,14,0,48
11406,2019,Venezuela (Bolivarian Republic of),Cayman Islands,0,0,0,0
11407,2019,Burundi,Chad,5,0,0,5
11408,2019,Central African Rep.,Chad,93711,1563,0,95274
11409,2019,Chad,Chad,0,0,170278,0
11410,2019,Cameroon,Chad,5,11,0,16
11411,2019,Congo,Chad,11,0,0,11
11412,2019,Dem. Rep. of the Congo,Chad,239,18,0,257
11413,2019,Eritrea,Chad,6,9,0,15
11414,2019,Ethiopia,Chad,18,6,0,24
11415,2019,Iran (Islamic Rep. of),Chad,5,0,0,5
11416,2019,Libya,Chad,21,18,0,39
11417,2019,Mali,Chad,7,0,0,7
11418,2019,Niger,Chad,607,0,0,607
11419,2019,Nigeria,Chad,12720,313,0,13033
11420,2019,Rwanda,Chad,13,0,0,13
11421,2019,Somalia,Chad,7,0,0,7
11422,2019,Sudan,Chad,335246,1805,0,337051
11423,2019,South Sudan,Chad,9,0,0,9
11424,2019,Syrian Arab Rep.,Chad,35,8,0,43
11425,2019,Yemen,Chad,5,5,0,10
11426,2019,Afghanistan,China,21,21,0,42
11427,2019,Burundi,China,7,0,0,7
11428,2019,Central African Rep.,China,0,5,0,5
11429,2019,Cameroon,China,5,226,0,231
11430,2019,Dem. Rep. of the Congo,China,10,18,0,28
11431,2019,Eritrea,China,5,5,0,10
11432,2019,Palestinian,China,13,12,0,25
11433,2019,Ghana,China,0,11,0,11
11434,2019,Cote d'Ivoire,China,0,7,0,7
11435,2019,Iran (Islamic Rep. of),China,0,5,0,5
11436,2019,Iraq,China,20,0,0,20
11437,2019,Kenya,China,0,17,0,17
11438,2019,Liberia,China,0,6,0,6
11439,2019,Mozambique,China,0,6,0,6
11440,2019,Nigeria,China,0,19,0,19
11441,2019,Pakistan,China,21,20,0,41
11442,2019,Rwanda,China,0,8,0,8
11443,2019,Sierra Leone,China,0,6,0,6
11444,2019,Somalia,China,106,17,0,123
11445,2019,Viet Nam,China,303095,0,0,303095
11446,2019,Syrian Arab Rep.,China,50,13,0,63
11447,2019,Türkiye,China,0,9,0,9
11448,2019,Uganda,China,5,85,0,90
11449,2019,Yemen,China,16,16,0,32
11450,2019,Zambia,China,0,5,0,5
11451,2019,Zimbabwe,China,5,107,0,112
11452,2019,Afghanistan,Chile,13,13,0,26
11453,2019,Angola,Chile,0,5,0,5
11454,2019,Bangladesh,Chile,0,7,0,7
11455,2019,Bolivia (Plurinational State of),Chile,0,21,0,21
11456,2019,Congo,Chile,8,5,0,13
11457,2019,Dem. Rep. of the Congo,Chile,5,0,0,5
11458,2019,Colombia,Chile,1227,3864,0,5091
11459,2019,Costa Rica,Chile,5,0,0,5
11460,2019,Cuba,Chile,19,1449,0,1468
11461,2019,Dominican Rep.,Chile,0,121,0,121
11462,2019,Ecuador,Chile,23,29,0,52
11463,2019,Palestinian,Chile,15,7,0,22
11464,2019,Ghana,Chile,0,8,0,8
11465,2019,Guatemala,Chile,0,5,0,5
11466,2019,Haiti,Chile,0,26,0,26
11467,2019,Honduras,Chile,5,0,0,5
11468,2019,Iraq,Chile,0,14,0,14
11469,2019,Kenya,Chile,5,0,0,5
11470,2019,Rep. of Korea,Chile,0,5,0,5
11471,2019,Sri Lanka,Chile,5,0,0,5
11472,2019,Nicaragua,Chile,0,5,0,5
11473,2019,Pakistan,Chile,0,7,0,7
11474,2019,Peru,Chile,113,15,0,128
11475,2019,Russian Federation,Chile,5,7,0,12
11476,2019,El Salvador,Chile,9,27,0,36
11477,2019,Senegal,Chile,5,0,0,5
11478,2019,Sierra Leone,Chile,0,5,0,5
11479,2019,Syrian Arab Rep.,Chile,112,33,0,145
11480,2019,Türkiye,Chile,26,5,0,31
11481,2019,United States of America,Chile,0,5,0,5
11482,2019,Venezuela (Bolivarian Republic of),Chile,14,2768,0,2782
11484,2019,Angola,Cameroon,5,0,0,5
11485,2019,Burundi,Cameroon,69,24,0,93
11486,2019,Burkina Faso,Cameroon,0,30,0,30
11487,2019,Cambodia,Cameroon,5,0,0,5
11488,2019,Central African Rep.,Cameroon,292767,7398,0,300165
11489,2019,Chad,Cameroon,1604,624,0,2228
11490,2019,Cameroon,Cameroon,0,0,950263,0
11491,2019,Congo,Cameroon,54,21,0,75
11492,2019,Dem. Rep. of the Congo,Cameroon,521,203,0,724
11493,2019,Ethiopia,Cameroon,0,5,0,5
11494,2019,Gabon,Cameroon,0,6,0,6
11495,2019,Gambia,Cameroon,0,5,0,5
11496,2019,Guinea-Bissau,Cameroon,0,12,0,12
11497,2019,Guinea,Cameroon,12,245,0,257
11498,2019,Cote d'Ivoire,Cameroon,70,97,0,167
11499,2019,Iran (Islamic Rep. of),Cameroon,5,0,0,5
11500,2019,Liberia,Cameroon,9,5,0,14
11501,2019,Mauritania,Cameroon,5,5,0,10
11502,2019,Mali,Cameroon,13,205,0,218
11503,2019,Morocco,Cameroon,7,0,0,7
11504,2019,Niger,Cameroon,0,598,0,598
11505,2019,Nigeria,Cameroon,110627,54,0,110681
11506,2019,Rwanda,Cameroon,334,211,0,545
11507,2019,Senegal,Cameroon,0,30,0,30
11508,2019,Sierra Leone,Cameroon,0,11,0,11
11509,2019,Sudan,Cameroon,98,54,0,152
11510,2019,South Sudan,Cameroon,13,5,0,18
11511,2019,Syrian Arab Rep.,Cameroon,24,5,0,29
11512,2019,Togo,Cameroon,17,15,0,32
11513,2019,Türkiye,Cameroon,0,57,0,57
11514,2019,Yemen,Cameroon,0,5,0,5
11515,2019,Angola,Congo,14,46,0,60
11516,2019,Egypt,Congo,0,0,0,0
11517,2019,Burundi,Congo,66,8,0,74
11518,2019,Burkina Faso,Congo,0,5,0,5
11519,2019,Central African Rep.,Congo,15014,3787,0,18801
11520,2019,Chad,Congo,24,20,0,44
11521,2019,Cameroon,Congo,5,15,0,20
11522,2019,Congo,Congo,0,0,134430,0
11523,2019,Dem. Rep. of the Congo,Congo,9694,10018,0,19712
11524,2019,Guinea,Congo,0,5,0,5
11525,2019,Cote d'Ivoire,Congo,5,5,0,10
11526,2019,Liberia,Congo,0,5,0,5
11527,2019,Mauritania,Congo,5,45,0,50
11528,2019,Mali,Congo,5,0,0,5
11529,2019,Rwanda,Congo,811,406,0,1217
11530,2019,Sudan,Congo,25,39,0,64
11531,2019,Syrian Arab Rep.,Congo,0,13,0,13
11532,2019,Angola,Dem. Rep. of the Congo,490,16,0,506
11533,2019,Burundi,Dem. Rep. of the Congo,47570,2199,0,49769
11534,2019,Central African Rep.,Dem. Rep. of the Congo,171234,632,0,171866
11535,2019,Chad,Dem. Rep. of the Congo,0,15,0,15
11536,2019,Cameroon,Dem. Rep. of the Congo,0,16,0,16
11537,2019,Congo,Dem. Rep. of the Congo,649,19,0,668
11538,2019,Dem. Rep. of the Congo,Dem. Rep. of the Congo,0,0,5014253,0
11539,2019,Eritrea,Dem. Rep. of the Congo,5,0,0,5
11540,2019,Ethiopia,Dem. Rep. of the Congo,0,5,0,5
11541,2019,Palestinian,Dem. Rep. of the Congo,0,7,0,7
11542,2019,Cote d'Ivoire,Dem. Rep. of the Congo,12,15,0,27
11543,2019,Kenya,Dem. Rep. of the Congo,0,5,0,5
11544,2019,Liberia,Dem. Rep. of the Congo,9,12,0,21
11545,2019,Mali,Dem. Rep. of the Congo,0,11,0,11
11546,2019,Niger,Dem. Rep. of the Congo,0,5,0,5
11547,2019,Romania,Dem. Rep. of the Congo,0,5,0,5
11548,2019,Rwanda,Dem. Rep. of the Congo,214989,133,0,215122
11549,2019,Somalia,Dem. Rep. of the Congo,16,51,0,67
11550,2019,Sudan,Dem. Rep. of the Congo,20,12,0,32
11551,2019,South Sudan,Dem. Rep. of the Congo,88717,8,0,88725
11552,2019,Syrian Arab Rep.,Dem. Rep. of the Congo,5,26,0,31
11553,2019,Uganda,Dem. Rep. of the Congo,17,0,0,17
11554,2019,Afghanistan,Colombia,9,0,0,9
11555,2019,Bolivia (Plurinational State of),Colombia,5,0,0,5
11556,2019,Cameroon,Colombia,0,6,0,6
11557,2019,Colombia,Colombia,0,0,7976412,0
11558,2019,Cuba,Colombia,73,85,0,158
11559,2019,Ecuador,Colombia,8,0,0,8
11560,2019,Eritrea,Colombia,5,0,0,5
11561,2019,Ethiopia,Colombia,17,0,0,17
11562,2019,Palestinian,Colombia,0,5,0,5
11563,2019,Ghana,Colombia,0,5,0,5
11564,2019,Honduras,Colombia,5,0,0,5
11565,2019,Hungary,Colombia,5,0,0,5
11566,2019,Iraq,Colombia,9,5,0,14
11567,2019,Nicaragua,Colombia,14,0,0,14
11568,2019,Nigeria,Colombia,0,5,0,5
11569,2019,Romania,Colombia,7,0,0,7
11570,2019,El Salvador,Colombia,11,0,0,11
11571,2019,Serbia and Kosovo: S/RES/1244 (1999),Colombia,7,0,0,7
11572,2019,Sierra Leone,Colombia,5,0,0,5
11573,2019,Somalia,Colombia,11,0,0,11
11574,2019,Syrian Arab Rep.,Colombia,8,8,0,16
11575,2019,Türkiye,Colombia,5,31,0,36
11576,2019,Venezuela (Bolivarian Republic of),Colombia,425,8824,0,9249
11577,2019,Yemen,Colombia,0,7,0,7
11580,2019,Angola,Costa Rica,0,51,0,51
11581,2019,Argentina,Costa Rica,0,17,0,17
11582,2019,Burundi,Costa Rica,5,0,0,5
11583,2019,Bangladesh,Costa Rica,0,16,0,16
11584,2019,Burkina Faso,Costa Rica,0,5,0,5
11585,2019,Bolivia (Plurinational State of),Costa Rica,0,5,0,5
11586,2019,Brazil,Costa Rica,0,12,0,12
11587,2019,China,Costa Rica,0,152,0,152
11588,2019,Chile,Costa Rica,0,12,0,12
11589,2019,Cameroon,Costa Rica,0,21,0,21
11590,2019,Congo,Costa Rica,0,57,0,57
11591,2019,Dem. Rep. of the Congo,Costa Rica,12,41,0,53
11592,2019,Colombia,Costa Rica,2325,1338,0,3663
11593,2019,Cuba,Costa Rica,380,1933,0,2313
11594,2019,Dominican Rep.,Costa Rica,0,64,0,64
11595,2019,Ecuador,Costa Rica,0,17,0,17
11596,2019,Eritrea,Costa Rica,0,7,0,7
11597,2019,Ethiopia,Costa Rica,5,0,0,5
11598,2019,Gambia,Costa Rica,0,5,0,5
11599,2019,Germany,Costa Rica,0,5,0,5
11600,2019,Ghana,Costa Rica,0,63,0,63
11601,2019,Guatemala,Costa Rica,24,35,0,59
11602,2019,Haiti,Costa Rica,12,111,0,123
11603,2019,Honduras,Costa Rica,189,715,0,904
11604,2019,Cote d'Ivoire,Costa Rica,0,5,0,5
11605,2019,Indonesia,Costa Rica,5,0,0,5
11606,2019,Iran (Islamic Rep. of),Costa Rica,5,0,0,5
11607,2019,Iraq,Costa Rica,5,0,0,5
11608,2019,Israel,Costa Rica,0,5,0,5
11609,2019,Italy,Costa Rica,0,6,0,6
11610,2019,Jamaica,Costa Rica,0,8,0,8
11611,2019,Mexico,Costa Rica,8,23,0,31
11612,2019,Nepal,Costa Rica,0,105,0,105
11613,2019,Niger,Costa Rica,0,5,0,5
11614,2019,Nicaragua,Costa Rica,1402,43481,0,44883
11615,2019,Nigeria,Costa Rica,17,0,0,17
11616,2019,Pakistan,Costa Rica,5,11,0,16
11617,2019,Panama,Costa Rica,5,13,0,18
11618,2019,Peru,Costa Rica,13,0,0,13
11619,2019,Russian Federation,Costa Rica,25,0,0,25
11620,2019,El Salvador,Costa Rica,1155,854,0,2009
11621,2019,Senegal,Costa Rica,0,5,0,5
11622,2019,Somalia,Costa Rica,7,7,0,14
11623,2019,Spain,Costa Rica,0,10,0,10
11624,2019,Syrian Arab Rep.,Costa Rica,5,24,0,29
11625,2019,Türkiye,Costa Rica,0,5,0,5
11626,2019,Ukraine,Costa Rica,13,0,0,13
11627,2019,United States of America,Costa Rica,5,31,0,36
11628,2019,Venezuela (Bolivarian Republic of),Costa Rica,577,6809,0,7386
11629,2019,Zimbabwe,Costa Rica,0,5,0,5
11632,2019,Afghanistan,Cuba,36,0,0,36
11633,2019,Eritrea,Cuba,14,0,0,14
11634,2019,Ethiopia,Cuba,6,0,0,6
11635,2019,Haiti,Cuba,5,0,0,5
11636,2019,Iran (Islamic Rep. of),Cuba,11,16,0,27
11637,2019,Iraq,Cuba,0,6,0,6
11638,2019,Sudan,Cuba,0,10,0,10
11639,2019,Syrian Arab Rep.,Cuba,40,0,0,40
11640,2019,Western Sahara,Cuba,107,0,0,107
11641,2019,Yemen,Cuba,14,0,0,14
11643,2019,Afghanistan,Cyprus,14,5,0,19
11644,2019,Albania,Cyprus,0,5,0,5
11645,2019,Algeria,Cyprus,8,8,0,16
11646,2019,Egypt,Cyprus,115,1007,0,1122
11647,2019,Armenia,Cyprus,26,21,0,47
11648,2019,Bangladesh,Cyprus,5,1521,0,1526
11649,2019,Burkina Faso,Cyprus,0,6,0,6
11650,2019,Belarus,Cyprus,0,6,0,6
11651,2019,Bosnia and Herzegovina,Cyprus,15,0,0,15
11652,2019,China,Cyprus,5,9,0,14
11653,2019,Cameroon,Cyprus,67,1817,0,1884
11654,2019,Congo,Cyprus,10,60,0,70
11655,2019,Dem. Rep. of the Congo,Cyprus,25,418,0,443
11656,2019,Comoros,Cyprus,0,5,0,5
11657,2019,Cuba,Cyprus,0,5,0,5
11658,2019,Eritrea,Cyprus,53,5,0,58
11659,2019,Ethiopia,Cyprus,10,13,0,23
11660,2019,Gambia,Cyprus,5,68,0,73
11661,2019,Palestinian,Cyprus,2059,330,0,2389
11662,2019,Georgia,Cyprus,85,1553,0,1638
11663,2019,Ghana,Cyprus,0,23,0,23
11664,2019,Guinea,Cyprus,5,116,0,121
11665,2019,Haiti,Cyprus,0,11,0,11
11666,2019,Cote d'Ivoire,Cyprus,5,52,0,57
11667,2019,India,Cyprus,7,1676,0,1683
11668,2019,Iran (Islamic Rep. of),Cyprus,565,587,0,1152
11669,2019,Iraq,Cyprus,919,357,0,1276
11670,2019,Jordan,Cyprus,38,98,0,136
11671,2019,Kazakhstan,Cyprus,5,0,0,5
11672,2019,Kenya,Cyprus,0,5,0,5
11673,2019,Kyrgyzstan,Cyprus,5,0,0,5
11674,2019,Libya,Cyprus,10,5,0,15
11675,2019,Lebanon,Cyprus,52,99,0,151
11676,2019,Sri Lanka,Cyprus,27,616,0,643
11677,2019,Rep. of Moldova,Cyprus,18,7,0,25
11678,2019,Mali,Cyprus,0,10,0,10
11679,2019,Morocco,Cyprus,0,7,0,7
11680,2019,Nepal,Cyprus,0,448,0,448
11681,2019,Nigeria,Cyprus,14,533,0,547
11682,2019,Pakistan,Cyprus,17,1357,0,1374
11683,2019,Philippines,Cyprus,12,256,0,268
11684,2019,Russian Federation,Cyprus,77,81,0,158
11685,2019,Rwanda,Cyprus,5,5,0,10
11686,2019,Serbia and Kosovo: S/RES/1244 (1999),Cyprus,59,8,0,67
11687,2019,Senegal,Cyprus,0,24,0,24
11688,2019,Sierra Leone,Cyprus,24,37,0,61
11689,2019,Somalia,Cyprus,221,369,0,590
11690,2019,Viet Nam,Cyprus,0,668,0,668
11691,2019,Sudan,Cyprus,13,5,0,18
11692,2019,Syrian Arab Rep.,Cyprus,7372,4073,0,11445
11693,2019,Togo,Cyprus,0,5,0,5
11694,2019,Tunisia,Cyprus,0,5,0,5
11695,2019,Türkiye,Cyprus,223,202,0,425
11696,2019,Ukraine,Cyprus,30,135,0,165
11697,2019,Uzbekistan,Cyprus,5,10,0,15
11698,2019,Venezuela (Bolivarian Republic of),Cyprus,0,5,0,5
11699,2019,Yemen,Cyprus,25,10,0,35
11700,2019,Zimbabwe,Cyprus,0,24,0,24
11703,2019,Afghanistan,Czechia,45,14,0,59
11704,2019,Algeria,Czechia,0,5,0,5
11705,2019,Egypt,Czechia,8,5,0,13
11706,2019,Armenia,Czechia,29,24,0,53
11707,2019,Azerbaijan,Czechia,20,25,0,45
11708,2019,Burundi,Czechia,5,0,0,5
11709,2019,Belarus,Czechia,175,14,0,189
11710,2019,Bosnia and Herzegovina,Czechia,5,0,0,5
11711,2019,China,Czechia,30,43,0,73
11712,2019,Cameroon,Czechia,5,5,0,10
11713,2019,Dem. Rep. of the Congo,Czechia,8,5,0,13
11714,2019,Cuba,Czechia,46,25,0,71
11715,2019,Eritrea,Czechia,13,0,0,13
11716,2019,Ethiopia,Czechia,5,0,0,5
11717,2019,Georgia,Czechia,15,43,0,58
11718,2019,Guinea,Czechia,5,0,0,5
11719,2019,India,Czechia,0,7,0,7
11720,2019,Iran (Islamic Rep. of),Czechia,6,9,0,15
11721,2019,Iraq,Czechia,146,6,0,152
11722,2019,Jordan,Czechia,0,5,0,5
11723,2019,Kazakhstan,Czechia,111,54,0,165
11724,2019,Kyrgyzstan,Czechia,22,12,0,34
11725,2019,Libya,Czechia,15,0,0,15
11726,2019,Lebanon,Czechia,5,8,0,13
11727,2019,Sri Lanka,Czechia,7,0,0,7
11728,2019,Rep. of Moldova,Czechia,18,5,0,23
11729,2019,Mongolia,Czechia,7,0,0,7
11730,2019,Morocco,Czechia,5,0,0,5
11731,2019,Myanmar,Czechia,145,0,0,145
11732,2019,Nigeria,Czechia,8,20,0,28
11733,2019,Pakistan,Czechia,14,16,0,30
11734,2019,Russian Federation,Czechia,164,59,0,223
11735,2019,Saudi Arabia,Czechia,6,0,0,6
11736,2019,Serbia and Kosovo: S/RES/1244 (1999),Czechia,9,0,0,9
11737,2019,Sierra Leone,Czechia,5,0,0,5
11738,2019,Somalia,Czechia,14,0,0,14
11739,2019,Viet Nam,Czechia,14,56,0,70
11740,2019,Sudan,Czechia,11,0,0,11
11741,2019,Syrian Arab Rep.,Czechia,408,18,0,426
11742,2019,Turkmenistan,Czechia,7,0,0,7
11743,2019,Togo,Czechia,5,0,0,5
11744,2019,Tunisia,Czechia,0,6,0,6
11745,2019,Türkiye,Czechia,9,15,0,24
11746,2019,Uganda,Czechia,5,0,0,5
11747,2019,Ukraine,Czechia,305,146,0,451
11748,2019,Uzbekistan,Czechia,53,58,0,111
11749,2019,Venezuela (Bolivarian Republic of),Czechia,0,35,0,35
11750,2019,Yemen,Czechia,20,0,0,20
11753,2019,Afghanistan,Denmark,2620,79,0,2699
11754,2019,Albania,Denmark,0,5,0,5
11755,2019,Algeria,Denmark,5,9,0,14
11756,2019,Egypt,Denmark,16,10,0,26
11757,2019,Armenia,Denmark,75,13,0,88
11758,2019,Azerbaijan,Denmark,41,0,0,41
11759,2019,Burundi,Denmark,5,5,0,10
11760,2019,Bangladesh,Denmark,20,5,0,25
11761,2019,Belarus,Denmark,5,11,0,16
11762,2019,Bosnia and Herzegovina,Denmark,5,5,0,10
11763,2019,China,Denmark,19,5,0,24
11764,2019,Cameroon,Denmark,7,13,0,20
11765,2019,Congo,Denmark,5,0,0,5
11766,2019,Dem. Rep. of the Congo,Denmark,77,9,0,86
11767,2019,Colombia,Denmark,5,30,0,35
11768,2019,Eritrea,Denmark,5320,132,0,5452
11769,2019,Ethiopia,Denmark,94,10,0,104
11770,2019,Gambia,Denmark,5,0,0,5
11771,2019,Palestinian,Denmark,20,0,0,20
11772,2019,Georgia,Denmark,0,64,0,64
11773,2019,Ghana,Denmark,5,0,0,5
11774,2019,Guinea-Bissau,Denmark,5,0,0,5
11775,2019,Guinea,Denmark,5,0,0,5
11776,2019,Cote d'Ivoire,Denmark,14,0,0,14
11777,2019,India,Denmark,5,16,0,21
11778,2019,Iran (Islamic Rep. of),Denmark,3240,141,0,3381
11779,2019,Iraq,Denmark,314,73,0,387
11780,2019,Jordan,Denmark,0,7,0,7
11781,2019,Kenya,Denmark,5,10,0,15
11782,2019,Kyrgyzstan,Denmark,5,0,0,5
11783,2019,Dem. People's Rep. of Korea,Denmark,8,0,0,8
11784,2019,Libya,Denmark,7,5,0,12
11785,2019,Lebanon,Denmark,26,13,0,39
11786,2019,Sri Lanka,Denmark,54,12,0,66
11787,2019,Mauritania,Denmark,0,5,0,5
11788,2019,North Macedonia,Denmark,0,10,0,10
11789,2019,Morocco,Denmark,8,34,0,42
11790,2019,Myanmar,Denmark,28,11,0,39
11791,2019,Nepal,Denmark,5,0,0,5
11792,2019,Nicaragua,Denmark,0,20,0,20
11793,2019,Nigeria,Denmark,9,11,0,20
11794,2019,Pakistan,Denmark,65,20,0,85
11795,2019,Russian Federation,Denmark,855,61,0,916
11796,2019,Rwanda,Denmark,15,0,0,15
11797,2019,El Salvador,Denmark,5,6,0,11
11798,2019,Somalia,Denmark,1308,150,0,1458
11799,2019,Sudan,Denmark,65,11,0,76
11800,2019,Syrian Arab Rep.,Denmark,20046,210,0,20256
11801,2019,United Rep. of Tanzania,Denmark,5,0,0,5
11802,2019,Thailand,Denmark,5,0,0,5
11803,2019,Tajikistan,Denmark,5,0,0,5
11804,2019,Tunisia,Denmark,0,5,0,5
11805,2019,Türkiye,Denmark,11,16,0,27
11806,2019,Uganda,Denmark,74,5,0,79
11807,2019,Ukraine,Denmark,28,29,0,57
11808,2019,Uzbekistan,Denmark,10,0,0,10
11809,2019,Venezuela (Bolivarian Republic of),Denmark,5,14,0,19
11810,2019,Yemen,Denmark,5,0,0,5
11811,2019,Zambia,Denmark,5,0,0,5
11812,2019,Zimbabwe,Denmark,8,0,0,8
11815,2019,Dem. Rep. of the Congo,Djibouti,0,5,0,5
11816,2019,Eritrea,Djibouti,422,469,0,891
11817,2019,Ethiopia,Djibouti,581,10545,0,11126
11818,2019,Iraq,Djibouti,15,5,0,20
11819,2019,Mali,Djibouti,0,5,0,5
11820,2019,Philippines,Djibouti,5,0,0,5
11821,2019,Somalia,Djibouti,13277,119,0,13396
11822,2019,Sudan,Djibouti,7,5,0,12
11823,2019,Syrian Arab Rep.,Djibouti,10,0,0,10
11824,2019,Yemen,Djibouti,5322,0,0,5322
11825,2019,Afghanistan,Dominican Rep.,0,9,0,9
11826,2019,Colombia,Dominican Rep.,0,10,0,10
11827,2019,Cuba,Dominican Rep.,0,32,0,32
11828,2019,Haiti,Dominican Rep.,164,244,0,408
11829,2019,Honduras,Dominican Rep.,0,5,0,5
11830,2019,Sri Lanka,Dominican Rep.,0,5,0,5
11831,2019,Nicaragua,Dominican Rep.,0,5,0,5
11832,2019,United States of America,Dominican Rep.,0,5,0,5
11833,2019,Venezuela (Bolivarian Republic of),Dominican Rep.,0,246,0,246
11834,2019,Afghanistan,Ecuador,150,5,0,155
11835,2019,Albania,Ecuador,6,0,0,6
11836,2019,Angola,Ecuador,5,30,0,35
11837,2019,Egypt,Ecuador,0,16,0,16
11838,2019,Argentina,Ecuador,0,5,0,5
11839,2019,Bangladesh,Ecuador,5,9,0,14
11840,2019,Brazil,Ecuador,5,15,0,20
11841,2019,Canada,Ecuador,0,5,0,5
11842,2019,China,Ecuador,12,0,0,12
11843,2019,Chile,Ecuador,7,6,0,13
11844,2019,Cameroon,Ecuador,16,17,0,33
11845,2019,Congo,Ecuador,5,9,0,14
11846,2019,Dem. Rep. of the Congo,Ecuador,8,14,0,22
11847,2019,Colombia,Ecuador,102928,9918,0,112846
11848,2019,Cuba,Ecuador,214,177,0,391
11849,2019,Dominican Rep.,Ecuador,5,8,0,13
11850,2019,Eritrea,Ecuador,11,5,0,16
11851,2019,Ethiopia,Ecuador,5,0,0,5
11852,2019,Gambia,Ecuador,0,5,0,5
11853,2019,Palestinian,Ecuador,8,14,0,22
11854,2019,Ghana,Ecuador,5,5,0,10
11855,2019,Guinea,Ecuador,9,0,0,9
11856,2019,Haiti,Ecuador,21,11,0,32
11857,2019,Honduras,Ecuador,0,5,0,5
11858,2019,India,Ecuador,5,11,0,16
11859,2019,Iran (Islamic Rep. of),Ecuador,61,20,0,81
11860,2019,Iraq,Ecuador,62,5,0,67
11861,2019,Liberia,Ecuador,5,0,0,5
11862,2019,Libya,Ecuador,6,0,0,6
11863,2019,Lebanon,Ecuador,14,5,0,19
11864,2019,Sri Lanka,Ecuador,18,9,0,27
11865,2019,North Macedonia,Ecuador,14,0,0,14
11866,2019,Mexico,Ecuador,0,5,0,5
11867,2019,Mali,Ecuador,5,0,0,5
11868,2019,Morocco,Ecuador,5,0,0,5
11869,2019,Nepal,Ecuador,5,0,0,5
11870,2019,Nicaragua,Ecuador,5,6,0,11
11871,2019,Nigeria,Ecuador,36,12,0,48
11872,2019,Pakistan,Ecuador,29,12,0,41
11873,2019,Panama,Ecuador,0,5,0,5
11874,2019,Peru,Ecuador,82,90,0,172
11875,2019,Philippines,Ecuador,0,6,0,6
11876,2019,Russian Federation,Ecuador,35,6,0,41
11877,2019,Rwanda,Ecuador,0,5,0,5
11878,2019,El Salvador,Ecuador,33,10,0,43
11879,2019,Saudi Arabia,Ecuador,8,0,0,8
11880,2019,Somalia,Ecuador,8,0,0,8
11881,2019,Spain,Ecuador,5,0,0,5
11882,2019,Viet Nam,Ecuador,5,0,0,5
11883,2019,Sudan,Ecuador,5,0,0,5
11884,2019,Syrian Arab Rep.,Ecuador,146,38,0,184
11885,2019,Türkiye,Ecuador,5,0,0,5
11886,2019,Ukraine,Ecuador,14,0,0,14
11887,2019,United States of America,Ecuador,7,5,0,12
11888,2019,Uzbekistan,Ecuador,5,0,0,5
11889,2019,Venezuela (Bolivarian Republic of),Ecuador,374,14442,0,14816
11890,2019,Western Sahara,Ecuador,5,0,0,5
11891,2019,Yemen,Ecuador,96,17,0,113
11892,2019,Zimbabwe,Ecuador,5,9,0,14
11894,2019,Eritrea,Eritrea,0,0,0,0
11895,2019,Ethiopia,Eritrea,15,0,0,15
11896,2019,Somalia,Eritrea,78,0,0,78
11897,2019,Sudan,Eritrea,99,0,0,99
11898,2019,South Sudan,Eritrea,7,0,0,7
11899,2019,Afghanistan,Estonia,9,0,0,9
11900,2019,Albania,Estonia,0,5,0,5
11901,2019,Egypt,Estonia,5,0,0,5
11902,2019,Azerbaijan,Estonia,5,0,0,5
11903,2019,Eritrea,Estonia,5,0,0,5
11904,2019,Georgia,Estonia,5,0,0,5
11905,2019,Iran (Islamic Rep. of),Estonia,5,5,0,10
11906,2019,Iraq,Estonia,22,0,0,22
11907,2019,Sri Lanka,Estonia,5,0,0,5
11908,2019,Pakistan,Estonia,5,0,0,5
11909,2019,Russian Federation,Estonia,30,18,0,48
11910,2019,Serbia and Kosovo: S/RES/1244 (1999),Estonia,6,0,0,6
11911,2019,Sudan,Estonia,16,0,0,16
11912,2019,Syrian Arab Rep.,Estonia,127,0,0,127
11913,2019,Türkiye,Estonia,19,5,0,24
11914,2019,Ukraine,Estonia,62,0,0,62
11915,2019,Yemen,Estonia,5,0,0,5
11917,2019,Egypt,Ethiopia,5,0,0,5
11918,2019,Burundi,Ethiopia,59,71,0,130
11919,2019,Cameroon,Ethiopia,0,5,0,5
11920,2019,Dem. Rep. of the Congo,Ethiopia,731,246,0,977
11921,2019,Cuba,Ethiopia,5,0,0,5
11922,2019,Djibouti,Ethiopia,49,0,0,49
11923,2019,Eritrea,Ethiopia,158596,94,0,158690
11924,2019,Ethiopia,Ethiopia,0,0,1733628,0
11925,2019,Palestinian,Ethiopia,0,5,0,5
11926,2019,Cote d'Ivoire,Ethiopia,5,0,0,5
11927,2019,Iraq,Ethiopia,10,0,0,10
11928,2019,Kenya,Ethiopia,4033,0,0,4033
11929,2019,Nigeria,Ethiopia,0,5,0,5
11930,2019,Rwanda,Ethiopia,11,6,0,17
11931,2019,Somalia,Ethiopia,192181,55,0,192236
11932,2019,Sudan,Ethiopia,41479,480,0,41959
11933,2019,South Sudan,Ethiopia,334014,168,0,334182
11934,2019,Syrian Arab Rep.,Ethiopia,0,410,0,410
11935,2019,Uganda,Ethiopia,19,5,0,24
11936,2019,Yemen,Ethiopia,1926,127,0,2053
11937,2019,Afghanistan,Fiji,5,5,0,10
11938,2019,Bangladesh,Fiji,0,5,0,5
11939,2019,Pakistan,Fiji,7,0,0,7
11940,2019,Afghanistan,Finland,3238,1220,0,4458
11941,2019,Albania,Finland,5,20,0,25
11942,2019,Algeria,Finland,14,13,0,27
11943,2019,Angola,Finland,110,26,0,136
11944,2019,Egypt,Finland,19,28,0,47
11945,2019,Azerbaijan,Finland,58,0,0,58
11946,2019,Burundi,Finland,5,5,0,10
11947,2019,Bangladesh,Finland,24,32,0,56
11948,2019,Burkina Faso,Finland,5,0,0,5
11949,2019,Belarus,Finland,14,17,0,31
11950,2019,Brazil,Finland,5,0,0,5
11951,2019,Cambodia,Finland,5,0,0,5
11952,2019,Central African Rep.,Finland,5,0,0,5
11953,2019,China,Finland,179,21,0,200
11954,2019,Cameroon,Finland,105,91,0,196
11955,2019,Congo,Finland,9,5,0,14
11956,2019,Dem. Rep. of the Congo,Finland,127,36,0,163
11957,2019,Colombia,Finland,0,19,0,19
11958,2019,Cuba,Finland,5,36,0,41
11959,2019,Dominican Rep.,Finland,5,0,0,5
11960,2019,Eritrea,Finland,851,7,0,858
11961,2019,Ethiopia,Finland,147,39,0,186
11962,2019,Finland,Finland,0,5,0,5
11963,2019,Gambia,Finland,30,29,0,59
11964,2019,Georgia,Finland,5,46,0,51
11965,2019,Ghana,Finland,52,18,0,70
11966,2019,Guatemala,Finland,5,0,0,5
11967,2019,Guinea,Finland,23,8,0,31
11968,2019,Honduras,Finland,13,26,0,39
11969,2019,Cote d'Ivoire,Finland,9,6,0,15
11970,2019,India,Finland,5,11,0,16
11971,2019,Indonesia,Finland,0,6,0,6
11972,2019,Iran (Islamic Rep. of),Finland,948,361,0,1309
11973,2019,Iraq,Finland,8862,3509,0,12371
11974,2019,Jordan,Finland,5,11,0,16
11975,2019,Kazakhstan,Finland,13,9,0,22
11976,2019,Kenya,Finland,15,11,0,26
11977,2019,Kyrgyzstan,Finland,19,0,0,19
11978,2019,Liberia,Finland,5,0,0,5
11979,2019,Libya,Finland,27,5,0,32
11980,2019,Lebanon,Finland,12,5,0,17
11981,2019,Sri Lanka,Finland,58,38,0,96
11982,2019,Rep. of Moldova,Finland,6,0,0,6
11983,2019,Mexico,Finland,0,7,0,7
11984,2019,Mali,Finland,6,0,0,6
11985,2019,Malaysia,Finland,0,6,0,6
11986,2019,Mongolia,Finland,0,5,0,5
11987,2019,Morocco,Finland,40,30,0,70
11988,2019,Montenegro,Finland,0,5,0,5
11989,2019,Myanmar,Finland,32,5,0,37
11990,2019,Nepal,Finland,0,5,0,5
11991,2019,Nicaragua,Finland,30,0,0,30
11992,2019,Nigeria,Finland,160,151,0,311
11993,2019,Pakistan,Finland,76,41,0,117
11994,2019,Peru,Finland,0,5,0,5
11995,2019,Philippines,Finland,0,5,0,5
11996,2019,Russian Federation,Finland,833,770,0,1603
11997,2019,Rwanda,Finland,28,29,0,57
11998,2019,El Salvador,Finland,10,5,0,15
11999,2019,Serbia and Kosovo: S/RES/1244 (1999),Finland,66,8,0,74
12000,2019,Senegal,Finland,5,6,0,11
12001,2019,Sierra Leone,Finland,6,14,0,20
12002,2019,Somalia,Finland,2977,728,0,3705
12003,2019,Viet Nam,Finland,5,5,0,10
12004,2019,Sudan,Finland,46,17,0,63
12005,2019,South Sudan,Finland,8,0,0,8
12006,2019,Syrian Arab Rep.,Finland,2585,77,0,2662
12007,2019,United Rep. of Tanzania,Finland,5,0,0,5
12008,2019,Tajikistan,Finland,0,10,0,10
12009,2019,Togo,Finland,5,0,0,5
12010,2019,Tunisia,Finland,5,5,0,10
12011,2019,Türkiye,Finland,581,324,0,905
12012,2019,Uganda,Finland,33,9,0,42
12013,2019,Ukraine,Finland,11,25,0,36
12014,2019,United States of America,Finland,0,7,0,7
12015,2019,Uzbekistan,Finland,9,5,0,14
12016,2019,Venezuela (Bolivarian Republic of),Finland,7,13,0,20
12017,2019,Yemen,Finland,263,57,0,320
12018,2019,Zimbabwe,Finland,6,5,0,11
12021,2019,Afghanistan,France,24293,11055,0,35348
12022,2019,Albania,France,5829,3096,0,8925
12023,2019,Algeria,France,1997,1211,0,3208
12024,2019,Angola,France,3678,1165,0,4843
12025,2019,Egypt,France,1091,417,0,1508
12026,2019,Argentina,France,5,0,0,5
12027,2019,Armenia,France,4251,1494,0,5745
12028,2019,Azerbaijan,France,2942,537,0,3479
12029,2019,Bahrain,France,10,0,0,10
12030,2019,Burundi,France,1089,573,0,1662
12031,2019,Benin,France,76,234,0,310
12032,2019,Bangladesh,France,6156,6722,0,12878
12033,2019,Bhutan,France,126,0,0,126
12034,2019,Burkina Faso,France,283,333,0,616
12035,2019,Belarus,France,524,22,0,546
12036,2019,Bolivia (Plurinational State of),France,38,7,0,45
12037,2019,Brazil,France,23,10,0,33
12038,2019,Bosnia and Herzegovina,France,4116,575,0,4691
12039,2019,Bulgaria,France,70,0,0,70
12040,2019,Cambodia,France,11021,21,0,11042
12041,2019,Central African Rep.,France,3419,520,0,3939
12042,2019,Chad,France,1890,1069,0,2959
12043,2019,China,France,6918,1269,0,8187
12044,2019,Chile,France,67,0,0,67
12045,2019,Cameroon,France,1524,1229,0,2753
12046,2019,Congo,France,3678,1118,0,4796
12047,2019,Dem. Rep. of the Congo,France,17512,3580,0,21092
12048,2019,Comoros,France,627,1037,0,1664
12049,2019,Colombia,France,587,454,0,1041
12050,2019,Costa Rica,France,5,0,0,5
12051,2019,Cuba,France,196,23,0,219
12052,2019,Czechia,France,24,0,0,24
12053,2019,Djibouti,France,342,26,0,368
12054,2019,Dominica,France,5,0,0,5
12055,2019,Dominican Rep.,France,76,84,0,160
12056,2019,Ecuador,France,24,0,0,24
12057,2019,Equatorial Guinea,France,35,5,0,40
12058,2019,Eritrea,France,6372,1439,0,7811
12059,2019,Estonia,France,5,0,0,5
12060,2019,Ethiopia,France,1689,878,0,2567
12061,2019,Gabon,France,260,475,0,735
12062,2019,Gambia,France,333,263,0,596
12063,2019,Palestinian,France,1109,230,0,1339
12064,2019,Georgia,France,3550,2617,0,6167
12065,2019,Germany,France,5,0,0,5
12066,2019,Ghana,France,517,27,0,544
12067,2019,Guinea-Bissau,France,907,137,0,1044
12068,2019,Guatemala,France,15,0,0,15
12069,2019,Guinea,France,11038,7136,0,18174
12070,2019,Guyana,France,19,0,0,19
12071,2019,Haiti,France,3815,1535,0,5350
12072,2019,Honduras,France,20,5,0,25
12073,2019,Croatia,France,56,0,0,56
12074,2019,Hungary,France,54,0,0,54
12075,2019,Cote d'Ivoire,France,5652,4921,0,10573
12076,2019,India,France,236,347,0,583
12077,2019,Indonesia,France,8,0,0,8
12078,2019,Iran (Islamic Rep. of),France,2970,674,0,3644
12079,2019,Iraq,France,8829,1330,0,10159
12080,2019,Israel,France,7,0,0,7
12081,2019,Jamaica,France,20,0,0,20
12082,2019,Jordan,France,32,5,0,37
12083,2019,Kazakhstan,France,607,306,0,913
12084,2019,Kenya,France,136,16,0,152
12085,2019,Kyrgyzstan,France,312,9,0,321
12086,2019,Rep. of Korea,France,0,5,0,5
12087,2019,Kuwait,France,164,401,0,565
12088,2019,Lao People's Dem. Rep.,France,6464,0,0,6464
12089,2019,Liberia,France,247,21,0,268
12090,2019,Libya,France,1028,631,0,1659
12091,2019,Saint Lucia,France,5,0,0,5
12092,2019,Lebanon,France,147,38,0,185
12093,2019,Sri Lanka,France,23821,2155,0,25976
12094,2019,Lithuania,France,6,0,0,6
12095,2019,Latvia,France,32,0,0,32
12096,2019,Madagascar,France,224,192,0,416
12097,2019,Mauritania,France,5675,1307,0,6982
12098,2019,North Macedonia,France,383,520,0,903
12099,2019,Rep. of Moldova,France,317,917,0,1234
12100,2019,Maldives,France,5,0,0,5
12101,2019,Mexico,France,27,0,0,27
12102,2019,Mali,France,5169,2295,0,7464
12103,2019,Malaysia,France,9,5,0,14
12104,2019,Mongolia,France,473,178,0,651
12105,2019,Morocco,France,794,518,0,1312
12106,2019,Mozambique,France,12,0,0,12
12107,2019,Montenegro,France,97,7,0,104
12108,2019,Mauritius,France,28,0,0,28
12109,2019,Myanmar,France,329,6,0,335
12110,2019,Nepal,France,150,35,0,185
12111,2019,Niger,France,115,143,0,258
12112,2019,Nicaragua,France,31,0,0,31
12113,2019,Nigeria,France,3216,4506,0,7722
12114,2019,Pakistan,France,1852,2733,0,4585
12115,2019,Paraguay,France,6,0,0,6
12116,2019,Peru,France,326,24,0,350
12117,2019,Philippines,France,5,0,0,5
12118,2019,Poland,France,132,0,0,132
12119,2019,Romania,France,143,0,0,143
12120,2019,South Africa,France,48,8,0,56
12121,2019,Russian Federation,France,16412,2864,0,19276
12122,2019,Rwanda,France,2995,439,0,3434
12123,2019,El Salvador,France,66,6,0,72
12124,2019,Saudi Arabia,France,18,0,0,18
12125,2019,Serbia and Kosovo: S/RES/1244 (1999),France,14141,2004,0,16145
12126,2019,Senegal,France,1687,1695,0,3382
12127,2019,Sierra Leone,France,671,326,0,997
12128,2019,Somalia,France,4535,3895,0,8430
12129,2019,Viet Nam,France,7735,6,0,7741
12130,2019,Sao Tome and Principe,France,5,0,0,5
12131,2019,Sudan,France,18473,2680,0,21153
12132,2019,Suriname,France,5,6,0,11
12133,2019,South Sudan,France,83,14,0,97
12134,2019,Slovakia,France,107,0,0,107
12135,2019,Syrian Arab Rep.,France,18244,3244,0,21488
12136,2019,United Rep. of Tanzania,France,10,7,0,17
12137,2019,Thailand,France,8,0,0,8
12138,2019,Tajikistan,France,56,44,0,100
12139,2019,Turkmenistan,France,23,0,0,23
12140,2019,Togo,France,759,215,0,974
12141,2019,Tunisia,France,368,305,0,673
12142,2019,Türkiye,France,11863,3481,0,15344
12143,2019,Uganda,France,159,6,0,165
12144,2019,Ukraine,France,1839,1020,0,2859
12145,2019,United States of America,France,0,5,0,5
12146,2019,Uzbekistan,France,214,6,0,220
12147,2019,Venezuela (Bolivarian Republic of),France,551,676,0,1227
12148,2019,Western Sahara,France,715,293,0,1008
12149,2019,Yemen,France,454,62,0,516
12150,2019,Zimbabwe,France,51,5,0,56
12153,2019,Burundi,Gabon,6,0,0,6
12154,2019,Central African Rep.,Gabon,16,20,0,36
12155,2019,Chad,Gabon,242,19,0,261
12156,2019,Cameroon,Gabon,5,6,0,11
12157,2019,Congo,Gabon,67,0,0,67
12158,2019,Dem. Rep. of the Congo,Gabon,72,31,0,103
12159,2019,Mauritania,Gabon,7,0,0,7
12160,2019,Sao Tome and Principe,Gabon,23,0,0,23
12161,2019,South Sudan,Gabon,5,0,0,5
12162,2019,Togo,Gabon,11,0,0,11
12163,2019,Central African Rep.,Gambia,7,8,0,15
12164,2019,Congo,Gambia,6,5,0,11
12165,2019,Dem. Rep. of the Congo,Gambia,52,7,0,59
12166,2019,Guinea-Bissau,Gambia,0,6,0,6
12167,2019,Guinea,Gambia,5,5,0,10
12168,2019,Cote d'Ivoire,Gambia,149,6,0,155
12169,2019,Liberia,Gambia,15,0,0,15
12170,2019,Senegal,Gambia,3943,158,0,4101
12171,2019,Sierra Leone,Gambia,107,11,0,118
12172,2019,Togo,Gambia,18,0,0,18
12173,2019,Afghanistan,United Kingdom of Great Britain and Northern Ireland,9513,2890,0,12403
12174,2019,Albania,United Kingdom of Great Britain and Northern Ireland,3182,6787,0,9969
12175,2019,Algeria,United Kingdom of Great Britain and Northern Ireland,344,353,0,697
12176,2019,Angola,United Kingdom of Great Britain and Northern Ireland,180,143,0,323
12177,2019,Antigua and Barbuda,United Kingdom of Great Britain and Northern Ireland,5,9,0,14
12178,2019,Egypt,United Kingdom of Great Britain and Northern Ireland,860,510,0,1370
12179,2019,Argentina,United Kingdom of Great Britain and Northern Ireland,0,10,0,10
12180,2019,Armenia,United Kingdom of Great Britain and Northern Ireland,63,13,0,76
12181,2019,Australia,United Kingdom of Great Britain and Northern Ireland,5,0,0,5
12182,2019,Azerbaijan,United Kingdom of Great Britain and Northern Ireland,159,57,0,216
12183,2019,Bahrain,United Kingdom of Great Britain and Northern Ireland,177,12,0,189
12184,2019,Barbados,United Kingdom of Great Britain and Northern Ireland,13,5,0,18
12185,2019,Burundi,United Kingdom of Great Britain and Northern Ireland,54,12,0,66
12186,2019,Benin,United Kingdom of Great Britain and Northern Ireland,9,12,0,21
12187,2019,Bangladesh,United Kingdom of Great Britain and Northern Ireland,1601,2329,0,3930
12188,2019,Bahamas,United Kingdom of Great Britain and Northern Ireland,5,0,0,5
12189,2019,Bhutan,United Kingdom of Great Britain and Northern Ireland,64,0,0,64
12190,2019,Burkina Faso,United Kingdom of Great Britain and Northern Ireland,8,14,0,22
12191,2019,Belarus,United Kingdom of Great Britain and Northern Ireland,124,18,0,142
12192,2019,Bolivia (Plurinational State of),United Kingdom of Great Britain and Northern Ireland,18,33,0,51
12193,2019,Botswana,United Kingdom of Great Britain and Northern Ireland,33,63,0,96
12194,2019,Brazil,United Kingdom of Great Britain and Northern Ireland,28,143,0,171
12195,2019,Bosnia and Herzegovina,United Kingdom of Great Britain and Northern Ireland,19,6,0,25
12196,2019,Belize,United Kingdom of Great Britain and Northern Ireland,5,0,0,5
12197,2019,Canada,United Kingdom of Great Britain and Northern Ireland,11,7,0,18
12198,2019,Central African Rep.,United Kingdom of Great Britain and Northern Ireland,11,10,0,21
12199,2019,Chad,United Kingdom of Great Britain and Northern Ireland,55,82,0,137
12200,2019,China,United Kingdom of Great Britain and Northern Ireland,1389,1689,0,3078
12201,2019,Chile,United Kingdom of Great Britain and Northern Ireland,0,8,0,8
12202,2019,Cameroon,United Kingdom of Great Britain and Northern Ireland,698,361,0,1059
12203,2019,Congo,United Kingdom of Great Britain and Northern Ireland,102,42,0,144
12204,2019,Dem. Rep. of the Congo,United Kingdom of Great Britain and Northern Ireland,1067,229,0,1296
12205,2019,Comoros,United Kingdom of Great Britain and Northern Ireland,5,0,0,5
12206,2019,Colombia,United Kingdom of Great Britain and Northern Ireland,24,61,0,85
12207,2019,Costa Rica,United Kingdom of Great Britain and Northern Ireland,0,6,0,6
12208,2019,Cuba,United Kingdom of Great Britain and Northern Ireland,10,11,0,21
12209,2019,Cabo Verde,United Kingdom of Great Britain and Northern Ireland,5,0,0,5
12210,2019,Cyprus,United Kingdom of Great Britain and Northern Ireland,0,6,0,6
12211,2019,Djibouti,United Kingdom of Great Britain and Northern Ireland,5,0,0,5
12212,2019,Dominica,United Kingdom of Great Britain and Northern Ireland,21,39,0,60
12213,2019,Dominican Rep.,United Kingdom of Great Britain and Northern Ireland,0,13,0,13
12214,2019,Ecuador,United Kingdom of Great Britain and Northern Ireland,9,11,0,20
12215,2019,Eritrea,United Kingdom of Great Britain and Northern Ireland,13755,1647,0,15402
12216,2019,Ethiopia,United Kingdom of Great Britain and Northern Ireland,1754,607,0,2361
12217,2019,Fiji,United Kingdom of Great Britain and Northern Ireland,9,5,0,14
12218,2019,Gabon,United Kingdom of Great Britain and Northern Ireland,5,0,0,5
12219,2019,Gambia,United Kingdom of Great Britain and Northern Ireland,1254,157,0,1411
12220,2019,Palestinian,United Kingdom of Great Britain and Northern Ireland,608,345,0,953
12221,2019,Georgia,United Kingdom of Great Britain and Northern Ireland,74,260,0,334
12222,2019,Germany,United Kingdom of Great Britain and Northern Ireland,0,5,0,5
12223,2019,Ghana,United Kingdom of Great Britain and Northern Ireland,340,388,0,728
12224,2019,Guinea-Bissau,United Kingdom of Great Britain and Northern Ireland,8,0,0,8
12225,2019,Greece,United Kingdom of Great Britain and Northern Ireland,5,0,0,5
12226,2019,Grenada,United Kingdom of Great Britain and Northern Ireland,24,29,0,53
12227,2019,Guatemala,United Kingdom of Great Britain and Northern Ireland,9,11,0,20
12228,2019,Guinea,United Kingdom of Great Britain and Northern Ireland,249,100,0,349
12229,2019,Guyana,United Kingdom of Great Britain and Northern Ireland,20,9,0,29
12230,2019,Haiti,United Kingdom of Great Britain and Northern Ireland,0,10,0,10
12231,2019,"China, Hong Kong SAR",United Kingdom of Great Britain and Northern Ireland,0,16,0,16
12232,2019,Honduras,United Kingdom of Great Britain and Northern Ireland,50,203,0,253
12233,2019,Cote d'Ivoire,United Kingdom of Great Britain and Northern Ireland,236,81,0,317
12234,2019,India,United Kingdom of Great Britain and Northern Ireland,463,2248,0,2711
12235,2019,Indonesia,United Kingdom of Great Britain and Northern Ireland,28,49,0,77
12236,2019,Iran (Islamic Rep. of),United Kingdom of Great Britain and Northern Ireland,19744,4845,0,24589
12237,2019,Iraq,United Kingdom of Great Britain and Northern Ireland,5752,5338,0,11090
12238,2019,Israel,United Kingdom of Great Britain and Northern Ireland,7,10,0,17
12239,2019,Italy,United Kingdom of Great Britain and Northern Ireland,0,5,0,5
12240,2019,Jamaica,United Kingdom of Great Britain and Northern Ireland,369,169,0,538
12241,2019,Jordan,United Kingdom of Great Britain and Northern Ireland,73,99,0,172
12242,2019,Japan,United Kingdom of Great Britain and Northern Ireland,0,9,0,9
12243,2019,Kazakhstan,United Kingdom of Great Britain and Northern Ireland,22,66,0,88
12244,2019,Kenya,United Kingdom of Great Britain and Northern Ireland,303,268,0,571
12245,2019,Kyrgyzstan,United Kingdom of Great Britain and Northern Ireland,38,22,0,60
12246,2019,Rep. of Korea,United Kingdom of Great Britain and Northern Ireland,6,0,0,6
12247,2019,Dem. People's Rep. of Korea,United Kingdom of Great Britain and Northern Ireland,78,24,0,102
12248,2019,Kuwait,United Kingdom of Great Britain and Northern Ireland,640,342,0,982
12249,2019,Lao People's Dem. Rep.,United Kingdom of Great Britain and Northern Ireland,5,0,0,5
12250,2019,Liberia,United Kingdom of Great Britain and Northern Ireland,32,17,0,49
12251,2019,Libya,United Kingdom of Great Britain and Northern Ireland,3755,896,0,4651
12252,2019,Saint Lucia,United Kingdom of Great Britain and Northern Ireland,24,22,0,46
12253,2019,Lebanon,United Kingdom of Great Britain and Northern Ireland,180,126,0,306
12254,2019,Lesotho,United Kingdom of Great Britain and Northern Ireland,0,5,0,5
12255,2019,Sri Lanka,United Kingdom of Great Britain and Northern Ireland,5522,1419,0,6941
12257,2019,Mauritania,United Kingdom of Great Britain and Northern Ireland,6,5,0,11
12258,2019,North Macedonia,United Kingdom of Great Britain and Northern Ireland,20,7,0,27
12259,2019,Rep. of Moldova,United Kingdom of Great Britain and Northern Ireland,12,5,0,17
12260,2019,Maldives,United Kingdom of Great Britain and Northern Ireland,40,5,0,45
12261,2019,Mexico,United Kingdom of Great Britain and Northern Ireland,13,23,0,36
12262,2019,Mali,United Kingdom of Great Britain and Northern Ireland,22,26,0,48
12263,2019,Malaysia,United Kingdom of Great Britain and Northern Ireland,248,331,0,579
12264,2019,Malawi,United Kingdom of Great Britain and Northern Ireland,347,85,0,432
12265,2019,Mongolia,United Kingdom of Great Britain and Northern Ireland,75,66,0,141
12266,2019,Morocco,United Kingdom of Great Britain and Northern Ireland,220,206,0,426
12267,2019,Mozambique,United Kingdom of Great Britain and Northern Ireland,6,7,0,13
12268,2019,Mauritius,United Kingdom of Great Britain and Northern Ireland,57,103,0,160
12269,2019,Myanmar,United Kingdom of Great Britain and Northern Ireland,613,54,0,667
12270,2019,Namibia,United Kingdom of Great Britain and Northern Ireland,107,659,0,766
12271,2019,Nepal,United Kingdom of Great Britain and Northern Ireland,47,287,0,334
12272,2019,Netherlands,United Kingdom of Great Britain and Northern Ireland,5,0,0,5
12273,2019,Niger,United Kingdom of Great Britain and Northern Ireland,190,11,0,201
12274,2019,Nicaragua,United Kingdom of Great Britain and Northern Ireland,12,86,0,98
12275,2019,Nigeria,United Kingdom of Great Britain and Northern Ireland,2816,2237,0,5053
12276,2019,Norway,United Kingdom of Great Britain and Northern Ireland,5,0,0,5
12277,2019,Oman,United Kingdom of Great Britain and Northern Ireland,19,17,0,36
12278,2019,Pakistan,United Kingdom of Great Britain and Northern Ireland,8164,3910,0,12074
12279,2019,Philippines,United Kingdom of Great Britain and Northern Ireland,40,179,0,219
12280,2019,Qatar,United Kingdom of Great Britain and Northern Ireland,5,10,0,15
12281,2019,Romania,United Kingdom of Great Britain and Northern Ireland,5,6,0,11
12282,2019,South Africa,United Kingdom of Great Britain and Northern Ireland,156,152,0,308
12283,2019,Russian Federation,United Kingdom of Great Britain and Northern Ireland,722,453,0,1175
12284,2019,Rwanda,United Kingdom of Great Britain and Northern Ireland,118,31,0,149
12285,2019,El Salvador,United Kingdom of Great Britain and Northern Ireland,304,998,0,1302
12286,2019,Saudi Arabia,United Kingdom of Great Britain and Northern Ireland,212,152,0,364
12287,2019,Serbia and Kosovo: S/RES/1244 (1999),United Kingdom of Great Britain and Northern Ireland,86,55,0,141
12288,2019,Senegal,United Kingdom of Great Britain and Northern Ireland,108,45,0,153
12289,2019,Seychelles,United Kingdom of Great Britain and Northern Ireland,5,6,0,11
12290,2019,Singapore,United Kingdom of Great Britain and Northern Ireland,5,5,0,10
12291,2019,Sierra Leone,United Kingdom of Great Britain and Northern Ireland,326,157,0,483
12292,2019,Somalia,United Kingdom of Great Britain and Northern Ireland,3271,508,0,3779
12293,2019,Viet Nam,United Kingdom of Great Britain and Northern Ireland,1928,2494,0,4422
12294,2019,Saint Kitts and Nevis,United Kingdom of Great Britain and Northern Ireland,8,12,0,20
12295,2019,Sudan,United Kingdom of Great Britain and Northern Ireland,10575,1523,0,12098
12296,2019,South Sudan,United Kingdom of Great Britain and Northern Ireland,55,29,0,84
12297,2019,Eswatini,United Kingdom of Great Britain and Northern Ireland,57,0,0,57
12298,2019,Syrian Arab Rep.,United Kingdom of Great Britain and Northern Ireland,10389,1228,0,11617
12299,2019,United Rep. of Tanzania,United Kingdom of Great Britain and Northern Ireland,98,100,0,198
12300,2019,Thailand,United Kingdom of Great Britain and Northern Ireland,41,66,0,107
12301,2019,Tajikistan,United Kingdom of Great Britain and Northern Ireland,10,11,0,21
12302,2019,Turkmenistan,United Kingdom of Great Britain and Northern Ireland,12,22,0,34
12303,2019,Togo,United Kingdom of Great Britain and Northern Ireland,18,15,0,33
12304,2019,Trinidad and Tobago,United Kingdom of Great Britain and Northern Ireland,89,92,0,181
12305,2019,Tunisia,United Kingdom of Great Britain and Northern Ireland,60,60,0,120
12306,2019,Türkiye,United Kingdom of Great Britain and Northern Ireland,1970,1206,0,3176
12307,2019,United Arab Emirates,United Kingdom of Great Britain and Northern Ireland,23,8,0,31
12308,2019,Uganda,United Kingdom of Great Britain and Northern Ireland,1237,248,0,1485
12309,2019,Ukraine,United Kingdom of Great Britain and Northern Ireland,185,233,0,418
12310,2019,United States of America,United Kingdom of Great Britain and Northern Ireland,58,81,0,139
12311,2019,Uzbekistan,United Kingdom of Great Britain and Northern Ireland,76,47,0,123
12312,2019,Saint Vincent and the Grenadines,United Kingdom of Great Britain and Northern Ireland,35,16,0,51
12313,2019,Venezuela (Bolivarian Republic of),United Kingdom of Great Britain and Northern Ireland,51,42,0,93
12314,2019,Western Sahara,United Kingdom of Great Britain and Northern Ireland,12,0,0,12
12315,2019,Yemen,United Kingdom of Great Britain and Northern Ireland,819,290,0,1109
12316,2019,Zambia,United Kingdom of Great Britain and Northern Ireland,89,41,0,130
12317,2019,Zimbabwe,United Kingdom of Great Britain and Northern Ireland,2324,390,0,2714
12320,2019,Afghanistan,Georgia,11,18,0,29
12321,2019,Egypt,Georgia,60,114,0,174
12322,2019,Azerbaijan,Georgia,5,5,0,10
12323,2019,Bangladesh,Georgia,0,25,0,25
12324,2019,China,Georgia,0,5,0,5
12325,2019,Cameroon,Georgia,0,7,0,7
12326,2019,Dem. Rep. of the Congo,Georgia,5,5,0,10
12327,2019,Eritrea,Georgia,0,15,0,15
12328,2019,Palestinian,Georgia,0,14,0,14
12329,2019,Georgia,Georgia,0,0,286216,0
12330,2019,India,Georgia,0,55,0,55
12331,2019,Iran (Islamic Rep. of),Georgia,33,462,0,495
12332,2019,Iraq,Georgia,527,66,0,593
12333,2019,Jordan,Georgia,0,25,0,25
12334,2019,Kazakhstan,Georgia,0,9,0,9
12335,2019,Lebanon,Georgia,6,7,0,13
12336,2019,Morocco,Georgia,0,5,0,5
12337,2019,Nigeria,Georgia,0,34,0,34
12338,2019,Pakistan,Georgia,11,20,0,31
12339,2019,South Africa,Georgia,0,5,0,5
12340,2019,Russian Federation,Georgia,240,50,0,290
12341,2019,Somalia,Georgia,0,33,0,33
12342,2019,Sudan,Georgia,6,6,0,12
12343,2019,Syrian Arab Rep.,Georgia,91,26,0,117
12344,2019,Tajikistan,Georgia,5,0,0,5
12345,2019,Turkmenistan,Georgia,0,5,0,5
12346,2019,Türkiye,Georgia,5,43,0,48
12347,2019,Ukraine,Georgia,306,6,0,312
12348,2019,Uzbekistan,Georgia,0,5,0,5
12349,2019,Yemen,Georgia,32,29,0,61
12352,2019,Afghanistan,Germany,140366,47343,0,187709
12353,2019,Albania,Germany,1278,2375,0,3653
12354,2019,Algeria,Germany,613,1087,0,1700
12355,2019,Angola,Germany,862,476,0,1338
12356,2019,Egypt,Germany,2310,2187,0,4497
12357,2019,Argentina,Germany,15,24,0,39
12358,2019,Armenia,Germany,2645,4926,0,7571
12359,2019,Australia,Germany,5,0,0,5
12360,2019,Austria,Germany,5,0,0,5
12361,2019,Azerbaijan,Germany,3784,5017,0,8801
12362,2019,Bahrain,Germany,89,5,0,94
12363,2019,Burundi,Germany,118,49,0,167
12364,2019,Belgium,Germany,6,0,0,6
12365,2019,Benin,Germany,92,184,0,276
12366,2019,Bangladesh,Germany,766,850,0,1616
12367,2019,Bhutan,Germany,20,5,0,25
12368,2019,Burkina Faso,Germany,93,176,0,269
12369,2019,Belarus,Germany,193,331,0,524
12370,2019,Bolivia (Plurinational State of),Germany,7,0,0,7
12371,2019,Botswana,Germany,5,5,0,10
12372,2019,Brazil,Germany,33,46,0,79
12373,2019,Bosnia and Herzegovina,Germany,1432,526,0,1958
12374,2019,Bulgaria,Germany,75,5,0,80
12375,2019,Cambodia,Germany,33,51,0,84
12376,2019,Canada,Germany,24,0,0,24
12377,2019,Central African Rep.,Germany,40,24,0,64
12378,2019,Chad,Germany,100,281,0,381
12379,2019,China,Germany,1760,943,0,2703
12380,2019,Chile,Germany,167,5,0,172
12381,2019,Cameroon,Germany,778,2840,0,3618
12382,2019,Congo,Germany,282,73,0,355
12383,2019,Dem. Rep. of the Congo,Germany,1650,655,0,2305
12384,2019,Comoros,Germany,0,13,0,13
12385,2019,Colombia,Germany,69,579,0,648
12386,2019,Cuba,Germany,86,66,0,152
12387,2019,Cabo Verde,Germany,0,5,0,5
12388,2019,Czechia,Germany,726,0,0,726
12389,2019,Djibouti,Germany,33,13,0,46
12390,2019,Dominican Rep.,Germany,9,10,0,19
12391,2019,Ecuador,Germany,13,0,0,13
12392,2019,Equatorial Guinea,Germany,24,11,0,35
12393,2019,Eritrea,Germany,58569,4757,0,63326
12394,2019,Estonia,Germany,5,0,0,5
12395,2019,Ethiopia,Germany,4982,5447,0,10429
12396,2019,France,Germany,15,5,0,20
12397,2019,Gabon,Germany,14,44,0,58
12398,2019,Gambia,Germany,1032,4940,0,5972
12399,2019,United Kingdom of Great Britain and Northern Ireland,Germany,19,0,0,19
12400,2019,Georgia,Germany,649,4445,0,5094
12401,2019,Ghana,Germany,600,1345,0,1945
12402,2019,Guinea-Bissau,Germany,102,193,0,295
12403,2019,Greece,Germany,51,0,0,51
12404,2019,Guatemala,Germany,5,7,0,12
12405,2019,Guinea,Germany,2963,5557,0,8520
12406,2019,Haiti,Germany,15,18,0,33
12407,2019,Honduras,Germany,68,64,0,132
12408,2019,Croatia,Germany,286,5,0,291
12409,2019,Hungary,Germany,241,0,0,241
12410,2019,Iceland,Germany,5,0,0,5
12411,2019,Cote d'Ivoire,Germany,610,1595,0,2205
12412,2019,India,Germany,391,1000,0,1391
12413,2019,Indonesia,Germany,16,20,0,36
12414,2019,Iran (Islamic Rep. of),Germany,43244,22005,0,65249
12415,2019,Iraq,Germany,141650,34890,0,176540
12416,2019,Israel,Germany,39,41,0,80
12417,2019,Italy,Germany,34,10,0,44
12418,2019,Jamaica,Germany,66,62,0,128
12419,2019,Jordan,Germany,435,448,0,883
12420,2019,Japan,Germany,23,5,0,28
12421,2019,Kazakhstan,Germany,114,168,0,282
12422,2019,Kenya,Germany,190,702,0,892
12423,2019,Kyrgyzstan,Germany,198,313,0,511
12424,2019,Rep. of Korea,Germany,30,17,0,47
12425,2019,Dem. People's Rep. of Korea,Germany,85,39,0,124
12426,2019,Kuwait,Germany,30,31,0,61
12427,2019,Lao People's Dem. Rep.,Germany,41,0,0,41
12428,2019,Liberia,Germany,102,372,0,474
12429,2019,Libya,Germany,1987,1179,0,3166
12430,2019,Lebanon,Germany,1656,2245,0,3901
12431,2019,Sri Lanka,Germany,3699,1375,0,5074
12432,2019,Lithuania,Germany,5,0,0,5
12433,2019,Luxembourg,Germany,5,0,0,5
12434,2019,Latvia,Germany,8,5,0,13
12435,2019,Madagascar,Germany,0,18,0,18
12436,2019,Mauritania,Germany,41,97,0,138
12437,2019,North Macedonia,Germany,722,1422,0,2144
12438,2019,Rep. of Moldova,Germany,128,1363,0,1491
12439,2019,Mexico,Germany,24,6,0,30
12440,2019,Mali,Germany,320,717,0,1037
12441,2019,Malaysia,Germany,14,8,0,22
12442,2019,Malawi,Germany,7,5,0,12
12443,2019,Mongolia,Germany,199,418,0,617
12444,2019,Morocco,Germany,800,1147,0,1947
12445,2019,Mozambique,Germany,15,26,0,41
12446,2019,Montenegro,Germany,253,229,0,482
12447,2019,Mauritius,Germany,5,5,0,10
12448,2019,Myanmar,Germany,851,294,0,1145
12449,2019,Namibia,Germany,0,28,0,28
12450,2019,Nepal,Germany,61,81,0,142
12451,2019,Netherlands,Germany,31,5,0,36
12452,2019,Niger,Germany,56,143,0,199
12453,2019,Nicaragua,Germany,5,127,0,132
12454,2019,Nigeria,Germany,7828,21814,0,29642
12455,2019,New Zealand,Germany,8,0,0,8
12456,2019,Oman,Germany,9,11,0,20
12457,2019,Pakistan,Germany,8125,10081,0,18206
12458,2019,Paraguay,Germany,0,6,0,6
12459,2019,Peru,Germany,40,5,0,45
12460,2019,Philippines,Germany,40,36,0,76
12461,2019,Poland,Germany,619,0,0,619
12462,2019,Portugal,Germany,5,5,0,10
12463,2019,Qatar,Germany,5,0,0,5
12464,2019,Romania,Germany,146,13,0,159
12465,2019,South Africa,Germany,19,73,0,92
12466,2019,Russian Federation,Germany,8722,15409,0,24131
12467,2019,Rwanda,Germany,270,193,0,463
12468,2019,El Salvador,Germany,85,41,0,126
12469,2019,Saudi Arabia,Germany,145,39,0,184
12470,2019,Serbia and Kosovo: S/RES/1244 (1999),Germany,8639,3138,0,11777
12471,2019,Senegal,Germany,183,487,0,670
12472,2019,Singapore,Germany,8,0,0,8
12473,2019,Sierra Leone,Germany,769,1208,0,1977
12474,2019,Solomon Islands,Germany,6,0,0,6
12475,2019,Somalia,Germany,26015,8438,0,34453
12476,2019,Spain,Germany,20,24,0,44
12477,2019,Viet Nam,Germany,1191,265,0,1456
12478,2019,Sudan,Germany,2606,1823,0,4429
12479,2019,South Sudan,Germany,86,92,0,178
12480,2019,Slovakia,Germany,78,0,0,78
12481,2019,Slovenia,Germany,6,0,0,6
12482,2019,Eswatini,Germany,5,5,0,10
12483,2019,Sweden,Germany,8,0,0,8
12484,2019,Syrian Arab Rep.,Germany,572818,41280,0,614098
12485,2019,United Rep. of Tanzania,Germany,64,360,0,424
12486,2019,Thailand,Germany,23,10,0,33
12487,2019,Tajikistan,Germany,871,1296,0,2167
12488,2019,Turkmenistan,Germany,83,206,0,289
12489,2019,Togo,Germany,1060,1048,0,2108
12490,2019,Trinidad and Tobago,Germany,5,5,0,10
12491,2019,Tunisia,Germany,218,574,0,792
12492,2019,Türkiye,Germany,28470,16830,0,45300
12493,2019,United Arab Emirates,Germany,39,0,0,39
12494,2019,Uganda,Germany,217,363,0,580
12495,2019,Ukraine,Germany,847,2312,0,3159
12496,2019,United States of America,Germany,133,23,0,156
12497,2019,Uzbekistan,Germany,123,129,0,252
12498,2019,Saint Vincent and the Grenadines,Germany,5,0,0,5
12499,2019,Venezuela (Bolivarian Republic of),Germany,320,923,0,1243
12500,2019,Yemen,Germany,2629,890,0,3519
12501,2019,Zambia,Germany,6,16,0,22
12502,2019,Zimbabwe,Germany,238,298,0,536
12505,2019,Egypt,Ghana,0,16,0,16
12506,2019,Burundi,Ghana,12,16,0,28
12507,2019,Benin,Ghana,5,5,0,10
12508,2019,Central African Rep.,Ghana,119,107,0,226
12509,2019,Chad,Ghana,32,14,0,46
12510,2019,Cameroon,Ghana,6,320,0,326
12511,2019,Congo,Ghana,7,7,0,14
12512,2019,Dem. Rep. of the Congo,Ghana,46,26,0,72
12513,2019,Eritrea,Ghana,64,98,0,162
12514,2019,Ethiopia,Ghana,8,5,0,13
12515,2019,Palestinian,Ghana,16,9,0,25
12516,2019,Cote d'Ivoire,Ghana,6524,339,0,6863
12517,2019,Iraq,Ghana,11,0,0,11
12518,2019,Liberia,Ghana,734,0,0,734
12519,2019,Libya,Ghana,0,14,0,14
12520,2019,Lebanon,Ghana,8,0,0,8
12521,2019,Mali,Ghana,0,5,0,5
12522,2019,Nigeria,Ghana,9,9,0,18
12523,2019,Pakistan,Ghana,26,41,0,67
12524,2019,Rwanda,Ghana,36,5,0,41
12525,2019,Sierra Leone,Ghana,89,7,0,96
12526,2019,Somalia,Ghana,63,21,0,84
12527,2019,Sudan,Ghana,485,190,0,675
12528,2019,South Sudan,Ghana,6,5,0,11
12529,2019,Syrian Arab Rep.,Ghana,167,113,0,280
12530,2019,Togo,Ghana,3459,75,0,3534
12531,2019,Türkiye,Ghana,0,47,0,47
12532,2019,Uganda,Ghana,5,6,0,11
12533,2019,Uzbekistan,Ghana,9,0,0,9
12534,2019,Yemen,Ghana,0,9,0,9
12535,2019,Burundi,Guinea-Bissau,5,0,0,5
12536,2019,Cote d'Ivoire,Guinea-Bissau,6,6,0,12
12537,2019,Liberia,Guinea-Bissau,7,0,0,7
12538,2019,Nigeria,Guinea-Bissau,0,6,0,6
12539,2019,Senegal,Guinea-Bissau,1818,8,0,1826
12540,2019,Sierra Leone,Guinea-Bissau,10,5,0,15
12541,2019,Türkiye,Guinea-Bissau,0,5,0,5
12542,2019,Afghanistan,Greece,17685,27608,0,45293
12543,2019,Albania,Greece,165,2092,0,2257
12544,2019,Algeria,Greece,98,478,0,576
12545,2019,Angola,Greece,6,46,0,52
12546,2019,Egypt,Greece,343,1502,0,1845
12547,2019,Armenia,Greece,11,86,0,97
12548,2019,Azerbaijan,Greece,5,5,0,10
12549,2019,Burundi,Greece,35,40,0,75
12550,2019,Benin,Greece,0,6,0,6
12551,2019,Bangladesh,Greece,295,2556,0,2851
12552,2019,Burkina Faso,Greece,17,86,0,103
12553,2019,Belarus,Greece,5,0,0,5
12554,2019,Brazil,Greece,0,14,0,14
12555,2019,Bosnia and Herzegovina,Greece,0,5,0,5
12556,2019,Central African Rep.,Greece,13,9,0,22
12557,2019,Chad,Greece,5,10,0,15
12558,2019,China,Greece,85,529,0,614
12559,2019,Chile,Greece,0,5,0,5
12560,2019,Cameroon,Greece,443,1102,0,1545
12561,2019,Congo,Greece,128,103,0,231
12562,2019,Dem. Rep. of the Congo,Greece,731,4041,0,4772
12563,2019,Comoros,Greece,6,11,0,17
12564,2019,Colombia,Greece,0,5,0,5
12565,2019,Cuba,Greece,0,24,0,24
12566,2019,Djibouti,Greece,5,12,0,17
12567,2019,Dominican Rep.,Greece,9,16,0,25
12568,2019,Equatorial Guinea,Greece,5,0,0,5
12569,2019,Eritrea,Greece,1065,268,0,1333
12570,2019,Ethiopia,Greece,416,97,0,513
12571,2019,Gabon,Greece,0,10,0,10
12572,2019,Gambia,Greece,33,143,0,176
12573,2019,Palestinian,Greece,2756,1530,0,4286
12574,2019,Georgia,Greece,267,1435,0,1702
12575,2019,Ghana,Greece,57,374,0,431
12576,2019,Guinea,Greece,101,223,0,324
12577,2019,Haiti,Greece,8,36,0,44
12578,2019,Cote d'Ivoire,Greece,79,50,0,129
12579,2019,India,Greece,29,439,0,468
12580,2019,Indonesia,Greece,15,41,0,56
12581,2019,Iran (Islamic Rep. of),Greece,1916,2768,0,4684
12582,2019,Iraq,Greece,9614,7283,0,16897
12583,2019,Jordan,Greece,24,27,0,51
12584,2019,Kazakhstan,Greece,5,9,0,14
12585,2019,Kenya,Greece,29,12,0,41
12586,2019,Kyrgyzstan,Greece,0,5,0,5
12587,2019,Kuwait,Greece,104,97,0,201
12588,2019,Libya,Greece,40,38,0,78
12589,2019,Lebanon,Greece,55,55,0,110
12590,2019,Sri Lanka,Greece,45,99,0,144
12591,2019,Mauritania,Greece,55,18,0,73
12592,2019,North Macedonia,Greece,0,5,0,5
12593,2019,Rep. of Moldova,Greece,13,42,0,55
12594,2019,Mexico,Greece,0,8,0,8
12595,2019,Mali,Greece,57,97,0,154
12596,2019,Morocco,Greece,175,265,0,440
12597,2019,Myanmar,Greece,74,24,0,98
12598,2019,Nepal,Greece,12,175,0,187
12599,2019,Niger,Greece,7,18,0,25
12600,2019,Nigeria,Greece,297,200,0,497
12601,2019,Pakistan,Greece,1019,6018,0,7037
12602,2019,Peru,Greece,0,5,0,5
12603,2019,Philippines,Greece,7,7,0,14
12604,2019,Russian Federation,Greece,18,64,0,82
12605,2019,Rwanda,Greece,10,5,0,15
12606,2019,El Salvador,Greece,12,0,0,12
12607,2019,Saudi Arabia,Greece,7,0,0,7
12608,2019,Serbia and Kosovo: S/RES/1244 (1999),Greece,22,19,0,41
12609,2019,Senegal,Greece,52,68,0,120
12610,2019,Sierra Leone,Greece,45,181,0,226
12611,2019,Somalia,Greece,1499,2289,0,3788
12612,2019,Viet Nam,Greece,5,10,0,15
12613,2019,Sudan,Greece,465,114,0,579
12614,2019,South Sudan,Greece,21,30,0,51
12615,2019,Syrian Arab Rep.,Greece,26696,16165,0,42861
12616,2019,United Rep. of Tanzania,Greece,13,9,0,22
12617,2019,Tajikistan,Greece,5,9,0,14
12618,2019,Turkmenistan,Greece,6,8,0,14
12619,2019,Togo,Greece,32,179,0,211
12620,2019,Tunisia,Greece,21,42,0,63
12621,2019,Türkiye,Greece,640,5185,0,5825
12622,2019,Uganda,Greece,29,64,0,93
12623,2019,Ukraine,Greece,151,97,0,248
12624,2019,United States of America,Greece,0,5,0,5
12625,2019,Uzbekistan,Greece,18,9,0,27
12626,2019,Venezuela (Bolivarian Republic of),Greece,6,34,0,40
12627,2019,Western Sahara,Greece,9,11,0,20
12628,2019,Yemen,Greece,574,213,0,787
12629,2019,Zimbabwe,Greece,8,5,0,13
12632,2019,Colombia,Guatemala,8,8,0,16
12633,2019,Cuba,Guatemala,0,39,0,39
12634,2019,Honduras,Guatemala,42,147,0,189
12635,2019,Mexico,Guatemala,0,5,0,5
12636,2019,Nicaragua,Guatemala,100,203,0,303
12637,2019,Russian Federation,Guatemala,5,0,0,5
12638,2019,El Salvador,Guatemala,230,175,0,405
12639,2019,United States of America,Guatemala,0,5,0,5
12640,2019,Venezuela (Bolivarian Republic of),Guatemala,23,49,0,72
12642,2019,Burundi,Guinea,5,0,0,5
12643,2019,Central African Rep.,Guinea,37,0,0,37
12644,2019,Cameroon,Guinea,5,0,0,5
12645,2019,Congo,Guinea,14,0,0,14
12646,2019,Dem. Rep. of the Congo,Guinea,39,7,0,46
12647,2019,Eritrea,Guinea,9,0,0,9
12648,2019,Gambia,Guinea,7,0,0,7
12649,2019,Cote d'Ivoire,Guinea,3935,6,0,3941
12650,2019,Liberia,Guinea,312,0,0,312
12651,2019,Sri Lanka,Guinea,8,0,0,8
12652,2019,Mali,Guinea,17,5,0,22
12653,2019,Nigeria,Guinea,7,0,0,7
12654,2019,Rwanda,Guinea,10,0,0,10
12655,2019,Sierra Leone,Guinea,530,1962,0,2492
12656,2019,Somalia,Guinea,6,0,0,6
12657,2019,Syrian Arab Rep.,Guinea,14,0,0,14
12658,2019,Togo,Guinea,9,0,0,9
12659,2019,Cuba,Guyana,9,57,0,66
12660,2019,Pakistan,Guyana,5,0,0,5
12661,2019,Venezuela (Bolivarian Republic of),Guyana,0,0,0,0
12662,2019,Nigeria,Haiti,0,5,0,5
12663,2019,Afghanistan,"China, Hong Kong SAR",5,0,0,5
12664,2019,Egypt,"China, Hong Kong SAR",5,0,0,5
12665,2019,Burundi,"China, Hong Kong SAR",12,0,0,12
12666,2019,Bangladesh,"China, Hong Kong SAR",5,0,0,5
12667,2019,Central African Rep.,"China, Hong Kong SAR",5,0,0,5
12668,2019,Congo,"China, Hong Kong SAR",5,0,0,5
12669,2019,Indonesia,"China, Hong Kong SAR",5,0,0,5
12670,2019,Sri Lanka,"China, Hong Kong SAR",17,0,0,17
12671,2019,Pakistan,"China, Hong Kong SAR",6,0,0,6
12672,2019,Philippines,"China, Hong Kong SAR",5,0,0,5
12673,2019,Rwanda,"China, Hong Kong SAR",20,0,0,20
12674,2019,Somalia,"China, Hong Kong SAR",22,0,0,22
12675,2019,Sudan,"China, Hong Kong SAR",5,0,0,5
12676,2019,Yemen,"China, Hong Kong SAR",11,0,0,11
12677,2019,Cuba,Honduras,0,5,0,5
12678,2019,Honduras,Honduras,0,0,247090,0
12679,2019,Nicaragua,Honduras,46,99,0,145
12680,2019,El Salvador,Honduras,22,5,0,27
12681,2019,Venezuela (Bolivarian Republic of),Honduras,7,0,0,7
12682,2019,Afghanistan,Croatia,53,108,0,161
12683,2019,Algeria,Croatia,0,23,0,23
12684,2019,Egypt,Croatia,7,0,0,7
12685,2019,Azerbaijan,Croatia,5,0,0,5
12686,2019,Bangladesh,Croatia,6,5,0,11
12687,2019,Belarus,Croatia,5,0,0,5
12688,2019,Bosnia and Herzegovina,Croatia,8,0,0,8
12689,2019,Congo,Croatia,5,0,0,5
12690,2019,Dem. Rep. of the Congo,Croatia,5,0,0,5
12691,2019,Eritrea,Croatia,23,0,0,23
12692,2019,Palestinian,Croatia,6,7,0,13
12693,2019,Georgia,Croatia,5,0,0,5
12694,2019,Croatia,Croatia,0,0,0,0
12695,2019,India,Croatia,0,14,0,14
12696,2019,Iran (Islamic Rep. of),Croatia,29,71,0,100
12697,2019,Iraq,Croatia,106,130,0,236
12698,2019,Kazakhstan,Croatia,5,7,0,12
12699,2019,Libya,Croatia,5,0,0,5
12700,2019,Mauritania,Croatia,5,0,0,5
12701,2019,Morocco,Croatia,0,12,0,12
12702,2019,Nepal,Croatia,0,5,0,5
12703,2019,Nigeria,Croatia,12,0,0,12
12704,2019,Pakistan,Croatia,7,12,0,19
12705,2019,Russian Federation,Croatia,15,0,0,15
12706,2019,Sierra Leone,Croatia,0,5,0,5
12707,2019,Somalia,Croatia,28,0,0,28
12708,2019,Viet Nam,Croatia,0,5,0,5
12709,2019,Sudan,Croatia,5,0,0,5
12710,2019,Syrian Arab Rep.,Croatia,527,10,0,537
12711,2019,Tunisia,Croatia,0,9,0,9
12712,2019,Türkiye,Croatia,19,26,0,45
12713,2019,Ukraine,Croatia,8,0,0,8
12714,2019,Uzbekistan,Croatia,5,0,0,5
12715,2019,Yemen,Croatia,7,0,0,7
12717,2019,Afghanistan,Hungary,1487,92,0,1579
12718,2019,Algeria,Hungary,15,0,0,15
12719,2019,Angola,Hungary,5,0,0,5
12720,2019,Egypt,Hungary,11,0,0,11
12721,2019,Armenia,Hungary,43,0,0,43
12722,2019,Azerbaijan,Hungary,13,0,0,13
12723,2019,Burundi,Hungary,0,5,0,5
12724,2019,Bangladesh,Hungary,8,0,0,8
12725,2019,China,Hungary,5,0,0,5
12726,2019,Cameroon,Hungary,40,0,0,40
12727,2019,Congo,Hungary,13,0,0,13
12728,2019,Dem. Rep. of the Congo,Hungary,24,0,0,24
12729,2019,Cuba,Hungary,79,0,0,79
12730,2019,Eritrea,Hungary,45,0,0,45
12731,2019,Ethiopia,Hungary,39,0,0,39
12732,2019,Palestinian,Hungary,90,6,0,96
12733,2019,Georgia,Hungary,61,0,0,61
12734,2019,Ghana,Hungary,5,0,0,5
12735,2019,Guinea,Hungary,5,0,0,5
12736,2019,Cote d'Ivoire,Hungary,15,0,0,15
12737,2019,Iran (Islamic Rep. of),Hungary,178,7,0,185
12738,2019,Iraq,Hungary,621,68,0,689
12739,2019,Libya,Hungary,7,0,0,7
12740,2019,Lebanon,Hungary,5,0,0,5
12741,2019,Sri Lanka,Hungary,12,0,0,12
12742,2019,Rep. of Moldova,Hungary,5,0,0,5
12743,2019,Myanmar,Hungary,5,0,0,5
12744,2019,Nepal,Hungary,11,0,0,11
12745,2019,Nigeria,Hungary,56,0,0,56
12746,2019,Pakistan,Hungary,58,27,0,85
12747,2019,Russian Federation,Hungary,36,0,0,36
12748,2019,Serbia and Kosovo: S/RES/1244 (1999),Hungary,52,0,0,52
12749,2019,Sierra Leone,Hungary,5,0,0,5
12750,2019,Somalia,Hungary,615,0,0,615
12751,2019,Sudan,Hungary,67,0,0,67
12752,2019,Syrian Arab Rep.,Hungary,934,7,0,941
12753,2019,Tunisia,Hungary,8,5,0,13
12754,2019,Türkiye,Hungary,33,5,0,38
12755,2019,Uganda,Hungary,7,0,0,7
12756,2019,Ukraine,Hungary,15,0,0,15
12757,2019,Uzbekistan,Hungary,6,0,0,6
12758,2019,Yemen,Hungary,18,0,0,18
12759,2019,Zimbabwe,Hungary,5,0,0,5
12762,2019,Afghanistan,Iceland,86,19,0,105
12763,2019,Albania,Iceland,5,16,0,21
12764,2019,Egypt,Iceland,6,0,0,6
12765,2019,Belarus,Iceland,0,5,0,5
12766,2019,Chile,Iceland,0,5,0,5
12767,2019,Cameroon,Iceland,5,0,0,5
12768,2019,Colombia,Iceland,0,5,0,5
12769,2019,Eritrea,Iceland,9,0,0,9
12770,2019,Palestinian,Iceland,37,11,0,48
12771,2019,Georgia,Iceland,5,0,0,5
12772,2019,Ghana,Iceland,0,10,0,10
12773,2019,Honduras,Iceland,0,5,0,5
12774,2019,Iran (Islamic Rep. of),Iceland,65,17,0,82
12775,2019,Iraq,Iceland,196,86,0,282
12776,2019,Kazakhstan,Iceland,5,0,0,5
12777,2019,Kenya,Iceland,5,0,0,5
12778,2019,Libya,Iceland,8,0,0,8
12779,2019,North Macedonia,Iceland,5,0,0,5
12780,2019,Rep. of Moldova,Iceland,0,6,0,6
12781,2019,Morocco,Iceland,5,13,0,18
12782,2019,Nigeria,Iceland,10,45,0,55
12783,2019,Pakistan,Iceland,18,12,0,30
12784,2019,Peru,Iceland,5,0,0,5
12785,2019,Russian Federation,Iceland,11,5,0,16
12786,2019,El Salvador,Iceland,16,0,0,16
12787,2019,Senegal,Iceland,5,0,0,5
12788,2019,Somalia,Iceland,38,33,0,71
12789,2019,Sudan,Iceland,6,0,0,6
12790,2019,South Sudan,Iceland,5,0,0,5
12791,2019,Syrian Arab Rep.,Iceland,109,19,0,128
12792,2019,Tunisia,Iceland,0,5,0,5
12793,2019,Türkiye,Iceland,8,6,0,14
12794,2019,Uganda,Iceland,12,0,0,12
12795,2019,Ukraine,Iceland,18,5,0,23
12796,2019,Venezuela (Bolivarian Republic of),Iceland,164,32,0,196
12797,2019,Yemen,Iceland,5,5,0,10
12800,2019,Burundi,Cote d'Ivoire,36,0,0,36
12801,2019,Benin,Cote d'Ivoire,0,5,0,5
12802,2019,Cambodia,Cote d'Ivoire,10,0,0,10
12803,2019,Central African Rep.,Cote d'Ivoire,525,27,0,552
12804,2019,Chad,Cote d'Ivoire,5,0,0,5
12805,2019,Cameroon,Cote d'Ivoire,0,15,0,15
12806,2019,Congo,Cote d'Ivoire,78,0,0,78
12807,2019,Dem. Rep. of the Congo,Cote d'Ivoire,134,17,0,151
12808,2019,Eritrea,Cote d'Ivoire,6,5,0,11
12809,2019,Ethiopia,Cote d'Ivoire,5,5,0,10
12810,2019,Guinea,Cote d'Ivoire,0,7,0,7
12811,2019,Cote d'Ivoire,Cote d'Ivoire,0,0,0,0
12812,2019,Iran (Islamic Rep. of),Cote d'Ivoire,6,0,0,6
12813,2019,Iraq,Cote d'Ivoire,5,0,0,5
12814,2019,Liberia,Cote d'Ivoire,932,21,0,953
12815,2019,Sri Lanka,Cote d'Ivoire,5,0,0,5
12816,2019,Mauritania,Cote d'Ivoire,0,5,0,5
12817,2019,Mali,Cote d'Ivoire,12,17,0,29
12818,2019,Nigeria,Cote d'Ivoire,5,0,0,5
12819,2019,Rwanda,Cote d'Ivoire,53,5,0,58
12820,2019,Somalia,Cote d'Ivoire,5,0,0,5
12821,2019,Viet Nam,Cote d'Ivoire,5,0,0,5
12822,2019,Sudan,Cote d'Ivoire,10,0,0,10
12823,2019,Syrian Arab Rep.,Cote d'Ivoire,132,11,0,143
12824,2019,Togo,Cote d'Ivoire,17,11,0,28
12825,2019,Türkiye,Cote d'Ivoire,34,0,0,34
12827,2019,Afghanistan,India,7470,8219,0,15689
12828,2019,Egypt,India,0,8,0,8
12829,2019,Benin,India,0,5,0,5
12830,2019,China,India,108008,0,0,108008
12831,2019,Cameroon,India,0,178,0,178
12832,2019,Congo,India,5,34,0,39
12833,2019,Dem. Rep. of the Congo,India,42,48,0,90
12834,2019,Eritrea,India,7,13,0,20
12835,2019,Ethiopia,India,18,24,0,42
12836,2019,Palestinian,India,72,7,0,79
12837,2019,Ghana,India,0,20,0,20
12838,2019,Guinea-Bissau,India,0,5,0,5
12839,2019,Cote d'Ivoire,India,5,86,0,91
12840,2019,Iran (Islamic Rep. of),India,49,56,0,105
12841,2019,Iraq,India,172,51,0,223
12842,2019,Kenya,India,0,6,0,6
12843,2019,Libya,India,8,0,0,8
12844,2019,Sri Lanka,India,59428,0,0,59428
12845,2019,Maldives,India,5,0,0,5
12846,2019,Myanmar,India,2574,676,0,3250
12847,2019,Nigeria,India,0,100,0,100
12848,2019,Russian Federation,India,0,14,0,14
12849,2019,Rwanda,India,5,5,0,10
12850,2019,Saudi Arabia,India,5,0,0,5
12851,2019,Senegal,India,0,7,0,7
12852,2019,Somalia,India,533,319,0,852
12853,2019,Sudan,India,69,116,0,185
12854,2019,South Sudan,India,0,95,0,95
12855,2019,Syrian Arab Rep.,India,70,29,0,99
12856,2019,United Rep. of Tanzania,India,0,5,0,5
12857,2019,Tajikistan,India,0,5,0,5
12858,2019,Turkmenistan,India,0,5,0,5
12859,2019,Türkiye,India,29,0,0,29
12860,2019,Uganda,India,0,5,0,5
12861,2019,Ukraine,India,0,9,0,9
12862,2019,Uzbekistan,India,0,7,0,7
12863,2019,Venezuela (Bolivarian Republic of),India,0,9,0,9
12864,2019,Yemen,India,5,830,0,835
12866,2019,Afghanistan,Indonesia,5866,1826,0,7692
12867,2019,Angola,Indonesia,6,0,0,6
12868,2019,Egypt,Indonesia,18,12,0,30
12869,2019,China,Indonesia,12,5,0,17
12870,2019,Cameroon,Indonesia,0,10,0,10
12871,2019,Dem. Rep. of the Congo,Indonesia,10,0,0,10
12872,2019,Eritrea,Indonesia,52,209,0,261
12873,2019,Ethiopia,Indonesia,132,38,0,170
12874,2019,Palestinian,Indonesia,321,86,0,407
12875,2019,Cote d'Ivoire,Indonesia,0,5,0,5
12876,2019,Iran (Islamic Rep. of),Indonesia,323,24,0,347
12877,2019,Iraq,Indonesia,553,225,0,778
12878,2019,Jordan,Indonesia,5,0,0,5
12879,2019,Kuwait,Indonesia,9,0,0,9
12880,2019,Libya,Indonesia,14,14,0,28
12881,2019,Sri Lanka,Indonesia,397,36,0,433
12882,2019,Mali,Indonesia,0,5,0,5
12883,2019,Myanmar,Indonesia,595,33,0,628
12884,2019,Pakistan,Indonesia,316,25,0,341
12885,2019,Russian Federation,Indonesia,5,0,0,5
12886,2019,Somalia,Indonesia,1120,302,0,1422
12887,2019,Viet Nam,Indonesia,20,0,0,20
12888,2019,Sudan,Indonesia,400,97,0,497
12889,2019,Syrian Arab Rep.,Indonesia,23,19,0,42
12890,2019,Türkiye,Indonesia,0,13,0,13
12891,2019,Uganda,Indonesia,5,5,0,10
12892,2019,Yemen,Indonesia,85,354,0,439
12894,2019,Afghanistan,Ireland,366,127,0,493
12895,2019,Albania,Ireland,145,783,0,928
12896,2019,Algeria,Ireland,54,202,0,256
12897,2019,Angola,Ireland,50,32,0,82
12898,2019,Egypt,Ireland,30,68,0,98
12899,2019,Armenia,Ireland,14,5,0,19
12900,2019,Azerbaijan,Ireland,5,0,0,5
12901,2019,Bahrain,Ireland,5,5,0,10
12902,2019,Burundi,Ireland,21,7,0,28
12903,2019,Benin,Ireland,5,0,0,5
12904,2019,Bangladesh,Ireland,57,216,0,273
12905,2019,Bhutan,Ireland,10,0,0,10
12906,2019,Belarus,Ireland,22,0,0,22
12907,2019,Bolivia (Plurinational State of),Ireland,12,41,0,53
12908,2019,Botswana,Ireland,10,35,0,45
12909,2019,Brazil,Ireland,5,178,0,183
12910,2019,Bosnia and Herzegovina,Ireland,5,0,0,5
12911,2019,Belize,Ireland,0,5,0,5
12912,2019,Chad,Ireland,5,0,0,5
12913,2019,China,Ireland,63,91,0,154
12914,2019,Chile,Ireland,0,5,0,5
12915,2019,Cameroon,Ireland,72,61,0,133
12916,2019,Congo,Ireland,14,5,0,19
12917,2019,Dem. Rep. of the Congo,Ireland,376,222,0,598
12918,2019,Cuba,Ireland,5,0,0,5
12919,2019,Dominican Rep.,Ireland,0,5,0,5
12920,2019,Eritrea,Ireland,69,13,0,82
12921,2019,Ethiopia,Ireland,34,16,0,50
12922,2019,Gambia,Ireland,0,5,0,5
12923,2019,Palestinian,Ireland,117,52,0,169
12924,2019,United Kingdom of Great Britain and Northern Ireland,Ireland,0,5,0,5
12925,2019,Georgia,Ireland,92,828,0,920
12926,2019,Ghana,Ireland,24,74,0,98
12927,2019,Guatemala,Ireland,0,11,0,11
12928,2019,Guinea,Ireland,16,0,0,16
12929,2019,Guyana,Ireland,0,5,0,5
12930,2019,Cote d'Ivoire,Ireland,14,14,0,28
12931,2019,India,Ireland,10,116,0,126
12932,2019,Iran (Islamic Rep. of),Ireland,141,46,0,187
12933,2019,Iraq,Ireland,398,81,0,479
12934,2019,Israel,Ireland,5,0,0,5
12935,2019,Jordan,Ireland,6,10,0,16
12936,2019,Kazakhstan,Ireland,19,0,0,19
12937,2019,Kenya,Ireland,51,29,0,80
12938,2019,Kyrgyzstan,Ireland,5,5,0,10
12939,2019,Dem. People's Rep. of Korea,Ireland,7,6,0,13
12940,2019,Kuwait,Ireland,50,24,0,74
12941,2019,Liberia,Ireland,13,0,0,13
12942,2019,Libya,Ireland,220,16,0,236
12943,2019,Lebanon,Ireland,5,10,0,15
12944,2019,Lesotho,Ireland,0,5,0,5
12945,2019,Sri Lanka,Ireland,21,12,0,33
12946,2019,Rep. of Moldova,Ireland,54,8,0,62
12947,2019,Mexico,Ireland,5,7,0,12
12948,2019,Mali,Ireland,8,0,0,8
12949,2019,Malaysia,Ireland,5,31,0,36
12950,2019,Malawi,Ireland,95,180,0,275
12951,2019,Mongolia,Ireland,5,14,0,19
12952,2019,Morocco,Ireland,10,46,0,56
12953,2019,Mozambique,Ireland,5,5,0,10
12954,2019,Montenegro,Ireland,5,0,0,5
12955,2019,Mauritius,Ireland,13,32,0,45
12956,2019,Myanmar,Ireland,13,5,0,18
12957,2019,Nepal,Ireland,6,26,0,32
12958,2019,Niger,Ireland,5,0,0,5
12959,2019,Nicaragua,Ireland,0,7,0,7
12960,2019,Nigeria,Ireland,293,703,0,996
12961,2019,Pakistan,Ireland,297,786,0,1083
12962,2019,South Africa,Ireland,77,519,0,596
12963,2019,Russian Federation,Ireland,74,31,0,105
12964,2019,Rwanda,Ireland,36,0,0,36
12965,2019,El Salvador,Ireland,5,18,0,23
12966,2019,Saudi Arabia,Ireland,13,8,0,21
12967,2019,Serbia and Kosovo: S/RES/1244 (1999),Ireland,60,32,0,92
12968,2019,Senegal,Ireland,0,5,0,5
12969,2019,Sierra Leone,Ireland,34,52,0,86
12970,2019,Somalia,Ireland,231,136,0,367
12971,2019,Viet Nam,Ireland,5,36,0,41
12972,2019,Sudan,Ireland,202,34,0,236
12973,2019,Eswatini,Ireland,15,26,0,41
12974,2019,Syrian Arab Rep.,Ireland,2882,54,0,2936
12975,2019,United Rep. of Tanzania,Ireland,0,9,0,9
12976,2019,Togo,Ireland,19,9,0,28
12977,2019,Trinidad and Tobago,Ireland,0,5,0,5
12978,2019,Tunisia,Ireland,5,10,0,15
12979,2019,Türkiye,Ireland,8,12,0,20
12980,2019,Uganda,Ireland,37,38,0,75
12981,2019,Ukraine,Ireland,81,33,0,114
12982,2019,United States of America,Ireland,0,17,0,17
12983,2019,Uzbekistan,Ireland,17,0,0,17
12984,2019,Venezuela (Bolivarian Republic of),Ireland,46,104,0,150
12985,2019,Yemen,Ireland,16,7,0,23
12986,2019,Zambia,Ireland,0,8,0,8
12987,2019,Zimbabwe,Ireland,438,790,0,1228
12990,2019,Afghanistan,Iran (Islamic Rep. of),951142,0,0,951142
12991,2019,Iraq,Iran (Islamic Rep. of),28268,0,0,28268
12992,2019,Kuwait,Iran (Islamic Rep. of),8,0,0,8
12993,2019,Myanmar,Iran (Islamic Rep. of),0,33,0,33
12994,2019,Pakistan,Iran (Islamic Rep. of),10,0,0,10
12995,2019,Uzbekistan,Iran (Islamic Rep. of),7,0,0,7
12996,2019,Afghanistan,Iraq,11,56,0,67
12997,2019,Egypt,Iraq,0,22,0,22
12998,2019,Bahrain,Iraq,0,23,0,23
12999,2019,Eritrea,Iraq,5,30,0,35
13000,2019,Palestinian,Iraq,7858,107,0,7965
13001,2019,Indonesia,Iraq,0,5,0,5
13002,2019,Iran (Islamic Rep. of),Iraq,5041,6051,0,11092
13003,2019,Iraq,Iraq,0,0,1414632,0
13004,2019,Kazakhstan,Iraq,0,5,0,5
13005,2019,Kyrgyzstan,Iraq,0,15,0,15
13006,2019,Kuwait,Iraq,0,209,0,209
13007,2019,Lebanon,Iraq,0,5,0,5
13008,2019,Pakistan,Iraq,0,25,0,25
13009,2019,Saudi Arabia,Iraq,0,5,0,5
13010,2019,Somalia,Iraq,6,5,0,11
13011,2019,Sudan,Iraq,88,692,0,780
13012,2019,South Sudan,Iraq,0,15,0,15
13013,2019,Syrian Arab Rep.,Iraq,245810,0,0,245810
13014,2019,Tunisia,Iraq,0,6,0,6
13015,2019,Türkiye,Iraq,15167,5510,0,20677
13016,2019,Uzbekistan,Iraq,0,5,0,5
13017,2019,Yemen,Iraq,0,147,0,147
13019,2019,Egypt,Israel,0,12,0,12
13020,2019,Argentina,Israel,0,5,0,5
13021,2019,Armenia,Israel,0,58,0,58
13022,2019,Azerbaijan,Israel,0,69,0,69
13023,2019,Benin,Israel,0,5,0,5
13024,2019,Burkina Faso,Israel,0,10,0,10
13025,2019,Belarus,Israel,0,952,0,952
13026,2019,Botswana,Israel,0,7,0,7
13027,2019,Brazil,Israel,0,7,0,7
13028,2019,Central African Rep.,Israel,0,17,0,17
13029,2019,Chad,Israel,5,5,0,10
13030,2019,China,Israel,0,235,0,235
13031,2019,Cameroon,Israel,0,49,0,49
13032,2019,Congo,Israel,0,30,0,30
13033,2019,Dem. Rep. of the Congo,Israel,210,209,0,419
13034,2019,Colombia,Israel,0,284,0,284
13035,2019,Ecuador,Israel,0,24,0,24
13036,2019,Eritrea,Israel,12181,11395,0,23576
13037,2019,Ethiopia,Israel,97,818,0,915
13038,2019,Georgia,Israel,5,1730,0,1735
13039,2019,Ghana,Israel,0,533,0,533
13040,2019,Guinea,Israel,0,7,0,7
13041,2019,Cote d'Ivoire,Israel,5,10,0,15
13042,2019,India,Israel,0,1270,0,1270
13043,2019,Iran (Islamic Rep. of),Israel,6,5,0,11
13044,2019,Iraq,Israel,10,0,0,10
13045,2019,Kazakhstan,Israel,0,214,0,214
13046,2019,Kenya,Israel,0,107,0,107
13047,2019,Kyrgyzstan,Israel,0,90,0,90
13048,2019,Dem. People's Rep. of Korea,Israel,5,0,0,5
13049,2019,Lesotho,Israel,0,7,0,7
13050,2019,Sri Lanka,Israel,0,1115,0,1115
13051,2019,Latvia,Israel,0,5,0,5
13052,2019,Rep. of Moldova,Israel,0,656,0,656
13053,2019,Mali,Israel,0,5,0,5
13054,2019,Malawi,Israel,0,67,0,67
13055,2019,Mongolia,Israel,0,7,0,7
13056,2019,Myanmar,Israel,0,23,0,23
13057,2019,Nepal,Israel,0,28,0,28
13058,2019,Nigeria,Israel,6,996,0,1002
13059,2019,Philippines,Israel,0,7,0,7
13060,2019,Romania,Israel,0,50,0,50
13061,2019,South Africa,Israel,0,502,0,502
13062,2019,Russian Federation,Israel,0,5932,0,5932
13063,2019,Rwanda,Israel,0,7,0,7
13064,2019,Sierra Leone,Israel,5,10,0,15
13065,2019,Somalia,Israel,0,11,0,11
13066,2019,Viet Nam,Israel,0,5,0,5
13067,2019,Sudan,Israel,3248,4461,0,7709
13068,2019,South Sudan,Israel,109,124,0,233
13069,2019,Thailand,Israel,0,6,0,6
13070,2019,Tajikistan,Israel,0,6,0,6
13071,2019,Turkmenistan,Israel,0,6,0,6
13072,2019,Togo,Israel,0,6,0,6
13073,2019,Türkiye,Israel,5,432,0,437
13074,2019,Uganda,Israel,0,148,0,148
13075,2019,Ukraine,Israel,5,5056,0,5061
13076,2019,Uzbekistan,Israel,0,546,0,546
13077,2019,Venezuela (Bolivarian Republic of),Israel,0,5,0,5
13078,2019,Zimbabwe,Israel,0,20,0,20
13081,2019,Afghanistan,Italy,17849,840,0,18689
13082,2019,Albania,Italy,809,589,0,1398
13083,2019,Algeria,Italy,228,130,0,358
13084,2019,Angola,Italy,34,9,0,43
13085,2019,Egypt,Italy,2379,638,0,3017
13086,2019,Argentina,Italy,9,16,0,25
13087,2019,Armenia,Italy,376,78,0,454
13088,2019,Azerbaijan,Italy,97,35,0,132
13089,2019,Bahrain,Italy,5,0,0,5
13090,2019,Burundi,Italy,29,5,0,34
13091,2019,Belgium,Italy,0,5,0,5
13092,2019,Benin,Italy,297,36,0,333
13093,2019,Bangladesh,Italy,8974,1934,0,10908
13094,2019,Bahamas,Italy,5,0,0,5
13095,2019,Burkina Faso,Italy,1212,126,0,1338
13096,2019,Belarus,Italy,40,22,0,62
13097,2019,Bolivia (Plurinational State of),Italy,16,6,0,22
13098,2019,Brazil,Italy,220,154,0,374
13099,2019,Bosnia and Herzegovina,Italy,667,35,0,702
13100,2019,Cambodia,Italy,5,0,0,5
13101,2019,Central African Rep.,Italy,110,22,0,132
13102,2019,Chad,Italy,473,34,0,507
13103,2019,China,Italy,241,499,0,740
13104,2019,Chile,Italy,10,7,0,17
13105,2019,Cameroon,Italy,2217,399,0,2616
13106,2019,Congo,Italy,421,0,0,421
13107,2019,Dem. Rep. of the Congo,Italy,645,41,0,686
13108,2019,Comoros,Italy,0,6,0,6
13109,2019,Colombia,Italy,690,466,0,1156
13110,2019,Costa Rica,Italy,6,0,0,6
13111,2019,Cuba,Italy,238,105,0,343
13112,2019,Cabo Verde,Italy,5,5,0,10
13113,2019,Dominican Rep.,Italy,29,20,0,49
13114,2019,Ecuador,Italy,35,25,0,60
13115,2019,Equatorial Guinea,Italy,15,5,0,20
13116,2019,Eritrea,Italy,7118,9257,0,16375
13117,2019,Ethiopia,Italy,1319,232,0,1551
13118,2019,Gabon,Italy,38,10,0,48
13119,2019,Gambia,Italy,12968,701,0,13669
13120,2019,Palestinian,Italy,1086,90,0,1176
13121,2019,Georgia,Italy,732,714,0,1446
13122,2019,Germany,Italy,0,11,0,11
13123,2019,Ghana,Italy,5953,589,0,6542
13124,2019,Guinea-Bissau,Italy,909,94,0,1003
13125,2019,Guatemala,Italy,17,17,0,34
13126,2019,Guinea,Italy,4868,884,0,5752
13127,2019,Haiti,Italy,9,0,0,9
13128,2019,Honduras,Italy,286,172,0,458
13129,2019,Croatia,Italy,18,0,0,18
13130,2019,Cote d'Ivoire,Italy,7659,1250,0,8909
13131,2019,India,Italy,396,746,0,1142
13132,2019,Indonesia,Italy,5,0,0,5
13133,2019,Iran (Islamic Rep. of),Italy,2094,186,0,2280
13134,2019,Iraq,Italy,6994,934,0,7928
13135,2019,Israel,Italy,9,0,0,9
13136,2019,Jamaica,Italy,5,0,0,5
13137,2019,Jordan,Italy,41,10,0,51
13138,2019,Kazakhstan,Italy,29,8,0,37
13139,2019,Kenya,Italy,124,23,0,147
13140,2019,Kyrgyzstan,Italy,101,45,0,146
13141,2019,Rep. of Korea,Italy,5,0,0,5
13142,2019,Kuwait,Italy,13,5,0,18
13143,2019,Liberia,Italy,389,35,0,424
13144,2019,Libya,Italy,1436,192,0,1628
13145,2019,Lebanon,Italy,372,97,0,469
13146,2019,Liechtenstein,Italy,0,14,0,14
13147,2019,Sri Lanka,Italy,588,346,0,934
13148,2019,Madagascar,Italy,23,5,0,28
13149,2019,Mauritania,Italy,355,8,0,363
13150,2019,North Macedonia,Italy,77,44,0,121
13151,2019,Rep. of Moldova,Italy,115,39,0,154
13152,2019,Mexico,Italy,13,8,0,21
13153,2019,Mali,Italy,15842,871,0,16713
13154,2019,Malaysia,Italy,5,0,0,5
13155,2019,Malawi,Italy,5,0,0,5
13156,2019,Mongolia,Italy,0,5,0,5
13157,2019,Morocco,Italy,1284,1102,0,2386
13158,2019,Mozambique,Italy,5,0,0,5
13159,2019,Montenegro,Italy,84,5,0,89
13160,2019,Mauritius,Italy,19,6,0,25
13161,2019,Myanmar,Italy,49,5,0,54
13162,2019,Namibia,Italy,5,0,0,5
13163,2019,Nepal,Italy,130,50,0,180
13164,2019,Niger,Italy,676,53,0,729
13165,2019,Nicaragua,Italy,47,25,0,72
13166,2019,Nigeria,Italy,25241,5380,0,30621
13167,2019,Pakistan,Italy,20063,7800,0,27863
13168,2019,Paraguay,Italy,7,22,0,29
13169,2019,Peru,Italy,246,1046,0,1292
13170,2019,Philippines,Italy,90,94,0,184
13171,2019,South Africa,Italy,13,0,0,13
13172,2019,Russian Federation,Italy,357,108,0,465
13173,2019,Rwanda,Italy,16,5,0,21
13174,2019,El Salvador,Italy,3291,1136,0,4427
13175,2019,Saudi Arabia,Italy,25,20,0,45
13176,2019,Serbia and Kosovo: S/RES/1244 (1999),Italy,1202,97,0,1299
13177,2019,Senegal,Italy,7991,1134,0,9125
13178,2019,Sierra Leone,Italy,795,120,0,915
13179,2019,Somalia,Italy,14029,444,0,14473
13180,2019,Viet Nam,Italy,9,5,0,14
13181,2019,Sudan,Italy,1718,513,0,2231
13182,2019,South Sudan,Italy,140,13,0,153
13183,2019,Eswatini,Italy,10,0,0,10
13184,2019,Switzerland,Italy,0,5,0,5
13185,2019,Syrian Arab Rep.,Italy,4781,917,0,5698
13186,2019,United Rep. of Tanzania,Italy,31,6,0,37
13187,2019,Tajikistan,Italy,11,0,0,11
13188,2019,Turkmenistan,Italy,5,0,0,5
13189,2019,Timor-Leste,Italy,5,0,0,5
13190,2019,Togo,Italy,982,75,0,1057
13191,2019,Tunisia,Italy,713,315,0,1028
13192,2019,Türkiye,Italy,2845,381,0,3226
13193,2019,United Arab Emirates,Italy,5,0,0,5
13194,2019,Uganda,Italy,80,10,0,90
13195,2019,Ukraine,Italy,6353,1189,0,7542
13196,2019,Uruguay,Italy,0,5,0,5
13197,2019,United States of America,Italy,5,0,0,5
13198,2019,Uzbekistan,Italy,21,0,0,21
13199,2019,Venezuela (Bolivarian Republic of),Italy,1988,580,0,2568
13200,2019,Western Sahara,Italy,5,0,0,5
13201,2019,Yemen,Italy,151,40,0,191
13202,2019,Zimbabwe,Italy,30,5,0,35
13205,2019,Haiti,Jamaica,0,5,0,5
13206,2019,Venezuela (Bolivarian Republic of),Jamaica,0,0,0,0
13207,2019,Afghanistan,Jordan,8,11,0,19
13208,2019,Algeria,Jordan,0,7,0,7
13209,2019,Egypt,Jordan,100,587,0,687
13210,2019,Bangladesh,Jordan,0,6,0,6
13211,2019,Burkina Faso,Jordan,0,5,0,5
13212,2019,Bosnia and Herzegovina,Jordan,9,0,0,9
13213,2019,Bulgaria,Jordan,0,0,0,0
13214,2019,Central African Rep.,Jordan,5,0,0,5
13215,2019,Chad,Jordan,8,12,0,20
13216,2019,Comoros,Jordan,0,5,0,5
13217,2019,Eritrea,Jordan,30,11,0,41
13218,2019,Ethiopia,Jordan,12,29,0,41
13219,2019,Palestinian,Jordan,0,0,0,0
13220,2019,Ghana,Jordan,0,6,0,6
13221,2019,India,Jordan,0,6,0,6
13222,2019,Iran (Islamic Rep. of),Jordan,5,0,0,5
13223,2019,Iraq,Jordan,34336,32843,0,67179
13224,2019,Jordan,Jordan,0,0,0,0
13225,2019,Kenya,Jordan,0,9,0,9
13226,2019,Kuwait,Jordan,0,0,0,0
13227,2019,Libya,Jordan,30,165,0,195
13228,2019,Lebanon,Jordan,6,103,0,109
13229,2019,Sri Lanka,Jordan,8,9,0,17
13230,2019,Morocco,Jordan,0,10,0,10
13231,2019,Niger,Jordan,0,11,0,11
13232,2019,Nigeria,Jordan,0,95,0,95
13233,2019,Pakistan,Jordan,5,25,0,30
13234,2019,Philippines,Jordan,0,5,0,5
13235,2019,Russian Federation,Jordan,24,11,0,35
13236,2019,Saudi Arabia,Jordan,0,15,0,15
13237,2019,Serbia and Kosovo: S/RES/1244 (1999),Jordan,0,5,0,5
13238,2019,Senegal,Jordan,0,5,0,5
13239,2019,Somalia,Jordan,660,84,0,744
13240,2019,Sudan,Jordan,2996,3014,0,6010
13241,2019,South Sudan,Jordan,11,8,0,19
13242,2019,Syrian Arab Rep.,Jordan,654692,0,0,654692
13243,2019,Tajikistan,Jordan,0,14,0,14
13244,2019,Tunisia,Jordan,8,13,0,21
13245,2019,United Arab Emirates,Jordan,0,5,0,5
13246,2019,Ukraine,Jordan,0,19,0,19
13247,2019,United States of America,Jordan,0,0,0,0
13248,2019,Venezuela (Bolivarian Republic of),Jordan,0,5,0,5
13249,2019,Yemen,Jordan,715,14059,0,14774
13251,2019,Afghanistan,Japan,68,0,0,68
13252,2019,Burundi,Japan,9,0,0,9
13253,2019,Bangladesh,Japan,24,0,0,24
13254,2019,China,Japan,56,0,0,56
13255,2019,Cameroon,Japan,17,0,0,17
13256,2019,Dem. Rep. of the Congo,Japan,20,0,0,20
13257,2019,Ethiopia,Japan,31,0,0,31
13258,2019,Iran (Islamic Rep. of),Japan,17,0,0,17
13259,2019,Iraq,Japan,13,0,0,13
13260,2019,Sri Lanka,Japan,58,0,0,58
13261,2019,Myanmar,Japan,668,0,0,668
13262,2019,Nigeria,Japan,5,0,0,5
13263,2019,Pakistan,Japan,35,0,0,35
13264,2019,Somalia,Japan,5,0,0,5
13265,2019,Sudan,Japan,15,0,0,15
13266,2019,Syrian Arab Rep.,Japan,69,0,0,69
13267,2019,Türkiye,Japan,51,0,0,51
13270,2019,Afghanistan,Kazakhstan,491,181,0,672
13271,2019,China,Kazakhstan,0,12,0,12
13272,2019,Syrian Arab Rep.,Kazakhstan,14,19,0,33
13273,2019,Uzbekistan,Kazakhstan,13,0,0,13
13275,2019,Afghanistan,Kenya,10,9,0,19
13276,2019,Egypt,Kenya,0,21,0,21
13277,2019,Burundi,Kenya,5775,9323,0,15098
13278,2019,Central African Rep.,Kenya,0,10,0,10
13279,2019,Cameroon,Kenya,0,52,0,52
13280,2019,Congo,Kenya,79,88,0,167
13281,2019,Dem. Rep. of the Congo,Kenya,28085,15492,0,43577
13282,2019,Eritrea,Kenya,869,963,0,1832
13283,2019,Ethiopia,Kenya,19552,8864,0,28416
13284,2019,Cote d'Ivoire,Kenya,5,5,0,10
13285,2019,India,Kenya,0,5,0,5
13286,2019,Iraq,Kenya,5,0,0,5
13287,2019,Sri Lanka,Kenya,9,0,0,9
13288,2019,Mozambique,Kenya,8,0,0,8
13289,2019,Nigeria,Kenya,5,16,0,21
13290,2019,Pakistan,Kenya,9,7,0,16
13291,2019,Rwanda,Kenya,732,1056,0,1788
13292,2019,Somalia,Kenya,257766,6499,0,264265
13293,2019,Sudan,Kenya,3568,6358,0,9926
13294,2019,South Sudan,Kenya,121410,143,0,121553
13295,2019,Syrian Arab Rep.,Kenya,5,5,0,10
13296,2019,United Rep. of Tanzania,Kenya,11,40,0,51
13297,2019,Türkiye,Kenya,41,40,0,81
13298,2019,Uganda,Kenya,890,1609,0,2499
13299,2019,Yemen,Kenya,60,217,0,277
13300,2019,Zimbabwe,Kenya,5,7,0,12
13302,2019,Afghanistan,Kyrgyzstan,227,104,0,331
13303,2019,Palestinian,Kyrgyzstan,0,5,0,5
13304,2019,Iraq,Kyrgyzstan,6,5,0,11
13305,2019,Syrian Arab Rep.,Kyrgyzstan,86,5,0,91
13306,2019,Tajikistan,Kyrgyzstan,5,0,0,5
13307,2019,Türkiye,Kyrgyzstan,0,36,0,36
13308,2019,Ukraine,Kyrgyzstan,23,0,0,23
13309,2019,Uzbekistan,Kyrgyzstan,0,9,0,9
13311,2019,Afghanistan,Rep. of Korea,41,49,0,90
13312,2019,Algeria,Rep. of Korea,6,239,0,245
13313,2019,Angola,Rep. of Korea,5,50,0,55
13314,2019,Egypt,Rep. of Korea,34,787,0,821
13315,2019,Argentina,Rep. of Korea,0,11,0,11
13316,2019,Azerbaijan,Rep. of Korea,0,7,0,7
13317,2019,Burundi,Rep. of Korea,39,16,0,55
13318,2019,Benin,Rep. of Korea,0,5,0,5
13319,2019,Bangladesh,Rep. of Korea,114,1087,0,1201
13320,2019,Burkina Faso,Rep. of Korea,0,11,0,11
13321,2019,Bolivia (Plurinational State of),Rep. of Korea,0,5,0,5
13322,2019,Brazil,Rep. of Korea,0,8,0,8
13323,2019,Cambodia,Rep. of Korea,0,80,0,80
13324,2019,China,Rep. of Korea,44,2606,0,2650
13325,2019,Cameroon,Rep. of Korea,20,269,0,289
13326,2019,Congo,Rep. of Korea,0,11,0,11
13327,2019,Dem. Rep. of the Congo,Rep. of Korea,61,38,0,99
13328,2019,Colombia,Rep. of Korea,0,10,0,10
13329,2019,Eritrea,Rep. of Korea,9,0,0,9
13330,2019,Ethiopia,Rep. of Korea,154,146,0,300
13331,2019,Gambia,Rep. of Korea,0,76,0,76
13332,2019,Palestinian,Rep. of Korea,7,5,0,12
13333,2019,Ghana,Rep. of Korea,7,301,0,308
13334,2019,Guinea-Bissau,Rep. of Korea,0,11,0,11
13335,2019,Guinea,Rep. of Korea,0,158,0,158
13336,2019,Haiti,Rep. of Korea,0,20,0,20
13337,2019,Cote d'Ivoire,Rep. of Korea,34,30,0,64
13338,2019,India,Rep. of Korea,0,2065,0,2065
13339,2019,Indonesia,Rep. of Korea,0,55,0,55
13340,2019,Iran (Islamic Rep. of),Rep. of Korea,61,75,0,136
13341,2019,Iraq,Rep. of Korea,27,38,0,65
13342,2019,Jordan,Rep. of Korea,7,14,0,21
13343,2019,Kazakhstan,Rep. of Korea,5,3417,0,3422
13344,2019,Kenya,Rep. of Korea,5,44,0,49
13345,2019,Kyrgyzstan,Rep. of Korea,0,166,0,166
13346,2019,Lao People's Dem. Rep.,Rep. of Korea,0,6,0,6
13347,2019,Liberia,Rep. of Korea,12,334,0,346
13348,2019,Libya,Rep. of Korea,7,21,0,28
13349,2019,Sri Lanka,Rep. of Korea,8,393,0,401
13350,2019,Mali,Rep. of Korea,7,91,0,98
13351,2019,Malaysia,Rep. of Korea,0,2287,0,2287
13352,2019,Mongolia,Rep. of Korea,0,506,0,506
13353,2019,Morocco,Rep. of Korea,5,514,0,519
13354,2019,Mozambique,Rep. of Korea,0,11,0,11
13355,2019,Myanmar,Rep. of Korea,363,72,0,435
13356,2019,Nepal,Rep. of Korea,5,431,0,436
13357,2019,Nigeria,Rep. of Korea,10,542,0,552
13358,2019,Pakistan,Rep. of Korea,105,1769,0,1874
13359,2019,Peru,Rep. of Korea,0,9,0,9
13360,2019,Philippines,Rep. of Korea,0,562,0,562
13361,2019,South Africa,Rep. of Korea,0,134,0,134
13362,2019,Russian Federation,Rep. of Korea,13,3628,0,3641
13363,2019,Rwanda,Rep. of Korea,0,26,0,26
13364,2019,Saudi Arabia,Rep. of Korea,0,10,0,10
13365,2019,Senegal,Rep. of Korea,0,112,0,112
13366,2019,Sierra Leone,Rep. of Korea,0,18,0,18
13367,2019,Somalia,Rep. of Korea,6,0,0,6
13368,2019,Viet Nam,Rep. of Korea,0,396,0,396
13369,2019,Sudan,Rep. of Korea,21,47,0,68
13370,2019,South Sudan,Rep. of Korea,0,5,0,5
13371,2019,Eswatini,Rep. of Korea,0,5,0,5
13372,2019,Syrian Arab Rep.,Rep. of Korea,1199,60,0,1259
13373,2019,United Rep. of Tanzania,Rep. of Korea,5,55,0,60
13374,2019,Thailand,Rep. of Korea,9,435,0,444
13375,2019,Tajikistan,Rep. of Korea,0,17,0,17
13376,2019,Togo,Rep. of Korea,0,18,0,18
13377,2019,Tunisia,Rep. of Korea,0,116,0,116
13378,2019,Türkiye,Rep. of Korea,0,405,0,405
13379,2019,Uganda,Rep. of Korea,36,78,0,114
13380,2019,Ukraine,Rep. of Korea,14,64,0,78
13381,2019,United States of America,Rep. of Korea,0,5,0,5
13382,2019,Uzbekistan,Rep. of Korea,9,319,0,328
13383,2019,Venezuela (Bolivarian Republic of),Rep. of Korea,0,14,0,14
13384,2019,Yemen,Rep. of Korea,682,124,0,806
13385,2019,Zimbabwe,Rep. of Korea,0,8,0,8
13387,2019,Afghanistan,Kuwait,0,17,0,17
13388,2019,Egypt,Kuwait,5,19,0,24
13389,2019,Djibouti,Kuwait,0,5,0,5
13390,2019,Eritrea,Kuwait,0,29,0,29
13391,2019,Ethiopia,Kuwait,0,11,0,11
13392,2019,Palestinian,Kuwait,0,5,0,5
13393,2019,Iran (Islamic Rep. of),Kuwait,9,83,0,92
13394,2019,Iraq,Kuwait,343,295,0,638
13395,2019,Jordan,Kuwait,0,6,0,6
13396,2019,Lebanon,Kuwait,0,5,0,5
13397,2019,Sri Lanka,Kuwait,0,6,0,6
13398,2019,Pakistan,Kuwait,0,12,0,12
13399,2019,Philippines,Kuwait,0,5,0,5
13400,2019,Somalia,Kuwait,218,442,0,660
13401,2019,Sudan,Kuwait,0,20,0,20
13402,2019,South Sudan,Kuwait,0,5,0,5
13403,2019,Syrian Arab Rep.,Kuwait,106,100,0,206
13404,2019,Ukraine,Kuwait,0,5,0,5
13405,2019,Yemen,Kuwait,5,9,0,14
13407,2019,Cameroon,Liberia,5,0,0,5
13408,2019,Dem. Rep. of the Congo,Liberia,20,6,0,26
13409,2019,Cote d'Ivoire,Liberia,8152,0,0,8152
13410,2019,Mali,Liberia,19,0,0,19
13411,2019,Nigeria,Liberia,0,5,0,5
13412,2019,Somalia,Liberia,5,0,0,5
13413,2019,Sudan,Liberia,8,0,0,8
13414,2019,Syrian Arab Rep.,Liberia,11,0,0,11
13415,2019,Togo,Liberia,5,0,0,5
13416,2019,Afghanistan,Libya,0,11,0,11
13417,2019,Chad,Libya,6,24,0,30
13418,2019,Congo,Libya,0,5,0,5
13419,2019,Dem. Rep. of the Congo,Libya,0,5,0,5
13420,2019,Eritrea,Libya,375,5126,0,5501
13421,2019,Ethiopia,Libya,14,1040,0,1054
13422,2019,Palestinian,Libya,2015,2853,0,4868
13423,2019,Cote d'Ivoire,Libya,0,5,0,5
13424,2019,Iraq,Libya,810,346,0,1156
13425,2019,Libya,Libya,0,0,355672,0
13426,2019,Rwanda,Libya,5,0,0,5
13427,2019,Somalia,Libya,91,2331,0,2422
13428,2019,Sudan,Libya,797,11963,0,12760
13429,2019,South Sudan,Libya,5,224,0,229
13430,2019,Syrian Arab Rep.,Libya,612,16738,0,17350
13431,2019,Yemen,Libya,0,47,0,47
13432,2019,Afghanistan,Lebanon,18,6,0,24
13433,2019,Algeria,Lebanon,0,6,0,6
13434,2019,Egypt,Lebanon,88,293,0,381
13435,2019,Armenia,Lebanon,0,6,0,6
13436,2019,Bahrain,Lebanon,19,7,0,26
13437,2019,Bangladesh,Lebanon,0,71,0,71
13438,2019,Cameroon,Lebanon,0,33,0,33
13439,2019,Congo,Lebanon,0,8,0,8
13440,2019,Dem. Rep. of the Congo,Lebanon,0,5,0,5
13441,2019,Eritrea,Lebanon,16,29,0,45
13442,2019,Ethiopia,Lebanon,31,691,0,722
13443,2019,Gambia,Lebanon,0,9,0,9
13444,2019,Palestinian,Lebanon,0,5,0,5
13445,2019,Ghana,Lebanon,0,5,0,5
13446,2019,Hungary,Lebanon,0,0,0,0
13447,2019,Cote d'Ivoire,Lebanon,0,10,0,10
13448,2019,India,Lebanon,0,6,0,6
13449,2019,Iran (Islamic Rep. of),Lebanon,35,43,0,78
13450,2019,Iraq,Lebanon,4551,8911,0,13462
13451,2019,Jordan,Lebanon,31,93,0,124
13452,2019,Kenya,Lebanon,0,14,0,14
13453,2019,Kuwait,Lebanon,9,0,0,9
13454,2019,Libya,Lebanon,10,11,0,21
13455,2019,Lebanon,Lebanon,0,0,0,0
13456,2019,Sri Lanka,Lebanon,0,11,0,11
13457,2019,Madagascar,Lebanon,0,7,0,7
13458,2019,Mali,Lebanon,0,5,0,5
13459,2019,Morocco,Lebanon,0,5,0,5
13460,2019,Nigeria,Lebanon,0,63,0,63
13461,2019,Pakistan,Lebanon,6,5,0,11
13462,2019,Philippines,Lebanon,0,23,0,23
13463,2019,Saudi Arabia,Lebanon,13,9,0,22
13464,2019,Somalia,Lebanon,14,8,0,22
13465,2019,Sudan,Lebanon,641,1560,0,2201
13466,2019,South Sudan,Lebanon,32,0,0,32
13467,2019,Syrian Arab Rep.,Lebanon,910586,0,0,910586
13468,2019,Tunisia,Lebanon,11,0,0,11
13469,2019,Türkiye,Lebanon,7,7,0,14
13470,2019,Ukraine,Lebanon,0,0,0,0
13471,2019,Yemen,Lebanon,23,124,0,147
13473,2019,Dem. Rep. of the Congo,Lesotho,92,61,0,153
13474,2019,Eritrea,Lesotho,24,12,0,36
13475,2019,Ethiopia,Lesotho,13,0,0,13
13476,2019,Niger,Lesotho,0,5,0,5
13477,2019,Uganda,Lesotho,9,0,0,9
13478,2019,Zimbabwe,Lesotho,5,0,0,5
13479,2019,Afghanistan,Liechtenstein,5,0,0,5
13480,2019,China,Liechtenstein,27,9,0,36
13481,2019,Dem. Rep. of the Congo,Liechtenstein,6,0,0,6
13482,2019,Eritrea,Liechtenstein,11,0,0,11
13483,2019,Iran (Islamic Rep. of),Liechtenstein,7,5,0,12
13484,2019,Iraq,Liechtenstein,7,0,0,7
13485,2019,Nigeria,Liechtenstein,0,5,0,5
13486,2019,Serbia and Kosovo: S/RES/1244 (1999),Liechtenstein,0,5,0,5
13487,2019,Somalia,Liechtenstein,25,5,0,30
13488,2019,Syrian Arab Rep.,Liechtenstein,32,0,0,32
13489,2019,Ukraine,Liechtenstein,5,0,0,5
13490,2019,Afghanistan,Sri Lanka,160,45,0,205
13491,2019,Bangladesh,Sri Lanka,0,5,0,5
13492,2019,Palestinian,Sri Lanka,5,5,0,10
13493,2019,Iran (Islamic Rep. of),Sri Lanka,23,12,0,35
13494,2019,Sri Lanka,Sri Lanka,0,0,25110,0
13495,2019,Myanmar,Sri Lanka,34,0,0,34
13496,2019,Nigeria,Sri Lanka,0,5,0,5
13497,2019,Pakistan,Sri Lanka,800,284,0,1084
13498,2019,Sudan,Sri Lanka,0,5,0,5
13499,2019,Syrian Arab Rep.,Sri Lanka,5,0,0,5
13500,2019,Yemen,Sri Lanka,14,0,0,14
13501,2019,Afghanistan,Lithuania,236,5,0,241
13502,2019,Armenia,Lithuania,5,5,0,10
13503,2019,Azerbaijan,Lithuania,16,0,0,16
13504,2019,Belarus,Lithuania,35,12,0,47
13505,2019,Cameroon,Lithuania,5,0,0,5
13506,2019,Cuba,Lithuania,5,0,0,5
13507,2019,Eritrea,Lithuania,40,0,0,40
13508,2019,Ethiopia,Lithuania,5,0,0,5
13509,2019,Georgia,Lithuania,5,0,0,5
13510,2019,India,Lithuania,0,6,0,6
13511,2019,Iran (Islamic Rep. of),Lithuania,9,5,0,14
13512,2019,Iraq,Lithuania,65,9,0,74
13513,2019,Sri Lanka,Lithuania,10,0,0,10
13514,2019,Rep. of Moldova,Lithuania,0,5,0,5
13515,2019,Nigeria,Lithuania,5,0,0,5
13516,2019,Pakistan,Lithuania,5,0,0,5
13517,2019,Russian Federation,Lithuania,668,202,0,870
13518,2019,Somalia,Lithuania,22,0,0,22
13519,2019,Syrian Arab Rep.,Lithuania,453,6,0,459
13520,2019,Tajikistan,Lithuania,73,140,0,213
13521,2019,Türkiye,Lithuania,44,8,0,52
13522,2019,Ukraine,Lithuania,64,5,0,69
13523,2019,Uzbekistan,Lithuania,16,0,0,16
13525,2019,Afghanistan,Luxembourg,97,170,0,267
13526,2019,Albania,Luxembourg,70,15,0,85
13527,2019,Algeria,Luxembourg,0,40,0,40
13528,2019,Angola,Luxembourg,13,5,0,18
13529,2019,Egypt,Luxembourg,5,5,0,10
13530,2019,Armenia,Luxembourg,6,0,0,6
13531,2019,Azerbaijan,Luxembourg,15,0,0,15
13532,2019,Benin,Luxembourg,0,10,0,10
13533,2019,Bhutan,Luxembourg,5,0,0,5
13534,2019,Burkina Faso,Luxembourg,0,5,0,5
13535,2019,Belarus,Luxembourg,7,20,0,27
13536,2019,Bosnia and Herzegovina,Luxembourg,7,5,0,12
13537,2019,Chad,Luxembourg,0,5,0,5
13538,2019,China,Luxembourg,5,0,0,5
13539,2019,Cameroon,Luxembourg,10,35,0,45
13540,2019,Congo,Luxembourg,5,0,0,5
13541,2019,Dem. Rep. of the Congo,Luxembourg,38,10,0,48
13542,2019,Colombia,Luxembourg,0,10,0,10
13543,2019,Eritrea,Luxembourg,257,505,0,762
13544,2019,Ethiopia,Luxembourg,47,25,0,72
13545,2019,Gabon,Luxembourg,5,0,0,5
13546,2019,Gambia,Luxembourg,6,5,0,11
13547,2019,Georgia,Luxembourg,0,15,0,15
13548,2019,Guinea,Luxembourg,9,35,0,44
13549,2019,Cote d'Ivoire,Luxembourg,6,15,0,21
13550,2019,Iran (Islamic Rep. of),Luxembourg,163,60,0,223
13551,2019,Iraq,Luxembourg,310,90,0,400
13552,2019,Dem. People's Rep. of Korea,Luxembourg,11,0,0,11
13553,2019,Kuwait,Luxembourg,0,5,0,5
13554,2019,Liberia,Luxembourg,0,5,0,5
13555,2019,Libya,Luxembourg,5,30,0,35
13556,2019,Lebanon,Luxembourg,0,5,0,5
13557,2019,Sri Lanka,Luxembourg,5,0,0,5
13558,2019,Mauritania,Luxembourg,0,5,0,5
13559,2019,Rep. of Moldova,Luxembourg,0,5,0,5
13560,2019,Mexico,Luxembourg,5,0,0,5
13561,2019,Mali,Luxembourg,0,5,0,5
13562,2019,Morocco,Luxembourg,0,30,0,30
13563,2019,Montenegro,Luxembourg,18,5,0,23
13564,2019,Nigeria,Luxembourg,9,20,0,29
13565,2019,Pakistan,Luxembourg,0,5,0,5
13566,2019,Peru,Luxembourg,5,0,0,5
13567,2019,Russian Federation,Luxembourg,20,10,0,30
13568,2019,Rwanda,Luxembourg,19,5,0,24
13569,2019,Serbia and Kosovo: S/RES/1244 (1999),Luxembourg,227,20,0,247
13570,2019,Senegal,Luxembourg,0,10,0,10
13571,2019,Somalia,Luxembourg,41,35,0,76
13572,2019,Sudan,Luxembourg,7,65,0,72
13573,2019,South Sudan,Luxembourg,0,5,0,5
13574,2019,Syrian Arab Rep.,Luxembourg,951,200,0,1151
13575,2019,Tajikistan,Luxembourg,0,5,0,5
13576,2019,Turkmenistan,Luxembourg,5,0,0,5
13577,2019,Togo,Luxembourg,5,10,0,15
13578,2019,Tunisia,Luxembourg,0,25,0,25
13579,2019,Türkiye,Luxembourg,33,80,0,113
13580,2019,Ukraine,Luxembourg,6,25,0,31
13581,2019,Venezuela (Bolivarian Republic of),Luxembourg,15,55,0,70
13582,2019,Yemen,Luxembourg,10,5,0,15
13583,2019,Zambia,Luxembourg,0,5,0,5
13586,2019,Afghanistan,Latvia,66,0,0,66
13587,2019,Egypt,Latvia,5,5,0,10
13588,2019,Azerbaijan,Latvia,11,15,0,26
13589,2019,Bangladesh,Latvia,0,5,0,5
13590,2019,Eritrea,Latvia,35,0,0,35
13591,2019,Palestinian,Latvia,6,0,0,6
13592,2019,Iran (Islamic Rep. of),Latvia,23,5,0,28
13593,2019,Iraq,Latvia,36,0,0,36
13594,2019,Kazakhstan,Latvia,5,0,0,5
13595,2019,Kyrgyzstan,Latvia,5,0,0,5
13596,2019,Lebanon,Latvia,5,0,0,5
13597,2019,Sri Lanka,Latvia,5,0,0,5
13598,2019,Nigeria,Latvia,5,0,0,5
13599,2019,Russian Federation,Latvia,56,6,0,62
13600,2019,Somalia,Latvia,5,0,0,5
13601,2019,Syrian Arab Rep.,Latvia,354,0,0,354
13602,2019,Tajikistan,Latvia,5,5,0,10
13603,2019,Türkiye,Latvia,24,0,0,24
13604,2019,Uzbekistan,Latvia,14,0,0,14
13606,2019,Afghanistan,Madagascar,10,10,0,20
13607,2019,Burundi,Madagascar,5,0,0,5
13608,2019,Dem. Rep. of the Congo,Madagascar,13,0,0,13
13609,2019,Costa Rica,Madagascar,0,5,0,5
13610,2019,Guinea,Madagascar,0,5,0,5
13611,2019,Pakistan,Madagascar,53,90,0,143
13612,2019,Syrian Arab Rep.,Madagascar,5,0,0,5
13613,2019,Türkiye,Madagascar,5,9,0,14
13614,2019,Yemen,Madagascar,22,9,0,31
13615,2019,Benin,Mauritania,0,6,0,6
13616,2019,Burkina Faso,Mauritania,0,25,0,25
13617,2019,Central African Rep.,Mauritania,622,74,0,696
13618,2019,Chad,Mauritania,5,0,0,5
13619,2019,China,Mauritania,5,5,0,10
13620,2019,Cameroon,Mauritania,0,129,0,129
13621,2019,Congo,Mauritania,9,18,0,27
13622,2019,Dem. Rep. of the Congo,Mauritania,32,28,0,60
13623,2019,Ethiopia,Mauritania,6,0,0,6
13624,2019,Gambia,Mauritania,0,14,0,14
13625,2019,Palestinian,Mauritania,60,27,0,87
13626,2019,Ghana,Mauritania,0,15,0,15
13627,2019,Guinea-Bissau,Mauritania,0,19,0,19
13628,2019,Guinea,Mauritania,10,184,0,194
13629,2019,Cote d'Ivoire,Mauritania,264,136,0,400
13630,2019,Iraq,Mauritania,24,0,0,24
13631,2019,Liberia,Mauritania,7,31,0,38
13632,2019,Lebanon,Mauritania,5,0,0,5
13633,2019,Mali,Mauritania,57392,167,0,57559
13634,2019,Morocco,Mauritania,0,7,0,7
13635,2019,Nigeria,Mauritania,11,106,0,117
13636,2019,Russian Federation,Mauritania,0,7,0,7
13637,2019,Senegal,Mauritania,45,124,0,169
13638,2019,Sierra Leone,Mauritania,0,213,0,213
13639,2019,Somalia,Mauritania,0,5,0,5
13640,2019,Sudan,Mauritania,10,20,0,30
13641,2019,Syrian Arab Rep.,Mauritania,355,36,0,391
13642,2019,Togo,Mauritania,23,83,0,106
13643,2019,Türkiye,Mauritania,0,24,0,24
13644,2019,Ukraine,Mauritania,5,0,0,5
13645,2019,Western Sahara,Mauritania,26000,0,0,26000
13646,2019,Yemen,Mauritania,10,37,0,47
13647,2019,Afghanistan,North Macedonia,5,15,0,20
13648,2019,Algeria,North Macedonia,0,7,0,7
13649,2019,Congo,North Macedonia,5,0,0,5
13650,2019,Cuba,North Macedonia,0,5,0,5
13651,2019,Iraq,North Macedonia,0,8,0,8
13652,2019,Morocco,North Macedonia,0,13,0,13
13653,2019,Pakistan,North Macedonia,5,8,0,13
13654,2019,Russian Federation,North Macedonia,0,5,0,5
13655,2019,Serbia and Kosovo: S/RES/1244 (1999),North Macedonia,322,0,0,322
13656,2019,Syrian Arab Rep.,North Macedonia,17,14,0,31
13659,2019,Afghanistan,Rep. of Moldova,24,0,0,24
13660,2019,Armenia,Rep. of Moldova,16,7,0,23
13661,2019,Azerbaijan,Rep. of Moldova,5,7,0,12
13662,2019,Bangladesh,Rep. of Moldova,0,21,0,21
13663,2019,Palestinian,Rep. of Moldova,5,0,0,5
13664,2019,Iran (Islamic Rep. of),Rep. of Moldova,5,0,0,5
13665,2019,Iraq,Rep. of Moldova,21,5,0,26
13666,2019,Kyrgyzstan,Rep. of Moldova,11,0,0,11
13667,2019,Libya,Rep. of Moldova,0,5,0,5
13668,2019,Russian Federation,Rep. of Moldova,5,5,0,10
13669,2019,Sudan,Rep. of Moldova,9,0,0,9
13670,2019,Syrian Arab Rep.,Rep. of Moldova,210,5,0,215
13671,2019,Tajikistan,Rep. of Moldova,8,0,0,8
13672,2019,Turkmenistan,Rep. of Moldova,5,0,0,5
13673,2019,Türkiye,Rep. of Moldova,26,29,0,55
13674,2019,Ukraine,Rep. of Moldova,53,5,0,58
13675,2019,Uzbekistan,Rep. of Moldova,6,5,0,11
13676,2019,Yemen,Rep. of Moldova,8,0,0,8
13678,2019,Albania,Mexico,8,0,0,8
13679,2019,Algeria,Mexico,5,0,0,5
13680,2019,Angola,Mexico,5,179,0,184
13681,2019,Egypt,Mexico,5,0,0,5
13682,2019,Argentina,Mexico,5,29,0,34
13683,2019,Benin,Mexico,0,9,0,9
13684,2019,Bangladesh,Mexico,6,5,0,11
13685,2019,Burkina Faso,Mexico,0,14,0,14
13686,2019,Bolivia (Plurinational State of),Mexico,0,6,0,6
13687,2019,Brazil,Mexico,0,543,0,543
13688,2019,Belize,Mexico,6,24,0,30
13689,2019,Cambodia,Mexico,24,44,0,68
13690,2019,China,Mexico,5,5,0,10
13691,2019,Chile,Mexico,5,399,0,404
13692,2019,Cameroon,Mexico,0,480,0,480
13693,2019,Congo,Mexico,21,31,0,52
13694,2019,Dem. Rep. of the Congo,Mexico,62,222,0,284
13695,2019,Colombia,Mexico,351,628,0,979
13696,2019,Costa Rica,Mexico,0,43,0,43
13697,2019,Cuba,Mexico,325,6746,0,7071
13698,2019,Dominican Rep.,Mexico,12,39,0,51
13699,2019,Ecuador,Mexico,6,79,0,85
13700,2019,Eritrea,Mexico,7,61,0,68
13701,2019,Ethiopia,Mexico,5,13,0,18
13702,2019,France,Mexico,0,5,0,5
13703,2019,Gambia,Mexico,0,5,0,5
13704,2019,Palestinian,Mexico,5,0,0,5
13705,2019,Ghana,Mexico,13,105,0,118
13706,2019,Guatemala,Mexico,1250,3631,0,4881
13707,2019,Guinea,Mexico,5,50,0,55
13708,2019,Guyana,Mexico,0,5,0,5
13709,2019,Haiti,Mexico,221,5566,0,5787
13710,2019,Honduras,Mexico,9257,29507,0,38764
13711,2019,Cote d'Ivoire,Mexico,5,5,0,10
13712,2019,India,Mexico,12,54,0,66
13713,2019,Iran (Islamic Rep. of),Mexico,39,6,0,45
13714,2019,Iraq,Mexico,43,5,0,48
13715,2019,Italy,Mexico,0,5,0,5
13716,2019,Jamaica,Mexico,6,5,0,11
13717,2019,Kyrgyzstan,Mexico,0,11,0,11
13718,2019,Rep. of Korea,Mexico,0,5,0,5
13719,2019,Sri Lanka,Mexico,20,45,0,65
13720,2019,Mauritania,Mexico,0,7,0,7
13721,2019,Mali,Mexico,0,5,0,5
13722,2019,Nepal,Mexico,0,9,0,9
13723,2019,Nicaragua,Mexico,545,2306,0,2851
13724,2019,Nigeria,Mexico,36,23,0,59
13725,2019,Pakistan,Mexico,10,11,0,21
13726,2019,Panama,Mexico,5,11,0,16
13727,2019,Peru,Mexico,16,24,0,40
13728,2019,Portugal,Mexico,5,5,0,10
13729,2019,Romania,Mexico,7,0,0,7
13730,2019,South Africa,Mexico,0,11,0,11
13731,2019,Russian Federation,Mexico,39,24,0,63
13732,2019,El Salvador,Mexico,7244,9563,0,16807
13733,2019,Sierra Leone,Mexico,5,10,0,15
13734,2019,Somalia,Mexico,0,6,0,6
13735,2019,Spain,Mexico,0,10,0,10
13736,2019,Sudan,Mexico,0,5,0,5
13737,2019,Syrian Arab Rep.,Mexico,29,8,0,37
13738,2019,Togo,Mexico,0,9,0,9
13739,2019,Türkiye,Mexico,8,0,0,8
13740,2019,Uganda,Mexico,0,66,0,66
13741,2019,Ukraine,Mexico,17,5,0,22
13742,2019,Uruguay,Mexico,0,15,0,15
13743,2019,United States of America,Mexico,18,60,0,78
13744,2019,Venezuela (Bolivarian Republic of),Mexico,8781,8614,0,17395
13745,2019,Yemen,Mexico,13,30,0,43
13747,2019,Burundi,Mali,12,6,0,18
13748,2019,Bangladesh,Mali,0,32,0,32
13749,2019,Burkina Faso,Mali,8457,72,0,8529
13750,2019,Central African Rep.,Mali,971,328,0,1299
13751,2019,Cameroon,Mali,5,7,0,12
13752,2019,Congo,Mali,30,5,0,35
13753,2019,Dem. Rep. of the Congo,Mali,271,60,0,331
13754,2019,Eritrea,Mali,5,0,0,5
13755,2019,Guinea,Mali,0,5,0,5
13756,2019,Cote d'Ivoire,Mali,515,43,0,558
13757,2019,Mauritania,Mali,15316,0,0,15316
13758,2019,Mali,Mali,0,0,207751,0
13759,2019,Niger,Mali,1024,0,0,1024
13760,2019,Nigeria,Mali,0,5,0,5
13761,2019,Pakistan,Mali,10,0,0,10
13762,2019,Rwanda,Mali,7,10,0,17
13763,2019,Syrian Arab Rep.,Mali,20,413,0,433
13764,2019,Togo,Mali,21,5,0,26
13765,2019,Türkiye,Mali,8,13,0,21
13766,2019,Afghanistan,Malaysia,1352,1126,0,2478
13767,2019,Algeria,Malaysia,0,7,0,7
13768,2019,Egypt,Malaysia,15,79,0,94
13769,2019,Australia,Malaysia,5,0,0,5
13770,2019,Bangladesh,Malaysia,39,17,0,56
13771,2019,Cambodia,Malaysia,80,9,0,89
13772,2019,Central African Rep.,Malaysia,5,0,0,5
13773,2019,China,Malaysia,44,7,0,51
13774,2019,Cameroon,Malaysia,5,21,0,26
13775,2019,Congo,Malaysia,0,5,0,5
13776,2019,Dem. Rep. of the Congo,Malaysia,0,7,0,7
13777,2019,Eritrea,Malaysia,7,20,0,27
13778,2019,Ethiopia,Malaysia,11,11,0,22
13779,2019,Palestinian,Malaysia,226,582,0,808
13780,2019,United Kingdom of Great Britain and Northern Ireland,Malaysia,6,0,0,6
13781,2019,Guinea,Malaysia,5,27,0,32
13782,2019,Cote d'Ivoire,Malaysia,5,0,0,5
13783,2019,India,Malaysia,5,11,0,16
13784,2019,Indonesia,Malaysia,996,8,0,1004
13785,2019,Iran (Islamic Rep. of),Malaysia,246,198,0,444
13786,2019,Iraq,Malaysia,435,876,0,1311
13787,2019,Jordan,Malaysia,0,6,0,6
13788,2019,Lao People's Dem. Rep.,Malaysia,0,5,0,5
13789,2019,Liberia,Malaysia,19,9,0,28
13790,2019,Libya,Malaysia,10,21,0,31
13791,2019,Lebanon,Malaysia,5,7,0,12
13792,2019,Sri Lanka,Malaysia,857,1046,0,1903
13793,2019,Mali,Malaysia,5,0,0,5
13794,2019,Morocco,Malaysia,5,0,0,5
13795,2019,Myanmar,Malaysia,119231,34546,0,153777
13796,2019,Nepal,Malaysia,11,0,0,11
13797,2019,Nigeria,Malaysia,5,32,0,37
13798,2019,Pakistan,Malaysia,3033,3574,0,6607
13799,2019,Philippines,Malaysia,24,0,0,24
13800,2019,Russian Federation,Malaysia,6,0,0,6
13801,2019,Sierra Leone,Malaysia,11,43,0,54
13802,2019,Somalia,Malaysia,1540,1754,0,3294
13803,2019,Viet Nam,Malaysia,5,0,0,5
13804,2019,Sudan,Malaysia,158,156,0,314
13805,2019,South Sudan,Malaysia,13,43,0,56
13806,2019,Syrian Arab Rep.,Malaysia,425,2861,0,3286
13807,2019,Thailand,Malaysia,29,22,0,51
13808,2019,Uganda,Malaysia,5,8,0,13
13809,2019,United States of America,Malaysia,7,0,0,7
13810,2019,Uzbekistan,Malaysia,0,8,0,8
13811,2019,Yemen,Malaysia,206,3462,0,3668
13812,2019,Zimbabwe,Malaysia,5,5,0,10
13814,2019,Burundi,Malawi,2592,7487,0,10079
13815,2019,Dem. Rep. of the Congo,Malawi,9264,18509,0,27773
13816,2019,Ethiopia,Malawi,8,49,0,57
13817,2019,Cote d'Ivoire,Malawi,5,0,0,5
13818,2019,Mozambique,Malawi,0,5,0,5
13819,2019,Rwanda,Malawi,2163,4117,0,6280
13820,2019,Somalia,Malawi,50,52,0,102
13821,2019,South Sudan,Malawi,5,0,0,5
13822,2019,United Rep. of Tanzania,Malawi,0,6,0,6
13823,2019,Türkiye,Malawi,0,47,0,47
13824,2019,Uganda,Malawi,0,14,0,14
13825,2019,Zimbabwe,Malawi,0,7,0,7
13826,2019,China,Mongolia,0,5,0,5
13827,2019,Mongolia,Mongolia,0,0,0,0
13829,2019,Afghanistan,Morocco,5,6,0,11
13830,2019,Algeria,Morocco,9,5,0,14
13831,2019,Egypt,Morocco,0,5,0,5
13832,2019,Burundi,Morocco,0,5,0,5
13833,2019,Benin,Morocco,0,5,0,5
13834,2019,Bangladesh,Morocco,0,132,0,132
13835,2019,Burkina Faso,Morocco,0,25,0,25
13836,2019,Central African Rep.,Morocco,560,29,0,589
13837,2019,Chad,Morocco,5,14,0,19
13838,2019,Cameroon,Morocco,110,687,0,797
13839,2019,Congo,Morocco,18,45,0,63
13840,2019,Dem. Rep. of the Congo,Morocco,172,112,0,284
13841,2019,Eritrea,Morocco,15,7,0,22
13842,2019,Gambia,Morocco,0,18,0,18
13843,2019,Palestinian,Morocco,183,0,0,183
13844,2019,Ghana,Morocco,0,11,0,11
13845,2019,Guinea-Bissau,Morocco,0,5,0,5
13846,2019,Guinea,Morocco,66,732,0,798
13847,2019,Cote d'Ivoire,Morocco,335,457,0,792
13848,2019,India,Morocco,0,5,0,5
13849,2019,Iraq,Morocco,137,6,0,143
13850,2019,Liberia,Morocco,6,36,0,42
13851,2019,Libya,Morocco,32,28,0,60
13852,2019,Lebanon,Morocco,6,8,0,14
13853,2019,Mauritania,Morocco,6,5,0,11
13854,2019,Mali,Morocco,31,133,0,164
13855,2019,Niger,Morocco,0,5,0,5
13856,2019,Nigeria,Morocco,17,277,0,294
13857,2019,Pakistan,Morocco,10,9,0,19
13858,2019,Senegal,Morocco,82,164,0,246
13859,2019,Sierra Leone,Morocco,0,44,0,44
13860,2019,Somalia,Morocco,8,10,0,18
13861,2019,Sudan,Morocco,18,24,0,42
13862,2019,South Sudan,Morocco,292,0,0,292
13863,2019,Syrian Arab Rep.,Morocco,3676,0,0,3676
13864,2019,Togo,Morocco,0,7,0,7
13865,2019,Tunisia,Morocco,0,5,0,5
13866,2019,Türkiye,Morocco,0,13,0,13
13867,2019,Yemen,Morocco,843,0,0,843
13868,2019,Angola,Mozambique,5,0,0,5
13869,2019,Burundi,Mozambique,906,7482,0,8388
13870,2019,Central African Rep.,Mozambique,0,5,0,5
13871,2019,Congo,Mozambique,15,34,0,49
13872,2019,Dem. Rep. of the Congo,Mozambique,2934,6786,0,9720
13873,2019,Comoros,Mozambique,0,347,0,347
13874,2019,Eritrea,Mozambique,0,25,0,25
13875,2019,Ethiopia,Mozambique,8,15,0,23
13876,2019,Guinea,Mozambique,0,5,0,5
13877,2019,Mozambique,Mozambique,0,0,180516,0
13878,2019,Rwanda,Mozambique,687,2972,0,3659
13879,2019,Somalia,Mozambique,148,3239,0,3387
13880,2019,Sudan,Mozambique,5,30,0,35
13881,2019,Uganda,Mozambique,5,35,0,40
13882,2019,Afghanistan,Malta,0,5,0,5
13883,2019,Algeria,Malta,0,15,0,15
13884,2019,Egypt,Malta,74,60,0,134
13885,2019,Armenia,Malta,0,5,0,5
13886,2019,Bangladesh,Malta,12,74,0,86
13887,2019,Burkina Faso,Malta,5,11,0,16
13888,2019,Belarus,Malta,9,0,0,9
13889,2019,Central African Rep.,Malta,0,5,0,5
13890,2019,Chad,Malta,8,48,0,56
13891,2019,China,Malta,17,0,0,17
13892,2019,Cameroon,Malta,10,12,0,22
13893,2019,Dem. Rep. of the Congo,Malta,5,0,0,5
13894,2019,Colombia,Malta,0,12,0,12
13895,2019,Eritrea,Malta,805,187,0,992
13896,2019,Ethiopia,Malta,175,37,0,212
13897,2019,Gambia,Malta,28,189,0,217
13898,2019,Palestinian,Malta,70,24,0,94
13899,2019,Georgia,Malta,5,19,0,24
13900,2019,Ghana,Malta,8,43,0,51
13901,2019,Guinea-Bissau,Malta,0,6,0,6
13902,2019,Guinea,Malta,0,73,0,73
13903,2019,Cote d'Ivoire,Malta,12,118,0,130
13904,2019,Iran (Islamic Rep. of),Malta,31,7,0,38
13905,2019,Iraq,Malta,84,5,0,89
13906,2019,Jordan,Malta,5,0,0,5
13907,2019,Liberia,Malta,6,5,0,11
13908,2019,Libya,Malta,2748,357,0,3105
13909,2019,Lebanon,Malta,0,5,0,5
13910,2019,Sri Lanka,Malta,7,10,0,17
13911,2019,North Macedonia,Malta,5,5,0,10
13912,2019,Mali,Malta,18,74,0,92
13913,2019,Morocco,Malta,31,59,0,90
13914,2019,Nepal,Malta,0,19,0,19
13915,2019,Niger,Malta,0,28,0,28
13916,2019,Nigeria,Malta,124,102,0,226
13917,2019,Pakistan,Malta,58,90,0,148
13918,2019,Peru,Malta,0,5,0,5
13919,2019,Russian Federation,Malta,18,5,0,23
13920,2019,El Salvador,Malta,0,5,0,5
13921,2019,Saudi Arabia,Malta,5,0,0,5
13922,2019,Serbia and Kosovo: S/RES/1244 (1999),Malta,7,5,0,12
13923,2019,Senegal,Malta,5,84,0,89
13924,2019,Sierra Leone,Malta,5,20,0,25
13925,2019,Somalia,Malta,1780,145,0,1925
13926,2019,Sudan,Malta,199,967,0,1166
13927,2019,South Sudan,Malta,22,62,0,84
13928,2019,Syrian Arab Rep.,Malta,1706,482,0,2188
13929,2019,Togo,Malta,5,10,0,15
13930,2019,Tunisia,Malta,13,26,0,39
13931,2019,Türkiye,Malta,5,16,0,21
13932,2019,Uganda,Malta,0,5,0,5
13933,2019,Ukraine,Malta,142,59,0,201
13934,2019,Uzbekistan,Malta,0,5,0,5
13935,2019,Venezuela (Bolivarian Republic of),Malta,5,65,0,70
13936,2019,Yemen,Malta,0,6,0,6
13937,2019,Zimbabwe,Malta,5,0,0,5
13940,2019,Afghanistan,Montenegro,0,50,0,50
13941,2019,Algeria,Montenegro,0,48,0,48
13942,2019,Egypt,Montenegro,0,5,0,5
13943,2019,Belarus,Montenegro,5,0,0,5
13944,2019,Bosnia and Herzegovina,Montenegro,16,0,0,16
13945,2019,Cuba,Montenegro,0,5,0,5
13946,2019,Palestinian,Montenegro,0,5,0,5
13947,2019,Ghana,Montenegro,5,0,0,5
13948,2019,Croatia,Montenegro,10,0,0,10
13949,2019,Iran (Islamic Rep. of),Montenegro,0,48,0,48
13950,2019,Iraq,Montenegro,0,5,0,5
13951,2019,Libya,Montenegro,0,6,0,6
13952,2019,Morocco,Montenegro,0,261,0,261
13953,2019,Pakistan,Montenegro,0,9,0,9
13954,2019,Russian Federation,Montenegro,0,12,0,12
13955,2019,Serbia and Kosovo: S/RES/1244 (1999),Montenegro,610,5,0,615
13956,2019,Syrian Arab Rep.,Montenegro,0,14,0,14
13957,2019,Türkiye,Montenegro,0,11,0,11
13958,2019,Yemen,Montenegro,7,0,0,7
13961,2019,Dem. Rep. of the Congo,Mauritius,10,0,0,10
13962,2019,Pakistan,Mauritius,5,0,0,5
13963,2019,Philippines,Mauritius,0,5,0,5
13964,2019,South Africa,Mauritius,5,0,0,5
13965,2019,Myanmar,Myanmar,0,0,312018,0
13967,2019,Burundi,Namibia,273,119,0,392
13968,2019,Central African Rep.,Namibia,5,15,0,20
13969,2019,Cameroon,Namibia,20,14,0,34
13970,2019,Congo,Namibia,5,5,0,10
13971,2019,Dem. Rep. of the Congo,Namibia,2685,1649,0,4334
13972,2019,Niger,Namibia,0,5,0,5
13973,2019,Rwanda,Namibia,121,32,0,153
13974,2019,Somalia,Namibia,5,6,0,11
13975,2019,Sudan,Namibia,6,0,0,6
13976,2019,South Sudan,Namibia,0,5,0,5
13977,2019,Uganda,Namibia,5,5,0,10
13978,2019,Zimbabwe,Namibia,57,51,0,108
13979,2019,Afghanistan,Nepal,51,0,0,51
13980,2019,Bangladesh,Nepal,5,0,0,5
13981,2019,Bhutan,Nepal,6396,0,0,6396
13982,2019,India,Nepal,0,0,0,0
13983,2019,Iran (Islamic Rep. of),Nepal,5,5,0,10
13984,2019,Sri Lanka,Nepal,20,6,0,26
13985,2019,Myanmar,Nepal,351,11,0,362
13986,2019,Nepal,Nepal,0,0,0,0
13987,2019,Pakistan,Nepal,176,30,0,206
13988,2019,Somalia,Nepal,26,0,0,26
13989,2019,Yemen,Nepal,0,5,0,5
13991,2019,Afghanistan,Netherlands,5815,543,0,6358
13992,2019,Albania,Netherlands,5,12,0,17
13993,2019,Algeria,Netherlands,15,293,0,308
13994,2019,Angola,Netherlands,41,30,0,71
13995,2019,Egypt,Netherlands,205,189,0,394
13996,2019,Argentina,Netherlands,5,5,0,10
13997,2019,Armenia,Netherlands,366,48,0,414
13998,2019,Azerbaijan,Netherlands,229,126,0,355
13999,2019,Bahrain,Netherlands,9,0,0,9
14000,2019,Burundi,Netherlands,128,13,0,141
14001,2019,Benin,Netherlands,5,5,0,10
14002,2019,Bangladesh,Netherlands,34,15,0,49
14003,2019,Bhutan,Netherlands,144,0,0,144
14004,2019,Burkina Faso,Netherlands,14,5,0,19
14005,2019,Belarus,Netherlands,45,65,0,110
14006,2019,Bosnia and Herzegovina,Netherlands,0,9,0,9
14007,2019,Cambodia,Netherlands,17,0,0,17
14008,2019,Central African Rep.,Netherlands,7,0,0,7
14009,2019,Chad,Netherlands,5,7,0,12
14010,2019,China,Netherlands,1004,153,0,1157
14011,2019,Cameroon,Netherlands,66,34,0,100
14012,2019,Congo,Netherlands,375,31,0,406
14013,2019,Dem. Rep. of the Congo,Netherlands,147,10,0,157
14014,2019,Colombia,Netherlands,19,146,0,165
14015,2019,Cuba,Netherlands,28,28,0,56
14016,2019,Dominican Rep.,Netherlands,0,6,0,6
14017,2019,Ecuador,Netherlands,8,0,0,8
14018,2019,Eritrea,Netherlands,14809,511,0,15320
14019,2019,Ethiopia,Netherlands,456,90,0,546
14020,2019,Gambia,Netherlands,32,229,0,261
14021,2019,Palestinian,Netherlands,160,42,0,202
14022,2019,Georgia,Netherlands,32,37,0,69
14023,2019,Ghana,Netherlands,7,20,0,27
14024,2019,Guinea-Bissau,Netherlands,0,9,0,9
14025,2019,Guinea,Netherlands,567,162,0,729
14026,2019,Guyana,Netherlands,0,5,0,5
14027,2019,Honduras,Netherlands,7,10,0,17
14028,2019,Cote d'Ivoire,Netherlands,237,30,0,267
14029,2019,India,Netherlands,6,19,0,25
14030,2019,Indonesia,Netherlands,0,11,0,11
14031,2019,Iran (Islamic Rep. of),Netherlands,4783,2490,0,7273
14032,2019,Iraq,Netherlands,8423,675,0,9098
14033,2019,Jamaica,Netherlands,190,10,0,200
14034,2019,Jordan,Netherlands,5,122,0,127
14035,2019,Kazakhstan,Netherlands,39,30,0,69
14036,2019,Kenya,Netherlands,37,13,0,50
14037,2019,Kyrgyzstan,Netherlands,20,5,0,25
14038,2019,Dem. People's Rep. of Korea,Netherlands,39,0,0,39
14039,2019,Kuwait,Netherlands,5,0,0,5
14040,2019,Lao People's Dem. Rep.,Netherlands,27,0,0,27
14041,2019,Liberia,Netherlands,54,20,0,74
14042,2019,Libya,Netherlands,278,164,0,442
14043,2019,Lebanon,Netherlands,50,107,0,157
14044,2019,Sri Lanka,Netherlands,543,47,0,590
14045,2019,Mauritania,Netherlands,5,5,0,10
14046,2019,North Macedonia,Netherlands,0,30,0,30
14047,2019,Rep. of Moldova,Netherlands,0,233,0,233
14048,2019,Mexico,Netherlands,0,5,0,5
14049,2019,Mali,Netherlands,17,12,0,29
14050,2019,Malaysia,Netherlands,7,0,0,7
14051,2019,Malawi,Netherlands,5,0,0,5
14052,2019,Mongolia,Netherlands,37,6,0,43
14053,2019,Morocco,Netherlands,49,259,0,308
14054,2019,Myanmar,Netherlands,495,40,0,535
14055,2019,Namibia,Netherlands,5,0,0,5
14056,2019,Nepal,Netherlands,192,7,0,199
14057,2019,Niger,Netherlands,6,31,0,37
14058,2019,Nicaragua,Netherlands,0,49,0,49
14059,2019,Nigeria,Netherlands,289,735,0,1024
14060,2019,Pakistan,Netherlands,456,375,0,831
14061,2019,Peru,Netherlands,9,9,0,18
14062,2019,South Africa,Netherlands,0,6,0,6
14063,2019,Russian Federation,Netherlands,300,185,0,485
14064,2019,Rwanda,Netherlands,51,15,0,66
14065,2019,El Salvador,Netherlands,0,34,0,34
14066,2019,Saudi Arabia,Netherlands,21,10,0,31
14067,2019,Serbia and Kosovo: S/RES/1244 (1999),Netherlands,23,28,0,51
14068,2019,Senegal,Netherlands,26,41,0,67
14069,2019,Sierra Leone,Netherlands,405,91,0,496
14070,2019,Somalia,Netherlands,13007,196,0,13203
14071,2019,Viet Nam,Netherlands,5,12,0,17
14072,2019,Sudan,Netherlands,792,131,0,923
14073,2019,Suriname,Netherlands,0,5,0,5
14074,2019,South Sudan,Netherlands,0,5,0,5
14075,2019,Syrian Arab Rep.,Netherlands,31694,3092,0,34786
14076,2019,United Rep. of Tanzania,Netherlands,5,17,0,22
14077,2019,Tajikistan,Netherlands,30,45,0,75
14078,2019,Turkmenistan,Netherlands,5,9,0,14
14079,2019,Timor-Leste,Netherlands,0,8,0,8
14080,2019,Togo,Netherlands,24,5,0,29
14081,2019,Trinidad and Tobago,Netherlands,77,12,0,89
14082,2019,Tunisia,Netherlands,19,80,0,99
14083,2019,Türkiye,Netherlands,1736,1308,0,3044
14084,2019,Uganda,Netherlands,488,251,0,739
14085,2019,Ukraine,Netherlands,20,59,0,79
14086,2019,United States of America,Netherlands,17,13,0,30
14087,2019,Uzbekistan,Netherlands,31,16,0,47
14088,2019,Venezuela (Bolivarian Republic of),Netherlands,13,207,0,220
14089,2019,Yemen,Netherlands,791,546,0,1337
14090,2019,Zambia,Netherlands,8,0,0,8
14091,2019,Zimbabwe,Netherlands,26,24,0,50
14094,2019,Burkina Faso,Niger,0,0,0,0
14095,2019,Central African Rep.,Niger,145,23,0,168
14096,2019,Chad,Niger,166,1291,0,1457
14097,2019,Cameroon,Niger,5,153,0,158
14098,2019,Congo,Niger,5,0,0,5
14099,2019,Dem. Rep. of the Congo,Niger,80,19,0,99
14100,2019,Eritrea,Niger,284,149,0,433
14101,2019,Ethiopia,Niger,38,14,0,52
14102,2019,Guinea,Niger,0,12,0,12
14103,2019,Cote d'Ivoire,Niger,38,5,0,43
14104,2019,Iraq,Niger,6,0,0,6
14105,2019,Libya,Niger,7,6,0,13
14106,2019,Mali,Niger,58000,74,0,58074
14107,2019,Niger,Niger,0,0,191902,0
14108,2019,Nigeria,Niger,120621,34699,0,155320
14109,2019,Pakistan,Niger,0,8,0,8
14110,2019,Rwanda,Niger,18,0,0,18
14111,2019,Somalia,Niger,163,64,0,227
14112,2019,Sudan,Niger,409,1362,0,1771
14113,2019,South Sudan,Niger,0,7,0,7
14114,2019,Syrian Arab Rep.,Niger,7,0,0,7
14115,2019,Togo,Niger,5,5,0,10
14116,2019,Yemen,Niger,0,5,0,5
14117,2019,Colombia,Nicaragua,6,0,0,6
14118,2019,Cuba,Nicaragua,15,0,0,15
14119,2019,Guatemala,Nicaragua,8,0,0,8
14120,2019,Honduras,Nicaragua,74,26,0,100
14121,2019,El Salvador,Nicaragua,219,100,0,319
14122,2019,Afghanistan,Nigeria,5,0,0,5
14123,2019,Benin,Nigeria,5,0,0,5
14124,2019,Central African Rep.,Nigeria,460,212,0,672
14125,2019,Chad,Nigeria,88,22,0,110
14126,2019,Cameroon,Nigeria,52066,424,0,52490
14127,2019,Congo,Nigeria,5,5,0,10
14128,2019,Dem. Rep. of the Congo,Nigeria,635,114,0,749
14129,2019,Eritrea,Nigeria,30,5,0,35
14130,2019,Ethiopia,Nigeria,6,0,0,6
14131,2019,Palestinian,Nigeria,11,5,0,16
14132,2019,Ghana,Nigeria,5,5,0,10
14133,2019,Guinea-Bissau,Nigeria,5,0,0,5
14134,2019,Guinea,Nigeria,17,5,0,22
14135,2019,Cote d'Ivoire,Nigeria,128,6,0,134
14136,2019,Liberia,Nigeria,9,5,0,14
14137,2019,Lebanon,Nigeria,0,7,0,7
14138,2019,Sri Lanka,Nigeria,5,0,0,5
14139,2019,Mali,Nigeria,144,18,0,162
14140,2019,Niger,Nigeria,6,0,0,6
14141,2019,Nigeria,Nigeria,0,0,2195779,0
14142,2019,Sierra Leone,Nigeria,23,5,0,28
14143,2019,Sudan,Nigeria,47,5,0,52
14144,2019,Syrian Arab Rep.,Nigeria,263,132,0,395
14145,2019,Togo,Nigeria,20,20,0,40
14146,2019,Türkiye,Nigeria,174,37,0,211
14147,2019,Afghanistan,Norway,5108,81,0,5189
14148,2019,Albania,Norway,20,26,0,46
14149,2019,Algeria,Norway,6,0,0,6
14150,2019,Angola,Norway,14,7,0,21
14151,2019,Egypt,Norway,59,10,0,69
14152,2019,Armenia,Norway,5,0,0,5
14153,2019,Azerbaijan,Norway,27,5,0,32
14154,2019,Burundi,Norway,51,0,0,51
14155,2019,Bangladesh,Norway,8,0,0,8
14156,2019,Belarus,Norway,5,0,0,5
14157,2019,Bulgaria,Norway,7,0,0,7
14158,2019,Central African Rep.,Norway,6,0,0,6
14159,2019,Chad,Norway,5,0,0,5
14160,2019,China,Norway,565,5,0,570
14161,2019,Cameroon,Norway,24,10,0,34
14162,2019,Congo,Norway,5,0,0,5
14163,2019,Dem. Rep. of the Congo,Norway,154,0,0,154
14164,2019,Colombia,Norway,12,26,0,38
14165,2019,Djibouti,Norway,5,0,0,5
14166,2019,Eritrea,Norway,14038,80,0,14118
14167,2019,Ethiopia,Norway,1732,24,0,1756
14168,2019,Gambia,Norway,16,0,0,16
14169,2019,Georgia,Norway,5,10,0,15
14170,2019,Ghana,Norway,7,0,0,7
14171,2019,Guinea-Bissau,Norway,5,0,0,5
14172,2019,Greece,Norway,0,5,0,5
14173,2019,Guatemala,Norway,7,0,0,7
14174,2019,Guinea,Norway,48,0,0,48
14175,2019,Honduras,Norway,5,0,0,5
14176,2019,Cote d'Ivoire,Norway,13,5,0,18
14177,2019,Iran (Islamic Rep. of),Norway,1810,171,0,1981
14178,2019,Iraq,Norway,1634,82,0,1716
14179,2019,Israel,Norway,8,0,0,8
14180,2019,Jordan,Norway,7,0,0,7
14181,2019,Kazakhstan,Norway,15,0,0,15
14182,2019,Kenya,Norway,9,0,0,9
14183,2019,Kyrgyzstan,Norway,13,5,0,18
14184,2019,Liberia,Norway,13,0,0,13
14185,2019,Libya,Norway,61,7,0,68
14186,2019,Lebanon,Norway,25,0,0,25
14187,2019,Sri Lanka,Norway,109,5,0,114
14188,2019,Mauritania,Norway,5,0,0,5
14189,2019,Rep. of Moldova,Norway,5,0,0,5
14190,2019,Mali,Norway,8,0,0,8
14191,2019,Malaysia,Norway,5,5,0,10
14192,2019,Mongolia,Norway,5,0,0,5
14193,2019,Morocco,Norway,27,10,0,37
14194,2019,Montenegro,Norway,5,0,0,5
14195,2019,Myanmar,Norway,109,0,0,109
14196,2019,Nepal,Norway,5,0,0,5
14197,2019,Nicaragua,Norway,0,19,0,19
14198,2019,Nigeria,Norway,163,5,0,168
14199,2019,Pakistan,Norway,96,21,0,117
14200,2019,Peru,Norway,0,10,0,10
14201,2019,Philippines,Norway,6,0,0,6
14202,2019,Russian Federation,Norway,587,50,0,637
14203,2019,Rwanda,Norway,36,6,0,42
14204,2019,El Salvador,Norway,10,0,0,10
14205,2019,Saudi Arabia,Norway,8,0,0,8
14206,2019,Serbia and Kosovo: S/RES/1244 (1999),Norway,51,11,0,62
14207,2019,Sierra Leone,Norway,12,0,0,12
14208,2019,Somalia,Norway,6518,40,0,6558
14209,2019,Viet Nam,Norway,42,5,0,47
14210,2019,Sudan,Norway,1906,15,0,1921
14211,2019,South Sudan,Norway,17,0,0,17
14212,2019,Syrian Arab Rep.,Norway,14359,252,0,14611
14213,2019,Tajikistan,Norway,5,0,0,5
14214,2019,Turkmenistan,Norway,5,0,0,5
14215,2019,Tunisia,Norway,5,5,0,10
14216,2019,Türkiye,Norway,1021,300,0,1321
14217,2019,Uganda,Norway,120,7,0,127
14218,2019,Ukraine,Norway,10,15,0,25
14219,2019,Uzbekistan,Norway,191,0,0,191
14220,2019,Venezuela (Bolivarian Republic of),Norway,15,24,0,39
14221,2019,Yemen,Norway,219,19,0,238
14222,2019,Zambia,Norway,5,0,0,5
14223,2019,Zimbabwe,Norway,12,0,0,12
14225,2019,Afghanistan,Nauru,25,5,0,30
14226,2019,Bangladesh,Nauru,14,27,0,41
14227,2019,India,Nauru,0,11,0,11
14228,2019,Indonesia,Nauru,0,5,0,5
14229,2019,Iran (Islamic Rep. of),Nauru,345,209,0,554
14230,2019,Iraq,Nauru,39,13,0,52
14231,2019,Kuwait,Nauru,5,0,0,5
14232,2019,Lebanon,Nauru,14,0,0,14
14233,2019,Sri Lanka,Nauru,73,51,0,124
14234,2019,Malaysia,Nauru,0,5,0,5
14235,2019,Myanmar,Nauru,66,13,0,79
14236,2019,Nepal,Nauru,0,15,0,15
14237,2019,Pakistan,Nauru,42,26,0,68
14238,2019,Somalia,Nauru,78,10,0,88
14239,2019,Sudan,Nauru,11,0,0,11
14240,2019,Syrian Arab Rep.,Nauru,0,5,0,5
14242,2019,Afghanistan,New Zealand,46,31,0,77
14243,2019,Algeria,New Zealand,5,0,0,5
14244,2019,Egypt,New Zealand,35,5,0,40
14245,2019,Bahrain,New Zealand,26,0,0,26
14246,2019,Bangladesh,New Zealand,7,21,0,28
14247,2019,Brazil,New Zealand,0,7,0,7
14248,2019,China,New Zealand,228,74,0,302
14249,2019,Chile,New Zealand,5,7,0,12
14250,2019,Cameroon,New Zealand,5,0,0,5
14251,2019,Dem. Rep. of the Congo,New Zealand,5,0,0,5
14252,2019,Colombia,New Zealand,30,10,0,40
14253,2019,Czechia,New Zealand,22,5,0,27
14254,2019,Eritrea,New Zealand,7,0,0,7
14255,2019,Ethiopia,New Zealand,7,9,0,16
14256,2019,Fiji,New Zealand,27,9,0,36
14257,2019,Palestinian,New Zealand,17,0,0,17
14258,2019,Hungary,New Zealand,8,0,0,8
14259,2019,India,New Zealand,11,59,0,70
14260,2019,Indonesia,New Zealand,5,5,0,10
14261,2019,Iran (Islamic Rep. of),New Zealand,129,34,0,163
14262,2019,Iraq,New Zealand,77,5,0,82
14263,2019,Jordan,New Zealand,8,0,0,8
14264,2019,Kuwait,New Zealand,7,0,0,7
14265,2019,Libya,New Zealand,22,0,0,22
14266,2019,Sri Lanka,New Zealand,50,53,0,103
14267,2019,Madagascar,New Zealand,5,0,0,5
14268,2019,Maldives,New Zealand,5,0,0,5
14269,2019,Mexico,New Zealand,5,5,0,10
14270,2019,Malaysia,New Zealand,9,24,0,33
14271,2019,Mongolia,New Zealand,0,11,0,11
14272,2019,Myanmar,New Zealand,12,0,0,12
14273,2019,Nepal,New Zealand,5,5,0,10
14274,2019,Pakistan,New Zealand,63,11,0,74
14275,2019,Philippines,New Zealand,7,6,0,13
14276,2019,Papua New Guinea,New Zealand,0,5,0,5
14277,2019,South Africa,New Zealand,8,10,0,18
14278,2019,Russian Federation,New Zealand,26,7,0,33
14279,2019,El Salvador,New Zealand,5,0,0,5
14280,2019,Saudi Arabia,New Zealand,68,5,0,73
14281,2019,Somalia,New Zealand,13,0,0,13
14282,2019,Viet Nam,New Zealand,9,5,0,14
14283,2019,Sudan,New Zealand,8,0,0,8
14284,2019,Syrian Arab Rep.,New Zealand,69,5,0,74
14285,2019,Tonga,New Zealand,0,5,0,5
14286,2019,Türkiye,New Zealand,55,13,0,68
14287,2019,Uganda,New Zealand,5,0,0,5
14288,2019,Yemen,New Zealand,8,0,0,8
14289,2019,Zimbabwe,New Zealand,20,0,0,20
14292,2019,Iraq,Oman,295,254,0,549
14293,2019,Pakistan,Oman,5,0,0,5
14294,2019,Syrian Arab Rep.,Oman,8,0,0,8
14295,2019,Afghanistan,Pakistan,1419084,8406,0,1427490
14296,2019,Algeria,Pakistan,22,0,0,22
14297,2019,China,Pakistan,5,15,0,20
14298,2019,Palestinian,Pakistan,21,0,0,21
14299,2019,India,Pakistan,0,5,0,5
14300,2019,Iran (Islamic Rep. of),Pakistan,40,21,0,61
14301,2019,Iraq,Pakistan,22,7,0,29
14302,2019,Myanmar,Pakistan,23,31,0,54
14303,2019,Pakistan,Pakistan,0,0,100680,0
14304,2019,Russian Federation,Pakistan,6,0,0,6
14305,2019,Somalia,Pakistan,181,21,0,202
14306,2019,Syrian Arab Rep.,Pakistan,43,0,0,43
14307,2019,Tajikistan,Pakistan,6,0,0,6
14308,2019,Türkiye,Pakistan,6,0,0,6
14309,2019,Yemen,Pakistan,137,22,0,159
14310,2019,Afghanistan,Panama,5,6,0,11
14311,2019,Armenia,Panama,0,5,0,5
14312,2019,Bangladesh,Panama,0,18,0,18
14313,2019,Belarus,Panama,7,5,0,12
14314,2019,Brazil,Panama,0,6,0,6
14315,2019,Bosnia and Herzegovina,Panama,5,0,0,5
14316,2019,Cameroon,Panama,9,5,0,14
14317,2019,Dem. Rep. of the Congo,Panama,5,0,0,5
14318,2019,Colombia,Panama,1702,1897,0,3599
14319,2019,Costa Rica,Panama,0,5,0,5
14320,2019,Cuba,Panama,120,2662,0,2782
14321,2019,Dominican Rep.,Panama,5,5,0,10
14322,2019,Ecuador,Panama,0,25,0,25
14323,2019,Eritrea,Panama,0,39,0,39
14324,2019,Guatemala,Panama,12,14,0,26
14325,2019,Haiti,Panama,19,0,0,19
14326,2019,Honduras,Panama,0,114,0,114
14327,2019,Croatia,Panama,5,0,0,5
14328,2019,Cote d'Ivoire,Panama,0,5,0,5
14329,2019,India,Panama,0,5,0,5
14330,2019,Iran (Islamic Rep. of),Panama,5,0,0,5
14331,2019,Italy,Panama,0,5,0,5
14332,2019,Jamaica,Panama,0,8,0,8
14333,2019,Kenya,Panama,0,5,0,5
14334,2019,Liberia,Panama,5,0,0,5
14335,2019,Sri Lanka,Panama,0,7,0,7
14336,2019,Mexico,Panama,6,0,0,6
14337,2019,Nepal,Panama,0,12,0,12
14338,2019,Nicaragua,Panama,178,7550,0,7728
14339,2019,Nigeria,Panama,10,35,0,45
14340,2019,Pakistan,Panama,0,29,0,29
14341,2019,Peru,Panama,23,5,0,28
14342,2019,El Salvador,Panama,344,1357,0,1701
14343,2019,Sierra Leone,Panama,5,0,0,5
14344,2019,Somalia,Panama,0,103,0,103
14345,2019,Sudan,Panama,5,0,0,5
14346,2019,Syrian Arab Rep.,Panama,0,12,0,12
14347,2019,Ukraine,Panama,0,5,0,5
14348,2019,Venezuela (Bolivarian Republic of),Panama,61,3724,0,3785
14349,2019,Argentina,Paraguay,0,6,0,6
14350,2019,Bolivia (Plurinational State of),Paraguay,16,0,0,16
14351,2019,Brazil,Paraguay,0,5,0,5
14352,2019,Cameroon,Paraguay,0,5,0,5
14353,2019,Colombia,Paraguay,17,18,0,35
14354,2019,Cuba,Paraguay,109,617,0,726
14355,2019,Iraq,Paraguay,6,0,0,6
14356,2019,Lebanon,Paraguay,0,5,0,5
14357,2019,Sri Lanka,Paraguay,5,0,0,5
14358,2019,Nigeria,Paraguay,0,5,0,5
14359,2019,Peru,Paraguay,5,0,0,5
14360,2019,El Salvador,Paraguay,13,0,0,13
14361,2019,Syrian Arab Rep.,Paraguay,88,11,0,99
14362,2019,Türkiye,Paraguay,5,0,0,5
14363,2019,Venezuela (Bolivarian Republic of),Paraguay,750,8,0,758
14364,2019,Angola,Peru,0,7,0,7
14365,2019,Argentina,Peru,0,12,0,12
14366,2019,Bangladesh,Peru,26,0,0,26
14367,2019,Bolivia (Plurinational State of),Peru,20,18,0,38
14368,2019,Brazil,Peru,5,10,0,15
14369,2019,China,Peru,0,12,0,12
14370,2019,Chile,Peru,0,8,0,8
14371,2019,Cameroon,Peru,20,0,0,20
14372,2019,Congo,Peru,0,9,0,9
14373,2019,Dem. Rep. of the Congo,Peru,8,0,0,8
14374,2019,Colombia,Peru,705,1230,0,1935
14375,2019,Costa Rica,Peru,0,5,0,5
14376,2019,Cuba,Peru,477,2693,0,3170
14377,2019,Dominican Rep.,Peru,19,41,0,60
14378,2019,Ecuador,Peru,0,98,0,98
14379,2019,Ethiopia,Peru,5,0,0,5
14380,2019,Gambia,Peru,5,0,0,5
14381,2019,Palestinian,Peru,41,8,0,49
14382,2019,Ghana,Peru,5,0,0,5
14383,2019,Haiti,Peru,78,63,0,141
14384,2019,Honduras,Peru,0,5,0,5
14385,2019,India,Peru,6,0,0,6
14386,2019,Iran (Islamic Rep. of),Peru,6,5,0,11
14387,2019,Iraq,Peru,42,0,0,42
14388,2019,Sri Lanka,Peru,0,6,0,6
14389,2019,Mexico,Peru,0,6,0,6
14390,2019,Morocco,Peru,0,5,0,5
14391,2019,Nepal,Peru,0,5,0,5
14392,2019,Nicaragua,Peru,7,6,0,13
14393,2019,Nigeria,Peru,24,8,0,32
14394,2019,Pakistan,Peru,0,10,0,10
14395,2019,Panama,Peru,0,9,0,9
14396,2019,Paraguay,Peru,0,5,0,5
14397,2019,Philippines,Peru,0,19,0,19
14398,2019,Poland,Peru,0,5,0,5
14399,2019,Portugal,Peru,0,14,0,14
14400,2019,Russian Federation,Peru,0,5,0,5
14401,2019,El Salvador,Peru,6,8,0,14
14402,2019,Spain,Peru,0,15,0,15
14403,2019,Syrian Arab Rep.,Peru,42,12,0,54
14404,2019,Turkmenistan,Peru,0,8,0,8
14405,2019,Türkiye,Peru,41,44,0,85
14406,2019,Ukraine,Peru,17,0,0,17
14407,2019,Uruguay,Peru,0,5,0,5
14408,2019,United States of America,Peru,0,5,0,5
14409,2019,Venezuela (Bolivarian Republic of),Peru,1230,482571,0,483801
14410,2019,Yemen,Peru,0,54,0,54
14412,2019,Afghanistan,Philippines,14,6,0,20
14413,2019,Burundi,Philippines,13,0,0,13
14414,2019,Cambodia,Philippines,13,5,0,18
14415,2019,China,Philippines,5,5,0,10
14416,2019,Cameroon,Philippines,24,37,0,61
14417,2019,Dem. Rep. of the Congo,Philippines,9,5,0,14
14418,2019,Eritrea,Philippines,19,5,0,24
14419,2019,Ethiopia,Philippines,5,0,0,5
14420,2019,Palestinian,Philippines,54,12,0,66
14421,2019,Ghana,Philippines,5,0,0,5
14422,2019,Guinea,Philippines,0,5,0,5
14423,2019,Cote d'Ivoire,Philippines,27,25,0,52
14424,2019,Iran (Islamic Rep. of),Philippines,68,14,0,82
14425,2019,Iraq,Philippines,43,12,0,55
14426,2019,Liberia,Philippines,5,5,0,10
14427,2019,Lebanon,Philippines,5,0,0,5
14428,2019,Sri Lanka,Philippines,20,0,0,20
14429,2019,Morocco,Philippines,5,0,0,5
14430,2019,Myanmar,Philippines,7,0,0,7
14431,2019,Nigeria,Philippines,6,12,0,18
14432,2019,Pakistan,Philippines,88,17,0,105
14433,2019,Philippines,Philippines,0,0,178897,0
14434,2019,Russian Federation,Philippines,5,0,0,5
14435,2019,Saudi Arabia,Philippines,8,5,0,13
14436,2019,Somalia,Philippines,31,14,0,45
14437,2019,Viet Nam,Philippines,11,0,0,11
14438,2019,Sudan,Philippines,6,25,0,31
14439,2019,Syrian Arab Rep.,Philippines,115,41,0,156
14440,2019,Türkiye,Philippines,49,17,0,66
14441,2019,United States of America,Philippines,0,5,0,5
14442,2019,Yemen,Philippines,15,40,0,55
14445,2019,Afghanistan,Papua New Guinea,43,5,0,48
14446,2019,Bangladesh,Papua New Guinea,14,0,0,14
14447,2019,India,Papua New Guinea,0,5,0,5
14448,2019,Indonesia,Papua New Guinea,9368,0,0,9368
14449,2019,Iran (Islamic Rep. of),Papua New Guinea,100,112,0,212
14450,2019,Iraq,Papua New Guinea,35,5,0,40
14451,2019,Sri Lanka,Papua New Guinea,10,0,0,10
14452,2019,Myanmar,Papua New Guinea,5,0,0,5
14453,2019,Pakistan,Papua New Guinea,40,5,0,45
14454,2019,Somalia,Papua New Guinea,19,0,0,19
14455,2019,Sudan,Papua New Guinea,55,0,0,55
14457,2019,Afghanistan,Poland,121,16,0,137
14458,2019,Algeria,Poland,5,10,0,15
14459,2019,Angola,Poland,0,5,0,5
14460,2019,Egypt,Poland,71,16,0,87
14461,2019,Armenia,Poland,78,49,0,127
14462,2019,Azerbaijan,Poland,8,19,0,27
14463,2019,Bangladesh,Poland,8,16,0,24
14464,2019,Burkina Faso,Poland,0,5,0,5
14465,2019,Belarus,Poland,201,63,0,264
14466,2019,Central African Rep.,Poland,5,0,0,5
14467,2019,China,Poland,21,6,0,27
14468,2019,Cameroon,Poland,11,0,0,11
14469,2019,Congo,Poland,8,0,0,8
14470,2019,Dem. Rep. of the Congo,Poland,6,0,0,6
14471,2019,Cuba,Poland,17,11,0,28
14472,2019,Eritrea,Poland,32,0,0,32
14473,2019,Ethiopia,Poland,5,5,0,10
14474,2019,Gambia,Poland,0,5,0,5
14475,2019,Palestinian,Poland,17,8,0,25
14476,2019,Georgia,Poland,71,96,0,167
14477,2019,Guinea,Poland,0,6,0,6
14478,2019,India,Poland,5,20,0,25
14479,2019,Iran (Islamic Rep. of),Poland,54,31,0,85
14480,2019,Iraq,Poland,272,24,0,296
14481,2019,Jordan,Poland,0,5,0,5
14482,2019,Kazakhstan,Poland,64,48,0,112
14483,2019,Kenya,Poland,5,0,0,5
14484,2019,Kyrgyzstan,Poland,59,79,0,138
14485,2019,Libya,Poland,31,7,0,38
14486,2019,Lebanon,Poland,0,22,0,22
14487,2019,Sri Lanka,Poland,49,0,0,49
14488,2019,Rep. of Moldova,Poland,5,6,0,11
14489,2019,Mongolia,Poland,19,0,0,19
14490,2019,Nepal,Poland,8,0,0,8
14491,2019,Nigeria,Poland,11,10,0,21
14492,2019,Pakistan,Poland,32,22,0,54
14493,2019,Russian Federation,Poland,9870,3320,0,13190
14494,2019,Rwanda,Poland,5,0,0,5
14495,2019,Serbia and Kosovo: S/RES/1244 (1999),Poland,5,0,0,5
14496,2019,Senegal,Poland,5,5,0,10
14497,2019,Sierra Leone,Poland,0,5,0,5
14498,2019,Somalia,Poland,50,0,0,50
14499,2019,Viet Nam,Poland,16,13,0,29
14500,2019,Sudan,Poland,5,0,0,5
14501,2019,Syrian Arab Rep.,Poland,542,23,0,565
14502,2019,Tajikistan,Poland,102,179,0,281
14503,2019,Turkmenistan,Poland,44,6,0,50
14504,2019,Tunisia,Poland,0,5,0,5
14505,2019,Türkiye,Poland,92,76,0,168
14506,2019,Uganda,Poland,6,5,0,11
14507,2019,Ukraine,Poland,485,515,0,1000
14508,2019,Uzbekistan,Poland,24,6,0,30
14509,2019,Venezuela (Bolivarian Republic of),Poland,0,5,0,5
14510,2019,Yemen,Poland,9,0,0,9
14512,2019,Afghanistan,Portugal,20,5,0,25
14513,2019,Albania,Portugal,0,5,0,5
14514,2019,Algeria,Portugal,0,5,0,5
14515,2019,Angola,Portugal,0,216,0,216
14516,2019,Egypt,Portugal,0,9,0,9
14517,2019,Armenia,Portugal,5,0,0,5
14518,2019,Benin,Portugal,0,5,0,5
14519,2019,Bangladesh,Portugal,5,5,0,10
14520,2019,Belarus,Portugal,16,0,0,16
14521,2019,Brazil,Portugal,0,18,0,18
14522,2019,Bosnia and Herzegovina,Portugal,10,0,0,10
14523,2019,Central African Rep.,Portugal,8,0,0,8
14524,2019,China,Portugal,0,7,0,7
14525,2019,Cameroon,Portugal,15,21,0,36
14526,2019,Congo,Portugal,9,5,0,14
14527,2019,Dem. Rep. of the Congo,Portugal,55,36,0,91
14528,2019,Colombia,Portugal,45,17,0,62
14529,2019,Cuba,Portugal,5,12,0,17
14530,2019,Eritrea,Portugal,195,12,0,207
14531,2019,Ethiopia,Portugal,6,0,0,6
14532,2019,Gambia,Portugal,5,75,0,80
14533,2019,Palestinian,Portugal,5,0,0,5
14534,2019,Georgia,Portugal,0,5,0,5
14535,2019,Ghana,Portugal,0,16,0,16
14536,2019,Guinea-Bissau,Portugal,9,79,0,88
14537,2019,Guinea,Portugal,103,57,0,160
14538,2019,Cote d'Ivoire,Portugal,32,12,0,44
14539,2019,Iran (Islamic Rep. of),Portugal,41,23,0,64
14540,2019,Iraq,Portugal,181,5,0,186
14541,2019,Jordan,Portugal,0,5,0,5
14542,2019,Kenya,Portugal,6,7,0,13
14543,2019,Libya,Portugal,15,10,0,25
14544,2019,Sri Lanka,Portugal,34,5,0,39
14545,2019,Mauritania,Portugal,5,0,0,5
14546,2019,Mali,Portugal,13,16,0,29
14547,2019,Morocco,Portugal,9,28,0,37
14548,2019,Nigeria,Portugal,25,48,0,73
14549,2019,Pakistan,Portugal,69,12,0,81
14550,2019,Russian Federation,Portugal,16,9,0,25
14551,2019,Rwanda,Portugal,5,0,0,5
14552,2019,Senegal,Portugal,6,27,0,33
14553,2019,Sierra Leone,Portugal,26,25,0,51
14554,2019,Somalia,Portugal,33,5,0,38
14555,2019,Sao Tome and Principe,Portugal,0,5,0,5
14556,2019,Sudan,Portugal,49,12,0,61
14557,2019,South Sudan,Portugal,30,0,0,30
14558,2019,Syrian Arab Rep.,Portugal,768,5,0,773
14559,2019,Togo,Portugal,7,13,0,20
14560,2019,Türkiye,Portugal,8,10,0,18
14561,2019,Uganda,Portugal,5,0,0,5
14562,2019,Ukraine,Portugal,436,93,0,529
14563,2019,Venezuela (Bolivarian Republic of),Portugal,0,67,0,67
14564,2019,Yemen,Portugal,9,0,0,9
14566,2019,Egypt,Qatar,13,8,0,21
14567,2019,Eritrea,Qatar,0,5,0,5
14568,2019,Iraq,Qatar,141,73,0,214
14569,2019,Somalia,Qatar,9,0,0,9
14570,2019,Sudan,Qatar,0,13,0,13
14571,2019,Syrian Arab Rep.,Qatar,34,0,0,34
14572,2019,Yemen,Qatar,5,0,0,5
14574,2019,Afghanistan,Romania,148,67,0,215
14575,2019,Algeria,Romania,0,55,0,55
14576,2019,Angola,Romania,5,0,0,5
14577,2019,Egypt,Romania,19,25,0,44
14578,2019,Burundi,Romania,7,0,0,7
14579,2019,Bangladesh,Romania,6,14,0,20
14580,2019,Central African Rep.,Romania,7,0,0,7
14581,2019,Cameroon,Romania,23,11,0,34
14582,2019,Congo,Romania,6,0,0,6
14583,2019,Dem. Rep. of the Congo,Romania,21,5,0,26
14584,2019,Comoros,Romania,5,0,0,5
14585,2019,Cuba,Romania,0,5,0,5
14586,2019,Eritrea,Romania,45,5,0,50
14587,2019,Ethiopia,Romania,7,5,0,12
14588,2019,Gambia,Romania,5,0,0,5
14589,2019,Palestinian,Romania,58,15,0,73
14590,2019,Guinea,Romania,5,0,0,5
14591,2019,India,Romania,0,15,0,15
14592,2019,Iran (Islamic Rep. of),Romania,116,60,0,176
14593,2019,Iraq,Romania,881,278,0,1159
14594,2019,Jordan,Romania,6,5,0,11
14595,2019,Liberia,Romania,5,0,0,5
14596,2019,Libya,Romania,0,30,0,30
14597,2019,Lebanon,Romania,5,0,0,5
14598,2019,Sri Lanka,Romania,0,5,0,5
14599,2019,Rep. of Moldova,Romania,0,5,0,5
14600,2019,Morocco,Romania,0,46,0,46
14601,2019,Myanmar,Romania,26,0,0,26
14602,2019,Nigeria,Romania,5,5,0,10
14603,2019,Pakistan,Romania,42,7,0,49
14604,2019,South Africa,Romania,0,5,0,5
14605,2019,Rwanda,Romania,7,5,0,12
14606,2019,Sierra Leone,Romania,5,0,0,5
14607,2019,Somalia,Romania,99,27,0,126
14608,2019,Sudan,Romania,16,0,0,16
14609,2019,Syrian Arab Rep.,Romania,2090,146,0,2236
14610,2019,Tunisia,Romania,0,21,0,21
14611,2019,Türkiye,Romania,39,35,0,74
14612,2019,Uganda,Romania,5,0,0,5
14613,2019,Ukraine,Romania,22,5,0,27
14614,2019,Yemen,Romania,29,0,0,29
14615,2019,Zimbabwe,Romania,6,0,0,6
14617,2019,Afghanistan,South Africa,0,24,0,24
14618,2019,Algeria,South Africa,5,230,0,235
14619,2019,Angola,South Africa,23,12,0,35
14620,2019,Egypt,South Africa,7,265,0,272
14621,2019,Bahrain,South Africa,0,10,0,10
14622,2019,Burundi,South Africa,2699,7171,0,9870
14623,2019,Benin,South Africa,5,47,0,52
14624,2019,Bangladesh,South Africa,205,28347,0,28552
14625,2019,Bahamas,South Africa,0,14,0,14
14626,2019,Burkina Faso,South Africa,0,44,0,44
14627,2019,Botswana,South Africa,0,5,0,5
14628,2019,Bulgaria,South Africa,5,0,0,5
14629,2019,Central African Rep.,South Africa,9,6,0,15
14630,2019,Chad,South Africa,5,5,0,10
14631,2019,China,South Africa,0,87,0,87
14632,2019,Cameroon,South Africa,328,1983,0,2311
14633,2019,Congo,South Africa,4552,8115,0,12667
14634,2019,Dem. Rep. of the Congo,South Africa,23160,36120,0,59280
14635,2019,Comoros,South Africa,0,20,0,20
14636,2019,Eritrea,South Africa,1574,1098,0,2672
14637,2019,Estonia,South Africa,5,12,0,17
14638,2019,Ethiopia,South Africa,15990,51288,0,67278
14639,2019,Gabon,South Africa,0,12,0,12
14640,2019,Gambia,South Africa,0,5,0,5
14641,2019,Palestinian,South Africa,39,13,0,52
14642,2019,Ghana,South Africa,7,1854,0,1861
14643,2019,Guinea-Bissau,South Africa,0,9,0,9
14644,2019,Guinea,South Africa,0,59,0,59
14645,2019,Cote d'Ivoire,South Africa,28,177,0,205
14646,2019,India,South Africa,5,4665,0,4670
14647,2019,Iraq,South Africa,14,6,0,20
14648,2019,Jordan,South Africa,5,11,0,16
14649,2019,Kenya,South Africa,143,1034,0,1177
14650,2019,Liberia,South Africa,50,69,0,119
14651,2019,Libya,South Africa,0,5,0,5
14652,2019,Lesotho,South Africa,0,27,0,27
14653,2019,Sri Lanka,South Africa,10,18,0,28
14654,2019,Mali,South Africa,5,133,0,138
14655,2019,Malawi,South Africa,8,2015,0,2023
14656,2019,Morocco,South Africa,5,11,0,16
14657,2019,Mozambique,South Africa,0,412,0,412
14658,2019,Nepal,South Africa,0,146,0,146
14659,2019,Niger,South Africa,0,736,0,736
14660,2019,Nigeria,South Africa,9,6372,0,6381
14661,2019,Pakistan,South Africa,12,10281,0,10293
14662,2019,Russian Federation,South Africa,10,0,0,10
14663,2019,Rwanda,South Africa,1067,1083,0,2150
14664,2019,Senegal,South Africa,5,913,0,918
14665,2019,Sierra Leone,South Africa,20,13,0,33
14666,2019,Solomon Islands,South Africa,7,0,0,7
14667,2019,Somalia,South Africa,23635,5054,0,28689
14668,2019,Sudan,South Africa,95,62,0,157
14669,2019,Eswatini,South Africa,7,19,0,26
14670,2019,Syrian Arab Rep.,South Africa,40,20,0,60
14671,2019,United Rep. of Tanzania,South Africa,33,568,0,601
14672,2019,Thailand,South Africa,0,46,0,46
14673,2019,Timor-Leste,South Africa,0,7,0,7
14674,2019,Togo,South Africa,12,31,0,43
14675,2019,Türkiye,South Africa,5,5,0,10
14676,2019,Uganda,South Africa,472,4374,0,4846
14677,2019,Ukraine,South Africa,5,0,0,5
14678,2019,Yemen,South Africa,5,15,0,20
14679,2019,Zambia,South Africa,62,227,0,289
14680,2019,Zimbabwe,South Africa,4003,12825,0,16828
14681,2019,Afghanistan,Russian Federation,795,268,0,1063
14682,2019,Egypt,Russian Federation,0,5,0,5
14683,2019,Armenia,Russian Federation,0,5,0,5
14684,2019,Azerbaijan,Russian Federation,18,11,0,29
14685,2019,Belgium,Russian Federation,0,23,0,23
14686,2019,Bangladesh,Russian Federation,5,0,0,5
14687,2019,Cameroon,Russian Federation,5,0,0,5
14688,2019,Congo,Russian Federation,5,0,0,5
14689,2019,Dem. Rep. of the Congo,Russian Federation,5,5,0,10
14690,2019,Palestinian,Russian Federation,10,0,0,10
14691,2019,Georgia,Russian Federation,147,5,0,152
14692,2019,Germany,Russian Federation,11,5,0,16
14693,2019,Cote d'Ivoire,Russian Federation,5,0,0,5
14694,2019,Iran (Islamic Rep. of),Russian Federation,5,0,0,5
14695,2019,Iraq,Russian Federation,17,5,0,22
14696,2019,Kazakhstan,Russian Federation,12,13,0,25
14697,2019,Kyrgyzstan,Russian Federation,32,14,0,46
14698,2019,Rep. of Korea,Russian Federation,5,0,0,5
14699,2019,Dem. People's Rep. of Korea,Russian Federation,50,7,0,57
14700,2019,Lebanon,Russian Federation,6,0,0,6
14701,2019,Latvia,Russian Federation,5,0,0,5
14702,2019,Rep. of Moldova,Russian Federation,30,8,0,38
14703,2019,Nigeria,Russian Federation,0,5,0,5
14704,2019,Pakistan,Russian Federation,5,0,0,5
14705,2019,Sudan,Russian Federation,6,0,0,6
14706,2019,Syrian Arab Rep.,Russian Federation,593,110,0,703
14707,2019,Tajikistan,Russian Federation,40,22,0,62
14708,2019,Turkmenistan,Russian Federation,12,5,0,17
14709,2019,Türkiye,Russian Federation,5,0,0,5
14710,2019,Ukraine,Russian Federation,40393,858,0,41251
14711,2019,Uzbekistan,Russian Federation,61,33,0,94
14712,2019,Yemen,Russian Federation,97,20,0,117
14715,2019,Angola,Rwanda,8,0,0,8
14716,2019,Burundi,Rwanda,71488,77,0,71565
14717,2019,Chad,Rwanda,5,0,0,5
14718,2019,Cameroon,Rwanda,0,5,0,5
14719,2019,Dem. Rep. of the Congo,Rwanda,73408,228,0,73636
14720,2019,Eritrea,Rwanda,104,143,0,247
14721,2019,Ethiopia,Rwanda,5,6,0,11
14722,2019,Rwanda,Rwanda,0,0,0,0
14723,2019,Somalia,Rwanda,18,24,0,42
14724,2019,Sudan,Rwanda,13,5,0,18
14725,2019,South Sudan,Rwanda,5,5,0,10
14726,2019,Colombia,El Salvador,5,6,0,11
14727,2019,Cuba,El Salvador,0,5,0,5
14728,2019,Honduras,El Salvador,19,8,0,27
14729,2019,Iraq,El Salvador,5,0,0,5
14730,2019,Mexico,El Salvador,5,0,0,5
14731,2019,Nicaragua,El Salvador,9,10,0,19
14732,2019,El Salvador,El Salvador,0,0,71500,0
14733,2019,Syrian Arab Rep.,El Salvador,5,0,0,5
14734,2019,Chad,Saudi Arabia,9,0,0,9
14735,2019,China,Saudi Arabia,14,14,0,28
14736,2019,Eritrea,Saudi Arabia,42,0,0,42
14737,2019,Palestinian,Saudi Arabia,8,14,0,22
14738,2019,Iraq,Saudi Arabia,31,30,0,61
14739,2019,Liberia,Saudi Arabia,9,0,0,9
14740,2019,Somalia,Saudi Arabia,16,0,0,16
14741,2019,Sudan,Saudi Arabia,0,5,0,5
14742,2019,Syrian Arab Rep.,Saudi Arabia,152,2220,0,2372
14743,2019,Tunisia,Saudi Arabia,7,0,0,7
14744,2019,Yemen,Saudi Arabia,27,44,0,71
14746,2019,Afghanistan,Serbia and Kosovo: S/RES/1244 (1999),19,10,0,29
14747,2019,Algeria,Serbia and Kosovo: S/RES/1244 (1999),0,5,0,5
14748,2019,Burundi,Serbia and Kosovo: S/RES/1244 (1999),0,26,0,26
14749,2019,Bangladesh,Serbia and Kosovo: S/RES/1244 (1999),0,6,0,6
14750,2019,Bosnia and Herzegovina,Serbia and Kosovo: S/RES/1244 (1999),8198,0,0,8198
14751,2019,Congo,Serbia and Kosovo: S/RES/1244 (1999),0,7,0,7
14752,2019,Dem. Rep. of the Congo,Serbia and Kosovo: S/RES/1244 (1999),0,5,0,5
14753,2019,Cuba,Serbia and Kosovo: S/RES/1244 (1999),7,0,0,7
14754,2019,Ethiopia,Serbia and Kosovo: S/RES/1244 (1999),5,0,0,5
14755,2019,Palestinian,Serbia and Kosovo: S/RES/1244 (1999),0,7,0,7
14756,2019,Guinea,Serbia and Kosovo: S/RES/1244 (1999),0,6,0,6
14757,2019,Croatia,Serbia and Kosovo: S/RES/1244 (1999),17972,0,0,17972
14758,2019,Iran (Islamic Rep. of),Serbia and Kosovo: S/RES/1244 (1999),12,59,0,71
14759,2019,Iraq,Serbia and Kosovo: S/RES/1244 (1999),13,9,0,22
14760,2019,Libya,Serbia and Kosovo: S/RES/1244 (1999),45,0,0,45
14761,2019,Morocco,Serbia and Kosovo: S/RES/1244 (1999),0,20,0,20
14762,2019,Nigeria,Serbia and Kosovo: S/RES/1244 (1999),0,10,0,10
14763,2019,Pakistan,Serbia and Kosovo: S/RES/1244 (1999),5,0,0,5
14764,2019,Russian Federation,Serbia and Kosovo: S/RES/1244 (1999),5,7,0,12
14765,2019,Serbia and Kosovo: S/RES/1244 (1999),Serbia and Kosovo: S/RES/1244 (1999),0,0,214696,0
14766,2019,Somalia,Serbia and Kosovo: S/RES/1244 (1999),5,20,0,25
14767,2019,Sudan,Serbia and Kosovo: S/RES/1244 (1999),5,0,0,5
14768,2019,Syrian Arab Rep.,Serbia and Kosovo: S/RES/1244 (1999),25,25,0,50
14769,2019,Tunisia,Serbia and Kosovo: S/RES/1244 (1999),0,5,0,5
14770,2019,Türkiye,Serbia and Kosovo: S/RES/1244 (1999),96,32,0,128
14771,2019,Ukraine,Serbia and Kosovo: S/RES/1244 (1999),15,0,0,15
14772,2019,Yemen,Serbia and Kosovo: S/RES/1244 (1999),0,10,0,10
14775,2019,Afghanistan,Senegal,0,5,0,5
14776,2019,Burundi,Senegal,8,8,0,16
14777,2019,Benin,Senegal,0,5,0,5
14778,2019,Burkina Faso,Senegal,0,5,0,5
14779,2019,Central African Rep.,Senegal,228,406,0,634
14780,2019,Chad,Senegal,8,22,0,30
14781,2019,Cameroon,Senegal,0,27,0,27
14782,2019,Congo,Senegal,0,86,0,86
14783,2019,Dem. Rep. of the Congo,Senegal,11,185,0,196
14784,2019,Eritrea,Senegal,0,13,0,13
14785,2019,Gambia,Senegal,10,336,0,346
14786,2019,Ghana,Senegal,0,5,0,5
14787,2019,Guinea-Bissau,Senegal,0,5,0,5
14788,2019,Guinea,Senegal,0,110,0,110
14789,2019,Haiti,Senegal,0,5,0,5
14790,2019,Cote d'Ivoire,Senegal,22,165,0,187
14791,2019,Liberia,Senegal,0,62,0,62
14792,2019,Sri Lanka,Senegal,0,6,0,6
14793,2019,Mauritania,Senegal,14150,68,0,14218
14794,2019,Mali,Senegal,0,64,0,64
14795,2019,Nigeria,Senegal,0,57,0,57
14796,2019,Rwanda,Senegal,13,7,0,20
14797,2019,Sierra Leone,Senegal,0,39,0,39
14798,2019,Sudan,Senegal,5,8,0,13
14799,2019,Syrian Arab Rep.,Senegal,0,14,0,14
14800,2019,Togo,Senegal,0,29,0,29
14801,2019,Türkiye,Senegal,12,49,0,61
14803,2019,Cote d'Ivoire,Sierra Leone,16,0,0,16
14804,2019,Liberia,Sierra Leone,425,0,0,425
14805,2019,Egypt,Somalia,0,26,0,26
14806,2019,Bangladesh,Somalia,6,0,0,6
14807,2019,Cameroon,Somalia,5,0,0,5
14808,2019,Djibouti,Somalia,0,14,0,14
14809,2019,Eritrea,Somalia,57,50,0,107
14810,2019,Ethiopia,Somalia,4287,17477,0,21764
14811,2019,Palestinian,Somalia,21,0,0,21
14812,2019,Iraq,Somalia,21,0,0,21
14813,2019,Mozambique,Somalia,0,5,0,5
14814,2019,Nigeria,Somalia,0,5,0,5
14815,2019,Pakistan,Somalia,0,5,0,5
14816,2019,Somalia,Somalia,0,0,2648000,0
14817,2019,Sudan,Somalia,5,15,0,20
14818,2019,Syrian Arab Rep.,Somalia,245,21,0,266
14819,2019,United Rep. of Tanzania,Somalia,0,121,0,121
14820,2019,Yemen,Somalia,13235,50,0,13285
14821,2019,Afghanistan,Spain,395,270,0,665
14822,2019,Albania,Spain,0,185,0,185
14823,2019,Algeria,Spain,61,1345,0,1406
14824,2019,Angola,Spain,6,70,0,76
14825,2019,Egypt,Spain,39,125,0,164
14826,2019,Argentina,Spain,0,300,0,300
14827,2019,Armenia,Spain,36,380,0,416
14828,2019,Azerbaijan,Spain,49,65,0,114
14829,2019,Burundi,Spain,6,0,0,6
14830,2019,Benin,Spain,5,15,0,20
14831,2019,Bangladesh,Spain,18,295,0,313
14832,2019,Burkina Faso,Spain,0,130,0,130
14833,2019,Belarus,Spain,10,95,0,105
14834,2019,Bolivia (Plurinational State of),Spain,9,115,0,124
14835,2019,Brazil,Spain,14,960,0,974
14836,2019,Canada,Spain,0,5,0,5
14837,2019,Central African Rep.,Spain,90,60,0,150
14838,2019,Chad,Spain,6,10,0,16
14839,2019,China,Spain,20,1010,0,1030
14840,2019,Chile,Spain,0,145,0,145
14841,2019,Cameroon,Spain,95,935,0,1030
14842,2019,Congo,Spain,42,80,0,122
14843,2019,Dem. Rep. of the Congo,Spain,50,280,0,330
14844,2019,Colombia,Spain,242,34110,0,34352
14845,2019,Costa Rica,Spain,0,65,0,65
14846,2019,Cuba,Spain,856,1645,0,2501
14847,2019,Djibouti,Spain,0,5,0,5
14848,2019,Dominican Rep.,Spain,8,220,0,228
14849,2019,Ecuador,Spain,0,240,0,240
14850,2019,Equatorial Guinea,Spain,30,70,0,100
14851,2019,Eritrea,Spain,291,65,0,356
14852,2019,Ethiopia,Spain,55,25,0,80
14853,2019,France,Spain,0,5,0,5
14854,2019,Gabon,Spain,0,10,0,10
14855,2019,Gambia,Spain,35,255,0,290
14856,2019,Palestinian,Spain,1184,1385,0,2569
14857,2019,United Kingdom of Great Britain and Northern Ireland,Spain,0,5,0,5
14858,2019,Georgia,Spain,18,2595,0,2613
14859,2019,Germany,Spain,0,5,0,5
14860,2019,Ghana,Spain,0,390,0,390
14861,2019,Guinea-Bissau,Spain,5,75,0,80
14862,2019,Guatemala,Spain,23,655,0,678
14863,2019,Guinea,Spain,24,1695,0,1719
14864,2019,Haiti,Spain,14,25,0,39
14865,2019,Honduras,Spain,281,9085,0,9366
14866,2019,Cote d'Ivoire,Spain,206,1100,0,1306
14867,2019,India,Spain,8,110,0,118
14868,2019,Iran (Islamic Rep. of),Spain,87,230,0,317
14869,2019,Iraq,Spain,292,250,0,542
14870,2019,Israel,Spain,0,10,0,10
14871,2019,Jamaica,Spain,32,25,0,57
14872,2019,Jordan,Spain,30,30,0,60
14873,2019,Kazakhstan,Spain,15,30,0,45
14874,2019,Kenya,Spain,0,20,0,20
14875,2019,Kyrgyzstan,Spain,9,15,0,24
14876,2019,Kuwait,Spain,0,5,0,5
14877,2019,Liberia,Spain,5,55,0,60
14878,2019,Libya,Spain,51,140,0,191
14879,2019,Lebanon,Spain,25,175,0,200
14880,2019,Sri Lanka,Spain,87,40,0,127
14881,2019,Mauritania,Spain,5,120,0,125
14882,2019,North Macedonia,Spain,0,15,0,15
14883,2019,Rep. of Moldova,Spain,0,40,0,40
14884,2019,Mexico,Spain,18,205,0,223
14885,2019,Mali,Spain,98,1755,0,1853
14886,2019,Mongolia,Spain,5,10,0,15
14887,2019,Morocco,Spain,366,1980,0,2346
14888,2019,Myanmar,Spain,8,0,0,8
14889,2019,Nepal,Spain,0,5,0,5
14890,2019,Niger,Spain,0,35,0,35
14891,2019,Nicaragua,Spain,182,6145,0,6327
14892,2019,Nigeria,Spain,87,1465,0,1552
14893,2019,Oman,Spain,0,5,0,5
14894,2019,Pakistan,Spain,407,1210,0,1617
14895,2019,Panama,Spain,0,70,0,70
14896,2019,Paraguay,Spain,5,355,0,360
14897,2019,Peru,Spain,26,3575,0,3601
14898,2019,Philippines,Spain,0,10,0,10
14899,2019,Portugal,Spain,0,5,0,5
14900,2019,South Africa,Spain,0,5,0,5
14901,2019,Russian Federation,Spain,211,1705,0,1916
14902,2019,Rwanda,Spain,5,5,0,10
14903,2019,El Salvador,Spain,274,6095,0,6369
14904,2019,Saudi Arabia,Spain,5,5,0,10
14905,2019,Serbia and Kosovo: S/RES/1244 (1999),Spain,6,25,0,31
14906,2019,Senegal,Spain,7,935,0,942
14907,2019,Sierra Leone,Spain,11,115,0,126
14908,2019,Somalia,Spain,747,140,0,887
14909,2019,Viet Nam,Spain,0,60,0,60
14910,2019,Sudan,Spain,63,145,0,208
14911,2019,South Sudan,Spain,5,5,0,10
14912,2019,Syrian Arab Rep.,Spain,14133,2805,0,16938
14913,2019,Tajikistan,Spain,5,15,0,20
14914,2019,Togo,Spain,13,45,0,58
14915,2019,Trinidad and Tobago,Spain,0,5,0,5
14916,2019,Tunisia,Spain,7,305,0,312
14917,2019,Türkiye,Spain,31,460,0,491
14918,2019,Uganda,Spain,5,5,0,10
14919,2019,Ukraine,Spain,631,6460,0,7091
14920,2019,Uruguay,Spain,0,120,0,120
14921,2019,United States of America,Spain,0,85,0,85
14922,2019,Uzbekistan,Spain,15,15,0,30
14923,2019,Venezuela (Bolivarian Republic of),Spain,35243,33960,0,69203
14924,2019,Western Sahara,Spain,19,50,0,69
14925,2019,Yemen,Spain,206,675,0,881
14926,2019,Zimbabwe,Spain,0,5,0,5
14931,2019,Cuba,Saint Kitts and Nevis,5,0,0,5
14932,2019,Afghanistan,Sudan,0,0,0,0
14933,2019,Argentina,Sudan,0,0,0,0
14934,2019,Central African Rep.,Sudan,25961,0,0,25961
14935,2019,Chad,Sudan,3487,5,0,3492
14936,2019,Eritrea,Sudan,112904,7425,0,120329
14937,2019,Ethiopia,Sudan,6704,6913,0,13617
14938,2019,Palestinian,Sudan,0,0,0,0
14939,2019,Jordan,Sudan,0,0,0,0
14940,2019,Kuwait,Sudan,0,0,0,0
14941,2019,Somalia,Sudan,438,171,0,609
14942,2019,Sudan,Sudan,0,0,1885782,0
14943,2019,South Sudan,Sudan,810917,0,0,810917
14944,2019,Syrian Arab Rep.,Sudan,93495,0,0,93495
14945,2019,Yemen,Sudan,1227,452,0,1679
14947,2019,Colombia,Suriname,0,5,0,5
14948,2019,Cuba,Suriname,36,1187,0,1223
14949,2019,Dominican Rep.,Suriname,0,14,0,14
14950,2019,Nigeria,Suriname,0,5,0,5
14951,2019,Venezuela (Bolivarian Republic of),Suriname,8,215,0,223
14952,2019,Burundi,South Sudan,55,844,0,899
14953,2019,Central African Rep.,South Sudan,2081,0,0,2081
14954,2019,Cameroon,South Sudan,0,5,0,5
14955,2019,Dem. Rep. of the Congo,South Sudan,16343,7,0,16350
14956,2019,Eritrea,South Sudan,202,2415,0,2617
14957,2019,Ethiopia,South Sudan,4065,362,0,4427
14958,2019,Somalia,South Sudan,0,31,0,31
14959,2019,Sudan,South Sudan,275563,13,0,275576
14960,2019,South Sudan,South Sudan,0,0,1665815,0
14961,2019,Afghanistan,Slovakia,276,0,0,276
14962,2019,Angola,Slovakia,24,0,0,24
14963,2019,Egypt,Slovakia,5,0,0,5
14964,2019,Armenia,Slovakia,34,0,0,34
14965,2019,Burundi,Slovakia,5,0,0,5
14966,2019,Bosnia and Herzegovina,Slovakia,36,0,0,36
14967,2019,Bulgaria,Slovakia,8,0,0,8
14968,2019,Cambodia,Slovakia,5,0,0,5
14969,2019,China,Slovakia,5,0,0,5
14970,2019,Cameroon,Slovakia,9,0,0,9
14971,2019,Dem. Rep. of the Congo,Slovakia,16,0,0,16
14972,2019,Cuba,Slovakia,32,0,0,32
14973,2019,Palestinian,Slovakia,7,0,0,7
14974,2019,Iran (Islamic Rep. of),Slovakia,31,0,0,31
14975,2019,Iraq,Slovakia,214,0,0,214
14976,2019,Liberia,Slovakia,5,0,0,5
14977,2019,Pakistan,Slovakia,7,0,0,7
14978,2019,Romania,Slovakia,37,0,0,37
14979,2019,Russian Federation,Slovakia,37,0,0,37
14980,2019,Serbia and Kosovo: S/RES/1244 (1999),Slovakia,46,0,0,46
14981,2019,Somalia,Slovakia,32,0,0,32
14982,2019,Viet Nam,Slovakia,16,0,0,16
14983,2019,Syrian Arab Rep.,Slovakia,14,5,0,19
14984,2019,Uganda,Slovakia,5,0,0,5
14985,2019,Ukraine,Slovakia,24,0,0,24
14986,2019,Uzbekistan,Slovakia,5,0,0,5
14987,2019,Yemen,Slovakia,21,0,0,21
14989,2019,Afghanistan,Slovenia,51,23,0,74
14990,2019,Algeria,Slovenia,0,41,0,41
14991,2019,Azerbaijan,Slovenia,0,5,0,5
14992,2019,Bosnia and Herzegovina,Slovenia,6,5,0,11
14993,2019,Cameroon,Slovenia,5,0,0,5
14994,2019,Dem. Rep. of the Congo,Slovenia,6,0,0,6
14995,2019,Eritrea,Slovenia,82,19,0,101
14996,2019,Palestinian,Slovenia,14,16,0,30
14997,2019,Iran (Islamic Rep. of),Slovenia,66,33,0,99
14998,2019,Iraq,Slovenia,43,19,0,62
14999,2019,Kazakhstan,Slovenia,20,0,0,20
15000,2019,Sri Lanka,Slovenia,0,9,0,9
15001,2019,Morocco,Slovenia,0,60,0,60
15002,2019,Nigeria,Slovenia,5,5,0,10
15003,2019,Pakistan,Slovenia,0,21,0,21
15004,2019,Russian Federation,Slovenia,19,5,0,24
15005,2019,Serbia and Kosovo: S/RES/1244 (1999),Slovenia,10,7,0,17
15006,2019,Somalia,Slovenia,50,0,0,50
15007,2019,Sudan,Slovenia,5,0,0,5
15008,2019,Syrian Arab Rep.,Slovenia,307,15,0,322
15009,2019,Tunisia,Slovenia,0,11,0,11
15010,2019,Türkiye,Slovenia,41,14,0,55
15011,2019,Ukraine,Slovenia,5,0,0,5
15012,2019,Yemen,Slovenia,6,0,0,6
15014,2019,Angola,Eswatini,13,0,0,13
15015,2019,Burundi,Eswatini,183,135,0,318
15016,2019,Cameroon,Eswatini,0,5,0,5
15017,2019,Congo,Eswatini,23,96,0,119
15018,2019,Dem. Rep. of the Congo,Eswatini,401,284,0,685
15019,2019,Eritrea,Eswatini,0,5,0,5
15020,2019,Ethiopia,Eswatini,9,73,0,82
15021,2019,Guinea,Eswatini,5,0,0,5
15022,2019,Kenya,Eswatini,5,0,0,5
15023,2019,Sri Lanka,Eswatini,5,0,0,5
15024,2019,Rwanda,Eswatini,184,104,0,288
15025,2019,Somalia,Eswatini,99,256,0,355
15026,2019,United Rep. of Tanzania,Eswatini,0,5,0,5
15027,2019,Uganda,Eswatini,6,0,0,6
15028,2019,Zimbabwe,Eswatini,7,0,0,7
15029,2019,Afghanistan,Sweden,30546,3015,0,33561
15030,2019,Albania,Sweden,327,376,0,703
15031,2019,Algeria,Sweden,60,70,0,130
15032,2019,Angola,Sweden,23,30,0,53
15033,2019,Egypt,Sweden,391,506,0,897
15034,2019,Argentina,Sweden,0,8,0,8
15035,2019,Armenia,Sweden,378,212,0,590
15036,2019,Azerbaijan,Sweden,651,453,0,1104
15037,2019,Bahrain,Sweden,17,5,0,22
15038,2019,Burundi,Sweden,217,113,0,330
15039,2019,Benin,Sweden,10,0,0,10
15040,2019,Bangladesh,Sweden,253,361,0,614
15041,2019,Burkina Faso,Sweden,5,5,0,10
15042,2019,Belarus,Sweden,116,85,0,201
15043,2019,Bolivia (Plurinational State of),Sweden,56,20,0,76
15044,2019,Brazil,Sweden,8,14,0,22
15045,2019,Bosnia and Herzegovina,Sweden,95,84,0,179
15046,2019,Bulgaria,Sweden,16,5,0,21
15047,2019,Central African Rep.,Sweden,70,0,0,70
15048,2019,Chad,Sweden,19,0,0,19
15049,2019,China,Sweden,285,78,0,363
15050,2019,Chile,Sweden,13,35,0,48
15051,2019,Cameroon,Sweden,187,206,0,393
15052,2019,Congo,Sweden,38,34,0,72
15053,2019,Dem. Rep. of the Congo,Sweden,875,113,0,988
15054,2019,Comoros,Sweden,5,0,0,5
15055,2019,Colombia,Sweden,39,322,0,361
15056,2019,Cuba,Sweden,36,26,0,62
15057,2019,Djibouti,Sweden,23,33,0,56
15058,2019,Ecuador,Sweden,5,18,0,23
15059,2019,Equatorial Guinea,Sweden,6,5,0,11
15060,2019,Eritrea,Sweden,27933,578,0,28511
15061,2019,Ethiopia,Sweden,2561,614,0,3175
15062,2019,France,Sweden,5,0,0,5
15063,2019,Gambia,Sweden,184,131,0,315
15064,2019,Palestinian,Sweden,1167,714,0,1881
15065,2019,United Kingdom of Great Britain and Northern Ireland,Sweden,7,0,0,7
15066,2019,Georgia,Sweden,107,353,0,460
15067,2019,Ghana,Sweden,62,87,0,149
15068,2019,Guinea-Bissau,Sweden,9,5,0,14
15069,2019,Greece,Sweden,18,0,0,18
15070,2019,Guatemala,Sweden,10,13,0,23
15071,2019,Guinea,Sweden,72,46,0,118
15072,2019,Honduras,Sweden,19,31,0,50
15073,2019,Croatia,Sweden,0,5,0,5
15074,2019,Hungary,Sweden,5,0,0,5
15075,2019,Cote d'Ivoire,Sweden,51,17,0,68
15076,2019,India,Sweden,23,105,0,128
15077,2019,Indonesia,Sweden,16,0,0,16
15078,2019,Iran (Islamic Rep. of),Sweden,7408,2441,0,9849
15079,2019,Iraq,Sweden,12460,2879,0,15339
15080,2019,Israel,Sweden,25,20,0,45
15081,2019,Italy,Sweden,5,0,0,5
15082,2019,Jamaica,Sweden,0,5,0,5
15083,2019,Jordan,Sweden,284,273,0,557
15084,2019,Kazakhstan,Sweden,251,219,0,470
15085,2019,Kenya,Sweden,99,67,0,166
15086,2019,Kyrgyzstan,Sweden,175,138,0,313
15087,2019,Rep. of Korea,Sweden,7,5,0,12
15088,2019,Dem. People's Rep. of Korea,Sweden,5,0,0,5
15089,2019,Kuwait,Sweden,32,26,0,58
15090,2019,Liberia,Sweden,13,11,0,24
15091,2019,Libya,Sweden,393,90,0,483
15092,2019,Lebanon,Sweden,542,455,0,997
15093,2019,Sri Lanka,Sweden,28,58,0,86
15094,2019,Lithuania,Sweden,0,7,0,7
15095,2019,Mauritania,Sweden,13,5,0,18
15096,2019,North Macedonia,Sweden,51,107,0,158
15097,2019,Rep. of Moldova,Sweden,8,5,0,13
15098,2019,Mexico,Sweden,0,5,0,5
15099,2019,Mali,Sweden,42,10,0,52
15100,2019,Malaysia,Sweden,13,6,0,19
15101,2019,Mongolia,Sweden,287,241,0,528
15102,2019,Morocco,Sweden,250,238,0,488
15103,2019,Mozambique,Sweden,0,9,0,9
15104,2019,Montenegro,Sweden,34,14,0,48
15105,2019,Myanmar,Sweden,10,12,0,22
15106,2019,Nepal,Sweden,14,20,0,34
15107,2019,Niger,Sweden,5,0,0,5
15108,2019,Nicaragua,Sweden,38,238,0,276
15109,2019,Nigeria,Sweden,588,539,0,1127
15110,2019,Pakistan,Sweden,595,515,0,1110
15111,2019,Peru,Sweden,10,108,0,118
15112,2019,Philippines,Sweden,7,19,0,26
15113,2019,Poland,Sweden,5,0,0,5
15114,2019,Romania,Sweden,56,0,0,56
15115,2019,South Africa,Sweden,0,6,0,6
15116,2019,Russian Federation,Sweden,1506,662,0,2168
15117,2019,Rwanda,Sweden,42,88,0,130
15118,2019,El Salvador,Sweden,127,215,0,342
15119,2019,Saudi Arabia,Sweden,55,11,0,66
15120,2019,Serbia and Kosovo: S/RES/1244 (1999),Sweden,861,351,0,1212
15121,2019,Senegal,Sweden,56,27,0,83
15122,2019,Sierra Leone,Sweden,70,19,0,89
15123,2019,Somalia,Sweden,17593,1084,0,18677
15124,2019,Viet Nam,Sweden,42,40,0,82
15125,2019,Sudan,Sweden,1128,185,0,1313
15126,2019,South Sudan,Sweden,63,0,0,63
15127,2019,Slovakia,Sweden,5,5,0,10
15128,2019,Eswatini,Sweden,5,0,0,5
15129,2019,Syrian Arab Rep.,Sweden,113418,2226,0,115644
15130,2019,United Rep. of Tanzania,Sweden,52,79,0,131
15131,2019,Thailand,Sweden,5,7,0,12
15132,2019,Tajikistan,Sweden,60,108,0,168
15133,2019,Turkmenistan,Sweden,9,5,0,14
15134,2019,Togo,Sweden,5,0,0,5
15135,2019,Tunisia,Sweden,52,71,0,123
15136,2019,Türkiye,Sweden,1638,940,0,2578
15137,2019,United Arab Emirates,Sweden,5,0,0,5
15138,2019,Uganda,Sweden,726,158,0,884
15139,2019,Ukraine,Sweden,223,471,0,694
15140,2019,United States of America,Sweden,22,25,0,47
15141,2019,Uzbekistan,Sweden,565,1371,0,1936
15142,2019,Venezuela (Bolivarian Republic of),Sweden,13,220,0,233
15143,2019,Yemen,Sweden,1659,193,0,1852
15144,2019,Zambia,Sweden,13,5,0,18
15145,2019,Zimbabwe,Sweden,19,5,0,24
15148,2019,Afghanistan,Switzerland,13455,1152,0,14607
15149,2019,Albania,Switzerland,106,76,0,182
15150,2019,Algeria,Switzerland,162,147,0,309
15151,2019,Angola,Switzerland,713,77,0,790
15152,2019,Egypt,Switzerland,115,24,0,139
15153,2019,Armenia,Switzerland,150,73,0,223
15154,2019,Azerbaijan,Switzerland,118,158,0,276
15155,2019,Bahrain,Switzerland,5,0,0,5
15156,2019,Burundi,Switzerland,123,37,0,160
15157,2019,Benin,Switzerland,19,5,0,24
15158,2019,Bangladesh,Switzerland,54,9,0,63
15159,2019,Burkina Faso,Switzerland,18,5,0,23
15160,2019,Belarus,Switzerland,52,20,0,72
15161,2019,Brazil,Switzerland,6,5,0,11
15162,2019,Bosnia and Herzegovina,Switzerland,1647,22,0,1669
15163,2019,Bulgaria,Switzerland,6,0,0,6
15164,2019,Cambodia,Switzerland,291,0,0,291
15165,2019,Canada,Switzerland,0,5,0,5
15166,2019,Central African Rep.,Switzerland,16,5,0,21
15167,2019,Chad,Switzerland,36,14,0,50
15168,2019,China,Switzerland,2825,207,0,3032
15169,2019,Chile,Switzerland,11,5,0,16
15170,2019,Cameroon,Switzerland,181,59,0,240
15171,2019,Congo,Switzerland,51,6,0,57
15172,2019,Dem. Rep. of the Congo,Switzerland,1231,122,0,1353
15173,2019,Colombia,Switzerland,246,90,0,336
15174,2019,Cuba,Switzerland,34,8,0,42
15175,2019,Czechia,Switzerland,5,0,0,5
15176,2019,Djibouti,Switzerland,16,5,0,21
15177,2019,Dominican Rep.,Switzerland,5,0,0,5
15178,2019,Ecuador,Switzerland,5,0,0,5
15179,2019,Equatorial Guinea,Switzerland,5,0,0,5
15180,2019,Eritrea,Switzerland,36698,892,0,37590
15181,2019,Ethiopia,Switzerland,1637,285,0,1922
15182,2019,France,Switzerland,7,0,0,7
15183,2019,Gabon,Switzerland,5,5,0,10
15184,2019,Gambia,Switzerland,52,27,0,79
15185,2019,Georgia,Switzerland,177,221,0,398
15186,2019,Germany,Switzerland,5,0,0,5
15187,2019,Ghana,Switzerland,20,18,0,38
15188,2019,Guinea-Bissau,Switzerland,50,5,0,55
15189,2019,Guatemala,Switzerland,7,0,0,7
15190,2019,Guinea,Switzerland,182,54,0,236
15191,2019,Honduras,Switzerland,0,6,0,6
15192,2019,Croatia,Switzerland,21,0,0,21
15193,2019,Hungary,Switzerland,5,0,0,5
15194,2019,Cote d'Ivoire,Switzerland,180,42,0,222
15195,2019,India,Switzerland,34,13,0,47
15196,2019,Indonesia,Switzerland,0,5,0,5
15197,2019,Iran (Islamic Rep. of),Switzerland,1800,1063,0,2863
15198,2019,Iraq,Switzerland,4545,671,0,5216
15199,2019,Israel,Switzerland,5,0,0,5
15200,2019,Italy,Switzerland,5,0,0,5
15201,2019,Jamaica,Switzerland,0,5,0,5
15202,2019,Jordan,Switzerland,59,0,0,59
15203,2019,Kazakhstan,Switzerland,21,6,0,27
15204,2019,Kenya,Switzerland,41,7,0,48
15205,2019,Kyrgyzstan,Switzerland,20,5,0,25
15206,2019,Kuwait,Switzerland,6,0,0,6
15207,2019,Lao People's Dem. Rep.,Switzerland,115,0,0,115
15208,2019,Liberia,Switzerland,37,0,0,37
15209,2019,Libya,Switzerland,312,50,0,362
15210,2019,Lebanon,Switzerland,43,20,0,63
15211,2019,Sri Lanka,Switzerland,5819,1319,0,7138
15212,2019,Madagascar,Switzerland,5,0,0,5
15213,2019,Mauritania,Switzerland,10,5,0,15
15214,2019,North Macedonia,Switzerland,162,12,0,174
15215,2019,Rep. of Moldova,Switzerland,10,42,0,52
15216,2019,Mali,Switzerland,34,8,0,42
15217,2019,Mongolia,Switzerland,153,13,0,166
15218,2019,Morocco,Switzerland,68,58,0,126
15219,2019,Montenegro,Switzerland,53,5,0,58
15220,2019,Myanmar,Switzerland,34,0,0,34
15221,2019,Nepal,Switzerland,20,8,0,28
15222,2019,Niger,Switzerland,8,0,0,8
15223,2019,Nicaragua,Switzerland,5,14,0,19
15224,2019,Nigeria,Switzerland,246,140,0,386
15225,2019,Pakistan,Switzerland,241,148,0,389
15226,2019,Paraguay,Switzerland,5,0,0,5
15227,2019,Peru,Switzerland,6,0,0,6
15228,2019,Philippines,Switzerland,10,0,0,10
15229,2019,Portugal,Switzerland,5,0,0,5
15230,2019,Romania,Switzerland,19,0,0,19
15231,2019,South Africa,Switzerland,11,0,0,11
15232,2019,Russian Federation,Switzerland,723,138,0,861
15233,2019,Rwanda,Switzerland,126,6,0,132
15234,2019,El Salvador,Switzerland,7,8,0,15
15235,2019,Saudi Arabia,Switzerland,11,9,0,20
15236,2019,Serbia and Kosovo: S/RES/1244 (1999),Switzerland,2389,121,0,2510
15237,2019,Senegal,Switzerland,56,19,0,75
15238,2019,Sierra Leone,Switzerland,30,11,0,41
15239,2019,Somalia,Switzerland,4762,250,0,5012
15240,2019,Spain,Switzerland,5,0,0,5
15241,2019,Viet Nam,Switzerland,848,0,0,848
15242,2019,Sudan,Switzerland,326,37,0,363
15243,2019,South Sudan,Switzerland,13,8,0,21
15244,2019,Syrian Arab Rep.,Switzerland,18755,918,0,19673
15245,2019,United Rep. of Tanzania,Switzerland,16,5,0,21
15246,2019,Tajikistan,Switzerland,21,0,0,21
15247,2019,Turkmenistan,Switzerland,5,0,0,5
15248,2019,Togo,Switzerland,576,24,0,600
15249,2019,Tunisia,Switzerland,205,27,0,232
15250,2019,Türkiye,Switzerland,3925,1774,0,5699
15251,2019,Uganda,Switzerland,42,25,0,67
15252,2019,Ukraine,Switzerland,65,50,0,115
15253,2019,Uzbekistan,Switzerland,54,7,0,61
15254,2019,Venezuela (Bolivarian Republic of),Switzerland,15,49,0,64
15255,2019,Western Sahara,Switzerland,9,5,0,14
15256,2019,Yemen,Switzerland,130,12,0,142
15257,2019,Zimbabwe,Switzerland,13,5,0,18
15260,2019,Afghanistan,Syrian Arab Rep.,1110,32,0,1142
15261,2019,Algeria,Syrian Arab Rep.,5,0,0,5
15262,2019,Egypt,Syrian Arab Rep.,33,10,0,43
15263,2019,Bahrain,Syrian Arab Rep.,0,5,0,5
15264,2019,Chad,Syrian Arab Rep.,9,6,0,15
15265,2019,Eritrea,Syrian Arab Rep.,18,0,0,18
15266,2019,Ethiopia,Syrian Arab Rep.,15,0,0,15
15267,2019,Guinea,Syrian Arab Rep.,51,5,0,56
15268,2019,Cote d'Ivoire,Syrian Arab Rep.,5,0,0,5
15269,2019,Iran (Islamic Rep. of),Syrian Arab Rep.,44,5,0,49
15270,2019,Iraq,Syrian Arab Rep.,13311,11720,0,25031
15271,2019,Jordan,Syrian Arab Rep.,19,0,0,19
15272,2019,Libya,Syrian Arab Rep.,11,10,0,21
15273,2019,Lebanon,Syrian Arab Rep.,23,5,0,28
15274,2019,Sri Lanka,Syrian Arab Rep.,0,5,0,5
15275,2019,Morocco,Syrian Arab Rep.,5,0,0,5
15276,2019,Pakistan,Syrian Arab Rep.,207,10,0,217
15277,2019,Saudi Arabia,Syrian Arab Rep.,9,0,0,9
15278,2019,Sierra Leone,Syrian Arab Rep.,19,0,0,19
15279,2019,Somalia,Syrian Arab Rep.,346,31,0,377
15280,2019,Sudan,Syrian Arab Rep.,718,92,0,810
15281,2019,South Sudan,Syrian Arab Rep.,80,0,0,80
15282,2019,Syrian Arab Rep.,Syrian Arab Rep.,0,0,6146994,0
15283,2019,United Rep. of Tanzania,Syrian Arab Rep.,0,7,0,7
15284,2019,Tunisia,Syrian Arab Rep.,5,5,0,10
15285,2019,Türkiye,Syrian Arab Rep.,6,7,0,13
15286,2019,Yemen,Syrian Arab Rep.,159,110,0,269
15289,2019,Burundi,United Rep. of Tanzania,192231,12059,0,204290
15290,2019,Congo,United Rep. of Tanzania,5,0,0,5
15291,2019,Dem. Rep. of the Congo,United Rep. of Tanzania,49672,17375,0,67047
15292,2019,Kenya,United Rep. of Tanzania,5,0,0,5
15293,2019,Lebanon,United Rep. of Tanzania,0,0,0,0
15294,2019,Rwanda,United Rep. of Tanzania,65,30,0,95
15295,2019,Somalia,United Rep. of Tanzania,159,5,0,164
15296,2019,South Sudan,United Rep. of Tanzania,10,9,0,19
15297,2019,Syrian Arab Rep.,United Rep. of Tanzania,5,16,0,21
15298,2019,United Rep. of Tanzania,United Rep. of Tanzania,0,0,0,0
15299,2019,Türkiye,United Rep. of Tanzania,0,10,0,10
15300,2019,Uganda,United Rep. of Tanzania,14,5,0,19
15301,2019,Yemen,United Rep. of Tanzania,5,45,0,50
15302,2019,Cuba,Turks and Caicos Islands,5,0,0,5
15303,2019,Afghanistan,Thailand,134,18,0,152
15304,2019,Egypt,Thailand,16,10,0,26
15305,2019,Cambodia,Thailand,228,93,0,321
15306,2019,China,Thailand,174,14,0,188
15307,2019,Cameroon,Thailand,29,22,0,51
15308,2019,Dem. Rep. of the Congo,Thailand,19,0,0,19
15309,2019,Eritrea,Thailand,5,0,0,5
15310,2019,Ethiopia,Thailand,20,10,0,30
15311,2019,Palestinian,Thailand,310,5,0,315
15312,2019,Guinea,Thailand,0,5,0,5
15313,2019,Cote d'Ivoire,Thailand,17,0,0,17
15314,2019,India,Thailand,0,5,0,5
15315,2019,Iran (Islamic Rep. of),Thailand,69,36,0,105
15316,2019,Iraq,Thailand,177,5,0,182
15317,2019,Jordan,Thailand,5,0,0,5
15318,2019,Lao People's Dem. Rep.,Thailand,6,0,0,6
15319,2019,Sri Lanka,Thailand,131,24,0,155
15320,2019,Myanmar,Thailand,93335,13,0,93348
15321,2019,Nepal,Thailand,6,0,0,6
15322,2019,Pakistan,Thailand,1667,111,0,1778
15323,2019,Somalia,Thailand,200,24,0,224
15324,2019,Viet Nam,Thailand,744,420,0,1164
15325,2019,Sudan,Thailand,5,0,0,5
15326,2019,Syrian Arab Rep.,Thailand,217,8,0,225
15327,2019,United Rep. of Tanzania,Thailand,5,0,0,5
15328,2019,Türkiye,Thailand,0,5,0,5
15329,2019,Yemen,Thailand,37,0,0,37
15330,2019,Zimbabwe,Thailand,0,9,0,9
15332,2019,Afghanistan,Tajikistan,3783,1413,0,5196
15333,2019,Iran (Islamic Rep. of),Tajikistan,5,0,0,5
15335,2019,Afghanistan,Turkmenistan,14,0,0,14
15336,2019,Azerbaijan,Turkmenistan,7,0,0,7
15338,2019,Burundi,Togo,5,0,0,5
15339,2019,Benin,Togo,0,5,0,5
15340,2019,Burkina Faso,Togo,0,5,0,5
15341,2019,Central African Rep.,Togo,236,127,0,363
15342,2019,Chad,Togo,12,13,0,25
15343,2019,Cameroon,Togo,7,9,0,16
15344,2019,Congo,Togo,30,20,0,50
15345,2019,Dem. Rep. of the Congo,Togo,101,84,0,185
15346,2019,Ghana,Togo,9768,0,0,9768
15347,2019,Cote d'Ivoire,Togo,1544,333,0,1877
15348,2019,Iraq,Togo,5,0,0,5
15349,2019,Lebanon,Togo,0,17,0,17
15350,2019,Sri Lanka,Togo,0,5,0,5
15351,2019,Mali,Togo,72,35,0,107
15352,2019,Nigeria,Togo,8,14,0,22
15353,2019,Rwanda,Togo,120,0,0,120
15354,2019,Sudan,Togo,0,5,0,5
15355,2019,Syrian Arab Rep.,Togo,6,11,0,17
15356,2019,Türkiye,Togo,50,9,0,59
15357,2019,Egypt,Trinidad and Tobago,0,5,0,5
15358,2019,Bangladesh,Trinidad and Tobago,8,89,0,97
15359,2019,China,Trinidad and Tobago,0,79,0,79
15360,2019,Cameroon,Trinidad and Tobago,0,10,0,10
15361,2019,Colombia,Trinidad and Tobago,12,53,0,65
15362,2019,Cuba,Trinidad and Tobago,155,2257,0,2412
15363,2019,Dominican Rep.,Trinidad and Tobago,0,130,0,130
15364,2019,Ghana,Trinidad and Tobago,0,39,0,39
15365,2019,Grenada,Trinidad and Tobago,0,5,0,5
15366,2019,Guyana,Trinidad and Tobago,0,53,0,53
15367,2019,Haiti,Trinidad and Tobago,0,15,0,15
15368,2019,India,Trinidad and Tobago,0,5,0,5
15369,2019,Jamaica,Trinidad and Tobago,15,94,0,109
15370,2019,Mexico,Trinidad and Tobago,6,0,0,6
15371,2019,Nicaragua,Trinidad and Tobago,0,5,0,5
15372,2019,Nigeria,Trinidad and Tobago,0,148,0,148
15373,2019,Pakistan,Trinidad and Tobago,9,21,0,30
15374,2019,Philippines,Trinidad and Tobago,0,5,0,5
15375,2019,Viet Nam,Trinidad and Tobago,0,7,0,7
15376,2019,Syrian Arab Rep.,Trinidad and Tobago,58,38,0,96
15377,2019,Tajikistan,Trinidad and Tobago,0,5,0,5
15378,2019,Trinidad and Tobago,Trinidad and Tobago,0,0,0,0
15379,2019,Saint Vincent and the Grenadines,Trinidad and Tobago,5,5,0,10
15380,2019,Venezuela (Bolivarian Republic of),Trinidad and Tobago,2040,14296,0,16336
15381,2019,Algeria,Tunisia,9,13,0,22
15382,2019,Egypt,Tunisia,0,5,0,5
15383,2019,Bangladesh,Tunisia,0,10,0,10
15384,2019,Burkina Faso,Tunisia,0,12,0,12
15385,2019,Central African Rep.,Tunisia,9,9,0,18
15386,2019,Chad,Tunisia,0,12,0,12
15387,2019,Cameroon,Tunisia,5,36,0,41
15388,2019,Dem. Rep. of the Congo,Tunisia,0,36,0,36
15389,2019,Eritrea,Tunisia,158,85,0,243
15390,2019,Ethiopia,Tunisia,0,42,0,42
15391,2019,Palestinian,Tunisia,35,9,0,44
15392,2019,Ghana,Tunisia,0,5,0,5
15393,2019,Guinea,Tunisia,0,38,0,38
15394,2019,Cote d'Ivoire,Tunisia,15,637,0,652
15395,2019,Iran (Islamic Rep. of),Tunisia,5,5,0,10
15396,2019,Iraq,Tunisia,20,7,0,27
15397,2019,Liberia,Tunisia,0,9,0,9
15398,2019,Libya,Tunisia,7,31,0,38
15399,2019,Lebanon,Tunisia,6,0,0,6
15400,2019,Mali,Tunisia,0,11,0,11
15401,2019,Niger,Tunisia,0,5,0,5
15402,2019,Nigeria,Tunisia,0,21,0,21
15403,2019,Rwanda,Tunisia,6,0,0,6
15404,2019,Senegal,Tunisia,0,5,0,5
15405,2019,Sierra Leone,Tunisia,5,0,0,5
15406,2019,Somalia,Tunisia,19,170,0,189
15407,2019,Sudan,Tunisia,51,232,0,283
15408,2019,South Sudan,Tunisia,0,26,0,26
15409,2019,Syrian Arab Rep.,Tunisia,1382,0,0,1382
15410,2019,Türkiye,Tunisia,0,15,0,15
15411,2019,Yemen,Tunisia,0,31,0,31
15412,2019,Afghanistan,Türkiye,1192,116403,0,117595
15413,2019,Iran (Islamic Rep. of),Türkiye,548,27029,0,27577
15414,2019,Iraq,Türkiye,1279,173245,0,174524
15415,2019,Syrian Arab Rep.,Türkiye,3576370,0,0,3576370
15417,2019,Afghanistan,United Arab Emirates,5,25,0,30
15418,2019,Algeria,United Arab Emirates,0,0,0,0
15419,2019,Egypt,United Arab Emirates,8,6,0,14
15420,2019,Chad,United Arab Emirates,6,0,0,6
15421,2019,Eritrea,United Arab Emirates,0,7,0,7
15422,2019,Ethiopia,United Arab Emirates,10,5,0,15
15423,2019,Palestinian,United Arab Emirates,15,0,0,15
15424,2019,Iran (Islamic Rep. of),United Arab Emirates,7,10,0,17
15425,2019,Iraq,United Arab Emirates,783,560,0,1343
15426,2019,Jordan,United Arab Emirates,6,0,0,6
15427,2019,Kuwait,United Arab Emirates,5,0,0,5
15428,2019,Libya,United Arab Emirates,0,5,0,5
15429,2019,Lebanon,United Arab Emirates,16,7,0,23
15430,2019,Morocco,United Arab Emirates,0,0,0,0
15431,2019,Pakistan,United Arab Emirates,5,0,0,5
15432,2019,Philippines,United Arab Emirates,0,0,0,0
15433,2019,Russian Federation,United Arab Emirates,0,5,0,5
15434,2019,Saudi Arabia,United Arab Emirates,5,0,0,5
15435,2019,Somalia,United Arab Emirates,18,0,0,18
15436,2019,Sudan,United Arab Emirates,8,11,0,19
15437,2019,Syrian Arab Rep.,United Arab Emirates,333,6575,0,6908
15438,2019,Yemen,United Arab Emirates,12,50,0,62
15439,2019,Egypt,Uganda,0,8,0,8
15440,2019,Burundi,Uganda,43888,1783,0,45671
15441,2019,Central African Rep.,Uganda,32,0,0,32
15442,2019,Chad,Uganda,6,5,0,11
15443,2019,Cameroon,Uganda,5,0,0,5
15444,2019,Congo,Uganda,19,0,0,19
15445,2019,Dem. Rep. of the Congo,Uganda,394037,3601,0,397638
15446,2019,Eritrea,Uganda,6435,8064,0,14499
15447,2019,Ethiopia,Uganda,2007,954,0,2961
15448,2019,Palestinian,Uganda,5,0,0,5
15449,2019,Guinea,Uganda,5,0,0,5
15450,2019,Kenya,Uganda,200,19,0,219
15451,2019,Mali,Uganda,0,5,0,5
15452,2019,Pakistan,Uganda,220,22,0,242
15453,2019,Rwanda,Uganda,15362,1748,0,17110
15454,2019,Senegal,Uganda,10,0,0,10
15455,2019,Somalia,Uganda,33073,4887,0,37960
15456,2019,Sudan,Uganda,2627,409,0,3036
15457,2019,South Sudan,Uganda,861452,138,0,861590
15458,2019,Syrian Arab Rep.,Uganda,6,10,0,16
15459,2019,United Rep. of Tanzania,Uganda,9,0,0,9
15460,2019,Türkiye,Uganda,33,0,0,33
15461,2019,Uganda,Uganda,0,0,0,0
15462,2019,Yemen,Uganda,27,5,0,32
15463,2019,Afghanistan,Ukraine,820,641,0,1461
15464,2019,Algeria,Ukraine,0,12,0,12
15465,2019,Angola,Ukraine,24,0,0,24
15466,2019,Egypt,Ukraine,5,15,0,20
15467,2019,Armenia,Ukraine,47,5,0,52
15468,2019,Azerbaijan,Ukraine,72,22,0,94
15469,2019,Bangladesh,Ukraine,5,161,0,166
15470,2019,Belarus,Ukraine,24,7,0,31
15471,2019,Chad,Ukraine,7,0,0,7
15472,2019,China,Ukraine,0,6,0,6
15473,2019,Cameroon,Ukraine,5,30,0,35
15474,2019,Congo,Ukraine,26,12,0,38
15475,2019,Dem. Rep. of the Congo,Ukraine,26,37,0,63
15476,2019,Eritrea,Ukraine,11,29,0,40
15477,2019,Ethiopia,Ukraine,26,5,0,31
15478,2019,Palestinian,Ukraine,10,39,0,49
15479,2019,Georgia,Ukraine,26,5,0,31
15480,2019,Ghana,Ukraine,0,13,0,13
15481,2019,Guinea,Ukraine,5,28,0,33
15482,2019,Cote d'Ivoire,Ukraine,0,19,0,19
15483,2019,India,Ukraine,7,28,0,35
15484,2019,Iran (Islamic Rep. of),Ukraine,73,53,0,126
15485,2019,Iraq,Ukraine,80,93,0,173
15486,2019,Jordan,Ukraine,5,8,0,13
15487,2019,Kazakhstan,Ukraine,7,18,0,25
15488,2019,Kyrgyzstan,Ukraine,7,32,0,39
15489,2019,Libya,Ukraine,0,19,0,19
15490,2019,Lebanon,Ukraine,8,16,0,24
15491,2019,Sri Lanka,Ukraine,7,29,0,36
15492,2019,Morocco,Ukraine,0,16,0,16
15493,2019,Myanmar,Ukraine,0,6,0,6
15494,2019,Nigeria,Ukraine,6,41,0,47
15495,2019,Pakistan,Ukraine,8,83,0,91
15496,2019,Russian Federation,Ukraine,122,233,0,355
15497,2019,Rwanda,Ukraine,5,0,0,5
15498,2019,Serbia and Kosovo: S/RES/1244 (1999),Ukraine,5,0,0,5
15499,2019,Senegal,Ukraine,0,5,0,5
15500,2019,Sierra Leone,Ukraine,5,0,0,5
15501,2019,Somalia,Ukraine,85,106,0,191
15502,2019,Viet Nam,Ukraine,0,13,0,13
15503,2019,Sudan,Ukraine,28,28,0,56
15504,2019,Syrian Arab Rep.,Ukraine,462,161,0,623
15505,2019,Tajikistan,Ukraine,13,161,0,174
15506,2019,Turkmenistan,Ukraine,7,0,0,7
15507,2019,Türkiye,Ukraine,7,10,0,17
15508,2019,Ukraine,Ukraine,0,0,734000,0
15509,2019,Uzbekistan,Ukraine,30,78,0,108
15510,2019,Yemen,Ukraine,5,48,0,53
15512,2019,Afghanistan,Uruguay,0,5,0,5
15513,2019,Angola,Uruguay,14,5,0,19
15514,2019,Egypt,Uruguay,0,5,0,5
15515,2019,Argentina,Uruguay,0,5,0,5
15516,2019,Bangladesh,Uruguay,0,66,0,66
15517,2019,Bolivia (Plurinational State of),Uruguay,5,0,0,5
15518,2019,Brazil,Uruguay,0,14,0,14
15519,2019,Canada,Uruguay,0,5,0,5
15520,2019,Cameroon,Uruguay,10,5,0,15
15521,2019,Congo,Uruguay,5,0,0,5
15522,2019,Colombia,Uruguay,158,29,0,187
15523,2019,Cuba,Uruguay,25,12371,0,12396
15524,2019,Cabo Verde,Uruguay,0,5,0,5
15525,2019,Dominican Rep.,Uruguay,0,194,0,194
15526,2019,Ecuador,Uruguay,7,5,0,12
15527,2019,Ghana,Uruguay,0,22,0,22
15528,2019,Guinea-Bissau,Uruguay,0,5,0,5
15529,2019,Guatemala,Uruguay,5,0,0,5
15530,2019,Guinea,Uruguay,0,11,0,11
15531,2019,Haiti,Uruguay,0,15,0,15
15532,2019,India,Uruguay,0,5,0,5
15533,2019,Libya,Uruguay,5,0,0,5
15534,2019,Latvia,Uruguay,5,0,0,5
15535,2019,Mauritania,Uruguay,0,5,0,5
15536,2019,Mexico,Uruguay,5,0,0,5
15537,2019,Morocco,Uruguay,0,14,0,14
15538,2019,Nicaragua,Uruguay,6,8,0,14
15539,2019,Nigeria,Uruguay,22,12,0,34
15540,2019,Pakistan,Uruguay,0,40,0,40
15541,2019,Paraguay,Uruguay,7,0,0,7
15542,2019,Peru,Uruguay,6,0,0,6
15543,2019,Russian Federation,Uruguay,12,5,0,17
15544,2019,El Salvador,Uruguay,37,18,0,55
15545,2019,Senegal,Uruguay,0,374,0,374
15546,2019,Somalia,Uruguay,5,0,0,5
15547,2019,Syrian Arab Rep.,Uruguay,61,7,0,68
15548,2019,Türkiye,Uruguay,13,5,0,18
15549,2019,Ukraine,Uruguay,11,5,0,16
15550,2019,Venezuela (Bolivarian Republic of),Uruguay,74,472,0,546
15551,2019,Yemen,Uruguay,0,5,0,5
15552,2019,Afghanistan,United States of America,1629,727,0,2356
15553,2019,Albania,United States of America,1436,1902,0,3338
15554,2019,Algeria,United States of America,158,376,0,534
15555,2019,Angola,United States of America,246,1684,0,1930
15556,2019,Antigua and Barbuda,United States of America,8,12,0,20
15557,2019,Egypt,United States of America,14291,4721,0,19012
15558,2019,Argentina,United States of America,41,264,0,305
15559,2019,Armenia,United States of America,1551,2925,0,4476
15560,2019,Australia,United States of America,5,13,0,18
15561,2019,Austria,United States of America,13,0,0,13
15562,2019,Azerbaijan,United States of America,474,1098,0,1572
15563,2019,Bahrain,United States of America,47,34,0,81
15564,2019,Barbados,United States of America,0,5,0,5
15565,2019,Burundi,United States of America,846,612,0,1458
15566,2019,Belgium,United States of America,23,32,0,55
15567,2019,Benin,United States of America,89,198,0,287
15568,2019,Bangladesh,United States of America,2038,7303,0,9341
15569,2019,Bahamas,United States of America,181,96,0,277
15570,2019,Bhutan,United States of America,34,353,0,387
15571,2019,Burkina Faso,United States of America,1403,3292,0,4695
15572,2019,Belarus,United States of America,1631,2193,0,3824
15573,2019,Bolivia (Plurinational State of),United States of America,111,453,0,564
15574,2019,Botswana,United States of America,0,6,0,6
15575,2019,Brazil,United States of America,932,9217,0,10149
15576,2019,Bosnia and Herzegovina,United States of America,98,174,0,272
15577,2019,Bulgaria,United States of America,234,265,0,499
15578,2019,Belize,United States of America,43,239,0,282
15579,2019,Cambodia,United States of America,142,63,0,205
15580,2019,Canada,United States of America,31,55,0,86
15581,2019,Central African Rep.,United States of America,199,99,0,298
15582,2019,Cayman Islands,United States of America,6,0,0,6
15583,2019,Chad,United States of America,276,223,0,499
15584,2019,China,United States of America,78752,68794,0,147546
15585,2019,Chile,United States of America,23,220,0,243
15586,2019,Cameroon,United States of America,5000,5078,0,10078
15587,2019,Congo,United States of America,1186,428,0,1614
15588,2019,Dem. Rep. of the Congo,United States of America,1448,2912,0,4360
15589,2019,Comoros,United States of America,5,10,0,15
15590,2019,Colombia,United States of America,2936,12570,0,15506
15591,2019,Costa Rica,United States of America,172,550,0,722
15592,2019,Cuba,United States of America,1765,5899,0,7664
15593,2019,Cabo Verde,United States of America,0,33,0,33
15594,2019,Cyprus,United States of America,0,5,0,5
15595,2019,Czechia,United States of America,13,33,0,46
15596,2019,Denmark,United States of America,0,5,0,5
15597,2019,Djibouti,United States of America,352,468,0,820
15598,2019,Dominica,United States of America,16,22,0,38
15599,2019,Dominican Rep.,United States of America,246,1046,0,1292
15600,2019,Ecuador,United States of America,1378,18557,0,19935
15601,2019,Equatorial Guinea,United States of America,17,52,0,69
15602,2019,Eritrea,United States of America,5941,1056,0,6997
15603,2019,Estonia,United States of America,254,38,0,292
15604,2019,Ethiopia,United States of America,9079,5556,0,14635
15605,2019,French Guiana,United States of America,0,5,0,5
15606,2019,Fiji,United States of America,154,278,0,432
15607,2019,France,United States of America,23,141,0,164
15608,2019,Gabon,United States of America,49,254,0,303
15609,2019,Gambia,United States of America,1511,816,0,2327
15610,2019,Palestinian,United States of America,14,99,0,113
15611,2019,United Kingdom of Great Britain and Northern Ireland,United States of America,32,110,0,142
15612,2019,Georgia,United States of America,456,1852,0,2308
15613,2019,Germany,United States of America,43,125,0,168
15614,2019,Ghana,United States of America,481,912,0,1393
15615,2019,Guinea-Bissau,United States of America,19,26,0,45
15616,2019,Greece,United States of America,15,71,0,86
15617,2019,Grenada,United States of America,25,40,0,65
15618,2019,Guatemala,United States of America,20883,114404,0,135287
15619,2019,Guinea,United States of America,2001,1098,0,3099
15620,2019,Guyana,United States of America,114,394,0,508
15621,2019,Haiti,United States of America,15698,19061,0,34759
15622,2019,"China, Hong Kong SAR",United States of America,0,15,0,15
15623,2019,Honduras,United States of America,15110,81375,0,96485
15624,2019,Croatia,United States of America,31,33,0,64
15625,2019,Hungary,United States of America,16,247,0,263
15626,2019,Cote d'Ivoire,United States of America,1162,1199,0,2361
15627,2019,India,United States of America,8174,33996,0,42170
15628,2019,Indonesia,United States of America,1228,2271,0,3499
15629,2019,Ireland,United States of America,0,29,0,29
15630,2019,Iran (Islamic Rep. of),United States of America,5824,2816,0,8640
15631,2019,Iraq,United States of America,5632,3339,0,8971
15632,2019,Israel,United States of America,130,480,0,610
15633,2019,Italy,United States of America,22,240,0,262
15634,2019,Jamaica,United States of America,926,1049,0,1975
15635,2019,Jordan,United States of America,621,2289,0,2910
15636,2019,Japan,United States of America,6,79,0,85
15637,2019,Kazakhstan,United States of America,1025,2196,0,3221
15638,2019,Kenya,United States of America,1931,4485,0,6416
15639,2019,Kyrgyzstan,United States of America,1584,1528,0,3112
15640,2019,Rep. of Korea,United States of America,32,162,0,194
15641,2019,Dem. People's Rep. of Korea,United States of America,6,26,0,32
15642,2019,Kuwait,United States of America,147,198,0,345
15643,2019,Lao People's Dem. Rep.,United States of America,79,156,0,235
15644,2019,Liberia,United States of America,1276,1040,0,2316
15645,2019,Libya,United States of America,395,1027,0,1422
15646,2019,Saint Lucia,United States of America,9,21,0,30
15647,2019,Lebanon,United States of America,411,810,0,1221
15648,2019,Lesotho,United States of America,6,0,0,6
15649,2019,Sri Lanka,United States of America,1232,1746,0,2978
15650,2019,Lithuania,United States of America,24,62,0,86
15651,2019,Latvia,United States of America,21,81,0,102
15652,2019,Madagascar,United States of America,12,14,0,26
15653,2019,Mauritania,United States of America,990,911,0,1901
15654,2019,North Macedonia,United States of America,121,193,0,314
15655,2019,Monaco,United States of America,5,0,0,5
15656,2019,Rep. of Moldova,United States of America,1530,2215,0,3745
15657,2019,Maldives,United States of America,5,0,0,5
15658,2019,Mexico,United States of America,11410,94275,0,105685
15659,2019,Marshall Islands,United States of America,7,0,0,7
15660,2019,Mali,United States of America,1129,563,0,1692
15661,2019,Malaysia,United States of America,97,348,0,445
15662,2019,Malawi,United States of America,37,115,0,152
15663,2019,Mongolia,United States of America,804,2067,0,2871
15664,2019,Morocco,United States of America,125,212,0,337
15665,2019,Mozambique,United States of America,21,36,0,57
15666,2019,Malta,United States of America,0,5,0,5
15667,2019,Montenegro,United States of America,94,331,0,425
15668,2019,Mauritius,United States of America,38,39,0,77
15669,2019,Myanmar,United States of America,1429,1294,0,2723
15670,2019,Namibia,United States of America,43,20,0,63
15671,2019,Nepal,United States of America,7122,6755,0,13877
15672,2019,Netherlands,United States of America,11,56,0,67
15673,2019,Niger,United States of America,152,303,0,455
15674,2019,Nicaragua,United States of America,1489,5861,0,7350
15675,2019,Nigeria,United States of America,2291,11682,0,13973
15676,2019,Niue,United States of America,19,6,0,25
15677,2019,Oman,United States of America,9,21,0,30
15678,2019,Pakistan,United States of America,3964,5567,0,9531
15679,2019,Panama,United States of America,13,105,0,118
15680,2019,Paraguay,United States of America,20,90,0,110
15681,2019,Peru,United States of America,531,3170,0,3701
15682,2019,Philippines,United States of America,168,1510,0,1678
15683,2019,Poland,United States of America,12,851,0,863
15684,2019,Portugal,United States of America,5,179,0,184
15685,2019,Qatar,United States of America,21,26,0,47
15686,2019,Romania,United States of America,444,3080,0,3524
15687,2019,South Africa,United States of America,52,291,0,343
15688,2019,Russian Federation,United States of America,6702,10194,0,16896
15689,2019,Rwanda,United States of America,1247,897,0,2144
15690,2019,El Salvador,United States of America,26216,113404,0,139620
15691,2019,Saudi Arabia,United States of America,568,768,0,1336
15692,2019,Serbia and Kosovo: S/RES/1244 (1999),United States of America,845,1095,0,1940
15693,2019,Senegal,United States of America,405,605,0,1010
15694,2019,Seychelles,United States of America,5,0,0,5
15695,2019,Singapore,United States of America,8,39,0,47
15696,2019,Sierra Leone,United States of America,464,316,0,780
15697,2019,Somalia,United States of America,1971,345,0,2316
15698,2019,Spain,United States of America,10,108,0,118
15699,2019,Viet Nam,United States of America,353,928,0,1281
15700,2019,Saint Kitts and Nevis,United States of America,5,5,0,10
15701,2019,Sudan,United States of America,1441,839,0,2280
15702,2019,Suriname,United States of America,12,37,0,49
15703,2019,South Sudan,United States of America,45,37,0,82
15704,2019,Slovakia,United States of America,6,12,0,18
15705,2019,Slovenia,United States of America,6,10,0,16
15706,2019,Eswatini,United States of America,5,17,0,22
15707,2019,Sweden,United States of America,5,18,0,23
15708,2019,Switzerland,United States of America,5,10,0,15
15709,2019,Syrian Arab Rep.,United States of America,8449,2660,0,11109
15710,2019,United Rep. of Tanzania,United States of America,130,193,0,323
15711,2019,Turks and Caicos Islands,United States of America,14,0,0,14
15712,2019,Thailand,United States of America,39,459,0,498
15713,2019,Tajikistan,United States of America,331,475,0,806
15714,2019,Turkmenistan,United States of America,205,285,0,490
15715,2019,Timor-Leste,United States of America,0,10,0,10
15716,2019,Togo,United States of America,565,574,0,1139
15717,2019,Tonga,United States of America,0,8,0,8
15718,2019,Trinidad and Tobago,United States of America,49,224,0,273
15719,2019,Tunisia,United States of America,86,246,0,332
15720,2019,Türkiye,United States of America,2501,3518,0,6019
15721,2019,United Arab Emirates,United States of America,72,154,0,226
15722,2019,Uganda,United States of America,1760,2795,0,4555
15723,2019,Ukraine,United States of America,2580,7817,0,10397
15724,2019,Uruguay,United States of America,5,123,0,128
15725,2019,Uzbekistan,United States of America,1317,2156,0,3473
15726,2019,Vanuatu,United States of America,0,9,0,9
15727,2019,Saint Vincent and the Grenadines,United States of America,32,20,0,52
15728,2019,Venezuela (Bolivarian Republic of),United States of America,15706,104989,0,120695
15729,2019,Yemen,United States of America,692,811,0,1503
15730,2019,Zambia,United States of America,51,86,0,137
15731,2019,Zimbabwe,United States of America,825,867,0,1692
15733,2019,Curacao ,United States of America,35,0,0,35
15735,2019,Afghanistan,Uzbekistan,13,0,0,13
15737,2019,Venezuela (Bolivarian Republic of),Saint Vincent and the Grenadines,0,0,0,0
15738,2019,Afghanistan,Venezuela (Bolivarian Republic of),10,0,0,10
15739,2019,Chile,Venezuela (Bolivarian Republic of),10,0,0,10
15740,2019,Congo,Venezuela (Bolivarian Republic of),5,0,0,5
15741,2019,Colombia,Venezuela (Bolivarian Republic of),67622,49,0,67671
15742,2019,Palestinian,Venezuela (Bolivarian Republic of),7,0,0,7
15743,2019,Haiti,Venezuela (Bolivarian Republic of),7,0,0,7
15744,2019,Iraq,Venezuela (Bolivarian Republic of),18,0,0,18
15745,2019,Liberia,Venezuela (Bolivarian Republic of),9,0,0,9
15746,2019,Libya,Venezuela (Bolivarian Republic of),5,0,0,5
15747,2019,Lebanon,Venezuela (Bolivarian Republic of),12,0,0,12
15748,2019,Nigeria,Venezuela (Bolivarian Republic of),7,0,0,7
15749,2019,Peru,Venezuela (Bolivarian Republic of),5,0,0,5
15750,2019,Rwanda,Venezuela (Bolivarian Republic of),5,0,0,5
15751,2019,Sierra Leone,Venezuela (Bolivarian Republic of),5,0,0,5
15752,2019,Syrian Arab Rep.,Venezuela (Bolivarian Republic of),5,0,0,5
15753,2019,Türkiye,Venezuela (Bolivarian Republic of),6,0,0,6
15754,2019,Venezuela (Bolivarian Republic of),Venezuela (Bolivarian Republic of),0,0,0,0
15755,2019,Western Sahara,Venezuela (Bolivarian Republic of),11,0,0,11
15756,2019,Egypt,Yemen,16,9,0,25
15757,2019,Cameroon,Yemen,0,5,0,5
15758,2019,Dem. Rep. of the Congo,Yemen,0,5,0,5
15759,2019,Djibouti,Yemen,5,6,0,11
15760,2019,Eritrea,Yemen,1365,475,0,1840
15761,2019,Ethiopia,Yemen,6565,8668,0,15233
15762,2019,Palestinian,Yemen,625,309,0,934
15763,2019,Iran (Islamic Rep. of),Yemen,5,0,0,5
15764,2019,Iraq,Yemen,3321,73,0,3394
15765,2019,Jordan,Yemen,17,8,0,25
15766,2019,Lebanon,Yemen,0,6,0,6
15767,2019,Mali,Yemen,0,5,0,5
15768,2019,Pakistan,Yemen,0,9,0,9
15769,2019,Somalia,Yemen,252899,155,0,253054
15770,2019,Viet Nam,Yemen,15,0,0,15
15771,2019,Sudan,Yemen,119,529,0,648
15772,2019,Syrian Arab Rep.,Yemen,3551,407,0,3958
15773,2019,United Rep. of Tanzania,Yemen,0,0,0,0
15774,2019,Yemen,Yemen,0,0,3625716,0
15775,2019,Angola,Zambia,0,0,0,0
15776,2019,Burundi,Zambia,5490,1528,0,7018
15777,2019,Cameroon,Zambia,5,21,0,26
15778,2019,Congo,Zambia,7,0,0,7
15779,2019,Dem. Rep. of the Congo,Zambia,47568,3093,0,50661
15780,2019,Eritrea,Zambia,22,30,0,52
15781,2019,Ethiopia,Zambia,27,19,0,46
15782,2019,Palestinian,Zambia,14,0,0,14
15783,2019,Liberia,Zambia,8,0,0,8
15784,2019,Nigeria,Zambia,0,5,0,5
15785,2019,South Africa,Zambia,6,0,0,6
15786,2019,Rwanda,Zambia,774,64,0,838
15787,2019,Sierra Leone,Zambia,5,5,0,10
15788,2019,Somalia,Zambia,3379,245,0,3624
15789,2019,Sudan,Zambia,28,0,0,28
15790,2019,Syrian Arab Rep.,Zambia,15,6,0,21
15791,2019,Türkiye,Zambia,53,7,0,60
15792,2019,Uganda,Zambia,46,44,0,90
15794,2019,Burundi,Zimbabwe,660,202,0,862
15795,2019,Central African Rep.,Zimbabwe,0,5,0,5
15796,2019,Cameroon,Zimbabwe,0,7,0,7
15797,2019,Congo,Zimbabwe,20,0,0,20
15798,2019,Dem. Rep. of the Congo,Zimbabwe,7483,2977,0,10460
15799,2019,Eritrea,Zimbabwe,20,5,0,25
15800,2019,Ethiopia,Zimbabwe,71,12,0,83
15801,2019,Cote d'Ivoire,Zimbabwe,12,20,0,32
15802,2019,Kenya,Zimbabwe,0,8,0,8
15803,2019,Mali,Zimbabwe,6,67,0,73
15804,2019,Mozambique,Zimbabwe,0,8119,0,8119
15805,2019,South Africa,Zimbabwe,0,0,0,0
15806,2019,Rwanda,Zimbabwe,649,62,0,711
15807,2019,Somalia,Zimbabwe,14,19,0,33
15808,2019,Sudan,Zimbabwe,5,0,0,5
15809,2019,South Sudan,Zimbabwe,8,24,0,32
15810,2019,Uganda,Zimbabwe,8,5,0,13
15811,2019,Zambia,Zimbabwe,0,0,0,0
15812,2019,Zimbabwe,Zimbabwe,0,0,270000,0
15813,2019,Venezuela (Bolivarian Republic of),Anguilla,0,0,0,0
15814,2019,Colombia,Aruba,0,8,0,8
15815,2019,Venezuela (Bolivarian Republic of),Aruba,0,398,0,398
15816,2019,Colombia,Curacao ,28,49,0,77
15817,2019,Venezuela (Bolivarian Republic of),Curacao ,14,296,0,310
15818,2019,Cuba,Sint Maarten (Dutch part),0,5,0,5
15819,2019,Iran (Islamic Rep. of),Sint Maarten (Dutch part),5,0,0,5
15820,2020,Afghanistan,Afghanistan,0,0,2886317,0
15821,2020,Benin,Afghanistan,0,5,0,5
15822,2020,Iran (Islamic Rep. of),Afghanistan,37,26,0,63
15823,2020,Pakistan,Afghanistan,72185,136,0,72321
15824,2020,Türkiye,Afghanistan,56,0,0,56
15825,2020,Afghanistan,Albania,0,0,0,0
15826,2020,Egypt,Albania,5,0,0,5
15827,2020,China,Albania,14,0,0,14
15828,2020,Palestinian,Albania,5,0,0,5
15829,2020,Iraq,Albania,5,0,0,5
15830,2020,Serbia and Kosovo: S/RES/1244 (1999),Albania,57,0,0,57
15831,2020,Syrian Arab Rep.,Albania,9,0,0,9
15832,2020,Uzbekistan,Albania,5,0,0,5
15833,2020,Venezuela (Bolivarian Republic of),Albania,5,0,0,5
15835,2020,Benin,Algeria,0,54,0,54
15836,2020,Burkina Faso,Algeria,0,14,0,14
15837,2020,Central African Rep.,Algeria,81,36,0,117
15838,2020,Chad,Algeria,0,31,0,31
15839,2020,Cameroon,Algeria,127,348,0,475
15840,2020,Congo,Algeria,0,5,0,5
15841,2020,Dem. Rep. of the Congo,Algeria,72,107,0,179
15842,2020,Eritrea,Algeria,0,6,0,6
15843,2020,Gambia,Algeria,0,5,0,5
15844,2020,Palestinian,Algeria,185,0,0,185
15845,2020,Ghana,Algeria,0,8,0,8
15846,2020,Guinea-Bissau,Algeria,0,5,0,5
15847,2020,Guinea,Algeria,32,355,0,387
15848,2020,Cote d'Ivoire,Algeria,79,216,0,295
15849,2020,Iraq,Algeria,12,5,0,17
15850,2020,Liberia,Algeria,0,50,0,50
15851,2020,Libya,Algeria,20,19,0,39
15852,2020,Mali,Algeria,131,395,0,526
15853,2020,Niger,Algeria,6,128,0,134
15854,2020,Nigeria,Algeria,5,238,0,243
15855,2020,Senegal,Algeria,0,7,0,7
15856,2020,Sierra Leone,Algeria,0,23,0,23
15857,2020,Sudan,Algeria,13,33,0,46
15858,2020,Syrian Arab Rep.,Algeria,6627,0,0,6627
15859,2020,Togo,Algeria,0,14,0,14
15860,2020,Türkiye,Algeria,0,22,0,22
15861,2020,Western Sahara,Algeria,90000,0,0,90000
15862,2020,Yemen,Algeria,261,0,0,261
15863,2020,Angola,Angola,0,0,0,0
15864,2020,Burundi,Angola,18,99,0,117
15865,2020,Central African Rep.,Angola,7,77,0,84
15866,2020,Chad,Angola,190,779,0,969
15867,2020,Congo,Angola,65,58,0,123
15868,2020,Dem. Rep. of the Congo,Angola,22905,501,0,23406
15869,2020,Eritrea,Angola,78,1789,0,1867
15870,2020,Ethiopia,Angola,0,57,0,57
15871,2020,Guinea-Bissau,Angola,7,268,0,275
15872,2020,Guinea,Angola,128,9146,0,9274
15873,2020,Cote d'Ivoire,Angola,417,5940,0,6357
15874,2020,Liberia,Angola,164,478,0,642
15875,2020,Mauritania,Angola,323,5402,0,5725
15876,2020,Rwanda,Angola,506,142,0,648
15877,2020,Sierra Leone,Angola,413,1497,0,1910
15878,2020,Somalia,Angola,270,1731,0,2001
15879,2020,Sudan,Angola,279,1670,0,1949
15880,2020,Syrian Arab Rep.,Angola,0,5,0,5
15881,2020,United Rep. of Tanzania,Angola,5,0,0,5
15882,2020,Türkiye,Angola,0,37,0,37
15883,2020,Uganda,Angola,0,6,0,6
15884,2020,Western Sahara,Angola,16,596,0,612
15885,2020,Afghanistan,Egypt,34,44,0,78
15886,2020,Burundi,Egypt,55,58,0,113
15887,2020,Brunei Darussalam,Egypt,0,5,0,5
15888,2020,Central African Rep.,Egypt,40,29,0,69
15889,2020,Chad,Egypt,56,37,0,93
15890,2020,China,Egypt,0,71,0,71
15891,2020,Cameroon,Egypt,17,29,0,46
15892,2020,Congo,Egypt,14,21,0,35
15893,2020,Dem. Rep. of the Congo,Egypt,52,26,0,78
15894,2020,Djibouti,Egypt,13,16,0,29
15895,2020,Eritrea,Egypt,13528,5551,0,19079
15896,2020,Ethiopia,Egypt,5296,10803,0,16099
15897,2020,Palestinian,Egypt,70022,0,0,70022
15898,2020,Guinea,Egypt,10,51,0,61
15899,2020,Cote d'Ivoire,Egypt,93,5,0,98
15900,2020,Iraq,Egypt,4660,2144,0,6804
15901,2020,Jordan,Egypt,11,10,0,21
15902,2020,Kenya,Egypt,8,5,0,13
15903,2020,Liberia,Egypt,0,7,0,7
15904,2020,Libya,Egypt,5,0,0,5
15905,2020,Sri Lanka,Egypt,0,5,0,5
15906,2020,Mali,Egypt,0,12,0,12
15907,2020,Nigeria,Egypt,24,157,0,181
15908,2020,Russian Federation,Egypt,8,21,0,29
15909,2020,Rwanda,Egypt,5,0,0,5
15910,2020,Saudi Arabia,Egypt,14,7,0,21
15911,2020,Sierra Leone,Egypt,5,9,0,14
15912,2020,Somalia,Egypt,4580,2150,0,6730
15913,2020,Sudan,Egypt,25283,23966,0,49249
15914,2020,South Sudan,Egypt,18179,1626,0,19805
15915,2020,Syrian Arab Rep.,Egypt,130577,0,0,130577
15916,2020,Tajikistan,Egypt,12,13,0,25
15917,2020,Turkmenistan,Egypt,5,0,0,5
15918,2020,Togo,Egypt,0,7,0,7
15919,2020,Tunisia,Egypt,5,0,0,5
15920,2020,Türkiye,Egypt,0,385,0,385
15921,2020,Uganda,Egypt,13,19,0,32
15922,2020,Uzbekistan,Egypt,0,17,0,17
15923,2020,Yemen,Egypt,154,9113,0,9267
15924,2020,Zimbabwe,Egypt,43,21,0,64
15927,2020,Afghanistan,Argentina,12,0,0,12
15928,2020,Albania,Argentina,18,0,0,18
15929,2020,Algeria,Argentina,30,22,0,52
15930,2020,Angola,Argentina,14,14,0,28
15931,2020,Egypt,Argentina,5,21,0,26
15932,2020,Armenia,Argentina,77,183,0,260
15933,2020,Burundi,Argentina,5,0,0,5
15934,2020,Bangladesh,Argentina,5,87,0,92
15935,2020,Bolivia (Plurinational State of),Argentina,65,56,0,121
15936,2020,Brazil,Argentina,0,10,0,10
15937,2020,Bosnia and Herzegovina,Argentina,6,0,0,6
15938,2020,China,Argentina,0,120,0,120
15939,2020,Chile,Argentina,34,5,0,39
15940,2020,Cameroon,Argentina,7,42,0,49
15941,2020,Dem. Rep. of the Congo,Argentina,26,25,0,51
15942,2020,Colombia,Argentina,560,226,0,786
15943,2020,Costa Rica,Argentina,5,0,0,5
15944,2020,Cuba,Argentina,259,821,0,1080
15945,2020,Cabo Verde,Argentina,0,5,0,5
15946,2020,Czechia,Argentina,0,5,0,5
15947,2020,Dominican Rep.,Argentina,5,578,0,583
15948,2020,Ecuador,Argentina,16,18,0,34
15949,2020,Ethiopia,Argentina,5,0,0,5
15950,2020,Gambia,Argentina,0,10,0,10
15951,2020,Palestinian,Argentina,19,10,0,29
15952,2020,Georgia,Argentina,5,0,0,5
15953,2020,Ghana,Argentina,38,142,0,180
15954,2020,Guinea-Bissau,Argentina,8,5,0,13
15955,2020,Guatemala,Argentina,6,0,0,6
15956,2020,Guinea,Argentina,10,9,0,19
15957,2020,Haiti,Argentina,74,766,0,840
15958,2020,Honduras,Argentina,5,12,0,17
15959,2020,Hungary,Argentina,0,5,0,5
15960,2020,Cote d'Ivoire,Argentina,20,0,0,20
15961,2020,India,Argentina,23,131,0,154
15962,2020,Iran (Islamic Rep. of),Argentina,24,12,0,36
15963,2020,Iraq,Argentina,22,0,0,22
15964,2020,Jamaica,Argentina,12,0,0,12
15965,2020,Jordan,Argentina,5,0,0,5
15966,2020,Kazakhstan,Argentina,18,13,0,31
15967,2020,Kyrgyzstan,Argentina,5,0,0,5
15968,2020,Liberia,Argentina,42,0,0,42
15969,2020,Libya,Argentina,0,8,0,8
15970,2020,Sri Lanka,Argentina,36,0,0,36
15971,2020,North Macedonia,Argentina,9,0,0,9
15972,2020,Mexico,Argentina,0,6,0,6
15973,2020,Mali,Argentina,9,0,0,9
15974,2020,Morocco,Argentina,0,13,0,13
15975,2020,Nepal,Argentina,0,5,0,5
15976,2020,Nicaragua,Argentina,11,19,0,30
15977,2020,Nigeria,Argentina,42,63,0,105
15978,2020,Pakistan,Argentina,39,19,0,58
15979,2020,Paraguay,Argentina,9,20,0,29
15980,2020,Peru,Argentina,545,49,0,594
15981,2020,Romania,Argentina,51,0,0,51
15982,2020,South Africa,Argentina,0,15,0,15
15983,2020,Russian Federation,Argentina,79,89,0,168
15984,2020,El Salvador,Argentina,46,34,0,80
15985,2020,Senegal,Argentina,41,1413,0,1454
15986,2020,Sierra Leone,Argentina,37,5,0,42
15987,2020,Somalia,Argentina,5,0,0,5
15988,2020,Spain,Argentina,0,7,0,7
15989,2020,Sudan,Argentina,5,0,0,5
15990,2020,Syrian Arab Rep.,Argentina,407,83,0,490
15991,2020,Tunisia,Argentina,0,5,0,5
15992,2020,Türkiye,Argentina,7,0,0,7
15993,2020,Ukraine,Argentina,118,88,0,206
15994,2020,United States of America,Argentina,5,10,0,15
15995,2020,Venezuela (Bolivarian Republic of),Argentina,312,3826,0,4138
15996,2020,Yemen,Argentina,19,5,0,24
15998,2020,Afghanistan,Armenia,5,0,0,5
15999,2020,Egypt,Armenia,5,0,0,5
16000,2020,Azerbaijan,Armenia,91766,5,0,91771
16001,2020,Congo,Armenia,5,0,0,5
16002,2020,Cuba,Armenia,0,26,0,26
16003,2020,Palestinian,Armenia,7,0,0,7
16004,2020,Georgia,Armenia,8,5,0,13
16005,2020,Cote d'Ivoire,Armenia,6,0,0,6
16006,2020,India,Armenia,0,5,0,5
16007,2020,Iran (Islamic Rep. of),Armenia,102,66,0,168
16008,2020,Iraq,Armenia,1086,0,0,1086
16009,2020,Lebanon,Armenia,25,5,0,30
16010,2020,Nigeria,Armenia,5,0,0,5
16011,2020,Russian Federation,Armenia,0,5,0,5
16012,2020,Syrian Arab Rep.,Armenia,14741,5,0,14746
16013,2020,Türkiye,Armenia,13,14,0,27
16014,2020,Ukraine,Armenia,115,0,0,115
16015,2020,Yemen,Armenia,21,0,0,21
16017,2020,Afghanistan,Australia,10659,1761,0,12420
16018,2020,Albania,Australia,45,92,0,137
16019,2020,Algeria,Australia,8,26,0,34
16020,2020,Egypt,Australia,1494,338,0,1832
16021,2020,Argentina,Australia,0,29,0,29
16022,2020,Azerbaijan,Australia,9,12,0,21
16023,2020,Bahrain,Australia,89,6,0,95
16024,2020,Burundi,Australia,48,27,0,75
16025,2020,Bangladesh,Australia,410,1246,0,1656
16026,2020,Bhutan,Australia,5,17,0,22
16027,2020,Belarus,Australia,6,0,0,6
16028,2020,Brazil,Australia,8,183,0,191
16029,2020,Brunei Darussalam,Australia,0,5,0,5
16030,2020,Bosnia and Herzegovina,Australia,0,5,0,5
16031,2020,Cambodia,Australia,70,515,0,585
16032,2020,China,Australia,1780,16811,0,18591
16033,2020,Chile,Australia,0,54,0,54
16034,2020,Cameroon,Australia,29,61,0,90
16035,2020,Congo,Australia,12,59,0,71
16036,2020,Dem. Rep. of the Congo,Australia,62,22,0,84
16037,2020,Colombia,Australia,103,317,0,420
16038,2020,Czechia,Australia,0,5,0,5
16039,2020,Djibouti,Australia,5,0,0,5
16040,2020,Eritrea,Australia,119,13,0,132
16041,2020,Ethiopia,Australia,301,266,0,567
16042,2020,Fiji,Australia,340,2318,0,2658
16043,2020,France,Australia,0,15,0,15
16044,2020,Gambia,Australia,8,11,0,19
16045,2020,Palestinian,Australia,508,154,0,662
16046,2020,United Kingdom of Great Britain and Northern Ireland,Australia,5,59,0,64
16047,2020,Georgia,Australia,14,26,0,40
16048,2020,Germany,Australia,10,5,0,15
16049,2020,Ghana,Australia,35,215,0,250
16050,2020,Greece,Australia,6,39,0,45
16051,2020,Guinea,Australia,8,5,0,13
16052,2020,"China, Hong Kong SAR",Australia,5,315,0,320
16053,2020,Honduras,Australia,5,5,0,10
16054,2020,Hungary,Australia,0,5,0,5
16055,2020,India,Australia,474,6471,0,6945
16056,2020,Indonesia,Australia,236,2054,0,2290
16057,2020,Ireland,Australia,0,28,0,28
16058,2020,Iran (Islamic Rep. of),Australia,12606,3837,0,16443
16059,2020,Iraq,Australia,4886,1149,0,6035
16060,2020,Israel,Australia,9,21,0,30
16061,2020,Italy,Australia,5,38,0,43
16062,2020,Jamaica,Australia,5,0,0,5
16063,2020,Jordan,Australia,129,213,0,342
16064,2020,Japan,Australia,11,18,0,29
16065,2020,Kazakhstan,Australia,7,0,0,7
16066,2020,Kenya,Australia,101,292,0,393
16067,2020,Kyrgyzstan,Australia,13,5,0,18
16068,2020,Rep. of Korea,Australia,28,171,0,199
16069,2020,Dem. People's Rep. of Korea,Australia,7,9,0,16
16070,2020,Kuwait,Australia,44,0,0,44
16071,2020,Lao People's Dem. Rep.,Australia,5,283,0,288
16072,2020,Liberia,Australia,44,18,0,62
16073,2020,Libya,Australia,1226,88,0,1314
16074,2020,Lebanon,Australia,540,874,0,1414
16075,2020,Sri Lanka,Australia,4194,2640,0,6834
16076,2020,North Macedonia,Australia,5,76,0,81
16077,2020,Maldives,Australia,16,16,0,32
16078,2020,Mexico,Australia,14,26,0,40
16079,2020,Malaysia,Australia,598,18764,0,19362
16080,2020,Mongolia,Australia,18,367,0,385
16081,2020,Morocco,Australia,12,19,0,31
16082,2020,Mozambique,Australia,5,5,0,10
16083,2020,Mauritius,Australia,10,119,0,129
16084,2020,Myanmar,Australia,477,310,0,787
16085,2020,Nepal,Australia,127,649,0,776
16086,2020,Nigeria,Australia,208,561,0,769
16087,2020,Nauru,Australia,5,16,0,21
16088,2020,New Zealand,Australia,27,27,0,54
16089,2020,Oman,Australia,5,0,0,5
16090,2020,Pakistan,Australia,5416,2569,0,7985
16091,2020,Peru,Australia,20,63,0,83
16092,2020,Philippines,Australia,48,1413,0,1461
16093,2020,Papua New Guinea,Australia,505,650,0,1155
16094,2020,Poland,Australia,0,21,0,21
16095,2020,Portugal,Australia,0,8,0,8
16096,2020,Romania,Australia,0,5,0,5
16097,2020,South Africa,Australia,33,454,0,487
16098,2020,Russian Federation,Australia,57,80,0,137
16099,2020,Rwanda,Australia,94,51,0,145
16100,2020,El Salvador,Australia,10,30,0,40
16101,2020,Saudi Arabia,Australia,199,78,0,277
16102,2020,Serbia and Kosovo: S/RES/1244 (1999),Australia,0,28,0,28
16103,2020,Singapore,Australia,6,26,0,32
16104,2020,Sierra Leone,Australia,28,140,0,168
16105,2020,Solomon Islands,Australia,24,267,0,291
16106,2020,Somalia,Australia,534,135,0,669
16107,2020,Viet Nam,Australia,298,3196,0,3494
16108,2020,Sudan,Australia,554,149,0,703
16109,2020,South Sudan,Australia,13,45,0,58
16110,2020,Eswatini,Australia,0,16,0,16
16111,2020,Syrian Arab Rep.,Australia,645,58,0,703
16112,2020,United Rep. of Tanzania,Australia,8,31,0,39
16113,2020,Thailand,Australia,20,2682,0,2702
16114,2020,Timor-Leste,Australia,6,299,0,305
16115,2020,Tonga,Australia,31,726,0,757
16116,2020,Tunisia,Australia,5,9,0,14
16117,2020,Türkiye,Australia,846,479,0,1325
16118,2020,United Arab Emirates,Australia,6,0,0,6
16119,2020,Uganda,Australia,60,96,0,156
16120,2020,Ukraine,Australia,24,97,0,121
16121,2020,United States of America,Australia,17,52,0,69
16122,2020,Uzbekistan,Australia,22,49,0,71
16123,2020,Vanuatu,Australia,0,81,0,81
16124,2020,Venezuela (Bolivarian Republic of),Australia,139,310,0,449
16125,2020,Samoa,Australia,0,123,0,123
16126,2020,Yemen,Australia,160,100,0,260
16127,2020,Zambia,Australia,12,25,0,37
16128,2020,Zimbabwe,Australia,417,213,0,630
16132,2020,Afghanistan,Austria,40096,6473,0,46569
16133,2020,Albania,Austria,60,23,0,83
16134,2020,Algeria,Austria,34,123,0,157
16135,2020,Angola,Austria,51,5,0,56
16136,2020,Egypt,Austria,231,141,0,372
16137,2020,Armenia,Austria,377,238,0,615
16138,2020,Azerbaijan,Austria,170,165,0,335
16139,2020,Burundi,Austria,14,0,0,14
16140,2020,Benin,Austria,5,24,0,29
16141,2020,Bangladesh,Austria,334,207,0,541
16142,2020,Burkina Faso,Austria,7,5,0,12
16143,2020,Belarus,Austria,35,16,0,51
16144,2020,Bosnia and Herzegovina,Austria,65,7,0,72
16145,2020,Canada,Austria,5,0,0,5
16146,2020,China,Austria,660,97,0,757
16147,2020,Cameroon,Austria,197,44,0,241
16148,2020,Congo,Austria,98,10,0,108
16149,2020,Dem. Rep. of the Congo,Austria,343,68,0,411
16150,2020,Colombia,Austria,0,19,0,19
16151,2020,Cuba,Austria,13,8,0,21
16152,2020,Eritrea,Austria,441,32,0,473
16153,2020,Ethiopia,Austria,231,60,0,291
16154,2020,Gabon,Austria,5,0,0,5
16155,2020,Gambia,Austria,115,86,0,201
16156,2020,Georgia,Austria,335,251,0,586
16157,2020,Ghana,Austria,17,28,0,45
16158,2020,Guinea-Bissau,Austria,5,5,0,10
16159,2020,Guatemala,Austria,6,0,0,6
16160,2020,Guinea,Austria,142,34,0,176
16161,2020,Hungary,Austria,0,5,0,5
16162,2020,Cote d'Ivoire,Austria,68,14,0,82
16163,2020,India,Austria,40,216,0,256
16164,2020,Iran (Islamic Rep. of),Austria,6878,1441,0,8319
16165,2020,Iraq,Austria,9152,3467,0,12619
16166,2020,Israel,Austria,10,0,0,10
16167,2020,Jordan,Austria,76,28,0,104
16168,2020,Kazakhstan,Austria,115,30,0,145
16169,2020,Kenya,Austria,26,11,0,37
16170,2020,Kyrgyzstan,Austria,154,26,0,180
16171,2020,Kuwait,Austria,9,14,0,23
16172,2020,Liberia,Austria,10,5,0,15
16173,2020,Libya,Austria,139,54,0,193
16174,2020,Lebanon,Austria,112,73,0,185
16175,2020,Sri Lanka,Austria,66,27,0,93
16176,2020,Madagascar,Austria,5,0,0,5
16177,2020,Mauritania,Austria,5,0,0,5
16178,2020,North Macedonia,Austria,19,9,0,28
16179,2020,Rep. of Moldova,Austria,27,20,0,47
16180,2020,Mali,Austria,13,11,0,24
16181,2020,Mongolia,Austria,132,110,0,242
16182,2020,Morocco,Austria,39,187,0,226
16183,2020,Montenegro,Austria,5,0,0,5
16184,2020,Myanmar,Austria,35,5,0,40
16185,2020,Nepal,Austria,19,44,0,63
16186,2020,Nicaragua,Austria,5,0,0,5
16187,2020,Nigeria,Austria,417,443,0,860
16188,2020,Pakistan,Austria,348,428,0,776
16189,2020,Philippines,Austria,18,10,0,28
16190,2020,Romania,Austria,5,0,0,5
16191,2020,South Africa,Austria,5,0,0,5
16192,2020,Russian Federation,Austria,7513,958,0,8471
16193,2020,Rwanda,Austria,15,6,0,21
16194,2020,Saudi Arabia,Austria,6,0,0,6
16195,2020,Serbia and Kosovo: S/RES/1244 (1999),Austria,563,144,0,707
16196,2020,Senegal,Austria,15,8,0,23
16197,2020,Sierra Leone,Austria,21,10,0,31
16198,2020,Somalia,Austria,8074,729,0,8803
16199,2020,Viet Nam,Austria,5,7,0,12
16200,2020,Sudan,Austria,336,18,0,354
16201,2020,South Sudan,Austria,6,0,0,6
16202,2020,Syrian Arab Rep.,Austria,54903,2820,0,57723
16203,2020,United Rep. of Tanzania,Austria,5,0,0,5
16204,2020,Tajikistan,Austria,243,36,0,279
16205,2020,Turkmenistan,Austria,7,0,0,7
16206,2020,Togo,Austria,7,0,0,7
16207,2020,Tunisia,Austria,7,58,0,65
16208,2020,Türkiye,Austria,574,390,0,964
16209,2020,Uganda,Austria,31,5,0,36
16210,2020,Ukraine,Austria,251,182,0,433
16211,2020,United States of America,Austria,5,0,0,5
16212,2020,Uzbekistan,Austria,55,69,0,124
16213,2020,Venezuela (Bolivarian Republic of),Austria,61,34,0,95
16214,2020,Yemen,Austria,355,79,0,434
16215,2020,Zambia,Austria,5,0,0,5
16216,2020,Zimbabwe,Austria,6,0,0,6
16219,2020,Afghanistan,Azerbaijan,1087,24,0,1111
16220,2020,Azerbaijan,Azerbaijan,0,0,653921,0
16221,2020,Palestinian,Azerbaijan,5,0,0,5
16222,2020,Iran (Islamic Rep. of),Azerbaijan,43,0,0,43
16223,2020,Iraq,Azerbaijan,10,0,0,10
16224,2020,Libya,Azerbaijan,5,0,0,5
16225,2020,Pakistan,Azerbaijan,17,0,0,17
16226,2020,Russian Federation,Azerbaijan,350,24,0,374
16227,2020,Syrian Arab Rep.,Azerbaijan,34,0,0,34
16228,2020,Ukraine,Azerbaijan,5,0,0,5
16229,2020,Uzbekistan,Azerbaijan,5,0,0,5
16230,2020,Yemen,Azerbaijan,11,0,0,11
16232,2020,Egypt,Bahrain,0,5,0,5
16233,2020,Palestinian,Bahrain,0,6,0,6
16234,2020,Iraq,Bahrain,242,59,0,301
16235,2020,Jordan,Bahrain,5,0,0,5
16236,2020,Syrian Arab Rep.,Bahrain,0,23,0,23
16237,2020,Tunisia,Bahrain,0,6,0,6
16238,2020,Yemen,Bahrain,9,5,0,14
16239,2020,Venezuela (Bolivarian Republic of),Barbados,0,5,0,5
16240,2020,Burundi,Burundi,0,0,21863,0
16241,2020,Benin,Burundi,0,0,0,0
16242,2020,Dem. Rep. of the Congo,Burundi,74928,4525,0,79453
16243,2020,Mali,Burundi,12,0,0,12
16244,2020,Oman,Burundi,0,0,0,0
16245,2020,Rwanda,Burundi,480,389,0,869
16246,2020,Somalia,Burundi,5,0,0,5
16247,2020,South Sudan,Burundi,8,0,0,8
16248,2020,United Rep. of Tanzania,Burundi,0,0,0,0
16249,2020,Türkiye,Burundi,21,0,0,21
16250,2020,Uganda,Burundi,7,0,0,7
16252,2020,Afghanistan,Belgium,4689,4215,0,8904
16253,2020,Albania,Belgium,669,400,0,1069
16254,2020,Algeria,Belgium,70,205,0,275
16255,2020,Angola,Belgium,88,310,0,398
16256,2020,Egypt,Belgium,98,95,0,193
16257,2020,Armenia,Belgium,144,230,0,374
16258,2020,Azerbaijan,Belgium,85,55,0,140
16259,2020,Burundi,Belgium,1611,555,0,2166
16260,2020,Benin,Belgium,38,60,0,98
16261,2020,Bangladesh,Belgium,21,20,0,41
16262,2020,Burkina Faso,Belgium,106,125,0,231
16263,2020,Belarus,Belgium,41,55,0,96
16264,2020,Brazil,Belgium,10,285,0,295
16265,2020,Bosnia and Herzegovina,Belgium,44,55,0,99
16266,2020,Bulgaria,Belgium,17,10,0,27
16267,2020,Cambodia,Belgium,13,0,0,13
16268,2020,Canada,Belgium,0,5,0,5
16269,2020,Central African Rep.,Belgium,62,25,0,87
16270,2020,Chad,Belgium,46,60,0,106
16271,2020,China,Belgium,1151,60,0,1211
16272,2020,Chile,Belgium,44,10,0,54
16273,2020,Cameroon,Belgium,478,755,0,1233
16274,2020,Congo,Belgium,25,40,0,65
16275,2020,Dem. Rep. of the Congo,Belgium,1508,895,0,2403
16276,2020,Colombia,Belgium,105,410,0,515
16277,2020,Costa Rica,Belgium,0,5,0,5
16278,2020,Cuba,Belgium,10,15,0,25
16279,2020,Czechia,Belgium,5,5,0,10
16280,2020,Djibouti,Belgium,373,65,0,438
16281,2020,Dominican Rep.,Belgium,0,5,0,5
16282,2020,Ecuador,Belgium,0,10,0,10
16283,2020,Equatorial Guinea,Belgium,0,5,0,5
16284,2020,Eritrea,Belgium,2764,1205,0,3969
16285,2020,Ethiopia,Belgium,175,70,0,245
16286,2020,Gabon,Belgium,26,40,0,66
16287,2020,Gambia,Belgium,31,125,0,156
16288,2020,Palestinian,Belgium,1224,3275,0,4499
16289,2020,Georgia,Belgium,139,235,0,374
16290,2020,Germany,Belgium,0,5,0,5
16291,2020,Ghana,Belgium,19,55,0,74
16292,2020,Guinea-Bissau,Belgium,7,10,0,17
16293,2020,Guatemala,Belgium,39,40,0,79
16294,2020,Guinea,Belgium,3446,1390,0,4836
16295,2020,Guyana,Belgium,5,0,0,5
16296,2020,Haiti,Belgium,5,5,0,10
16297,2020,Honduras,Belgium,18,20,0,38
16298,2020,Croatia,Belgium,5,5,0,10
16299,2020,Hungary,Belgium,29,0,0,29
16300,2020,Cote d'Ivoire,Belgium,208,260,0,468
16301,2020,India,Belgium,14,40,0,54
16302,2020,Iran (Islamic Rep. of),Belgium,1648,765,0,2413
16303,2020,Iraq,Belgium,5515,1235,0,6750
16304,2020,Israel,Belgium,0,5,0,5
16305,2020,Jamaica,Belgium,5,0,0,5
16306,2020,Jordan,Belgium,23,70,0,93
16307,2020,Japan,Belgium,0,5,0,5
16308,2020,Kazakhstan,Belgium,60,45,0,105
16309,2020,Kenya,Belgium,15,20,0,35
16310,2020,Kyrgyzstan,Belgium,65,35,0,100
16311,2020,Dem. People's Rep. of Korea,Belgium,32,5,0,37
16312,2020,Kuwait,Belgium,6,10,0,16
16313,2020,Lao People's Dem. Rep.,Belgium,10,0,0,10
16314,2020,Liberia,Belgium,15,30,0,45
16315,2020,Libya,Belgium,75,130,0,205
16316,2020,Lebanon,Belgium,105,165,0,270
16317,2020,Sri Lanka,Belgium,304,55,0,359
16318,2020,Lithuania,Belgium,5,0,0,5
16319,2020,Latvia,Belgium,0,5,0,5
16320,2020,Madagascar,Belgium,0,5,0,5
16321,2020,Mauritania,Belgium,269,185,0,454
16322,2020,North Macedonia,Belgium,128,115,0,243
16323,2020,Rep. of Moldova,Belgium,5,75,0,80
16324,2020,Mali,Belgium,99,85,0,184
16325,2020,Mongolia,Belgium,0,15,0,15
16326,2020,Morocco,Belgium,142,275,0,417
16327,2020,Mozambique,Belgium,0,10,0,10
16328,2020,Montenegro,Belgium,13,5,0,18
16329,2020,Mauritius,Belgium,0,5,0,5
16330,2020,Myanmar,Belgium,8,0,0,8
16331,2020,Namibia,Belgium,0,5,0,5
16332,2020,Nepal,Belgium,6,10,0,16
16333,2020,Netherlands,Belgium,0,5,0,5
16334,2020,Niger,Belgium,126,160,0,286
16335,2020,Nicaragua,Belgium,16,25,0,41
16336,2020,Nigeria,Belgium,55,220,0,275
16337,2020,Pakistan,Belgium,300,205,0,505
16338,2020,Peru,Belgium,0,50,0,50
16339,2020,Philippines,Belgium,0,5,0,5
16340,2020,Poland,Belgium,98,0,0,98
16341,2020,Romania,Belgium,36,15,0,51
16342,2020,South Africa,Belgium,5,0,0,5
16343,2020,Russian Federation,Belgium,2560,585,0,3145
16344,2020,Rwanda,Belgium,781,440,0,1221
16345,2020,El Salvador,Belgium,442,1570,0,2012
16346,2020,Saudi Arabia,Belgium,8,5,0,13
16347,2020,Serbia and Kosovo: S/RES/1244 (1999),Belgium,898,285,0,1183
16348,2020,Senegal,Belgium,371,370,0,741
16349,2020,Sierra Leone,Belgium,27,50,0,77
16350,2020,Somalia,Belgium,2316,935,0,3251
16351,2020,Spain,Belgium,0,5,0,5
16352,2020,Viet Nam,Belgium,23,15,0,38
16353,2020,Sudan,Belgium,259,230,0,489
16354,2020,Suriname,Belgium,0,60,0,60
16355,2020,South Sudan,Belgium,5,15,0,20
16356,2020,Slovakia,Belgium,0,15,0,15
16357,2020,Syrian Arab Rep.,Belgium,17693,2165,0,19858
16358,2020,United Rep. of Tanzania,Belgium,43,40,0,83
16359,2020,Tajikistan,Belgium,11,10,0,21
16360,2020,Togo,Belgium,163,140,0,303
16361,2020,Tunisia,Belgium,53,80,0,133
16362,2020,Türkiye,Belgium,2646,1030,0,3676
16363,2020,Uganda,Belgium,24,25,0,49
16364,2020,Ukraine,Belgium,254,155,0,409
16365,2020,United States of America,Belgium,0,15,0,15
16366,2020,Uzbekistan,Belgium,37,10,0,47
16367,2020,Venezuela (Bolivarian Republic of),Belgium,399,505,0,904
16368,2020,Yemen,Belgium,77,200,0,277
16372,2020,Burundi,Benin,7,0,0,7
16373,2020,Central African Rep.,Benin,1050,171,0,1221
16374,2020,Chad,Benin,15,25,0,40
16375,2020,Cameroon,Benin,35,64,0,99
16376,2020,Congo,Benin,0,10,0,10
16377,2020,Dem. Rep. of the Congo,Benin,11,51,0,62
16378,2020,Eritrea,Benin,5,0,0,5
16379,2020,Guinea,Benin,0,13,0,13
16380,2020,Cote d'Ivoire,Benin,167,28,0,195
16381,2020,Liberia,Benin,0,5,0,5
16382,2020,Sri Lanka,Benin,5,0,0,5
16383,2020,Mali,Benin,36,19,0,55
16384,2020,Niger,Benin,0,5,0,5
16385,2020,Nigeria,Benin,0,26,0,26
16386,2020,Pakistan,Benin,5,0,0,5
16387,2020,Rwanda,Benin,0,5,0,5
16388,2020,Senegal,Benin,5,0,0,5
16389,2020,Sudan,Benin,9,8,0,17
16390,2020,Syrian Arab Rep.,Benin,22,9,0,31
16391,2020,Togo,Benin,0,25,0,25
16392,2020,Türkiye,Benin,10,0,0,10
16393,2020,Yemen,Benin,14,0,0,14
16394,2020,Bangladesh,Bangladesh,0,0,0,0
16395,2020,Myanmar,Bangladesh,866518,0,0,866518
16396,2020,Somalia,Bangladesh,11,10,0,21
16397,2020,Türkiye,Bangladesh,0,8,0,8
16398,2020,Yemen,Bangladesh,5,0,0,5
16400,2020,Cambodia,Bahamas,0,5,0,5
16401,2020,Colombia,Bahamas,5,0,0,5
16402,2020,Cuba,Bahamas,5,0,0,5
16403,2020,Jamaica,Bahamas,5,0,0,5
16404,2020,South Africa,Bahamas,0,8,0,8
16405,2020,Burundi,Burkina Faso,28,0,0,28
16406,2020,Benin,Burkina Faso,8,0,0,8
16407,2020,Burkina Faso,Burkina Faso,0,0,1074993,0
16408,2020,Central African Rep.,Burkina Faso,193,25,0,218
16409,2020,Chad,Burkina Faso,81,0,0,81
16410,2020,Cameroon,Burkina Faso,7,0,0,7
16411,2020,Congo,Burkina Faso,26,0,0,26
16412,2020,Dem. Rep. of the Congo,Burkina Faso,33,0,0,33
16413,2020,Cote d'Ivoire,Burkina Faso,5,0,0,5
16414,2020,Mali,Burkina Faso,19816,0,0,19816
16415,2020,Rwanda,Burkina Faso,16,0,0,16
16416,2020,South Sudan,Burkina Faso,0,5,0,5
16417,2020,Syrian Arab Rep.,Burkina Faso,5,0,0,5
16418,2020,Togo,Burkina Faso,15,0,0,15
16419,2020,Türkiye,Burkina Faso,19,0,0,19
16420,2020,Afghanistan,Belarus,222,0,0,222
16421,2020,Armenia,Belarus,5,5,0,10
16422,2020,Azerbaijan,Belarus,5,0,0,5
16423,2020,Cameroon,Belarus,5,5,0,10
16424,2020,Ethiopia,Belarus,5,0,0,5
16425,2020,Palestinian,Belarus,5,0,0,5
16426,2020,Georgia,Belarus,50,0,0,50
16427,2020,Iran (Islamic Rep. of),Belarus,5,0,0,5
16428,2020,Iraq,Belarus,12,5,0,17
16429,2020,Libya,Belarus,7,0,0,7
16430,2020,Russian Federation,Belarus,0,7,0,7
16431,2020,Syrian Arab Rep.,Belarus,64,8,0,72
16432,2020,Tajikistan,Belarus,11,0,0,11
16433,2020,Turkmenistan,Belarus,0,5,0,5
16434,2020,Türkiye,Belarus,5,6,0,11
16435,2020,Ukraine,Belarus,2471,96,0,2567
16436,2020,Yemen,Belarus,28,6,0,34
16438,2020,Argentina,Bolivia (Plurinational State of),13,0,0,13
16439,2020,Colombia,Bolivia (Plurinational State of),202,0,0,202
16440,2020,Cuba,Bolivia (Plurinational State of),48,0,0,48
16441,2020,Ecuador,Bolivia (Plurinational State of),5,0,0,5
16442,2020,Cote d'Ivoire,Bolivia (Plurinational State of),5,0,0,5
16443,2020,Iraq,Bolivia (Plurinational State of),16,0,0,16
16444,2020,Niger,Bolivia (Plurinational State of),5,0,0,5
16445,2020,Pakistan,Bolivia (Plurinational State of),5,0,0,5
16446,2020,Peru,Bolivia (Plurinational State of),524,0,0,524
16447,2020,Russian Federation,Bolivia (Plurinational State of),14,0,0,14
16448,2020,Syrian Arab Rep.,Bolivia (Plurinational State of),22,0,0,22
16449,2020,Ukraine,Bolivia (Plurinational State of),5,0,0,5
16450,2020,Uruguay,Bolivia (Plurinational State of),10,0,0,10
16451,2020,Venezuela (Bolivarian Republic of),Bolivia (Plurinational State of),242,157,0,399
16452,2020,Angola,Botswana,0,0,0,0
16453,2020,Burundi,Botswana,73,0,0,73
16454,2020,Dem. Rep. of the Congo,Botswana,159,94,0,253
16455,2020,Eritrea,Botswana,5,0,0,5
16456,2020,Ethiopia,Botswana,5,0,0,5
16457,2020,Kenya,Botswana,5,0,0,5
16458,2020,Rwanda,Botswana,18,0,0,18
16459,2020,Somalia,Botswana,307,36,0,343
16460,2020,Sudan,Botswana,5,0,0,5
16461,2020,Uganda,Botswana,20,0,0,20
16462,2020,Zimbabwe,Botswana,20,292,0,312
16463,2020,Afghanistan,Brazil,143,173,0,316
16464,2020,Albania,Brazil,0,7,0,7
16465,2020,Algeria,Brazil,7,37,0,44
16466,2020,Andorra,Brazil,0,5,0,5
16467,2020,Angola,Brazil,1150,5177,0,6327
16468,2020,Egypt,Brazil,57,483,0,540
16469,2020,Argentina,Brazil,6,149,0,155
16470,2020,Armenia,Brazil,5,7,0,12
16471,2020,Burundi,Brazil,46,24,0,70
16472,2020,Belgium,Brazil,0,6,0,6
16473,2020,Benin,Brazil,0,279,0,279
16474,2020,Bangladesh,Brazil,18,5617,0,5635
16475,2020,Bhutan,Brazil,30,36,0,66
16476,2020,Burkina Faso,Brazil,5,310,0,315
16477,2020,Bolivia (Plurinational State of),Brazil,153,455,0,608
16478,2020,Bosnia and Herzegovina,Brazil,5,0,0,5
16479,2020,Bulgaria,Brazil,0,5,0,5
16480,2020,Cambodia,Brazil,0,5,0,5
16481,2020,Canada,Brazil,0,7,0,7
16482,2020,Central African Rep.,Brazil,5,7,0,12
16483,2020,China,Brazil,11,5143,0,5154
16484,2020,Chile,Brazil,21,134,0,155
16485,2020,Cameroon,Brazil,75,593,0,668
16486,2020,Congo,Brazil,20,100,0,120
16487,2020,Dem. Rep. of the Congo,Brazil,1668,2685,0,4353
16488,2020,Colombia,Brazil,1297,1986,0,3283
16489,2020,Costa Rica,Brazil,0,15,0,15
16490,2020,Cuba,Brazil,359,15392,0,15751
16491,2020,Cabo Verde,Brazil,0,210,0,210
16492,2020,Cyprus,Brazil,0,5,0,5
16493,2020,Czechia,Brazil,0,6,0,6
16494,2020,Denmark,Brazil,0,12,0,12
16495,2020,Djibouti,Brazil,0,11,0,11
16496,2020,Dominica,Brazil,0,18,0,18
16497,2020,Dominican Rep.,Brazil,6,1295,0,1301
16498,2020,Ecuador,Brazil,58,98,0,156
16499,2020,Equatorial Guinea,Brazil,0,11,0,11
16500,2020,Eritrea,Brazil,25,117,0,142
16501,2020,Ethiopia,Brazil,29,89,0,118
16502,2020,French Guiana,Brazil,0,19,0,19
16503,2020,Fiji,Brazil,0,20,0,20
16504,2020,France,Brazil,0,40,0,40
16505,2020,Gambia,Brazil,6,357,0,363
16506,2020,Palestinian,Brazil,571,378,0,949
16507,2020,United Kingdom of Great Britain and Northern Ireland,Brazil,0,13,0,13
16508,2020,Georgia,Brazil,10,5,0,15
16509,2020,Germany,Brazil,0,8,0,8
16510,2020,Ghana,Brazil,35,2447,0,2482
16511,2020,Guinea-Bissau,Brazil,24,1699,0,1723
16512,2020,Greece,Brazil,0,6,0,6
16513,2020,Guatemala,Brazil,0,22,0,22
16514,2020,Guinea,Brazil,107,908,0,1015
16515,2020,Guyana,Brazil,5,149,0,154
16516,2020,Haiti,Brazil,8,38130,0,38138
16517,2020,Honduras,Brazil,5,17,0,22
16518,2020,Croatia,Brazil,5,0,0,5
16519,2020,Hungary,Brazil,5,5,0,10
16520,2020,Cote d'Ivoire,Brazil,55,189,0,244
16521,2020,India,Brazil,9,1062,0,1071
16522,2020,Indonesia,Brazil,0,8,0,8
16523,2020,Iran (Islamic Rep. of),Brazil,69,190,0,259
16524,2020,Iraq,Brazil,308,419,0,727
16525,2020,Israel,Brazil,0,33,0,33
16526,2020,Italy,Brazil,0,27,0,27
16527,2020,Jamaica,Brazil,0,11,0,11
16528,2020,Jordan,Brazil,11,95,0,106
16529,2020,Japan,Brazil,0,6,0,6
16530,2020,Kazakhstan,Brazil,0,10,0,10
16531,2020,Kenya,Brazil,10,78,0,88
16532,2020,Rep. of Korea,Brazil,0,269,0,269
16533,2020,Kuwait,Brazil,0,7,0,7
16534,2020,Liberia,Brazil,259,33,0,292
16535,2020,Libya,Brazil,6,51,0,57
16536,2020,Lebanon,Brazil,413,1923,0,2336
16537,2020,Lesotho,Brazil,0,5,0,5
16538,2020,Sri Lanka,Brazil,19,73,0,92
16539,2020,Lithuania,Brazil,0,7,0,7
16541,2020,Mauritania,Brazil,50,244,0,294
16542,2020,North Macedonia,Brazil,6,5,0,11
16543,2020,Mexico,Brazil,6,48,0,54
16544,2020,Mali,Brazil,92,428,0,520
16545,2020,Malaysia,Brazil,0,5,0,5
16546,2020,Mongolia,Brazil,0,7,0,7
16547,2020,Morocco,Brazil,27,732,0,759
16548,2020,Mozambique,Brazil,0,91,0,91
16549,2020,Malta,Brazil,0,5,0,5
16550,2020,Myanmar,Brazil,0,6,0,6
16551,2020,Namibia,Brazil,0,39,0,39
16552,2020,Nepal,Brazil,12,380,0,392
16553,2020,Netherlands,Brazil,0,6,0,6
16554,2020,Niger,Brazil,0,7,0,7
16555,2020,Nicaragua,Brazil,0,40,0,40
16556,2020,Nigeria,Brazil,140,3466,0,3606
16557,2020,Norway,Brazil,0,6,0,6
16558,2020,New Zealand,Brazil,0,5,0,5
16559,2020,Pakistan,Brazil,356,1758,0,2114
16560,2020,Panama,Brazil,0,8,0,8
16561,2020,Paraguay,Brazil,5,176,0,181
16562,2020,Peru,Brazil,46,243,0,289
16563,2020,Philippines,Brazil,5,564,0,569
16564,2020,Poland,Brazil,0,13,0,13
16565,2020,Portugal,Brazil,0,104,0,104
16566,2020,Romania,Brazil,0,15,0,15
16567,2020,South Africa,Brazil,5,446,0,451
16568,2020,Russian Federation,Brazil,19,43,0,62
16569,2020,Rwanda,Brazil,18,5,0,23
16570,2020,El Salvador,Brazil,59,5,0,64
16571,2020,Saudi Arabia,Brazil,0,21,0,21
16572,2020,Serbia and Kosovo: S/RES/1244 (1999),Brazil,92,7,0,99
16573,2020,Senegal,Brazil,15,6367,0,6382
16574,2020,Sierra Leone,Brazil,164,363,0,527
16575,2020,Somalia,Brazil,48,575,0,623
16576,2020,Spain,Brazil,0,51,0,51
16577,2020,Viet Nam,Brazil,5,0,0,5
16578,2020,Sao Tome and Principe,Brazil,0,23,0,23
16579,2020,Sudan,Brazil,76,144,0,220
16580,2020,Suriname,Brazil,0,22,0,22
16581,2020,Sweden,Brazil,0,6,0,6
16582,2020,Switzerland,Brazil,0,5,0,5
16583,2020,Syrian Arab Rep.,Brazil,3924,4086,0,8010
16584,2020,United Rep. of Tanzania,Brazil,8,114,0,122
16585,2020,Thailand,Brazil,0,46,0,46
16586,2020,Togo,Brazil,52,642,0,694
16587,2020,Trinidad and Tobago,Brazil,0,7,0,7
16588,2020,Tunisia,Brazil,5,132,0,137
16589,2020,Türkiye,Brazil,6,279,0,285
16590,2020,Uganda,Brazil,6,34,0,40
16591,2020,Ukraine,Brazil,19,80,0,99
16592,2020,Uruguay,Brazil,0,36,0,36
16593,2020,United States of America,Brazil,0,50,0,50
16594,2020,Uzbekistan,Brazil,0,5,0,5
16595,2020,Vanuatu,Brazil,0,57,0,57
16596,2020,Holy See,Brazil,0,12,0,12
16597,2020,Venezuela (Bolivarian Republic of),Brazil,46675,90934,0,137609
16598,2020,Yemen,Brazil,7,150,0,157
16599,2020,Zambia,Brazil,0,7,0,7
16600,2020,Zimbabwe,Brazil,5,13,0,18
16604,2020,Afghanistan,Bosnia and Herzegovina,0,33,0,33
16605,2020,Algeria,Bosnia and Herzegovina,0,5,0,5
16606,2020,Egypt,Bosnia and Herzegovina,0,0,0,0
16607,2020,Azerbaijan,Bosnia and Herzegovina,5,0,0,5
16608,2020,Bangladesh,Bosnia and Herzegovina,0,5,0,5
16609,2020,Bosnia and Herzegovina,Bosnia and Herzegovina,0,0,96305,0
16610,2020,China,Bosnia and Herzegovina,0,0,0,0
16611,2020,Cameroon,Bosnia and Herzegovina,0,7,0,7
16612,2020,Eritrea,Bosnia and Herzegovina,0,0,0,0
16613,2020,Palestinian,Bosnia and Herzegovina,0,5,0,5
16614,2020,Ghana,Bosnia and Herzegovina,0,0,0,0
16615,2020,Croatia,Bosnia and Herzegovina,5112,0,0,5112
16616,2020,India,Bosnia and Herzegovina,0,7,0,7
16617,2020,Iran (Islamic Rep. of),Bosnia and Herzegovina,0,29,0,29
16618,2020,Iraq,Bosnia and Herzegovina,0,37,0,37
16619,2020,Kuwait,Bosnia and Herzegovina,0,0,0,0
16620,2020,Libya,Bosnia and Herzegovina,0,5,0,5
16621,2020,North Macedonia,Bosnia and Herzegovina,0,5,0,5
16622,2020,Morocco,Bosnia and Herzegovina,0,15,0,15
16623,2020,Myanmar,Bosnia and Herzegovina,0,0,0,0
16624,2020,Nepal,Bosnia and Herzegovina,0,0,0,0
16625,2020,Pakistan,Bosnia and Herzegovina,0,32,0,32
16626,2020,Russian Federation,Bosnia and Herzegovina,0,5,0,5
16627,2020,Serbia and Kosovo: S/RES/1244 (1999),Bosnia and Herzegovina,54,0,0,54
16628,2020,Somalia,Bosnia and Herzegovina,0,5,0,5
16629,2020,Sudan,Bosnia and Herzegovina,0,0,0,0
16630,2020,Syrian Arab Rep.,Bosnia and Herzegovina,22,10,0,32
16631,2020,Tunisia,Bosnia and Herzegovina,0,0,0,0
16632,2020,Türkiye,Bosnia and Herzegovina,33,44,0,77
16633,2020,Western Sahara,Bosnia and Herzegovina,0,0,0,0
16634,2020,Yemen,Bosnia and Herzegovina,6,7,0,13
16637,2020,Afghanistan,Bulgaria,244,942,0,1186
16638,2020,Algeria,Bulgaria,0,13,0,13
16639,2020,Egypt,Bulgaria,14,12,0,26
16640,2020,Armenia,Bulgaria,13,14,0,27
16641,2020,Bangladesh,Bulgaria,9,10,0,19
16642,2020,China,Bulgaria,0,14,0,14
16643,2020,Congo,Bulgaria,9,0,0,9
16644,2020,Dem. Rep. of the Congo,Bulgaria,0,6,0,6
16645,2020,Eritrea,Bulgaria,12,0,0,12
16646,2020,Ethiopia,Bulgaria,10,0,0,10
16647,2020,Ghana,Bulgaria,0,6,0,6
16648,2020,Guinea,Bulgaria,5,0,0,5
16649,2020,Cote d'Ivoire,Bulgaria,5,5,0,10
16650,2020,India,Bulgaria,5,0,0,5
16651,2020,Iran (Islamic Rep. of),Bulgaria,77,55,0,132
16652,2020,Iraq,Bulgaria,1235,27,0,1262
16653,2020,Jordan,Bulgaria,6,0,0,6
16654,2020,Kyrgyzstan,Bulgaria,0,6,0,6
16655,2020,Lebanon,Bulgaria,29,9,0,38
16656,2020,Mali,Bulgaria,5,5,0,10
16657,2020,Morocco,Bulgaria,5,19,0,24
16658,2020,Nepal,Bulgaria,0,5,0,5
16659,2020,Nigeria,Bulgaria,0,5,0,5
16660,2020,Pakistan,Bulgaria,26,83,0,109
16661,2020,Russian Federation,Bulgaria,0,20,0,20
16662,2020,Somalia,Bulgaria,50,5,0,55
16663,2020,Sudan,Bulgaria,12,0,0,12
16664,2020,Syrian Arab Rep.,Bulgaria,18310,593,0,18903
16665,2020,Tunisia,Bulgaria,5,11,0,16
16666,2020,Türkiye,Bulgaria,11,5,0,16
16667,2020,Ukraine,Bulgaria,0,32,0,32
16668,2020,Venezuela (Bolivarian Republic of),Bulgaria,0,5,0,5
16669,2020,Yemen,Bulgaria,15,7,0,22
16671,2020,Cuba,Belize,0,5,0,5
16672,2020,Guatemala,Belize,0,434,0,434
16673,2020,Honduras,Belize,5,485,0,490
16674,2020,Nicaragua,Belize,0,11,0,11
16675,2020,Peru,Belize,0,5,0,5
16676,2020,El Salvador,Belize,24,1309,0,1333
16678,2020,Viet Nam,Cambodia,0,12,0,12
16680,2020,Afghanistan,Canada,2261,507,0,2768
16681,2020,Albania,Canada,729,229,0,958
16682,2020,Algeria,Canada,592,847,0,1439
16683,2020,Angola,Canada,314,1225,0,1539
16684,2020,Antigua and Barbuda,Canada,96,22,0,118
16685,2020,Egypt,Canada,2940,756,0,3696
16686,2020,Argentina,Canada,0,50,0,50
16687,2020,Armenia,Canada,35,0,0,35
16688,2020,Azerbaijan,Canada,622,117,0,739
16689,2020,Bahrain,Canada,56,0,0,56
16690,2020,Barbados,Canada,216,106,0,322
16691,2020,Burundi,Canada,2796,294,0,3090
16692,2020,Belgium,Canada,5,0,0,5
16693,2020,Benin,Canada,48,69,0,117
16694,2020,Bangladesh,Canada,1288,1292,0,2580
16695,2020,Bahamas,Canada,353,554,0,907
16696,2020,Burkina Faso,Canada,83,157,0,240
16697,2020,Belarus,Canada,45,0,0,45
16698,2020,Bolivia (Plurinational State of),Canada,21,30,0,51
16699,2020,Botswana,Canada,144,0,0,144
16700,2020,Brazil,Canada,116,508,0,624
16701,2020,Bulgaria,Canada,109,42,0,151
16702,2020,Belize,Canada,19,0,0,19
16703,2020,Cambodia,Canada,42,26,0,68
16704,2020,Central African Rep.,Canada,49,34,0,83
16705,2020,Chad,Canada,577,410,0,987
16706,2020,China,Canada,5916,1945,0,7861
16707,2020,Chile,Canada,63,298,0,361
16708,2020,Cameroon,Canada,964,611,0,1575
16709,2020,Congo,Canada,259,179,0,438
16710,2020,Dem. Rep. of the Congo,Canada,1039,2230,0,3269
16711,2020,Colombia,Canada,4577,4501,0,9078
16712,2020,Costa Rica,Canada,12,32,0,44
16713,2020,Cuba,Canada,504,292,0,796
16714,2020,Czechia,Canada,346,78,0,424
16715,2020,Denmark,Canada,5,0,0,5
16716,2020,Djibouti,Canada,1156,81,0,1237
16717,2020,Dominica,Canada,6,0,0,6
16718,2020,Dominican Rep.,Canada,107,156,0,263
16719,2020,Ecuador,Canada,34,111,0,145
16720,2020,Equatorial Guinea,Canada,18,0,0,18
16721,2020,Eritrea,Canada,2151,275,0,2426
16722,2020,Estonia,Canada,5,0,0,5
16723,2020,Ethiopia,Canada,1420,599,0,2019
16724,2020,Fiji,Canada,18,0,0,18
16725,2020,France,Canada,0,33,0,33
16726,2020,Gabon,Canada,32,39,0,71
16727,2020,Gambia,Canada,79,98,0,177
16728,2020,Palestinian,Canada,1777,754,0,2531
16729,2020,Georgia,Canada,337,258,0,595
16730,2020,Ghana,Canada,300,321,0,621
16731,2020,Guinea-Bissau,Canada,8,0,0,8
16732,2020,Grenada,Canada,24,0,0,24
16733,2020,Guatemala,Canada,423,225,0,648
16734,2020,Guinea,Canada,372,365,0,737
16735,2020,Guyana,Canada,93,52,0,145
16736,2020,Haiti,Canada,4587,4662,0,9249
16737,2020,"China, Hong Kong SAR",Canada,0,27,0,27
16738,2020,Honduras,Canada,905,421,0,1326
16739,2020,Croatia,Canada,265,0,0,265
16740,2020,Hungary,Canada,4261,275,0,4536
16741,2020,Cote d'Ivoire,Canada,158,235,0,393
16742,2020,India,Canada,1598,10116,0,11714
16743,2020,Indonesia,Canada,97,56,0,153
16744,2020,Ireland,Canada,0,33,0,33
16745,2020,Iran (Islamic Rep. of),Canada,5085,2426,0,7511
16746,2020,Iraq,Canada,70,394,0,464
16747,2020,Israel,Canada,134,56,0,190
16748,2020,Italy,Canada,5,76,0,81
16749,2020,Jamaica,Canada,896,318,0,1214
16750,2020,Jordan,Canada,377,611,0,988
16751,2020,Kazakhstan,Canada,143,61,0,204
16752,2020,Kenya,Canada,229,517,0,746
16753,2020,Kyrgyzstan,Canada,64,0,0,64
16754,2020,Rep. of Korea,Canada,46,0,0,46
16755,2020,Dem. People's Rep. of Korea,Canada,370,0,0,370
16756,2020,Kuwait,Canada,22,40,0,62
16757,2020,Lao People's Dem. Rep.,Canada,5,0,0,5
16758,2020,Liberia,Canada,27,178,0,205
16759,2020,Libya,Canada,1719,258,0,1977
16760,2020,Saint Lucia,Canada,688,22,0,710
16761,2020,Lebanon,Canada,743,559,0,1302
16762,2020,Sri Lanka,Canada,2065,1038,0,3103
16763,2020,Lithuania,Canada,21,0,0,21
16764,2020,Latvia,Canada,71,0,0,71
16765,2020,Madagascar,Canada,15,21,0,36
16766,2020,Mauritania,Canada,134,201,0,335
16767,2020,North Macedonia,Canada,16,0,0,16
16768,2020,Rep. of Moldova,Canada,82,0,0,82
16769,2020,Mexico,Canada,3173,6770,0,9943
16770,2020,Mali,Canada,194,158,0,352
16771,2020,Malawi,Canada,10,74,0,84
16772,2020,Mongolia,Canada,135,45,0,180
16773,2020,Morocco,Canada,138,143,0,281
16774,2020,Malta,Canada,5,0,0,5
16775,2020,Mauritius,Canada,11,20,0,31
16776,2020,Namibia,Canada,286,0,0,286
16777,2020,Nepal,Canada,25,180,0,205
16778,2020,Netherlands,Canada,8,0,0,8
16779,2020,Niger,Canada,55,87,0,142
16780,2020,Nicaragua,Canada,338,464,0,802
16781,2020,Nigeria,Canada,8082,9148,0,17230
16782,2020,Pakistan,Canada,6085,2741,0,8826
16783,2020,Panama,Canada,21,0,0,21
16784,2020,Paraguay,Canada,15,0,0,15
16785,2020,Peru,Canada,112,303,0,415
16786,2020,Philippines,Canada,60,124,0,184
16787,2020,Poland,Canada,69,105,0,174
16788,2020,Portugal,Canada,5,23,0,28
16789,2020,Romania,Canada,423,526,0,949
16790,2020,South Africa,Canada,0,215,0,215
16791,2020,Russian Federation,Canada,675,153,0,828
16792,2020,Rwanda,Canada,811,643,0,1454
16793,2020,El Salvador,Canada,1540,570,0,2110
16794,2020,Saudi Arabia,Canada,463,116,0,579
16795,2020,Serbia and Kosovo: S/RES/1244 (1999),Canada,205,41,0,246
16796,2020,Senegal,Canada,217,324,0,541
16797,2020,Seychelles,Canada,5,0,0,5
16798,2020,Singapore,Canada,10,0,0,10
16799,2020,Sierra Leone,Canada,24,68,0,92
16800,2020,Somalia,Canada,2039,377,0,2416
16801,2020,Spain,Canada,11,28,0,39
16802,2020,Viet Nam,Canada,0,96,0,96
16803,2020,Saint Kitts and Nevis,Canada,44,0,0,44
16804,2020,Sudan,Canada,1776,549,0,2325
16805,2020,South Sudan,Canada,6,0,0,6
16806,2020,Slovakia,Canada,1180,138,0,1318
16807,2020,Slovenia,Canada,6,0,0,6
16808,2020,Eswatini,Canada,101,0,0,101
16809,2020,Syrian Arab Rep.,Canada,131,180,0,311
16810,2020,United Rep. of Tanzania,Canada,138,160,0,298
16811,2020,Tajikistan,Canada,33,0,0,33
16812,2020,Turkmenistan,Canada,22,0,0,22
16813,2020,Timor-Leste,Canada,5,0,0,5
16814,2020,Togo,Canada,79,104,0,183
16815,2020,Trinidad and Tobago,Canada,66,47,0,113
16816,2020,Tunisia,Canada,164,146,0,310
16817,2020,Türkiye,Canada,6387,974,0,7361
16818,2020,United Arab Emirates,Canada,24,0,0,24
16819,2020,Uganda,Canada,660,646,0,1306
16820,2020,Ukraine,Canada,1205,190,0,1395
16821,2020,United States of America,Canada,12,1932,0,1944
16822,2020,Uzbekistan,Canada,139,0,0,139
16823,2020,Saint Vincent and the Grenadines,Canada,666,0,0,666
16824,2020,Venezuela (Bolivarian Republic of),Canada,3524,1000,0,4524
16825,2020,Yemen,Canada,1949,184,0,2133
16826,2020,Zambia,Canada,0,28,0,28
16827,2020,Zimbabwe,Canada,629,334,0,963
16830,2020,Angola,Central African Rep.,13,0,0,13
16831,2020,Burundi,Central African Rep.,22,0,0,22
16832,2020,Central African Rep.,Central African Rep.,0,0,681930,0
16833,2020,Chad,Central African Rep.,1041,19,0,1060
16834,2020,Cameroon,Central African Rep.,19,23,0,42
16835,2020,Congo,Central African Rep.,17,8,0,25
16836,2020,Dem. Rep. of the Congo,Central African Rep.,5541,218,0,5759
16837,2020,Guinea,Central African Rep.,6,0,0,6
16838,2020,Cote d'Ivoire,Central African Rep.,6,0,0,6
16839,2020,Liberia,Central African Rep.,5,0,0,5
16840,2020,Rwanda,Central African Rep.,212,0,0,212
16841,2020,Sudan,Central African Rep.,387,12,0,399
16842,2020,South Sudan,Central African Rep.,1802,5,0,1807
16843,2020,Türkiye,Central African Rep.,5,0,0,5
16844,2020,Uganda,Central African Rep.,7,0,0,7
16845,2020,Cuba,Cayman Islands,38,28,0,66
16846,2020,Venezuela (Bolivarian Republic of),Cayman Islands,0,0,0,0
16847,2020,Burundi,Chad,5,0,0,5
16848,2020,Central African Rep.,Chad,96883,2366,0,99249
16849,2020,Chad,Chad,0,0,336124,0
16850,2020,Cameroon,Chad,6,16,0,22
16851,2020,Congo,Chad,11,0,0,11
16852,2020,Dem. Rep. of the Congo,Chad,243,25,0,268
16853,2020,Eritrea,Chad,6,15,0,21
16854,2020,Ethiopia,Chad,19,11,0,30
16855,2020,Cote d'Ivoire,Chad,5,0,0,5
16856,2020,Iran (Islamic Rep. of),Chad,5,0,0,5
16857,2020,Libya,Chad,24,20,0,44
16858,2020,Mali,Chad,7,0,0,7
16859,2020,Niger,Chad,707,0,0,707
16860,2020,Nigeria,Chad,16126,332,0,16458
16861,2020,Rwanda,Chad,14,0,0,14
16862,2020,Somalia,Chad,7,0,0,7
16863,2020,Sudan,Chad,364535,1769,0,366304
16864,2020,South Sudan,Chad,9,0,0,9
16865,2020,Syrian Arab Rep.,Chad,32,6,0,38
16866,2020,Yemen,Chad,5,8,0,13
16867,2020,Afghanistan,China,20,12,0,32
16868,2020,Burundi,China,7,0,0,7
16869,2020,Cameroon,China,5,377,0,382
16870,2020,Dem. Rep. of the Congo,China,10,20,0,30
16871,2020,Eritrea,China,9,0,0,9
16872,2020,Palestinian,China,13,9,0,22
16873,2020,Ghana,China,0,11,0,11
16874,2020,Cote d'Ivoire,China,0,8,0,8
16875,2020,Iran (Islamic Rep. of),China,5,0,0,5
16876,2020,Iraq,China,17,0,0,17
16877,2020,Kenya,China,0,29,0,29
16878,2020,Liberia,China,0,6,0,6
16879,2020,Morocco,China,0,5,0,5
16880,2020,Nigeria,China,0,17,0,17
16881,2020,Pakistan,China,32,9,0,41
16882,2020,Rwanda,China,0,9,0,9
16883,2020,Sierra Leone,China,0,7,0,7
16884,2020,Somalia,China,120,5,0,125
16885,2020,Viet Nam,China,303095,0,0,303095
16886,2020,Syrian Arab Rep.,China,41,13,0,54
16887,2020,Uganda,China,5,98,0,103
16888,2020,Yemen,China,21,13,0,34
16889,2020,Zambia,China,0,5,0,5
16890,2020,Zimbabwe,China,5,90,0,95
16891,2020,Afghanistan,Chile,13,13,0,26
16892,2020,Angola,Chile,0,5,0,5
16893,2020,Bangladesh,Chile,0,7,0,7
16894,2020,Bolivia (Plurinational State of),Chile,0,21,0,21
16895,2020,Congo,Chile,8,5,0,13
16896,2020,Dem. Rep. of the Congo,Chile,5,0,0,5
16897,2020,Colombia,Chile,1231,3332,0,4563
16898,2020,Costa Rica,Chile,5,0,0,5
16899,2020,Cuba,Chile,19,1597,0,1616
16900,2020,Dominican Rep.,Chile,0,116,0,116
16901,2020,Ecuador,Chile,23,29,0,52
16902,2020,Palestinian,Chile,15,7,0,22
16903,2020,Ghana,Chile,0,8,0,8
16904,2020,Guatemala,Chile,0,5,0,5
16905,2020,Haiti,Chile,0,26,0,26
16906,2020,Honduras,Chile,5,0,0,5
16907,2020,Iraq,Chile,0,14,0,14
16908,2020,Kenya,Chile,5,0,0,5
16909,2020,Rep. of Korea,Chile,0,5,0,5
16910,2020,Sri Lanka,Chile,5,0,0,5
16911,2020,Nicaragua,Chile,0,5,0,5
16912,2020,Pakistan,Chile,0,7,0,7
16913,2020,Peru,Chile,113,15,0,128
16914,2020,Russian Federation,Chile,5,7,0,12
16915,2020,El Salvador,Chile,9,27,0,36
16916,2020,Senegal,Chile,5,0,0,5
16917,2020,Sierra Leone,Chile,0,5,0,5
16918,2020,Syrian Arab Rep.,Chile,113,32,0,145
16919,2020,Türkiye,Chile,27,5,0,32
16920,2020,United States of America,Chile,0,5,0,5
16921,2020,Venezuela (Bolivarian Republic of),Chile,14,2763,0,2777
16923,2020,Angola,Cameroon,5,0,0,5
16924,2020,Burundi,Cameroon,70,20,0,90
16925,2020,Burkina Faso,Cameroon,0,40,0,40
16926,2020,Central African Rep.,Cameroon,316128,4541,0,320669
16927,2020,Chad,Cameroon,1600,375,0,1975
16928,2020,Cameroon,Cameroon,0,0,1032942,0
16929,2020,Congo,Cameroon,53,5,0,58
16930,2020,Dem. Rep. of the Congo,Cameroon,525,140,0,665
16931,2020,Ethiopia,Cameroon,0,5,0,5
16932,2020,Gambia,Cameroon,0,5,0,5
16933,2020,Guinea-Bissau,Cameroon,0,11,0,11
16934,2020,Guinea,Cameroon,14,278,0,292
16935,2020,Cote d'Ivoire,Cameroon,73,99,0,172
16936,2020,Iran (Islamic Rep. of),Cameroon,5,0,0,5
16937,2020,Liberia,Cameroon,9,5,0,14
16938,2020,Mauritania,Cameroon,5,5,0,10
16939,2020,Mali,Cameroon,21,255,0,276
16940,2020,Morocco,Cameroon,7,0,0,7
16941,2020,Niger,Cameroon,0,743,0,743
16942,2020,Nigeria,Cameroon,117422,41,0,117463
16943,2020,Rwanda,Cameroon,298,124,0,422
16944,2020,Senegal,Cameroon,0,27,0,27
16945,2020,Sierra Leone,Cameroon,0,10,0,10
16946,2020,Sudan,Cameroon,102,33,0,135
16947,2020,South Sudan,Cameroon,13,0,0,13
16948,2020,Syrian Arab Rep.,Cameroon,24,5,0,29
16949,2020,Togo,Cameroon,17,17,0,34
16950,2020,Türkiye,Cameroon,0,25,0,25
16951,2020,Yemen,Cameroon,5,0,0,5
16952,2020,Angola,Congo,13,46,0,59
16953,2020,Egypt,Congo,0,0,0,0
16954,2020,Burundi,Congo,71,8,0,79
16955,2020,Central African Rep.,Congo,16378,2907,0,19285
16956,2020,Chad,Congo,26,18,0,44
16957,2020,Cameroon,Congo,5,20,0,25
16958,2020,Congo,Congo,0,0,134430,0
16959,2020,Dem. Rep. of the Congo,Congo,9752,10035,0,19787
16960,2020,Guinea,Congo,0,5,0,5
16961,2020,Cote d'Ivoire,Congo,5,5,0,10
16962,2020,Liberia,Congo,0,5,0,5
16963,2020,Mauritania,Congo,5,45,0,50
16964,2020,Mali,Congo,5,0,0,5
16965,2020,Nigeria,Congo,5,0,0,5
16966,2020,Rwanda,Congo,796,477,0,1273
16967,2020,Sudan,Congo,31,38,0,69
16968,2020,Syrian Arab Rep.,Congo,5,13,0,18
16969,2020,Angola,Dem. Rep. of the Congo,414,25,0,439
16970,2020,Burundi,Dem. Rep. of the Congo,46829,536,0,47365
16971,2020,Central African Rep.,Dem. Rep. of the Congo,173731,590,0,174321
16972,2020,Chad,Dem. Rep. of the Congo,5,15,0,20
16973,2020,Cameroon,Dem. Rep. of the Congo,0,19,0,19
16974,2020,Congo,Dem. Rep. of the Congo,637,25,0,662
16975,2020,Dem. Rep. of the Congo,Dem. Rep. of the Congo,0,0,5198131,0
16976,2020,Eritrea,Dem. Rep. of the Congo,6,0,0,6
16977,2020,Ethiopia,Dem. Rep. of the Congo,0,5,0,5
16978,2020,Palestinian,Dem. Rep. of the Congo,0,6,0,6
16979,2020,Cote d'Ivoire,Dem. Rep. of the Congo,7,9,0,16
16980,2020,Kenya,Dem. Rep. of the Congo,0,5,0,5
16981,2020,Liberia,Dem. Rep. of the Congo,5,10,0,15
16982,2020,Lebanon,Dem. Rep. of the Congo,0,5,0,5
16983,2020,Mali,Dem. Rep. of the Congo,0,11,0,11
16984,2020,Niger,Dem. Rep. of the Congo,0,5,0,5
16985,2020,Romania,Dem. Rep. of the Congo,0,5,0,5
16986,2020,Rwanda,Dem. Rep. of the Congo,213777,133,0,213910
16987,2020,Somalia,Dem. Rep. of the Congo,14,55,0,69
16988,2020,Sudan,Dem. Rep. of the Congo,32,8,0,40
16989,2020,South Sudan,Dem. Rep. of the Congo,54755,0,0,54755
16990,2020,Syrian Arab Rep.,Dem. Rep. of the Congo,8,13,0,21
16991,2020,Uganda,Dem. Rep. of the Congo,23,0,0,23
16992,2020,Afghanistan,Colombia,9,0,0,9
16993,2020,Bolivia (Plurinational State of),Colombia,5,0,0,5
16994,2020,Cameroon,Colombia,0,6,0,6
16995,2020,Colombia,Colombia,0,0,8252788,0
16996,2020,Cuba,Colombia,77,137,0,214
16997,2020,Ecuador,Colombia,7,5,0,12
16998,2020,Eritrea,Colombia,5,0,0,5
16999,2020,Ethiopia,Colombia,7,0,0,7
17000,2020,Palestinian,Colombia,0,5,0,5
17001,2020,Ghana,Colombia,0,5,0,5
17002,2020,Honduras,Colombia,5,0,0,5
17003,2020,Hungary,Colombia,5,0,0,5
17004,2020,Iraq,Colombia,7,5,0,12
17005,2020,Nicaragua,Colombia,9,0,0,9
17006,2020,Nigeria,Colombia,0,5,0,5
17007,2020,El Salvador,Colombia,11,0,0,11
17008,2020,Serbia and Kosovo: S/RES/1244 (1999),Colombia,5,0,0,5
17009,2020,Sierra Leone,Colombia,5,0,0,5
17010,2020,Somalia,Colombia,11,0,0,11
17011,2020,Syrian Arab Rep.,Colombia,8,8,0,16
17012,2020,Türkiye,Colombia,5,34,0,39
17013,2020,Venezuela (Bolivarian Republic of),Colombia,771,19587,0,20358
17014,2020,Yemen,Colombia,0,7,0,7
17017,2020,Angola,Costa Rica,0,52,0,52
17018,2020,Argentina,Costa Rica,0,8,0,8
17019,2020,Burundi,Costa Rica,9,0,0,9
17020,2020,Bangladesh,Costa Rica,0,16,0,16
17021,2020,Burkina Faso,Costa Rica,0,5,0,5
17022,2020,Bolivia (Plurinational State of),Costa Rica,0,5,0,5
17023,2020,Brazil,Costa Rica,0,13,0,13
17024,2020,China,Costa Rica,0,205,0,205
17025,2020,Chile,Costa Rica,0,16,0,16
17026,2020,Cameroon,Costa Rica,0,22,0,22
17027,2020,Congo,Costa Rica,0,57,0,57
17028,2020,Dem. Rep. of the Congo,Costa Rica,12,42,0,54
17029,2020,Colombia,Costa Rica,2322,1042,0,3364
17030,2020,Cuba,Costa Rica,417,3206,0,3623
17031,2020,Dominican Rep.,Costa Rica,0,71,0,71
17032,2020,Ecuador,Costa Rica,0,16,0,16
17033,2020,Eritrea,Costa Rica,0,7,0,7
17034,2020,Ethiopia,Costa Rica,5,0,0,5
17035,2020,Gambia,Costa Rica,0,5,0,5
17036,2020,Germany,Costa Rica,0,5,0,5
17037,2020,Ghana,Costa Rica,0,57,0,57
17038,2020,Guatemala,Costa Rica,25,36,0,61
17039,2020,Haiti,Costa Rica,12,128,0,140
17040,2020,Honduras,Costa Rica,205,702,0,907
17041,2020,Cote d'Ivoire,Costa Rica,0,5,0,5
17042,2020,India,Costa Rica,0,5,0,5
17043,2020,Indonesia,Costa Rica,5,0,0,5
17044,2020,Iran (Islamic Rep. of),Costa Rica,5,0,0,5
17045,2020,Iraq,Costa Rica,5,0,0,5
17046,2020,Israel,Costa Rica,0,5,0,5
17047,2020,Italy,Costa Rica,0,5,0,5
17048,2020,Jamaica,Costa Rica,0,13,0,13
17049,2020,Lebanon,Costa Rica,0,5,0,5
17050,2020,Mexico,Costa Rica,13,11,0,24
17051,2020,Nepal,Costa Rica,0,102,0,102
17052,2020,Niger,Costa Rica,0,5,0,5
17053,2020,Nicaragua,Costa Rica,3811,38700,0,42511
17054,2020,Nigeria,Costa Rica,17,0,0,17
17055,2020,Pakistan,Costa Rica,5,11,0,16
17056,2020,Panama,Costa Rica,5,17,0,22
17057,2020,Peru,Costa Rica,13,7,0,20
17058,2020,Russian Federation,Costa Rica,27,0,0,27
17059,2020,El Salvador,Costa Rica,1384,141,0,1525
17060,2020,Senegal,Costa Rica,0,5,0,5
17061,2020,Somalia,Costa Rica,7,7,0,14
17062,2020,Spain,Costa Rica,0,6,0,6
17063,2020,Syrian Arab Rep.,Costa Rica,5,21,0,26
17064,2020,Ukraine,Costa Rica,13,0,0,13
17065,2020,United States of America,Costa Rica,5,30,0,35
17066,2020,Venezuela (Bolivarian Republic of),Costa Rica,1266,5422,0,6688
17067,2020,Zimbabwe,Costa Rica,0,5,0,5
17070,2020,Afghanistan,Cuba,28,0,0,28
17071,2020,Eritrea,Cuba,12,0,0,12
17072,2020,Ethiopia,Cuba,6,0,0,6
17073,2020,Haiti,Cuba,5,0,0,5
17074,2020,Iran (Islamic Rep. of),Cuba,11,5,0,16
17075,2020,Sudan,Cuba,10,0,0,10
17076,2020,Syrian Arab Rep.,Cuba,40,5,0,45
17077,2020,Western Sahara,Cuba,95,0,0,95
17078,2020,Yemen,Cuba,15,0,0,15
17080,2020,Afghanistan,Cyprus,16,17,0,33
17081,2020,Albania,Cyprus,0,5,0,5
17082,2020,Algeria,Cyprus,8,7,0,15
17083,2020,Egypt,Cyprus,119,842,0,961
17084,2020,Armenia,Cyprus,26,18,0,44
17085,2020,Burundi,Cyprus,0,5,0,5
17086,2020,Bangladesh,Cyprus,5,1594,0,1599
17087,2020,Burkina Faso,Cyprus,0,5,0,5
17088,2020,Belarus,Cyprus,0,5,0,5
17089,2020,Bosnia and Herzegovina,Cyprus,15,0,0,15
17090,2020,China,Cyprus,5,9,0,14
17091,2020,Cameroon,Cyprus,83,2350,0,2433
17092,2020,Congo,Cyprus,10,88,0,98
17093,2020,Dem. Rep. of the Congo,Cyprus,25,771,0,796
17094,2020,Comoros,Cyprus,0,7,0,7
17095,2020,Eritrea,Cyprus,53,5,0,58
17096,2020,Ethiopia,Cyprus,10,14,0,24
17097,2020,Gambia,Cyprus,6,56,0,62
17098,2020,Palestinian,Cyprus,2105,247,0,2352
17099,2020,Georgia,Cyprus,85,957,0,1042
17100,2020,Ghana,Cyprus,0,29,0,29
17101,2020,Guinea,Cyprus,5,222,0,227
17102,2020,Haiti,Cyprus,0,12,0,12
17103,2020,Cote d'Ivoire,Cyprus,5,70,0,75
17104,2020,India,Cyprus,9,2089,0,2098
17105,2020,Iran (Islamic Rep. of),Cyprus,584,581,0,1165
17106,2020,Iraq,Cyprus,962,228,0,1190
17107,2020,Jordan,Cyprus,40,94,0,134
17108,2020,Kazakhstan,Cyprus,5,0,0,5
17109,2020,Kenya,Cyprus,0,5,0,5
17110,2020,Kyrgyzstan,Cyprus,5,5,0,10
17111,2020,Liberia,Cyprus,0,5,0,5
17112,2020,Libya,Cyprus,12,5,0,17
17113,2020,Lebanon,Cyprus,52,106,0,158
17114,2020,Sri Lanka,Cyprus,27,561,0,588
17115,2020,Rep. of Moldova,Cyprus,18,10,0,28
17116,2020,Mali,Cyprus,0,11,0,11
17117,2020,Morocco,Cyprus,0,6,0,6
17118,2020,Nepal,Cyprus,0,582,0,582
17119,2020,Nigeria,Cyprus,14,815,0,829
17120,2020,Pakistan,Cyprus,18,916,0,934
17121,2020,Philippines,Cyprus,12,179,0,191
17122,2020,Russian Federation,Cyprus,77,76,0,153
17123,2020,Rwanda,Cyprus,5,6,0,11
17124,2020,Serbia and Kosovo: S/RES/1244 (1999),Cyprus,59,9,0,68
17125,2020,Senegal,Cyprus,0,26,0,26
17126,2020,Sierra Leone,Cyprus,24,157,0,181
17127,2020,Somalia,Cyprus,320,312,0,632
17128,2020,Viet Nam,Cyprus,5,640,0,645
17129,2020,Sudan,Cyprus,13,5,0,18
17130,2020,Syrian Arab Rep.,Cyprus,8797,4415,0,13212
17131,2020,Turkmenistan,Cyprus,0,5,0,5
17132,2020,Togo,Cyprus,0,12,0,12
17133,2020,Türkiye,Cyprus,240,224,0,464
17134,2020,Ukraine,Cyprus,30,139,0,169
17135,2020,Uzbekistan,Cyprus,5,13,0,18
17136,2020,Yemen,Cyprus,27,20,0,47
17137,2020,Zimbabwe,Cyprus,0,24,0,24
17140,2020,Afghanistan,Czechia,39,5,0,44
17141,2020,Algeria,Czechia,0,5,0,5
17142,2020,Egypt,Czechia,8,6,0,14
17143,2020,Armenia,Czechia,28,22,0,50
17144,2020,Azerbaijan,Czechia,21,23,0,44
17145,2020,Burundi,Czechia,5,0,0,5
17146,2020,Belarus,Czechia,134,63,0,197
17147,2020,Bosnia and Herzegovina,Czechia,5,0,0,5
17148,2020,China,Czechia,22,54,0,76
17149,2020,Cameroon,Czechia,0,5,0,5
17150,2020,Dem. Rep. of the Congo,Czechia,6,5,0,11
17151,2020,Cuba,Czechia,43,16,0,59
17152,2020,Eritrea,Czechia,11,0,0,11
17153,2020,Ethiopia,Czechia,5,0,0,5
17154,2020,Georgia,Czechia,14,23,0,37
17155,2020,Guinea,Czechia,5,0,0,5
17156,2020,Iran (Islamic Rep. of),Czechia,5,6,0,11
17157,2020,Iraq,Czechia,109,5,0,114
17158,2020,Kazakhstan,Czechia,109,23,0,132
17159,2020,Kyrgyzstan,Czechia,21,11,0,32
17160,2020,Libya,Czechia,20,7,0,27
17161,2020,Lebanon,Czechia,5,0,0,5
17162,2020,Sri Lanka,Czechia,6,0,0,6
17163,2020,Rep. of Moldova,Czechia,18,14,0,32
17164,2020,Mongolia,Czechia,6,10,0,16
17165,2020,Morocco,Czechia,5,0,0,5
17166,2020,Myanmar,Czechia,145,0,0,145
17167,2020,Nigeria,Czechia,8,10,0,18
17168,2020,Pakistan,Czechia,14,5,0,19
17169,2020,Russian Federation,Czechia,177,23,0,200
17170,2020,Saudi Arabia,Czechia,6,0,0,6
17171,2020,Serbia and Kosovo: S/RES/1244 (1999),Czechia,7,0,0,7
17172,2020,Sierra Leone,Czechia,5,0,0,5
17173,2020,Somalia,Czechia,14,0,0,14
17174,2020,Viet Nam,Czechia,15,23,0,38
17175,2020,Sudan,Czechia,9,0,0,9
17176,2020,Syrian Arab Rep.,Czechia,386,12,0,398
17177,2020,Turkmenistan,Czechia,8,0,0,8
17178,2020,Togo,Czechia,5,0,0,5
17179,2020,Tunisia,Czechia,0,7,0,7
17180,2020,Türkiye,Czechia,11,22,0,33
17181,2020,Uganda,Czechia,5,0,0,5
17182,2020,Ukraine,Czechia,284,121,0,405
17183,2020,Uzbekistan,Czechia,53,37,0,90
17184,2020,Venezuela (Bolivarian Republic of),Czechia,5,13,0,18
17185,2020,Yemen,Czechia,24,5,0,29
17188,2020,Afghanistan,Denmark,2134,82,0,2216
17189,2020,Albania,Denmark,0,5,0,5
17190,2020,Algeria,Denmark,0,16,0,16
17191,2020,Egypt,Denmark,16,10,0,26
17192,2020,Armenia,Denmark,80,12,0,92
17193,2020,Azerbaijan,Denmark,32,0,0,32
17194,2020,Burundi,Denmark,5,0,0,5
17195,2020,Bangladesh,Denmark,18,6,0,24
17196,2020,Belarus,Denmark,5,11,0,16
17197,2020,Bosnia and Herzegovina,Denmark,5,0,0,5
17198,2020,China,Denmark,17,5,0,22
17199,2020,Cameroon,Denmark,7,10,0,17
17200,2020,Congo,Denmark,5,0,0,5
17201,2020,Dem. Rep. of the Congo,Denmark,71,7,0,78
17202,2020,Colombia,Denmark,5,17,0,22
17203,2020,Eritrea,Denmark,5399,203,0,5602
17204,2020,Ethiopia,Denmark,95,10,0,105
17205,2020,Gambia,Denmark,5,5,0,10
17206,2020,Palestinian,Denmark,9,0,0,9
17207,2020,Georgia,Denmark,0,30,0,30
17208,2020,Ghana,Denmark,5,5,0,10
17209,2020,Guinea-Bissau,Denmark,5,0,0,5
17210,2020,Cote d'Ivoire,Denmark,14,0,0,14
17211,2020,India,Denmark,5,11,0,16
17212,2020,Iran (Islamic Rep. of),Denmark,3051,127,0,3178
17213,2020,Iraq,Denmark,289,49,0,338
17214,2020,Jordan,Denmark,0,5,0,5
17215,2020,Kenya,Denmark,5,0,0,5
17216,2020,Kyrgyzstan,Denmark,5,0,0,5
17217,2020,Dem. People's Rep. of Korea,Denmark,6,0,0,6
17218,2020,Libya,Denmark,5,6,0,11
17219,2020,Lebanon,Denmark,30,6,0,36
17220,2020,Sri Lanka,Denmark,44,6,0,50
17221,2020,North Macedonia,Denmark,0,9,0,9
17222,2020,Mongolia,Denmark,0,5,0,5
17223,2020,Morocco,Denmark,9,50,0,59
17224,2020,Myanmar,Denmark,21,0,0,21
17225,2020,Nepal,Denmark,5,0,0,5
17226,2020,Nicaragua,Denmark,9,0,0,9
17227,2020,Nigeria,Denmark,10,7,0,17
17228,2020,Pakistan,Denmark,65,31,0,96
17229,2020,Russian Federation,Denmark,748,30,0,778
17230,2020,Rwanda,Denmark,14,6,0,20
17231,2020,El Salvador,Denmark,5,0,0,5
17232,2020,Serbia and Kosovo: S/RES/1244 (1999),Denmark,0,5,0,5
17233,2020,Somalia,Denmark,1321,80,0,1401
17234,2020,Sudan,Denmark,63,5,0,68
17235,2020,Syrian Arab Rep.,Denmark,19878,281,0,20159
17236,2020,United Rep. of Tanzania,Denmark,5,0,0,5
17237,2020,Thailand,Denmark,5,0,0,5
17238,2020,Tajikistan,Denmark,6,0,0,6
17239,2020,Tunisia,Denmark,0,5,0,5
17240,2020,Türkiye,Denmark,15,27,0,42
17241,2020,Uganda,Denmark,74,9,0,83
17242,2020,Ukraine,Denmark,29,28,0,57
17243,2020,Uzbekistan,Denmark,9,5,0,14
17244,2020,Venezuela (Bolivarian Republic of),Denmark,5,11,0,16
17245,2020,Yemen,Denmark,7,0,0,7
17246,2020,Zambia,Denmark,5,0,0,5
17247,2020,Zimbabwe,Denmark,8,0,0,8
17249,2020,Dem. Rep. of the Congo,Djibouti,5,9,0,14
17250,2020,Djibouti,Djibouti,0,0,0,0
17251,2020,Eritrea,Djibouti,515,438,0,953
17252,2020,Ethiopia,Djibouti,1413,10225,0,11638
17253,2020,Iraq,Djibouti,19,0,0,19
17254,2020,Mali,Djibouti,0,5,0,5
17255,2020,Somalia,Djibouti,13558,129,0,13687
17256,2020,Sudan,Djibouti,7,5,0,12
17257,2020,Syrian Arab Rep.,Djibouti,10,0,0,10
17258,2020,Yemen,Djibouti,5666,0,0,5666
17259,2020,Afghanistan,Dominican Rep.,0,8,0,8
17260,2020,Colombia,Dominican Rep.,0,5,0,5
17261,2020,Cuba,Dominican Rep.,0,49,0,49
17262,2020,Haiti,Dominican Rep.,162,273,0,435
17263,2020,Honduras,Dominican Rep.,0,5,0,5
17264,2020,Sri Lanka,Dominican Rep.,0,5,0,5
17265,2020,Nicaragua,Dominican Rep.,0,5,0,5
17266,2020,Venezuela (Bolivarian Republic of),Dominican Rep.,0,275,0,275
17267,2020,Afghanistan,Ecuador,146,5,0,151
17268,2020,Albania,Ecuador,6,0,0,6
17269,2020,Angola,Ecuador,5,18,0,23
17270,2020,Egypt,Ecuador,0,8,0,8
17271,2020,Argentina,Ecuador,0,6,0,6
17272,2020,Bangladesh,Ecuador,5,14,0,19
17273,2020,Brazil,Ecuador,5,15,0,20
17274,2020,China,Ecuador,12,5,0,17
17275,2020,Chile,Ecuador,6,5,0,11
17276,2020,Cameroon,Ecuador,19,26,0,45
17277,2020,Congo,Ecuador,5,5,0,10
17278,2020,Dem. Rep. of the Congo,Ecuador,8,13,0,21
17279,2020,Colombia,Ecuador,102931,11401,0,114332
17280,2020,Cuba,Ecuador,214,330,0,544
17281,2020,Dominican Rep.,Ecuador,5,43,0,48
17282,2020,Eritrea,Ecuador,11,5,0,16
17283,2020,Ethiopia,Ecuador,5,0,0,5
17284,2020,Gambia,Ecuador,0,5,0,5
17285,2020,Palestinian,Ecuador,9,9,0,18
17286,2020,Ghana,Ecuador,5,5,0,10
17287,2020,Guinea,Ecuador,9,5,0,14
17288,2020,Haiti,Ecuador,21,36,0,57
17289,2020,Honduras,Ecuador,0,5,0,5
17290,2020,Cote d'Ivoire,Ecuador,0,5,0,5
17291,2020,India,Ecuador,5,23,0,28
17292,2020,Iran (Islamic Rep. of),Ecuador,62,20,0,82
17293,2020,Iraq,Ecuador,56,18,0,74
17294,2020,Jordan,Ecuador,0,5,0,5
17295,2020,Liberia,Ecuador,6,0,0,6
17296,2020,Lebanon,Ecuador,19,14,0,33
17297,2020,Sri Lanka,Ecuador,18,14,0,32
17298,2020,Mali,Ecuador,5,5,0,10
17299,2020,Morocco,Ecuador,5,0,0,5
17300,2020,Nepal,Ecuador,5,5,0,10
17301,2020,Nicaragua,Ecuador,5,0,0,5
17302,2020,Nigeria,Ecuador,37,6,0,43
17303,2020,Pakistan,Ecuador,29,10,0,39
17304,2020,Peru,Ecuador,82,116,0,198
17305,2020,Romania,Ecuador,0,5,0,5
17306,2020,South Africa,Ecuador,0,7,0,7
17307,2020,Russian Federation,Ecuador,34,8,0,42
17308,2020,Rwanda,Ecuador,5,0,0,5
17309,2020,El Salvador,Ecuador,23,8,0,31
17310,2020,Saudi Arabia,Ecuador,8,0,0,8
17311,2020,Somalia,Ecuador,8,0,0,8
17312,2020,Spain,Ecuador,5,0,0,5
17313,2020,Viet Nam,Ecuador,5,0,0,5
17314,2020,Sudan,Ecuador,5,8,0,13
17315,2020,Syrian Arab Rep.,Ecuador,142,29,0,171
17316,2020,Türkiye,Ecuador,5,0,0,5
17317,2020,United Arab Emirates,Ecuador,0,5,0,5
17318,2020,Ukraine,Ecuador,15,5,0,20
17319,2020,United States of America,Ecuador,8,6,0,14
17320,2020,Uzbekistan,Ecuador,5,0,0,5
17321,2020,Venezuela (Bolivarian Republic of),Ecuador,410,13648,0,14058
17322,2020,Western Sahara,Ecuador,5,0,0,5
17323,2020,Yemen,Ecuador,102,53,0,155
17324,2020,Zimbabwe,Ecuador,5,9,0,14
17326,2020,Eritrea,Eritrea,0,0,0,0
17327,2020,Ethiopia,Eritrea,15,0,0,15
17328,2020,Somalia,Eritrea,80,0,0,80
17329,2020,Sudan,Eritrea,99,0,0,99
17330,2020,South Sudan,Eritrea,7,0,0,7
17331,2020,Egypt,Estonia,5,0,0,5
17332,2020,Azerbaijan,Estonia,5,0,0,5
17333,2020,Eritrea,Estonia,8,0,0,8
17334,2020,Georgia,Estonia,5,0,0,5
17335,2020,Iran (Islamic Rep. of),Estonia,5,0,0,5
17336,2020,Iraq,Estonia,22,0,0,22
17337,2020,Pakistan,Estonia,5,0,0,5
17338,2020,Russian Federation,Estonia,40,5,0,45
17339,2020,Serbia and Kosovo: S/RES/1244 (1999),Estonia,6,0,0,6
17340,2020,Sudan,Estonia,14,0,0,14
17341,2020,Syrian Arab Rep.,Estonia,105,0,0,105
17342,2020,Türkiye,Estonia,23,0,0,23
17343,2020,Ukraine,Estonia,29,0,0,29
17344,2020,Yemen,Estonia,5,0,0,5
17346,2020,Egypt,Ethiopia,5,0,0,5
17347,2020,Burundi,Ethiopia,59,72,0,131
17348,2020,Cameroon,Ethiopia,0,5,0,5
17349,2020,Dem. Rep. of the Congo,Ethiopia,738,282,0,1020
17350,2020,Cuba,Ethiopia,5,0,0,5
17351,2020,Djibouti,Ethiopia,49,0,0,49
17352,2020,Eritrea,Ethiopia,181091,180,0,181271
17353,2020,Ethiopia,Ethiopia,0,0,2733628,0
17354,2020,Palestinian,Ethiopia,0,5,0,5
17355,2020,Cote d'Ivoire,Ethiopia,5,0,0,5
17356,2020,Iraq,Ethiopia,10,0,0,10
17357,2020,Jordan,Ethiopia,0,10,0,10
17358,2020,Kenya,Ethiopia,4022,0,0,4022
17359,2020,Nigeria,Ethiopia,0,5,0,5
17360,2020,Rwanda,Ethiopia,13,7,0,20
17361,2020,Somalia,Ethiopia,203803,46,0,203849
17362,2020,Sudan,Ethiopia,43566,532,0,44098
17363,2020,South Sudan,Ethiopia,365030,206,0,365236
17364,2020,Syrian Arab Rep.,Ethiopia,6,424,0,430
17365,2020,Uganda,Ethiopia,7,5,0,12
17366,2020,Yemen,Ethiopia,2045,122,0,2167
17367,2020,Afghanistan,Fiji,8,0,0,8
17368,2020,Bangladesh,Fiji,0,5,0,5
17369,2020,Pakistan,Fiji,6,0,0,6
17370,2020,Afghanistan,Finland,3331,928,0,4259
17371,2020,Albania,Finland,5,7,0,12
17372,2020,Algeria,Finland,10,5,0,15
17373,2020,Angola,Finland,91,5,0,96
17374,2020,Egypt,Finland,26,28,0,54
17375,2020,Azerbaijan,Finland,60,15,0,75
17376,2020,Burundi,Finland,5,5,0,10
17377,2020,Bangladesh,Finland,29,24,0,53
17378,2020,Burkina Faso,Finland,5,0,0,5
17379,2020,Belarus,Finland,14,6,0,20
17380,2020,Brazil,Finland,5,0,0,5
17381,2020,Cambodia,Finland,5,0,0,5
17382,2020,Central African Rep.,Finland,6,0,0,6
17383,2020,China,Finland,186,16,0,202
17384,2020,Cameroon,Finland,117,67,0,184
17385,2020,Congo,Finland,7,5,0,12
17386,2020,Dem. Rep. of the Congo,Finland,110,39,0,149
17387,2020,Colombia,Finland,0,26,0,26
17388,2020,Cuba,Finland,5,22,0,27
17389,2020,Dominican Rep.,Finland,5,0,0,5
17390,2020,Eritrea,Finland,856,19,0,875
17391,2020,Ethiopia,Finland,146,38,0,184
17392,2020,Gambia,Finland,31,29,0,60
17393,2020,Georgia,Finland,5,11,0,16
17394,2020,Ghana,Finland,47,32,0,79
17395,2020,Guatemala,Finland,5,0,0,5
17396,2020,Guinea,Finland,24,7,0,31
17397,2020,Honduras,Finland,28,6,0,34
17398,2020,Cote d'Ivoire,Finland,9,6,0,15
17399,2020,India,Finland,5,16,0,21
17400,2020,Indonesia,Finland,5,0,0,5
17401,2020,Iran (Islamic Rep. of),Finland,942,265,0,1207
17402,2020,Iraq,Finland,8938,2633,0,11571
17403,2020,Jordan,Finland,5,0,0,5
17404,2020,Kazakhstan,Finland,14,6,0,20
17405,2020,Kenya,Finland,18,12,0,30
17406,2020,Kyrgyzstan,Finland,19,0,0,19
17407,2020,Rep. of Korea,Finland,0,5,0,5
17408,2020,Liberia,Finland,5,0,0,5
17409,2020,Libya,Finland,32,5,0,37
17410,2020,Lebanon,Finland,13,5,0,18
17411,2020,Sri Lanka,Finland,38,23,0,61
17412,2020,Rep. of Moldova,Finland,6,0,0,6
17413,2020,Mexico,Finland,0,8,0,8
17414,2020,Mali,Finland,6,0,0,6
17415,2020,Malaysia,Finland,0,5,0,5
17416,2020,Morocco,Finland,43,21,0,64
17417,2020,Myanmar,Finland,33,6,0,39
17418,2020,Nepal,Finland,0,5,0,5
17419,2020,Nicaragua,Finland,53,22,0,75
17420,2020,Nigeria,Finland,148,114,0,262
17421,2020,Pakistan,Finland,75,31,0,106
17422,2020,Philippines,Finland,0,5,0,5
17423,2020,South Africa,Finland,0,5,0,5
17424,2020,Russian Federation,Finland,885,545,0,1430
17425,2020,Rwanda,Finland,35,26,0,61
17426,2020,El Salvador,Finland,10,5,0,15
17427,2020,Serbia and Kosovo: S/RES/1244 (1999),Finland,47,0,0,47
17428,2020,Senegal,Finland,5,5,0,10
17429,2020,Sierra Leone,Finland,6,11,0,17
17430,2020,Somalia,Finland,2509,637,0,3146
17431,2020,Viet Nam,Finland,5,5,0,10
17432,2020,Sudan,Finland,50,11,0,61
17433,2020,South Sudan,Finland,8,0,0,8
17434,2020,Syrian Arab Rep.,Finland,2620,84,0,2704
17435,2020,United Rep. of Tanzania,Finland,5,5,0,10
17436,2020,Tajikistan,Finland,7,5,0,12
17437,2020,Togo,Finland,5,0,0,5
17438,2020,Tunisia,Finland,5,10,0,15
17439,2020,Türkiye,Finland,729,203,0,932
17440,2020,Uganda,Finland,34,5,0,39
17441,2020,Ukraine,Finland,11,43,0,54
17442,2020,United States of America,Finland,0,5,0,5
17443,2020,Uzbekistan,Finland,11,0,0,11
17444,2020,Venezuela (Bolivarian Republic of),Finland,7,9,0,16
17445,2020,Yemen,Finland,297,27,0,324
17446,2020,Zimbabwe,Finland,6,0,0,6
17449,2020,Afghanistan,France,31546,13560,0,45106
17450,2020,Albania,France,6229,1721,0,7950
17451,2020,Algeria,France,2134,1200,0,3334
17452,2020,Angola,France,3774,1961,0,5735
17453,2020,Egypt,France,1121,556,0,1677
17454,2020,Argentina,France,5,0,0,5
17455,2020,Armenia,France,4297,978,0,5275
17456,2020,Azerbaijan,France,2956,520,0,3476
17457,2020,Bahrain,France,10,0,0,10
17458,2020,Burundi,France,1286,585,0,1871
17459,2020,Benin,France,108,310,0,418
17460,2020,Bangladesh,France,6496,8979,0,15475
17461,2020,Bhutan,France,127,0,0,127
17462,2020,Burkina Faso,France,341,405,0,746
17463,2020,Belarus,France,536,146,0,682
17464,2020,Bolivia (Plurinational State of),France,39,6,0,45
17465,2020,Brazil,France,31,13,0,44
17466,2020,Bosnia and Herzegovina,France,4113,571,0,4684
17467,2020,Bulgaria,France,70,0,0,70
17468,2020,Cambodia,France,10894,14,0,10908
17469,2020,Central African Rep.,France,3718,527,0,4245
17470,2020,Chad,France,2114,1457,0,3571
17471,2020,China,France,8343,263,0,8606
17472,2020,Chile,France,67,0,0,67
17473,2020,Cameroon,France,1791,1490,0,3281
17474,2020,Congo,France,3808,1229,0,5037
17475,2020,Dem. Rep. of the Congo,France,18332,4995,0,23327
17476,2020,Comoros,France,722,2095,0,2817
17477,2020,Colombia,France,644,690,0,1334
17478,2020,Costa Rica,France,5,0,0,5
17479,2020,Cuba,France,225,223,0,448
17480,2020,Czechia,France,24,0,0,24
17481,2020,Djibouti,France,358,181,0,539
17482,2020,Dominica,France,5,0,0,5
17483,2020,Dominican Rep.,France,95,85,0,180
17484,2020,Ecuador,France,24,0,0,24
17485,2020,Equatorial Guinea,France,42,0,0,42
17486,2020,Eritrea,France,7318,1669,0,8987
17487,2020,Estonia,France,5,0,0,5
17488,2020,Ethiopia,France,1963,907,0,2870
17489,2020,Gabon,France,305,638,0,943
17490,2020,Gambia,France,365,574,0,939
17491,2020,Palestinian,France,1256,177,0,1433
17492,2020,Georgia,France,3701,1426,0,5127
17493,2020,Germany,France,5,0,0,5
17494,2020,Ghana,France,521,178,0,699
17495,2020,Guinea-Bissau,France,909,187,0,1096
17496,2020,Guatemala,France,19,0,0,19
17497,2020,Guinea,France,13277,7755,0,21032
17498,2020,Guyana,France,19,0,0,19
17499,2020,Haiti,France,4128,1935,0,6063
17500,2020,Honduras,France,30,5,0,35
17501,2020,Croatia,France,56,0,0,56
17502,2020,Hungary,France,54,0,0,54
17503,2020,Cote d'Ivoire,France,7023,6407,0,13430
17504,2020,India,France,242,344,0,586
17505,2020,Indonesia,France,8,0,0,8
17506,2020,Iran (Islamic Rep. of),France,3122,740,0,3862
17507,2020,Iraq,France,9075,1307,0,10382
17508,2020,Israel,France,8,0,0,8
17509,2020,Jamaica,France,20,0,0,20
17510,2020,Jordan,France,33,5,0,38
17511,2020,Kazakhstan,France,633,211,0,844
17512,2020,Kenya,France,141,14,0,155
17513,2020,Kyrgyzstan,France,314,10,0,324
17514,2020,Rep. of Korea,France,0,5,0,5
17515,2020,Kuwait,France,224,310,0,534
17516,2020,Lao People's Dem. Rep.,France,6397,0,0,6397
17517,2020,Liberia,France,252,14,0,266
17518,2020,Libya,France,1298,627,0,1925
17519,2020,Saint Lucia,France,5,0,0,5
17520,2020,Lebanon,France,167,191,0,358
17521,2020,Sri Lanka,France,23764,2398,0,26162
17522,2020,Lithuania,France,6,0,0,6
17523,2020,Latvia,France,32,0,0,32
17524,2020,Madagascar,France,234,271,0,505
17525,2020,Mauritania,France,5891,1773,0,7664
17526,2020,North Macedonia,France,396,198,0,594
17527,2020,Rep. of Moldova,France,325,1214,0,1539
17528,2020,Maldives,France,5,0,0,5
17529,2020,Mexico,France,27,0,0,27
17530,2020,Mali,France,5576,2636,0,8212
17531,2020,Malaysia,France,16,0,0,16
17532,2020,Mongolia,France,503,223,0,726
17533,2020,Morocco,France,920,561,0,1481
17534,2020,Mozambique,France,12,0,0,12
17535,2020,Montenegro,France,97,0,0,97
17536,2020,Mauritius,France,31,0,0,31
17537,2020,Myanmar,France,324,5,0,329
17538,2020,Nepal,France,161,60,0,221
17539,2020,Niger,France,126,181,0,307
17540,2020,Nicaragua,France,33,5,0,38
17541,2020,Nigeria,France,3661,6714,0,10375
17542,2020,Pakistan,France,2017,3458,0,5475
17543,2020,Paraguay,France,6,0,0,6
17544,2020,Peru,France,339,148,0,487
17545,2020,Philippines,France,5,0,0,5
17546,2020,Poland,France,132,0,0,132
17547,2020,Romania,France,143,0,0,143
17548,2020,South Africa,France,62,6,0,68
17549,2020,Russian Federation,France,16775,3358,0,20133
17550,2020,Rwanda,France,3076,498,0,3574
17551,2020,El Salvador,France,75,7,0,82
17552,2020,Saudi Arabia,France,34,5,0,39
17553,2020,Serbia and Kosovo: S/RES/1244 (1999),France,14268,1646,0,15914
17554,2020,Senegal,France,2011,1863,0,3874
17555,2020,Sierra Leone,France,735,439,0,1174
17556,2020,Somalia,France,5774,4879,0,10653
17557,2020,Viet Nam,France,7671,17,0,7688
17558,2020,Sao Tome and Principe,France,5,0,0,5
17559,2020,Sudan,France,20236,1973,0,22209
17560,2020,Suriname,France,5,7,0,12
17561,2020,South Sudan,France,123,10,0,133
17562,2020,Slovakia,France,102,0,0,102
17563,2020,Syrian Arab Rep.,France,21849,2587,0,24436
17564,2020,United Rep. of Tanzania,France,10,8,0,18
17565,2020,Thailand,France,12,0,0,12
17566,2020,Tajikistan,France,62,133,0,195
17567,2020,Turkmenistan,France,24,0,0,24
17568,2020,Togo,France,794,269,0,1063
17569,2020,Tunisia,France,397,294,0,691
17570,2020,Türkiye,France,12459,5087,0,17546
17571,2020,United Arab Emirates,France,5,0,0,5
17572,2020,Uganda,France,172,9,0,181
17573,2020,Ukraine,France,1921,1940,0,3861
17574,2020,United States of America,France,0,5,0,5
17575,2020,Uzbekistan,France,206,5,0,211
17576,2020,Venezuela (Bolivarian Republic of),France,778,748,0,1526
17577,2020,Western Sahara,France,744,406,0,1150
17578,2020,Yemen,France,566,239,0,805
17579,2020,Zimbabwe,France,51,0,0,51
17582,2020,Burundi,Gabon,7,0,0,7
17583,2020,Central African Rep.,Gabon,19,22,0,41
17584,2020,Chad,Gabon,254,20,0,274
17585,2020,Cameroon,Gabon,5,5,0,10
17586,2020,Congo,Gabon,67,0,0,67
17587,2020,Dem. Rep. of the Congo,Gabon,74,33,0,107
17588,2020,Mauritania,Gabon,7,0,0,7
17589,2020,Sao Tome and Principe,Gabon,23,0,0,23
17590,2020,South Sudan,Gabon,5,0,0,5
17591,2020,Togo,Gabon,6,0,0,6
17592,2020,Central African Rep.,Gambia,7,8,0,15
17593,2020,Congo,Gambia,6,5,0,11
17594,2020,Dem. Rep. of the Congo,Gambia,52,6,0,58
17595,2020,Guinea-Bissau,Gambia,0,6,0,6
17596,2020,Guinea,Gambia,5,5,0,10
17597,2020,Cote d'Ivoire,Gambia,149,7,0,156
17598,2020,Liberia,Gambia,15,0,0,15
17599,2020,Senegal,Gambia,4019,159,0,4178
17600,2020,Sierra Leone,Gambia,107,11,0,118
17601,2020,Togo,Gambia,18,0,0,18
17602,2020,Afghanistan,United Kingdom of Great Britain and Northern Ireland,9351,3227,0,12578
17603,2020,Albania,United Kingdom of Great Britain and Northern Ireland,3687,8491,0,12178
17604,2020,Algeria,United Kingdom of Great Britain and Northern Ireland,336,403,0,739
17605,2020,Angola,United Kingdom of Great Britain and Northern Ireland,154,147,0,301
17606,2020,Antigua and Barbuda,United Kingdom of Great Britain and Northern Ireland,5,16,0,21
17607,2020,Egypt,United Kingdom of Great Britain and Northern Ireland,938,662,0,1600
17608,2020,Argentina,United Kingdom of Great Britain and Northern Ireland,0,21,0,21
17609,2020,Armenia,United Kingdom of Great Britain and Northern Ireland,62,13,0,75
17610,2020,Australia,United Kingdom of Great Britain and Northern Ireland,5,0,0,5
17611,2020,Azerbaijan,United Kingdom of Great Britain and Northern Ireland,140,48,0,188
17612,2020,Bahrain,United Kingdom of Great Britain and Northern Ireland,181,8,0,189
17613,2020,Barbados,United Kingdom of Great Britain and Northern Ireland,14,9,0,23
17614,2020,Burundi,United Kingdom of Great Britain and Northern Ireland,55,16,0,71
17615,2020,Benin,United Kingdom of Great Britain and Northern Ireland,8,21,0,29
17616,2020,Bangladesh,United Kingdom of Great Britain and Northern Ireland,1667,2605,0,4272
17617,2020,Bhutan,United Kingdom of Great Britain and Northern Ireland,47,0,0,47
17618,2020,Burkina Faso,United Kingdom of Great Britain and Northern Ireland,11,14,0,25
17619,2020,Belarus,United Kingdom of Great Britain and Northern Ireland,121,33,0,154
17620,2020,Bolivia (Plurinational State of),United Kingdom of Great Britain and Northern Ireland,22,24,0,46
17621,2020,Botswana,United Kingdom of Great Britain and Northern Ireland,30,85,0,115
17622,2020,Brazil,United Kingdom of Great Britain and Northern Ireland,29,245,0,274
17623,2020,Bosnia and Herzegovina,United Kingdom of Great Britain and Northern Ireland,10,7,0,17
17624,2020,Belize,United Kingdom of Great Britain and Northern Ireland,0,5,0,5
17625,2020,Canada,United Kingdom of Great Britain and Northern Ireland,11,11,0,22
17626,2020,Central African Rep.,United Kingdom of Great Britain and Northern Ireland,9,12,0,21
17627,2020,Chad,United Kingdom of Great Britain and Northern Ireland,67,172,0,239
17628,2020,China,United Kingdom of Great Britain and Northern Ireland,1286,2040,0,3326
17629,2020,Chile,United Kingdom of Great Britain and Northern Ireland,0,14,0,14
17630,2020,Cameroon,United Kingdom of Great Britain and Northern Ireland,738,374,0,1112
17631,2020,Congo,United Kingdom of Great Britain and Northern Ireland,94,59,0,153
17632,2020,Dem. Rep. of the Congo,United Kingdom of Great Britain and Northern Ireland,1024,206,0,1230
17633,2020,Comoros,United Kingdom of Great Britain and Northern Ireland,5,0,0,5
17634,2020,Colombia,United Kingdom of Great Britain and Northern Ireland,23,52,0,75
17635,2020,Costa Rica,United Kingdom of Great Britain and Northern Ireland,0,5,0,5
17636,2020,Cuba,United Kingdom of Great Britain and Northern Ireland,11,17,0,28
17637,2020,Cabo Verde,United Kingdom of Great Britain and Northern Ireland,5,0,0,5
17638,2020,Cyprus,United Kingdom of Great Britain and Northern Ireland,0,7,0,7
17639,2020,Djibouti,United Kingdom of Great Britain and Northern Ireland,5,5,0,10
17640,2020,Dominica,United Kingdom of Great Britain and Northern Ireland,24,21,0,45
17641,2020,Dominican Rep.,United Kingdom of Great Britain and Northern Ireland,0,5,0,5
17642,2020,Ecuador,United Kingdom of Great Britain and Northern Ireland,9,16,0,25
17643,2020,Equatorial Guinea,United Kingdom of Great Britain and Northern Ireland,0,5,0,5
17644,2020,Eritrea,United Kingdom of Great Britain and Northern Ireland,14016,3111,0,17127
17645,2020,Ethiopia,United Kingdom of Great Britain and Northern Ireland,1824,680,0,2504
17646,2020,Fiji,United Kingdom of Great Britain and Northern Ireland,9,0,0,9
17647,2020,Gabon,United Kingdom of Great Britain and Northern Ireland,5,10,0,15
17648,2020,Gambia,United Kingdom of Great Britain and Northern Ireland,1096,218,0,1314
17649,2020,Palestinian,United Kingdom of Great Britain and Northern Ireland,647,435,0,1082
17650,2020,Georgia,United Kingdom of Great Britain and Northern Ireland,77,334,0,411
17651,2020,Ghana,United Kingdom of Great Britain and Northern Ireland,360,411,0,771
17652,2020,Guinea-Bissau,United Kingdom of Great Britain and Northern Ireland,7,8,0,15
17653,2020,Greece,United Kingdom of Great Britain and Northern Ireland,5,0,0,5
17654,2020,Grenada,United Kingdom of Great Britain and Northern Ireland,26,38,0,64
17655,2020,Guatemala,United Kingdom of Great Britain and Northern Ireland,9,17,0,26
17656,2020,Guinea,United Kingdom of Great Britain and Northern Ireland,224,126,0,350
17657,2020,Guyana,United Kingdom of Great Britain and Northern Ireland,20,9,0,29
17658,2020,Haiti,United Kingdom of Great Britain and Northern Ireland,0,10,0,10
17659,2020,"China, Hong Kong SAR",United Kingdom of Great Britain and Northern Ireland,5,71,0,76
17660,2020,Honduras,United Kingdom of Great Britain and Northern Ireland,74,366,0,440
17661,2020,Cote d'Ivoire,United Kingdom of Great Britain and Northern Ireland,230,100,0,330
17662,2020,India,United Kingdom of Great Britain and Northern Ireland,496,2277,0,2773
17663,2020,Indonesia,United Kingdom of Great Britain and Northern Ireland,34,86,0,120
17664,2020,Iran (Islamic Rep. of),United Kingdom of Great Britain and Northern Ireland,20433,6389,0,26822
17665,2020,Iraq,United Kingdom of Great Britain and Northern Ireland,6399,6090,0,12489
17666,2020,Israel,United Kingdom of Great Britain and Northern Ireland,7,16,0,23
17667,2020,Italy,United Kingdom of Great Britain and Northern Ireland,0,5,0,5
17668,2020,Jamaica,United Kingdom of Great Britain and Northern Ireland,324,212,0,536
17669,2020,Jordan,United Kingdom of Great Britain and Northern Ireland,88,120,0,208
17670,2020,Japan,United Kingdom of Great Britain and Northern Ireland,0,6,0,6
17671,2020,Kazakhstan,United Kingdom of Great Britain and Northern Ireland,27,57,0,84
17672,2020,Kenya,United Kingdom of Great Britain and Northern Ireland,309,355,0,664
17673,2020,Kyrgyzstan,United Kingdom of Great Britain and Northern Ireland,37,27,0,64
17674,2020,Rep. of Korea,United Kingdom of Great Britain and Northern Ireland,7,0,0,7
17675,2020,Dem. People's Rep. of Korea,United Kingdom of Great Britain and Northern Ireland,72,26,0,98
17676,2020,Kuwait,United Kingdom of Great Britain and Northern Ireland,670,454,0,1124
17677,2020,Lao People's Dem. Rep.,United Kingdom of Great Britain and Northern Ireland,5,5,0,10
17678,2020,Liberia,United Kingdom of Great Britain and Northern Ireland,29,30,0,59
17679,2020,Libya,United Kingdom of Great Britain and Northern Ireland,4352,816,0,5168
17680,2020,Saint Lucia,United Kingdom of Great Britain and Northern Ireland,27,37,0,64
17681,2020,Lebanon,United Kingdom of Great Britain and Northern Ireland,179,159,0,338
17682,2020,Sri Lanka,United Kingdom of Great Britain and Northern Ireland,5338,1586,0,6924
17683,2020,Lithuania,United Kingdom of Great Britain and Northern Ireland,0,5,0,5
17685,2020,Mauritania,United Kingdom of Great Britain and Northern Ireland,7,7,0,14
17686,2020,North Macedonia,United Kingdom of Great Britain and Northern Ireland,20,10,0,30
17687,2020,Rep. of Moldova,United Kingdom of Great Britain and Northern Ireland,9,0,0,9
17688,2020,Maldives,United Kingdom of Great Britain and Northern Ireland,42,7,0,49
17689,2020,Mexico,United Kingdom of Great Britain and Northern Ireland,14,0,0,14
17690,2020,Marshall Islands,United Kingdom of Great Britain and Northern Ireland,0,50,0,50
17691,2020,Mali,United Kingdom of Great Britain and Northern Ireland,27,50,0,77
17692,2020,Malaysia,United Kingdom of Great Britain and Northern Ireland,297,381,0,678
17693,2020,Malawi,United Kingdom of Great Britain and Northern Ireland,328,81,0,409
17694,2020,Mongolia,United Kingdom of Great Britain and Northern Ireland,71,60,0,131
17695,2020,Morocco,United Kingdom of Great Britain and Northern Ireland,223,310,0,533
17696,2020,Mozambique,United Kingdom of Great Britain and Northern Ireland,7,6,0,13
17697,2020,Mauritius,United Kingdom of Great Britain and Northern Ireland,66,109,0,175
17698,2020,Myanmar,United Kingdom of Great Britain and Northern Ireland,511,64,0,575
17699,2020,Namibia,United Kingdom of Great Britain and Northern Ireland,128,728,0,856
17700,2020,Nepal,United Kingdom of Great Britain and Northern Ireland,53,336,0,389
17701,2020,Netherlands,United Kingdom of Great Britain and Northern Ireland,5,0,0,5
17702,2020,Niger,United Kingdom of Great Britain and Northern Ireland,190,12,0,202
17703,2020,Nicaragua,United Kingdom of Great Britain and Northern Ireland,36,72,0,108
17704,2020,Nigeria,United Kingdom of Great Britain and Northern Ireland,3059,2423,0,5482
17705,2020,Norway,United Kingdom of Great Britain and Northern Ireland,5,0,0,5
17706,2020,Oman,United Kingdom of Great Britain and Northern Ireland,20,22,0,42
17707,2020,Pakistan,United Kingdom of Great Britain and Northern Ireland,8350,4241,0,12591
17708,2020,Peru,United Kingdom of Great Britain and Northern Ireland,0,6,0,6
17709,2020,Philippines,United Kingdom of Great Britain and Northern Ireland,47,375,0,422
17710,2020,Poland,United Kingdom of Great Britain and Northern Ireland,0,5,0,5
17711,2020,Qatar,United Kingdom of Great Britain and Northern Ireland,8,13,0,21
17712,2020,Romania,United Kingdom of Great Britain and Northern Ireland,5,8,0,13
17713,2020,South Africa,United Kingdom of Great Britain and Northern Ireland,143,143,0,286
17714,2020,Russian Federation,United Kingdom of Great Britain and Northern Ireland,809,594,0,1403
17715,2020,Rwanda,United Kingdom of Great Britain and Northern Ireland,119,40,0,159
17716,2020,El Salvador,United Kingdom of Great Britain and Northern Ireland,551,1598,0,2149
17717,2020,Saudi Arabia,United Kingdom of Great Britain and Northern Ireland,256,148,0,404
17718,2020,Serbia and Kosovo: S/RES/1244 (1999),United Kingdom of Great Britain and Northern Ireland,86,60,0,146
17719,2020,Senegal,United Kingdom of Great Britain and Northern Ireland,107,59,0,166
17720,2020,Seychelles,United Kingdom of Great Britain and Northern Ireland,5,5,0,10
17721,2020,Singapore,United Kingdom of Great Britain and Northern Ireland,5,9,0,14
17722,2020,Sierra Leone,United Kingdom of Great Britain and Northern Ireland,325,299,0,624
17723,2020,Somalia,United Kingdom of Great Britain and Northern Ireland,2855,674,0,3529
17724,2020,Viet Nam,United Kingdom of Great Britain and Northern Ireland,2259,2946,0,5205
17725,2020,Saint Kitts and Nevis,United Kingdom of Great Britain and Northern Ireland,5,13,0,18
17726,2020,Sudan,United Kingdom of Great Britain and Northern Ireland,10994,2280,0,13274
17727,2020,South Sudan,United Kingdom of Great Britain and Northern Ireland,67,50,0,117
17728,2020,Eswatini,United Kingdom of Great Britain and Northern Ireland,56,5,0,61
17729,2020,Sweden,United Kingdom of Great Britain and Northern Ireland,0,5,0,5
17730,2020,Syrian Arab Rep.,United Kingdom of Great Britain and Northern Ireland,10919,2231,0,13150
17731,2020,United Rep. of Tanzania,United Kingdom of Great Britain and Northern Ireland,107,90,0,197
17732,2020,Thailand,United Kingdom of Great Britain and Northern Ireland,35,92,0,127
17733,2020,Tajikistan,United Kingdom of Great Britain and Northern Ireland,14,6,0,20
17734,2020,Turkmenistan,United Kingdom of Great Britain and Northern Ireland,17,26,0,43
17735,2020,Togo,United Kingdom of Great Britain and Northern Ireland,17,34,0,51
17736,2020,Trinidad and Tobago,United Kingdom of Great Britain and Northern Ireland,97,106,0,203
17737,2020,Tunisia,United Kingdom of Great Britain and Northern Ireland,65,75,0,140
17738,2020,Türkiye,United Kingdom of Great Britain and Northern Ireland,2223,1593,0,3816
17739,2020,United Arab Emirates,United Kingdom of Great Britain and Northern Ireland,25,13,0,38
17740,2020,Uganda,United Kingdom of Great Britain and Northern Ireland,1231,297,0,1528
17741,2020,Ukraine,United Kingdom of Great Britain and Northern Ireland,208,228,0,436
17742,2020,United States of America,United Kingdom of Great Britain and Northern Ireland,62,103,0,165
17743,2020,Uzbekistan,United Kingdom of Great Britain and Northern Ireland,82,58,0,140
17744,2020,Saint Vincent and the Grenadines,United Kingdom of Great Britain and Northern Ireland,36,21,0,57
17745,2020,Venezuela (Bolivarian Republic of),United Kingdom of Great Britain and Northern Ireland,61,41,0,102
17746,2020,Samoa,United Kingdom of Great Britain and Northern Ireland,0,5,0,5
17747,2020,Western Sahara,United Kingdom of Great Britain and Northern Ireland,11,0,0,11
17748,2020,Yemen,United Kingdom of Great Britain and Northern Ireland,981,604,0,1585
17749,2020,Zambia,United Kingdom of Great Britain and Northern Ireland,89,49,0,138
17750,2020,Zimbabwe,United Kingdom of Great Britain and Northern Ireland,1594,467,0,2061
17753,2020,Afghanistan,Georgia,11,18,0,29
17754,2020,Egypt,Georgia,64,122,0,186
17755,2020,Azerbaijan,Georgia,5,5,0,10
17756,2020,Bangladesh,Georgia,0,17,0,17
17757,2020,China,Georgia,0,5,0,5
17758,2020,Cameroon,Georgia,0,9,0,9
17759,2020,Dem. Rep. of the Congo,Georgia,5,6,0,11
17760,2020,Eritrea,Georgia,0,14,0,14
17761,2020,Palestinian,Georgia,0,17,0,17
17762,2020,Georgia,Georgia,0,0,288538,0
17763,2020,Ghana,Georgia,0,5,0,5
17764,2020,India,Georgia,0,21,0,21
17765,2020,Iran (Islamic Rep. of),Georgia,37,499,0,536
17766,2020,Iraq,Georgia,406,69,0,475
17767,2020,Jordan,Georgia,0,70,0,70
17768,2020,Kazakhstan,Georgia,0,14,0,14
17769,2020,Lebanon,Georgia,6,22,0,28
17770,2020,Sri Lanka,Georgia,0,5,0,5
17771,2020,Morocco,Georgia,0,6,0,6
17772,2020,Nigeria,Georgia,0,47,0,47
17773,2020,Pakistan,Georgia,11,28,0,39
17774,2020,Philippines,Georgia,0,5,0,5
17775,2020,South Africa,Georgia,0,7,0,7
17776,2020,Russian Federation,Georgia,238,72,0,310
17777,2020,Saudi Arabia,Georgia,0,5,0,5
17778,2020,Somalia,Georgia,0,13,0,13
17779,2020,Sudan,Georgia,6,7,0,13
17780,2020,Syrian Arab Rep.,Georgia,437,20,0,457
17781,2020,Tajikistan,Georgia,5,5,0,10
17782,2020,Türkiye,Georgia,0,88,0,88
17783,2020,Ukraine,Georgia,493,13,0,506
17784,2020,Yemen,Georgia,40,18,0,58
17787,2020,Afghanistan,Germany,147994,33103,0,181097
17788,2020,Albania,Germany,1272,1460,0,2732
17789,2020,Algeria,Germany,600,1269,0,1869
17790,2020,Angola,Germany,822,511,0,1333
17791,2020,Egypt,Germany,2298,1481,0,3779
17792,2020,Argentina,Germany,15,27,0,42
17793,2020,Armenia,Germany,2681,2902,0,5583
17794,2020,Australia,Germany,5,0,0,5
17795,2020,Austria,Germany,5,0,0,5
17796,2020,Azerbaijan,Germany,3850,3585,0,7435
17797,2020,Bahrain,Germany,80,5,0,85
17798,2020,Burundi,Germany,114,55,0,169
17799,2020,Belgium,Germany,6,5,0,11
17800,2020,Benin,Germany,96,133,0,229
17801,2020,Bangladesh,Germany,796,589,0,1385
17802,2020,Bhutan,Germany,20,0,0,20
17803,2020,Burkina Faso,Germany,104,146,0,250
17804,2020,Belarus,Germany,187,290,0,477
17805,2020,Bolivia (Plurinational State of),Germany,7,0,0,7
17806,2020,Botswana,Germany,5,0,0,5
17807,2020,Brazil,Germany,32,50,0,82
17808,2020,Bosnia and Herzegovina,Germany,1358,358,0,1716
17809,2020,Bulgaria,Germany,74,5,0,79
17810,2020,Cambodia,Germany,34,56,0,90
17811,2020,Canada,Germany,23,0,0,23
17812,2020,Central African Rep.,Germany,48,17,0,65
17813,2020,Chad,Germany,95,267,0,362
17814,2020,China,Germany,1986,544,0,2530
17815,2020,Chile,Germany,160,5,0,165
17816,2020,Cameroon,Germany,824,2427,0,3251
17817,2020,Congo,Germany,278,66,0,344
17818,2020,Dem. Rep. of the Congo,Germany,1539,632,0,2171
17819,2020,Comoros,Germany,0,13,0,13
17820,2020,Colombia,Germany,69,845,0,914
17821,2020,Costa Rica,Germany,0,5,0,5
17822,2020,Cuba,Germany,78,49,0,127
17823,2020,Cabo Verde,Germany,0,5,0,5
17824,2020,Czechia,Germany,706,0,0,706
17825,2020,Djibouti,Germany,33,8,0,41
17826,2020,Dominica,Germany,5,0,0,5
17827,2020,Dominican Rep.,Germany,10,8,0,18
17828,2020,Ecuador,Germany,11,6,0,17
17829,2020,Equatorial Guinea,Germany,23,7,0,30
17830,2020,Eritrea,Germany,61226,3292,0,64518
17831,2020,Estonia,Germany,5,0,0,5
17832,2020,Ethiopia,Germany,5385,3865,0,9250
17833,2020,France,Germany,16,5,0,21
17834,2020,Gabon,Germany,13,47,0,60
17835,2020,Gambia,Germany,1189,2555,0,3744
17836,2020,Palestinian,Germany,2066,497,0,2563
17837,2020,United Kingdom of Great Britain and Northern Ireland,Germany,16,5,0,21
17838,2020,Georgia,Germany,691,3356,0,4047
17839,2020,Ghana,Germany,640,1097,0,1737
17840,2020,Guinea-Bissau,Germany,119,140,0,259
17841,2020,Greece,Germany,47,0,0,47
17842,2020,Guatemala,Germany,5,10,0,15
17843,2020,Guinea,Germany,3488,4527,0,8015
17844,2020,Haiti,Germany,14,20,0,34
17845,2020,Honduras,Germany,71,65,0,136
17846,2020,Croatia,Germany,280,5,0,285
17847,2020,Hungary,Germany,233,10,0,243
17848,2020,Iceland,Germany,5,0,0,5
17849,2020,Cote d'Ivoire,Germany,658,1322,0,1980
17850,2020,India,Germany,415,757,0,1172
17851,2020,Indonesia,Germany,14,13,0,27
17852,2020,Iran (Islamic Rep. of),Germany,44965,18355,0,63320
17853,2020,Iraq,Germany,146009,27400,0,173409
17854,2020,Israel,Germany,40,26,0,66
17855,2020,Italy,Germany,30,6,0,36
17856,2020,Jamaica,Germany,68,40,0,108
17857,2020,Jordan,Germany,485,426,0,911
17858,2020,Japan,Germany,23,5,0,28
17859,2020,Kazakhstan,Germany,117,205,0,322
17860,2020,Kenya,Germany,172,674,0,846
17861,2020,Kyrgyzstan,Germany,238,194,0,432
17862,2020,Rep. of Korea,Germany,26,11,0,37
17863,2020,Dem. People's Rep. of Korea,Germany,85,12,0,97
17864,2020,Kuwait,Germany,39,33,0,72
17865,2020,Lao People's Dem. Rep.,Germany,41,0,0,41
17866,2020,Liberia,Germany,123,347,0,470
17867,2020,Libya,Germany,2545,935,0,3480
17868,2020,Lebanon,Germany,1775,1888,0,3663
17869,2020,Sri Lanka,Germany,3626,801,0,4427
17870,2020,Lithuania,Germany,5,0,0,5
17871,2020,Luxembourg,Germany,5,0,0,5
17872,2020,Latvia,Germany,7,5,0,12
17873,2020,Madagascar,Germany,0,16,0,16
17874,2020,Mauritania,Germany,58,82,0,140
17875,2020,North Macedonia,Germany,655,921,0,1576
17876,2020,Rep. of Moldova,Germany,126,1139,0,1265
17877,2020,Mexico,Germany,23,17,0,40
17878,2020,Mali,Germany,358,476,0,834
17879,2020,Malaysia,Germany,12,10,0,22
17880,2020,Malawi,Germany,7,6,0,13
17881,2020,Mongolia,Germany,213,293,0,506
17882,2020,Morocco,Germany,835,1170,0,2005
17883,2020,Mozambique,Germany,15,35,0,50
17884,2020,Montenegro,Germany,228,149,0,377
17885,2020,Mauritius,Germany,5,0,0,5
17886,2020,Myanmar,Germany,869,443,0,1312
17887,2020,Namibia,Germany,0,40,0,40
17888,2020,Nepal,Germany,60,36,0,96
17889,2020,Netherlands,Germany,31,5,0,36
17890,2020,Niger,Germany,57,126,0,183
17891,2020,Nicaragua,Germany,5,180,0,185
17892,2020,Nigeria,Germany,8813,16486,0,25299
17893,2020,Norway,Germany,0,9,0,9
17894,2020,New Zealand,Germany,8,0,0,8
17895,2020,Oman,Germany,8,10,0,18
17896,2020,Pakistan,Germany,8475,6453,0,14928
17897,2020,Paraguay,Germany,5,8,0,13
17898,2020,Peru,Germany,39,18,0,57
17899,2020,Philippines,Germany,40,29,0,69
17900,2020,Poland,Germany,597,5,0,602
17901,2020,Portugal,Germany,7,0,0,7
17902,2020,Qatar,Germany,5,0,0,5
17903,2020,Romania,Germany,137,5,0,142
17904,2020,South Africa,Germany,21,65,0,86
17905,2020,Russian Federation,Germany,9172,13111,0,22283
17906,2020,Rwanda,Germany,297,259,0,556
17907,2020,El Salvador,Germany,121,43,0,164
17908,2020,Saudi Arabia,Germany,178,12,0,190
17909,2020,Serbia and Kosovo: S/RES/1244 (1999),Germany,7926,2042,0,9968
17910,2020,Senegal,Germany,203,415,0,618
17911,2020,Singapore,Germany,8,0,0,8
17912,2020,Sierra Leone,Germany,788,962,0,1750
17913,2020,Solomon Islands,Germany,6,0,0,6
17914,2020,Somalia,Germany,28061,6579,0,34640
17915,2020,Spain,Germany,22,12,0,34
17916,2020,Viet Nam,Germany,1138,248,0,1386
17917,2020,Sudan,Germany,2774,1224,0,3998
17918,2020,South Sudan,Germany,101,64,0,165
17919,2020,Slovakia,Germany,76,0,0,76
17920,2020,Slovenia,Germany,6,0,0,6
17921,2020,Eswatini,Germany,5,5,0,10
17922,2020,Sweden,Germany,8,0,0,8
17923,2020,Syrian Arab Rep.,Germany,605338,37219,0,642557
17924,2020,United Rep. of Tanzania,Germany,61,324,0,385
17925,2020,Thailand,Germany,25,18,0,43
17926,2020,Tajikistan,Germany,1064,1232,0,2296
17927,2020,Turkmenistan,Germany,95,160,0,255
17928,2020,Togo,Germany,996,704,0,1700
17929,2020,Trinidad and Tobago,Germany,5,10,0,15
17930,2020,Tunisia,Germany,234,606,0,840
17931,2020,Türkiye,Germany,33345,14782,0,48127
17932,2020,United Arab Emirates,Germany,38,0,0,38
17933,2020,Uganda,Germany,228,352,0,580
17934,2020,Ukraine,Germany,895,1519,0,2414
17935,2020,United States of America,Germany,134,25,0,159
17936,2020,Uzbekistan,Germany,139,85,0,224
17937,2020,Saint Vincent and the Grenadines,Germany,5,0,0,5
17938,2020,Venezuela (Bolivarian Republic of),Germany,757,748,0,1505
17939,2020,Yemen,Germany,3039,840,0,3879
17940,2020,Zambia,Germany,5,8,0,13
17941,2020,Zimbabwe,Germany,282,254,0,536
17944,2020,Egypt,Ghana,0,16,0,16
17945,2020,Burundi,Ghana,14,14,0,28
17946,2020,Benin,Ghana,7,0,0,7
17947,2020,Central African Rep.,Ghana,169,60,0,229
17948,2020,Chad,Ghana,34,17,0,51
17949,2020,Cameroon,Ghana,212,128,0,340
17950,2020,Congo,Ghana,7,0,0,7
17951,2020,Dem. Rep. of the Congo,Ghana,58,20,0,78
17952,2020,Eritrea,Ghana,103,60,0,163
17953,2020,Ethiopia,Ghana,8,5,0,13
17954,2020,Palestinian,Ghana,18,9,0,27
17955,2020,Cote d'Ivoire,Ghana,6417,888,0,7305
17956,2020,Iraq,Ghana,12,0,0,12
17957,2020,Liberia,Ghana,694,0,0,694
17958,2020,Libya,Ghana,7,6,0,13
17959,2020,Lebanon,Ghana,8,0,0,8
17960,2020,Mali,Ghana,0,5,0,5
17961,2020,Nigeria,Ghana,9,7,0,16
17962,2020,Pakistan,Ghana,60,5,0,65
17963,2020,Rwanda,Ghana,37,5,0,42
17964,2020,Sierra Leone,Ghana,90,10,0,100
17965,2020,Somalia,Ghana,68,22,0,90
17966,2020,Sudan,Ghana,588,96,0,684
17967,2020,South Sudan,Ghana,7,5,0,12
17968,2020,Syrian Arab Rep.,Ghana,230,48,0,278
17969,2020,Togo,Ghana,3479,71,0,3550
17970,2020,Türkiye,Ghana,44,6,0,50
17971,2020,Uganda,Ghana,10,0,0,10
17972,2020,Uzbekistan,Ghana,9,0,0,9
17973,2020,Yemen,Ghana,7,8,0,15
17974,2020,Burundi,Guinea-Bissau,5,0,0,5
17975,2020,Cote d'Ivoire,Guinea-Bissau,6,6,0,12
17976,2020,Liberia,Guinea-Bissau,7,0,0,7
17977,2020,Nigeria,Guinea-Bissau,0,6,0,6
17978,2020,Senegal,Guinea-Bissau,1818,8,0,1826
17979,2020,Sierra Leone,Guinea-Bissau,10,5,0,15
17980,2020,Türkiye,Guinea-Bissau,0,5,0,5
17981,2020,Afghanistan,Greece,21456,19706,0,41162
17982,2020,Albania,Greece,174,1681,0,1855
17983,2020,Algeria,Greece,116,310,0,426
17984,2020,Angola,Greece,13,57,0,70
17985,2020,Egypt,Greece,388,1535,0,1923
17986,2020,Armenia,Greece,13,50,0,63
17987,2020,Azerbaijan,Greece,5,0,0,5
17988,2020,Burundi,Greece,63,21,0,84
17989,2020,Benin,Greece,0,5,0,5
17990,2020,Bangladesh,Greece,318,3115,0,3433
17991,2020,Burkina Faso,Greece,27,79,0,106
17992,2020,Belarus,Greece,5,0,0,5
17993,2020,Brazil,Greece,0,12,0,12
17994,2020,Central African Rep.,Greece,18,5,0,23
17995,2020,Chad,Greece,8,5,0,13
17996,2020,China,Greece,113,418,0,531
17997,2020,Cameroon,Greece,706,907,0,1613
17998,2020,Congo,Greece,148,94,0,242
17999,2020,Dem. Rep. of the Congo,Greece,1426,3713,0,5139
18000,2020,Comoros,Greece,6,15,0,21
18001,2020,Colombia,Greece,0,5,0,5
18002,2020,Cuba,Greece,0,42,0,42
18003,2020,Djibouti,Greece,8,5,0,13
18004,2020,Dominican Rep.,Greece,9,12,0,21
18005,2020,Equatorial Guinea,Greece,5,0,0,5
18006,2020,Eritrea,Greece,1239,227,0,1466
18007,2020,Ethiopia,Greece,481,59,0,540
18008,2020,Gabon,Greece,5,15,0,20
18009,2020,Gambia,Greece,60,117,0,177
18010,2020,Palestinian,Greece,4723,524,0,5247
18011,2020,Georgia,Greece,271,1387,0,1658
18012,2020,Ghana,Greece,76,368,0,444
18013,2020,Guinea,Greece,150,197,0,347
18014,2020,Haiti,Greece,23,37,0,60
18015,2020,Cote d'Ivoire,Greece,91,61,0,152
18016,2020,India,Greece,36,399,0,435
18017,2020,Indonesia,Greece,15,50,0,65
18018,2020,Iran (Islamic Rep. of),Greece,2476,2250,0,4726
18019,2020,Iraq,Greece,11840,4229,0,16069
18020,2020,Jordan,Greece,38,11,0,49
18021,2020,Kazakhstan,Greece,5,5,0,10
18022,2020,Kenya,Greece,30,5,0,35
18023,2020,Kuwait,Greece,133,45,0,178
18024,2020,Liberia,Greece,5,0,0,5
18025,2020,Libya,Greece,61,50,0,111
18026,2020,Lebanon,Greece,67,61,0,128
18027,2020,Sri Lanka,Greece,51,132,0,183
18028,2020,Mauritania,Greece,63,14,0,77
18029,2020,North Macedonia,Greece,0,5,0,5
18030,2020,Rep. of Moldova,Greece,13,40,0,53
18031,2020,Mali,Greece,94,95,0,189
18032,2020,Morocco,Greece,202,207,0,409
18033,2020,Myanmar,Greece,101,16,0,117
18034,2020,Nepal,Greece,16,164,0,180
18035,2020,Niger,Greece,12,25,0,37
18036,2020,Nigeria,Greece,331,235,0,566
18037,2020,Pakistan,Greece,1150,5423,0,6573
18038,2020,Peru,Greece,0,5,0,5
18039,2020,Philippines,Greece,7,6,0,13
18040,2020,Russian Federation,Greece,16,47,0,63
18041,2020,Rwanda,Greece,10,0,0,10
18042,2020,El Salvador,Greece,12,0,0,12
18043,2020,Saudi Arabia,Greece,7,5,0,12
18044,2020,Serbia and Kosovo: S/RES/1244 (1999),Greece,23,13,0,36
18045,2020,Senegal,Greece,59,56,0,115
18046,2020,Sierra Leone,Greece,117,150,0,267
18047,2020,Somalia,Greece,3113,1506,0,4619
18048,2020,Viet Nam,Greece,5,12,0,17
18049,2020,Sudan,Greece,519,77,0,596
18050,2020,South Sudan,Greece,45,15,0,60
18051,2020,Syrian Arab Rep.,Greece,36448,5965,0,42413
18052,2020,United Rep. of Tanzania,Greece,13,5,0,18
18053,2020,Tajikistan,Greece,5,5,0,10
18054,2020,Turkmenistan,Greece,6,8,0,14
18055,2020,Togo,Greece,62,151,0,213
18056,2020,Tunisia,Greece,22,35,0,57
18057,2020,Türkiye,Greece,853,4195,0,5048
18058,2020,Uganda,Greece,49,65,0,114
18059,2020,Ukraine,Greece,158,63,0,221
18060,2020,Uzbekistan,Greece,17,5,0,22
18061,2020,Venezuela (Bolivarian Republic of),Greece,13,20,0,33
18062,2020,Western Sahara,Greece,10,6,0,16
18063,2020,Yemen,Greece,853,47,0,900
18064,2020,Zambia,Greece,0,5,0,5
18065,2020,Zimbabwe,Greece,12,5,0,17
18068,2020,Venezuela (Bolivarian Republic of),Grenada,0,0,0,0
18069,2020,Colombia,Guatemala,10,5,0,15
18070,2020,Cuba,Guatemala,7,50,0,57
18071,2020,Guatemala,Guatemala,0,0,0,0
18072,2020,Honduras,Guatemala,67,298,0,365
18073,2020,Mexico,Guatemala,0,6,0,6
18074,2020,Nicaragua,Guatemala,61,127,0,188
18075,2020,Russian Federation,Guatemala,5,0,0,5
18076,2020,El Salvador,Guatemala,265,222,0,487
18077,2020,Venezuela (Bolivarian Republic of),Guatemala,27,76,0,103
18079,2020,Burundi,Guinea,6,0,0,6
18080,2020,Central African Rep.,Guinea,40,0,0,40
18081,2020,Cameroon,Guinea,5,0,0,5
18082,2020,Congo,Guinea,15,0,0,15
18083,2020,Dem. Rep. of the Congo,Guinea,40,11,0,51
18084,2020,Eritrea,Guinea,12,0,0,12
18085,2020,Gambia,Guinea,7,0,0,7
18086,2020,Cote d'Ivoire,Guinea,4201,501,0,4702
18087,2020,Kenya,Guinea,0,6,0,6
18088,2020,Liberia,Guinea,357,35,0,392
18089,2020,Sri Lanka,Guinea,9,0,0,9
18090,2020,Mali,Guinea,10,0,0,10
18091,2020,Nigeria,Guinea,12,0,0,12
18092,2020,Rwanda,Guinea,10,0,0,10
18093,2020,Sierra Leone,Guinea,1272,2978,0,4250
18094,2020,Somalia,Guinea,6,0,0,6
18095,2020,Syrian Arab Rep.,Guinea,17,12,0,29
18096,2020,Togo,Guinea,10,0,0,10
18097,2020,Cameroon,Guyana,0,5,0,5
18098,2020,Cuba,Guyana,18,67,0,85
18099,2020,Pakistan,Guyana,5,0,0,5
18100,2020,Venezuela (Bolivarian Republic of),Guyana,0,0,0,0
18101,2020,Nigeria,Haiti,0,5,0,5
18102,2020,Afghanistan,"China, Hong Kong SAR",10,0,0,10
18103,2020,Egypt,"China, Hong Kong SAR",15,0,0,15
18104,2020,Burundi,"China, Hong Kong SAR",12,0,0,12
18105,2020,Bangladesh,"China, Hong Kong SAR",12,0,0,12
18106,2020,Central African Rep.,"China, Hong Kong SAR",5,0,0,5
18107,2020,Cameroon,"China, Hong Kong SAR",5,0,0,5
18108,2020,Dem. Rep. of the Congo,"China, Hong Kong SAR",10,0,0,10
18109,2020,Ethiopia,"China, Hong Kong SAR",5,0,0,5
18110,2020,Palestinian,"China, Hong Kong SAR",5,0,0,5
18111,2020,Indonesia,"China, Hong Kong SAR",14,0,0,14
18112,2020,Sri Lanka,"China, Hong Kong SAR",21,0,0,21
18113,2020,Nepal,"China, Hong Kong SAR",6,0,0,6
18114,2020,Pakistan,"China, Hong Kong SAR",21,0,0,21
18115,2020,Philippines,"China, Hong Kong SAR",6,0,0,6
18116,2020,Rwanda,"China, Hong Kong SAR",29,0,0,29
18117,2020,Somalia,"China, Hong Kong SAR",35,0,0,35
18118,2020,Sudan,"China, Hong Kong SAR",5,0,0,5
18119,2020,Yemen,"China, Hong Kong SAR",29,0,0,29
18120,2020,Colombia,Honduras,0,5,0,5
18121,2020,Cuba,Honduras,0,5,0,5
18122,2020,Haiti,Honduras,0,0,0,0
18123,2020,Honduras,Honduras,0,0,247090,0
18124,2020,Nicaragua,Honduras,56,92,0,148
18125,2020,El Salvador,Honduras,22,9,0,31
18126,2020,Venezuela (Bolivarian Republic of),Honduras,7,5,0,12
18128,2020,Afghanistan,Croatia,54,351,0,405
18129,2020,Algeria,Croatia,0,5,0,5
18130,2020,Egypt,Croatia,8,0,0,8
18131,2020,Azerbaijan,Croatia,5,0,0,5
18132,2020,Bangladesh,Croatia,7,6,0,13
18133,2020,Belarus,Croatia,5,0,0,5
18134,2020,Bosnia and Herzegovina,Croatia,5,0,0,5
18135,2020,Cameroon,Croatia,5,0,0,5
18136,2020,Congo,Croatia,5,0,0,5
18137,2020,Dem. Rep. of the Congo,Croatia,6,0,0,6
18138,2020,Eritrea,Croatia,23,11,0,34
18139,2020,Georgia,Croatia,5,0,0,5
18140,2020,Croatia,Croatia,0,0,0,0
18141,2020,Iran (Islamic Rep. of),Croatia,37,32,0,69
18142,2020,Iraq,Croatia,113,49,0,162
18143,2020,Kazakhstan,Croatia,5,0,0,5
18144,2020,Libya,Croatia,5,5,0,10
18145,2020,Mauritania,Croatia,5,0,0,5
18146,2020,Morocco,Croatia,0,8,0,8
18147,2020,Nigeria,Croatia,12,0,0,12
18148,2020,Pakistan,Croatia,7,23,0,30
18149,2020,Russian Federation,Croatia,15,5,0,20
18150,2020,Serbia and Kosovo: S/RES/1244 (1999),Croatia,0,10,0,10
18151,2020,Somalia,Croatia,29,0,0,29
18152,2020,Sudan,Croatia,5,0,0,5
18153,2020,Syrian Arab Rep.,Croatia,539,26,0,565
18154,2020,Türkiye,Croatia,24,36,0,60
18155,2020,Ukraine,Croatia,8,0,0,8
18156,2020,Uzbekistan,Croatia,5,0,0,5
18157,2020,Yemen,Croatia,7,0,0,7
18160,2020,Afghanistan,Hungary,1503,17,0,1520
18161,2020,Albania,Hungary,5,0,0,5
18162,2020,Algeria,Hungary,14,0,0,14
18163,2020,Angola,Hungary,5,0,0,5
18164,2020,Egypt,Hungary,11,0,0,11
18165,2020,Armenia,Hungary,43,0,0,43
18166,2020,Azerbaijan,Hungary,13,0,0,13
18167,2020,Bangladesh,Hungary,11,0,0,11
18168,2020,China,Hungary,5,0,0,5
18169,2020,Cameroon,Hungary,40,0,0,40
18170,2020,Congo,Hungary,13,0,0,13
18171,2020,Dem. Rep. of the Congo,Hungary,24,0,0,24
18172,2020,Cuba,Hungary,78,0,0,78
18173,2020,Eritrea,Hungary,47,0,0,47
18174,2020,Ethiopia,Hungary,39,0,0,39
18175,2020,Palestinian,Hungary,90,0,0,90
18176,2020,Georgia,Hungary,59,0,0,59
18177,2020,Ghana,Hungary,5,0,0,5
18178,2020,Guinea,Hungary,5,0,0,5
18179,2020,Cote d'Ivoire,Hungary,15,0,0,15
18180,2020,Iran (Islamic Rep. of),Hungary,184,5,0,189
18181,2020,Iraq,Hungary,635,6,0,641
18182,2020,Libya,Hungary,7,0,0,7
18183,2020,Lebanon,Hungary,5,0,0,5
18184,2020,Sri Lanka,Hungary,11,0,0,11
18185,2020,Rep. of Moldova,Hungary,5,0,0,5
18186,2020,Myanmar,Hungary,5,0,0,5
18187,2020,Nepal,Hungary,11,0,0,11
18188,2020,Nigeria,Hungary,52,0,0,52
18189,2020,Pakistan,Hungary,106,5,0,111
18190,2020,Russian Federation,Hungary,36,0,0,36
18191,2020,Serbia and Kosovo: S/RES/1244 (1999),Hungary,48,0,0,48
18192,2020,Sierra Leone,Hungary,5,0,0,5
18193,2020,Somalia,Hungary,614,0,0,614
18194,2020,Sudan,Hungary,67,0,0,67
18195,2020,Syrian Arab Rep.,Hungary,923,0,0,923
18196,2020,Tunisia,Hungary,8,0,0,8
18197,2020,Türkiye,Hungary,33,5,0,38
18198,2020,Uganda,Hungary,7,0,0,7
18199,2020,Ukraine,Hungary,14,0,0,14
18200,2020,Uzbekistan,Hungary,6,0,0,6
18201,2020,Yemen,Hungary,16,0,0,16
18202,2020,Zimbabwe,Hungary,5,0,0,5
18205,2020,Afghanistan,Iceland,121,5,0,126
18206,2020,Albania,Iceland,5,0,0,5
18207,2020,Egypt,Iceland,10,0,0,10
18208,2020,Azerbaijan,Iceland,5,5,0,10
18209,2020,Bangladesh,Iceland,5,5,0,10
18210,2020,China,Iceland,5,0,0,5
18211,2020,Cameroon,Iceland,5,0,0,5
18212,2020,Dem. Rep. of the Congo,Iceland,5,0,0,5
18213,2020,Eritrea,Iceland,9,0,0,9
18214,2020,Palestinian,Iceland,74,84,0,158
18215,2020,Georgia,Iceland,5,0,0,5
18216,2020,Honduras,Iceland,12,0,0,12
18217,2020,Cote d'Ivoire,Iceland,5,5,0,10
18218,2020,Iran (Islamic Rep. of),Iceland,94,5,0,99
18219,2020,Iraq,Iceland,297,6,0,303
18220,2020,Kazakhstan,Iceland,5,0,0,5
18221,2020,Kenya,Iceland,5,0,0,5
18222,2020,Libya,Iceland,8,0,0,8
18223,2020,Sri Lanka,Iceland,5,0,0,5
18224,2020,North Macedonia,Iceland,5,0,0,5
18225,2020,Mali,Iceland,5,0,0,5
18226,2020,Morocco,Iceland,5,5,0,10
18227,2020,Mozambique,Iceland,5,0,0,5
18228,2020,Nigeria,Iceland,55,15,0,70
18229,2020,Pakistan,Iceland,22,5,0,27
18230,2020,Peru,Iceland,5,0,0,5
18231,2020,Russian Federation,Iceland,14,0,0,14
18232,2020,El Salvador,Iceland,18,0,0,18
18233,2020,Senegal,Iceland,5,5,0,10
18234,2020,Somalia,Iceland,81,16,0,97
18235,2020,Sudan,Iceland,7,0,0,7
18236,2020,South Sudan,Iceland,5,0,0,5
18237,2020,Syrian Arab Rep.,Iceland,167,5,0,172
18238,2020,Tajikistan,Iceland,5,0,0,5
18239,2020,Tunisia,Iceland,5,0,0,5
18240,2020,Türkiye,Iceland,10,0,0,10
18241,2020,Uganda,Iceland,14,0,0,14
18242,2020,Ukraine,Iceland,19,0,0,19
18243,2020,Venezuela (Bolivarian Republic of),Iceland,294,10,0,304
18244,2020,Yemen,Iceland,9,0,0,9
18247,2020,Burundi,Cote d'Ivoire,35,0,0,35
18248,2020,Benin,Cote d'Ivoire,0,5,0,5
18249,2020,Burkina Faso,Cote d'Ivoire,0,5,0,5
18250,2020,Cambodia,Cote d'Ivoire,10,0,0,10
18251,2020,Central African Rep.,Cote d'Ivoire,525,59,0,584
18252,2020,Chad,Cote d'Ivoire,5,5,0,10
18253,2020,Cameroon,Cote d'Ivoire,0,21,0,21
18254,2020,Congo,Cote d'Ivoire,85,10,0,95
18255,2020,Dem. Rep. of the Congo,Cote d'Ivoire,136,22,0,158
18256,2020,Eritrea,Cote d'Ivoire,8,6,0,14
18257,2020,Ethiopia,Cote d'Ivoire,5,5,0,10
18258,2020,Guinea,Cote d'Ivoire,0,6,0,6
18259,2020,Cote d'Ivoire,Cote d'Ivoire,0,0,5394,0
18260,2020,Iran (Islamic Rep. of),Cote d'Ivoire,6,0,0,6
18261,2020,Iraq,Cote d'Ivoire,5,0,0,5
18262,2020,Liberia,Cote d'Ivoire,973,21,0,994
18263,2020,Sri Lanka,Cote d'Ivoire,5,0,0,5
18264,2020,Mauritania,Cote d'Ivoire,0,5,0,5
18265,2020,Mali,Cote d'Ivoire,12,18,0,30
18266,2020,Nigeria,Cote d'Ivoire,5,5,0,10
18267,2020,Rwanda,Cote d'Ivoire,53,5,0,58
18268,2020,Somalia,Cote d'Ivoire,5,0,0,5
18269,2020,Viet Nam,Cote d'Ivoire,5,0,0,5
18270,2020,Sudan,Cote d'Ivoire,10,0,0,10
18271,2020,South Sudan,Cote d'Ivoire,0,5,0,5
18272,2020,Syrian Arab Rep.,Cote d'Ivoire,142,9,0,151
18273,2020,Togo,Cote d'Ivoire,17,12,0,29
18274,2020,Türkiye,Cote d'Ivoire,34,0,0,34
18275,2020,Yemen,Cote d'Ivoire,5,0,0,5
18277,2020,Afghanistan,India,8275,6857,0,15132
18278,2020,Egypt,India,0,8,0,8
18279,2020,Burundi,India,0,5,0,5
18280,2020,Benin,India,0,5,0,5
18281,2020,Bangladesh,India,8,0,0,8
18282,2020,China,India,73407,0,0,73407
18283,2020,Cameroon,India,0,175,0,175
18284,2020,Congo,India,8,42,0,50
18285,2020,Dem. Rep. of the Congo,India,49,70,0,119
18286,2020,Eritrea,India,9,13,0,22
18287,2020,Ethiopia,India,15,21,0,36
18288,2020,Palestinian,India,58,8,0,66
18289,2020,Ghana,India,0,44,0,44
18290,2020,Guinea,India,0,6,0,6
18291,2020,Cote d'Ivoire,India,5,125,0,130
18292,2020,Iran (Islamic Rep. of),India,49,57,0,106
18293,2020,Iraq,India,153,52,0,205
18294,2020,Kenya,India,0,20,0,20
18295,2020,Liberia,India,0,5,0,5
18296,2020,Libya,India,8,7,0,15
18297,2020,Sri Lanka,India,93259,0,0,93259
18298,2020,Maldives,India,5,0,0,5
18299,2020,Myanmar,India,19398,1974,0,21372
18300,2020,Nigeria,India,0,242,0,242
18301,2020,Russian Federation,India,0,12,0,12
18302,2020,Rwanda,India,5,10,0,15
18303,2020,Saudi Arabia,India,5,0,0,5
18304,2020,Senegal,India,0,18,0,18
18305,2020,Sierra Leone,India,0,5,0,5
18306,2020,Somalia,India,514,288,0,802
18307,2020,Sudan,India,65,121,0,186
18308,2020,South Sudan,India,0,98,0,98
18309,2020,Syrian Arab Rep.,India,63,57,0,120
18310,2020,United Rep. of Tanzania,India,0,6,0,6
18311,2020,Tajikistan,India,0,5,0,5
18312,2020,Turkmenistan,India,0,5,0,5
18313,2020,Türkiye,India,5,0,0,5
18314,2020,Uganda,India,0,7,0,7
18315,2020,Ukraine,India,0,5,0,5
18316,2020,Uzbekistan,India,0,5,0,5
18317,2020,Venezuela (Bolivarian Republic of),India,5,6,0,11
18318,2020,Yemen,India,5,833,0,838
18320,2020,Afghanistan,Indonesia,5863,1739,0,7602
18321,2020,Angola,Indonesia,7,0,0,7
18322,2020,Egypt,Indonesia,18,20,0,38
18323,2020,Bangladesh,Indonesia,0,5,0,5
18324,2020,China,Indonesia,11,5,0,16
18325,2020,Cameroon,Indonesia,0,15,0,15
18326,2020,Dem. Rep. of the Congo,Indonesia,10,0,0,10
18327,2020,Eritrea,Indonesia,100,167,0,267
18328,2020,Ethiopia,Indonesia,135,40,0,175
18329,2020,Palestinian,Indonesia,269,93,0,362
18330,2020,Cote d'Ivoire,Indonesia,0,5,0,5
18331,2020,Indonesia,Indonesia,0,0,0,0
18332,2020,Iran (Islamic Rep. of),Indonesia,310,19,0,329
18333,2020,Iraq,Indonesia,515,216,0,731
18334,2020,Jordan,Indonesia,5,0,0,5
18335,2020,Kuwait,Indonesia,9,0,0,9
18336,2020,Libya,Indonesia,15,11,0,26
18337,2020,Sri Lanka,Indonesia,395,68,0,463
18338,2020,Myanmar,Indonesia,491,418,0,909
18339,2020,Pakistan,Indonesia,284,24,0,308
18340,2020,Russian Federation,Indonesia,5,0,0,5
18341,2020,Somalia,Indonesia,1119,250,0,1369
18342,2020,Viet Nam,Indonesia,20,0,0,20
18343,2020,Sudan,Indonesia,409,95,0,504
18344,2020,Syrian Arab Rep.,Indonesia,23,21,0,44
18345,2020,United Rep. of Tanzania,Indonesia,0,5,0,5
18346,2020,Türkiye,Indonesia,0,18,0,18
18347,2020,Uganda,Indonesia,5,11,0,16
18348,2020,Venezuela (Bolivarian Republic of),Indonesia,0,5,0,5
18349,2020,Yemen,Indonesia,96,347,0,443
18351,2020,Afghanistan,Ireland,420,159,0,579
18352,2020,Albania,Ireland,190,516,0,706
18353,2020,Algeria,Ireland,64,221,0,285
18354,2020,Angola,Ireland,53,26,0,79
18355,2020,Egypt,Ireland,43,68,0,111
18356,2020,Armenia,Ireland,14,5,0,19
18357,2020,Azerbaijan,Ireland,5,0,0,5
18358,2020,Bahrain,Ireland,6,10,0,16
18359,2020,Burundi,Ireland,22,8,0,30
18360,2020,Benin,Ireland,5,0,0,5
18361,2020,Bangladesh,Ireland,96,204,0,300
18362,2020,Bhutan,Ireland,11,0,0,11
18363,2020,Belarus,Ireland,19,5,0,24
18364,2020,Bolivia (Plurinational State of),Ireland,21,47,0,68
18365,2020,Botswana,Ireland,12,38,0,50
18366,2020,Brazil,Ireland,20,211,0,231
18367,2020,Bosnia and Herzegovina,Ireland,5,0,0,5
18368,2020,Chad,Ireland,5,0,0,5
18369,2020,China,Ireland,68,88,0,156
18370,2020,Chile,Ireland,0,5,0,5
18371,2020,Cameroon,Ireland,94,46,0,140
18372,2020,Congo,Ireland,14,5,0,19
18373,2020,Dem. Rep. of the Congo,Ireland,435,178,0,613
18374,2020,Cuba,Ireland,5,0,0,5
18375,2020,Eritrea,Ireland,84,10,0,94
18376,2020,Ethiopia,Ireland,36,19,0,55
18377,2020,Gambia,Ireland,0,10,0,10
18378,2020,Palestinian,Ireland,138,32,0,170
18379,2020,Georgia,Ireland,132,646,0,778
18380,2020,Ghana,Ireland,31,77,0,108
18381,2020,Guatemala,Ireland,5,15,0,20
18382,2020,Guinea,Ireland,16,9,0,25
18383,2020,Honduras,Ireland,0,5,0,5
18384,2020,Cote d'Ivoire,Ireland,15,8,0,23
18385,2020,India,Ireland,14,105,0,119
18386,2020,Indonesia,Ireland,5,0,0,5
18387,2020,Iran (Islamic Rep. of),Ireland,155,33,0,188
18388,2020,Iraq,Ireland,425,65,0,490
18389,2020,Israel,Ireland,12,0,0,12
18390,2020,Jordan,Ireland,6,15,0,21
18391,2020,Kazakhstan,Ireland,18,0,0,18
18392,2020,Kenya,Ireland,49,27,0,76
18393,2020,Kyrgyzstan,Ireland,5,5,0,10
18394,2020,Dem. People's Rep. of Korea,Ireland,7,5,0,12
18395,2020,Kuwait,Ireland,52,18,0,70
18396,2020,Liberia,Ireland,13,0,0,13
18397,2020,Libya,Ireland,241,22,0,263
18398,2020,Lebanon,Ireland,9,9,0,18
18399,2020,Lesotho,Ireland,0,6,0,6
18400,2020,Sri Lanka,Ireland,21,16,0,37
18401,2020,Rep. of Moldova,Ireland,54,5,0,59
18402,2020,Mexico,Ireland,9,5,0,14
18403,2020,Mali,Ireland,7,0,0,7
18404,2020,Malaysia,Ireland,5,29,0,34
18405,2020,Malawi,Ireland,126,183,0,309
18406,2020,Mongolia,Ireland,5,11,0,16
18407,2020,Morocco,Ireland,12,58,0,70
18408,2020,Mozambique,Ireland,5,0,0,5
18409,2020,Montenegro,Ireland,5,0,0,5
18410,2020,Mauritius,Ireland,19,26,0,45
18411,2020,Myanmar,Ireland,13,5,0,18
18412,2020,Nepal,Ireland,9,23,0,32
18413,2020,Niger,Ireland,5,0,0,5
18414,2020,Nicaragua,Ireland,9,5,0,14
18415,2020,Nigeria,Ireland,339,818,0,1157
18416,2020,Pakistan,Ireland,365,654,0,1019
18417,2020,Philippines,Ireland,0,5,0,5
18418,2020,South Africa,Ireland,116,468,0,584
18419,2020,Russian Federation,Ireland,82,24,0,106
18420,2020,Rwanda,Ireland,39,0,0,39
18421,2020,El Salvador,Ireland,13,28,0,41
18422,2020,Saudi Arabia,Ireland,16,7,0,23
18423,2020,Serbia and Kosovo: S/RES/1244 (1999),Ireland,61,38,0,99
18424,2020,Senegal,Ireland,0,5,0,5
18425,2020,Sierra Leone,Ireland,51,52,0,103
18426,2020,Somalia,Ireland,275,250,0,525
18427,2020,Viet Nam,Ireland,6,39,0,45
18428,2020,Sudan,Ireland,212,31,0,243
18429,2020,Eswatini,Ireland,19,17,0,36
18430,2020,Syrian Arab Rep.,Ireland,3126,67,0,3193
18431,2020,United Rep. of Tanzania,Ireland,0,10,0,10
18432,2020,Turks and Caicos Islands,Ireland,0,5,0,5
18433,2020,Togo,Ireland,21,20,0,41
18434,2020,Trinidad and Tobago,Ireland,0,5,0,5
18435,2020,Tunisia,Ireland,7,6,0,13
18436,2020,Türkiye,Ireland,16,15,0,31
18437,2020,Uganda,Ireland,40,42,0,82
18438,2020,Ukraine,Ireland,85,19,0,104
18439,2020,United States of America,Ireland,0,21,0,21
18440,2020,Uzbekistan,Ireland,17,0,0,17
18441,2020,Venezuela (Bolivarian Republic of),Ireland,101,90,0,191
18442,2020,Yemen,Ireland,20,6,0,26
18443,2020,Zambia,Ireland,5,5,0,10
18444,2020,Zimbabwe,Ireland,597,688,0,1285
18447,2020,Afghanistan,Iran (Islamic Rep. of),780000,0,0,780000
18448,2020,Iraq,Iran (Islamic Rep. of),20000,0,0,20000
18449,2020,Kuwait,Iran (Islamic Rep. of),8,0,0,8
18450,2020,Myanmar,Iran (Islamic Rep. of),0,34,0,34
18451,2020,Pakistan,Iran (Islamic Rep. of),10,0,0,10
18452,2020,Uzbekistan,Iran (Islamic Rep. of),7,0,0,7
18454,2020,Afghanistan,Iraq,11,64,0,75
18455,2020,Egypt,Iraq,0,23,0,23
18456,2020,Bahrain,Iraq,0,25,0,25
18457,2020,Eritrea,Iraq,5,27,0,32
18458,2020,Ethiopia,Iraq,0,7,0,7
18459,2020,Palestinian,Iraq,7868,95,0,7963
18460,2020,Indonesia,Iraq,0,5,0,5
18461,2020,Iran (Islamic Rep. of),Iraq,5061,5765,0,10826
18462,2020,Iraq,Iraq,0,0,1224108,0
18463,2020,Kazakhstan,Iraq,0,5,0,5
18464,2020,Kyrgyzstan,Iraq,0,15,0,15
18465,2020,Kuwait,Iraq,0,249,0,249
18466,2020,Lebanon,Iraq,0,5,0,5
18467,2020,Pakistan,Iraq,0,27,0,27
18468,2020,Saudi Arabia,Iraq,0,6,0,6
18469,2020,Somalia,Iraq,6,5,0,11
18470,2020,Sudan,Iraq,94,684,0,778
18471,2020,South Sudan,Iraq,0,15,0,15
18472,2020,Syrian Arab Rep.,Iraq,242163,0,0,242163
18473,2020,Tunisia,Iraq,0,6,0,6
18474,2020,Türkiye,Iraq,15169,5477,0,20646
18475,2020,Yemen,Iraq,0,165,0,165
18477,2020,Albania,Israel,0,28,0,28
18478,2020,Argentina,Israel,0,7,0,7
18479,2020,Armenia,Israel,0,53,0,53
18480,2020,Azerbaijan,Israel,0,57,0,57
18481,2020,Benin,Israel,0,5,0,5
18482,2020,Burkina Faso,Israel,0,8,0,8
18483,2020,Belarus,Israel,5,850,0,855
18484,2020,Bolivia (Plurinational State of),Israel,0,5,0,5
18485,2020,Botswana,Israel,0,6,0,6
18486,2020,Brazil,Israel,0,8,0,8
18487,2020,Bulgaria,Israel,0,5,0,5
18488,2020,Central African Rep.,Israel,0,16,0,16
18489,2020,Chad,Israel,5,5,0,10
18490,2020,China,Israel,0,275,0,275
18491,2020,Cameroon,Israel,0,44,0,44
18492,2020,Congo,Israel,0,26,0,26
18493,2020,Dem. Rep. of the Congo,Israel,0,205,0,205
18494,2020,Colombia,Israel,0,295,0,295
18495,2020,Ecuador,Israel,0,38,0,38
18496,2020,Eritrea,Israel,213,12003,0,12216
18497,2020,Ethiopia,Israel,102,811,0,913
18498,2020,Georgia,Israel,5,699,0,704
18499,2020,Ghana,Israel,0,493,0,493
18500,2020,Guinea,Israel,0,5,0,5
18501,2020,Honduras,Israel,0,10,0,10
18502,2020,Cote d'Ivoire,Israel,7,9,0,16
18503,2020,India,Israel,0,1193,0,1193
18504,2020,Iran (Islamic Rep. of),Israel,6,0,0,6
18505,2020,Iraq,Israel,10,0,0,10
18506,2020,Kazakhstan,Israel,0,186,0,186
18507,2020,Kenya,Israel,0,108,0,108
18508,2020,Kyrgyzstan,Israel,0,78,0,78
18509,2020,Dem. People's Rep. of Korea,Israel,5,0,0,5
18510,2020,Lesotho,Israel,0,7,0,7
18511,2020,Sri Lanka,Israel,0,1048,0,1048
18512,2020,North Macedonia,Israel,0,29,0,29
18513,2020,Rep. of Moldova,Israel,0,504,0,504
18514,2020,Mexico,Israel,0,9,0,9
18515,2020,Mali,Israel,0,6,0,6
18516,2020,Malawi,Israel,0,76,0,76
18517,2020,Mongolia,Israel,0,5,0,5
18518,2020,Mozambique,Israel,0,5,0,5
18519,2020,Montenegro,Israel,0,14,0,14
18520,2020,Myanmar,Israel,0,26,0,26
18521,2020,Nepal,Israel,0,36,0,36
18522,2020,Nigeria,Israel,8,995,0,1003
18523,2020,Peru,Israel,0,18,0,18
18524,2020,Philippines,Israel,0,6,0,6
18525,2020,Romania,Israel,0,37,0,37
18526,2020,South Africa,Israel,0,483,0,483
18527,2020,Russian Federation,Israel,5,3967,0,3972
18528,2020,Rwanda,Israel,0,7,0,7
18529,2020,Serbia and Kosovo: S/RES/1244 (1999),Israel,0,120,0,120
18530,2020,Sierra Leone,Israel,5,15,0,20
18531,2020,Somalia,Israel,0,12,0,12
18532,2020,Viet Nam,Israel,0,5,0,5
18533,2020,Sudan,Israel,1157,4500,0,5657
18534,2020,South Sudan,Israel,72,105,0,177
18535,2020,United Rep. of Tanzania,Israel,0,5,0,5
18536,2020,Thailand,Israel,0,5,0,5
18537,2020,Tajikistan,Israel,0,5,0,5
18538,2020,Turkmenistan,Israel,0,6,0,6
18539,2020,Togo,Israel,0,6,0,6
18540,2020,Türkiye,Israel,5,361,0,366
18541,2020,Uganda,Israel,0,174,0,174
18542,2020,Ukraine,Israel,27,1829,0,1856
18543,2020,Uzbekistan,Israel,0,483,0,483
18544,2020,Venezuela (Bolivarian Republic of),Israel,0,5,0,5
18545,2020,Zambia,Israel,0,5,0,5
18546,2020,Zimbabwe,Israel,0,19,0,19
18549,2020,Afghanistan,Italy,12096,1339,0,13435
18550,2020,Albania,Italy,620,406,0,1026
18551,2020,Algeria,Italy,0,127,0,127
18552,2020,Angola,Italy,0,15,0,15
18553,2020,Egypt,Italy,786,521,0,1307
18554,2020,Argentina,Italy,0,25,0,25
18555,2020,Armenia,Italy,208,98,0,306
18556,2020,Azerbaijan,Italy,0,46,0,46
18557,2020,Burundi,Italy,0,6,0,6
18558,2020,Benin,Italy,154,34,0,188
18559,2020,Bangladesh,Italy,4360,2949,0,7309
18560,2020,Burkina Faso,Italy,675,127,0,802
18561,2020,Belarus,Italy,0,33,0,33
18562,2020,Bolivia (Plurinational State of),Italy,0,9,0,9
18563,2020,Brazil,Italy,179,231,0,410
18564,2020,Bosnia and Herzegovina,Italy,0,64,0,64
18565,2020,Canada,Italy,0,5,0,5
18566,2020,Central African Rep.,Italy,0,35,0,35
18567,2020,Chad,Italy,0,55,0,55
18568,2020,China,Italy,400,357,0,757
18569,2020,Chile,Italy,0,13,0,13
18570,2020,Cameroon,Italy,1555,470,0,2025
18571,2020,Congo,Italy,329,32,0,361
18572,2020,Dem. Rep. of the Congo,Italy,683,56,0,739
18573,2020,Comoros,Italy,0,5,0,5
18574,2020,Colombia,Italy,664,573,0,1237
18575,2020,Cuba,Italy,0,118,0,118
18576,2020,Cabo Verde,Italy,0,5,0,5
18577,2020,Dominican Rep.,Italy,0,19,0,19
18578,2020,Ecuador,Italy,0,34,0,34
18579,2020,Equatorial Guinea,Italy,0,5,0,5
18580,2020,Eritrea,Italy,3496,13163,0,16659
18581,2020,Ethiopia,Italy,1031,114,0,1145
18582,2020,Gabon,Italy,0,9,0,9
18583,2020,Gambia,Italy,5740,733,0,6473
18584,2020,Palestinian,Italy,677,149,0,826
18585,2020,Georgia,Italy,383,699,0,1082
18586,2020,Germany,Italy,0,6,0,6
18587,2020,Ghana,Italy,2538,638,0,3176
18588,2020,Guinea-Bissau,Italy,438,58,0,496
18589,2020,Guatemala,Italy,0,21,0,21
18590,2020,Guinea,Italy,2358,694,0,3052
18591,2020,Honduras,Italy,290,180,0,470
18592,2020,Croatia,Italy,0,6,0,6
18593,2020,Cote d'Ivoire,Italy,4116,1214,0,5330
18594,2020,India,Italy,209,452,0,661
18595,2020,Iran (Islamic Rep. of),Italy,1313,227,0,1540
18596,2020,Iraq,Italy,4938,1119,0,6057
18597,2020,Jordan,Italy,0,21,0,21
18598,2020,Kazakhstan,Italy,0,6,0,6
18599,2020,Kenya,Italy,0,27,0,27
18600,2020,Kyrgyzstan,Italy,0,27,0,27
18601,2020,Liberia,Italy,317,41,0,358
18602,2020,Libya,Italy,1027,251,0,1278
18603,2020,Lebanon,Italy,0,55,0,55
18604,2020,Liechtenstein,Italy,0,5,0,5
18605,2020,Sri Lanka,Italy,338,234,0,572
18606,2020,Madagascar,Italy,0,5,0,5
18607,2020,Mauritania,Italy,286,6,0,292
18608,2020,North Macedonia,Italy,0,40,0,40
18609,2020,Rep. of Moldova,Italy,0,62,0,62
18610,2020,Mexico,Italy,0,10,0,10
18611,2020,Mali,Italy,10063,997,0,11060
18612,2020,Malaysia,Italy,0,5,0,5
18613,2020,Mongolia,Italy,0,5,0,5
18614,2020,Morocco,Italy,699,787,0,1486
18615,2020,Montenegro,Italy,0,6,0,6
18616,2020,Mauritius,Italy,0,18,0,18
18617,2020,Myanmar,Italy,0,6,0,6
18618,2020,Nepal,Italy,0,49,0,49
18619,2020,Niger,Italy,459,61,0,520
18620,2020,Nicaragua,Italy,0,23,0,23
18621,2020,Nigeria,Italy,18473,5104,0,23577
18622,2020,Pakistan,Italy,14484,9415,0,23899
18623,2020,Paraguay,Italy,0,12,0,12
18624,2020,Peru,Italy,276,931,0,1207
18625,2020,Philippines,Italy,0,67,0,67
18626,2020,Russian Federation,Italy,214,101,0,315
18627,2020,Rwanda,Italy,0,5,0,5
18628,2020,El Salvador,Italy,2826,1298,0,4124
18629,2020,Serbia and Kosovo: S/RES/1244 (1999),Italy,1253,423,0,1676
18630,2020,Senegal,Italy,4324,796,0,5120
18631,2020,Sierra Leone,Italy,434,128,0,562
18632,2020,Somalia,Italy,7704,930,0,8634
18633,2020,Viet Nam,Italy,0,5,0,5
18634,2020,Sudan,Italy,1298,407,0,1705
18635,2020,South Sudan,Italy,0,10,0,10
18636,2020,Syrian Arab Rep.,Italy,3508,1037,0,4545
18637,2020,United Rep. of Tanzania,Italy,0,8,0,8
18638,2020,Togo,Italy,713,91,0,804
18639,2020,Tunisia,Italy,211,447,0,658
18640,2020,Türkiye,Italy,1560,350,0,1910
18641,2020,United Arab Emirates,Italy,0,5,0,5
18642,2020,Uganda,Italy,0,10,0,10
18643,2020,Ukraine,Italy,2920,961,0,3881
18644,2020,Uruguay,Italy,0,6,0,6
18645,2020,United States of America,Italy,0,8,0,8
18646,2020,Venezuela (Bolivarian Republic of),Italy,2119,780,0,2899
18647,2020,Western Sahara,Italy,0,5,0,5
18648,2020,Yemen,Italy,0,56,0,56
18649,2020,Zimbabwe,Italy,0,5,0,5
18652,2020,Haiti,Jamaica,27,5,0,32
18653,2020,Venezuela (Bolivarian Republic of),Jamaica,0,0,0,0
18654,2020,Afghanistan,Jordan,8,11,0,19
18655,2020,Algeria,Jordan,0,6,0,6
18656,2020,Egypt,Jordan,114,544,0,658
18657,2020,Bangladesh,Jordan,0,7,0,7
18658,2020,Bosnia and Herzegovina,Jordan,9,0,0,9
18659,2020,Bulgaria,Jordan,0,0,0,0
18660,2020,Central African Rep.,Jordan,5,0,0,5
18661,2020,Chad,Jordan,9,14,0,23
18662,2020,Comoros,Jordan,0,5,0,5
18663,2020,Eritrea,Jordan,30,11,0,41
18664,2020,Ethiopia,Jordan,13,27,0,40
18665,2020,Palestinian,Jordan,0,0,0,0
18666,2020,Ghana,Jordan,0,5,0,5
18667,2020,India,Jordan,0,6,0,6
18668,2020,Iran (Islamic Rep. of),Jordan,5,0,0,5
18669,2020,Iraq,Jordan,34318,32474,0,66792
18670,2020,Jordan,Jordan,0,0,0,0
18671,2020,Kenya,Jordan,0,6,0,6
18672,2020,Kuwait,Jordan,0,0,0,0
18673,2020,Libya,Jordan,46,117,0,163
18674,2020,Lebanon,Jordan,6,108,0,114
18675,2020,Sri Lanka,Jordan,7,6,0,13
18676,2020,Morocco,Jordan,0,10,0,10
18677,2020,Niger,Jordan,0,6,0,6
18678,2020,Nigeria,Jordan,0,66,0,66
18679,2020,Pakistan,Jordan,5,25,0,30
18680,2020,Philippines,Jordan,0,5,0,5
18681,2020,South Africa,Jordan,0,5,0,5
18682,2020,Russian Federation,Jordan,24,11,0,35
18683,2020,Saudi Arabia,Jordan,0,8,0,8
18684,2020,Senegal,Jordan,0,5,0,5
18685,2020,Somalia,Jordan,665,62,0,727
18686,2020,Sudan,Jordan,3562,2470,0,6032
18687,2020,South Sudan,Jordan,11,7,0,18
18688,2020,Syrian Arab Rep.,Jordan,662790,0,0,662790
18689,2020,Tajikistan,Jordan,0,15,0,15
18690,2020,Tunisia,Jordan,11,9,0,20
18691,2020,United Arab Emirates,Jordan,0,5,0,5
18692,2020,Uganda,Jordan,5,0,0,5
18693,2020,Ukraine,Jordan,0,10,0,10
18694,2020,United States of America,Jordan,0,0,0,0
18695,2020,Venezuela (Bolivarian Republic of),Jordan,0,5,0,5
18696,2020,Yemen,Jordan,818,13552,0,14370
18698,2020,Afghanistan,Japan,73,0,0,73
18699,2020,Burundi,Japan,9,0,0,9
18700,2020,Bangladesh,Japan,18,0,0,18
18701,2020,China,Japan,55,0,0,55
18702,2020,Cameroon,Japan,17,0,0,17
18703,2020,Dem. Rep. of the Congo,Japan,23,0,0,23
18704,2020,Ethiopia,Japan,27,0,0,27
18705,2020,Guinea,Japan,5,0,0,5
18706,2020,Iran (Islamic Rep. of),Japan,14,0,0,14
18707,2020,Iraq,Japan,15,0,0,15
18708,2020,Sri Lanka,Japan,54,0,0,54
18709,2020,Myanmar,Japan,285,0,0,285
18710,2020,Nigeria,Japan,5,0,0,5
18711,2020,Pakistan,Japan,33,0,0,33
18712,2020,Rwanda,Japan,5,0,0,5
18713,2020,Somalia,Japan,5,0,0,5
18714,2020,Sudan,Japan,16,0,0,16
18715,2020,Syrian Arab Rep.,Japan,73,0,0,73
18716,2020,Türkiye,Japan,46,0,0,46
18717,2020,Uganda,Japan,5,0,0,5
18718,2020,Yemen,Japan,11,0,0,11
18721,2020,Afghanistan,Kazakhstan,408,198,0,606
18722,2020,China,Kazakhstan,5,7,0,12
18723,2020,Syrian Arab Rep.,Kazakhstan,14,18,0,32
18724,2020,Uzbekistan,Kazakhstan,13,0,0,13
18726,2020,Afghanistan,Kenya,11,8,0,19
18727,2020,Egypt,Kenya,0,21,0,21
18728,2020,Burundi,Kenya,6759,9761,0,16520
18729,2020,Central African Rep.,Kenya,0,10,0,10
18730,2020,Cameroon,Kenya,0,55,0,55
18731,2020,Congo,Kenya,87,85,0,172
18732,2020,Dem. Rep. of the Congo,Kenya,29625,15641,0,45266
18733,2020,Eritrea,Kenya,888,1007,0,1895
18734,2020,Ethiopia,Kenya,20442,8762,0,29204
18735,2020,Cote d'Ivoire,Kenya,5,5,0,10
18736,2020,India,Kenya,0,5,0,5
18737,2020,Iraq,Kenya,5,0,0,5
18738,2020,Kenya,Kenya,0,0,0,0
18739,2020,Sri Lanka,Kenya,9,0,0,9
18740,2020,Mozambique,Kenya,8,0,0,8
18741,2020,Nigeria,Kenya,6,13,0,19
18742,2020,Pakistan,Kenya,9,8,0,17
18743,2020,Rwanda,Kenya,744,1127,0,1871
18744,2020,Somalia,Kenya,265352,7138,0,272490
18745,2020,Sudan,Kenya,3998,6111,0,10109
18746,2020,South Sudan,Kenya,123912,56,0,123968
18747,2020,Syrian Arab Rep.,Kenya,5,5,0,10
18748,2020,United Rep. of Tanzania,Kenya,16,45,0,61
18749,2020,Türkiye,Kenya,108,51,0,159
18750,2020,Uganda,Kenya,837,1789,0,2626
18751,2020,Yemen,Kenya,85,206,0,291
18752,2020,Zimbabwe,Kenya,5,7,0,12
18754,2020,Afghanistan,Kyrgyzstan,219,41,0,260
18755,2020,Iraq,Kyrgyzstan,6,0,0,6
18756,2020,Syrian Arab Rep.,Kyrgyzstan,78,8,0,86
18757,2020,Tajikistan,Kyrgyzstan,5,0,0,5
18758,2020,Turkmenistan,Kyrgyzstan,5,0,0,5
18759,2020,Türkiye,Kyrgyzstan,0,289,0,289
18760,2020,Ukraine,Kyrgyzstan,21,0,0,21
18761,2020,Uzbekistan,Kyrgyzstan,0,5,0,5
18763,2020,Afghanistan,Rep. of Korea,42,45,0,87
18764,2020,Algeria,Rep. of Korea,6,207,0,213
18765,2020,Angola,Rep. of Korea,5,42,0,47
18766,2020,Egypt,Rep. of Korea,44,1018,0,1062
18767,2020,Argentina,Rep. of Korea,0,9,0,9
18768,2020,Azerbaijan,Rep. of Korea,0,10,0,10
18769,2020,Burundi,Rep. of Korea,45,12,0,57
18770,2020,Bangladesh,Rep. of Korea,128,1131,0,1259
18771,2020,Burkina Faso,Rep. of Korea,0,10,0,10
18772,2020,Bolivia (Plurinational State of),Rep. of Korea,0,5,0,5
18773,2020,Brazil,Rep. of Korea,0,18,0,18
18774,2020,Cambodia,Rep. of Korea,0,56,0,56
18775,2020,China,Rep. of Korea,46,1754,0,1800
18776,2020,Chile,Rep. of Korea,0,6,0,6
18777,2020,Cameroon,Rep. of Korea,22,210,0,232
18778,2020,Congo,Rep. of Korea,0,11,0,11
18779,2020,Dem. Rep. of the Congo,Rep. of Korea,61,34,0,95
18780,2020,Colombia,Rep. of Korea,0,14,0,14
18781,2020,Eritrea,Rep. of Korea,10,0,0,10
18782,2020,Ethiopia,Rep. of Korea,160,172,0,332
18783,2020,Gabon,Rep. of Korea,0,5,0,5
18784,2020,Gambia,Rep. of Korea,0,61,0,61
18785,2020,Palestinian,Rep. of Korea,8,5,0,13
18786,2020,Ghana,Rep. of Korea,7,238,0,245
18787,2020,Guinea-Bissau,Rep. of Korea,0,11,0,11
18788,2020,Guinea,Rep. of Korea,0,135,0,135
18789,2020,Haiti,Rep. of Korea,0,24,0,24
18790,2020,Cote d'Ivoire,Rep. of Korea,38,29,0,67
18791,2020,India,Rep. of Korea,0,1827,0,1827
18792,2020,Indonesia,Rep. of Korea,0,46,0,46
18793,2020,Iran (Islamic Rep. of),Rep. of Korea,61,60,0,121
18794,2020,Iraq,Rep. of Korea,28,46,0,74
18795,2020,Jordan,Rep. of Korea,7,14,0,21
18796,2020,Kazakhstan,Rep. of Korea,5,1957,0,1962
18797,2020,Kenya,Rep. of Korea,5,55,0,60
18798,2020,Kyrgyzstan,Rep. of Korea,0,117,0,117
18799,2020,Lao People's Dem. Rep.,Rep. of Korea,0,5,0,5
18800,2020,Liberia,Rep. of Korea,12,267,0,279
18801,2020,Libya,Rep. of Korea,9,48,0,57
18802,2020,Sri Lanka,Rep. of Korea,8,300,0,308
18803,2020,Mali,Rep. of Korea,7,94,0,101
18804,2020,Malaysia,Rep. of Korea,0,1848,0,1848
18805,2020,Mongolia,Rep. of Korea,0,370,0,370
18806,2020,Morocco,Rep. of Korea,5,405,0,410
18807,2020,Mozambique,Rep. of Korea,0,6,0,6
18808,2020,Myanmar,Rep. of Korea,390,51,0,441
18809,2020,Nepal,Rep. of Korea,5,487,0,492
18810,2020,Niger,Rep. of Korea,0,5,0,5
18811,2020,Nigeria,Rep. of Korea,12,445,0,457
18812,2020,Pakistan,Rep. of Korea,112,1442,0,1554
18813,2020,Peru,Rep. of Korea,0,12,0,12
18814,2020,Philippines,Rep. of Korea,0,546,0,546
18815,2020,South Africa,Rep. of Korea,0,100,0,100
18816,2020,Russian Federation,Rep. of Korea,13,2421,0,2434
18817,2020,Rwanda,Rep. of Korea,0,28,0,28
18818,2020,Saudi Arabia,Rep. of Korea,0,8,0,8
18819,2020,Senegal,Rep. of Korea,0,92,0,92
18820,2020,Sierra Leone,Rep. of Korea,0,18,0,18
18821,2020,Somalia,Rep. of Korea,5,0,0,5
18822,2020,Viet Nam,Rep. of Korea,0,239,0,239
18823,2020,Sudan,Rep. of Korea,31,62,0,93
18824,2020,South Sudan,Rep. of Korea,0,5,0,5
18825,2020,Syrian Arab Rep.,Rep. of Korea,1236,35,0,1271
18826,2020,United Rep. of Tanzania,Rep. of Korea,5,43,0,48
18827,2020,Thailand,Rep. of Korea,10,354,0,364
18828,2020,Tajikistan,Rep. of Korea,0,11,0,11
18829,2020,Togo,Rep. of Korea,0,17,0,17
18830,2020,Tunisia,Rep. of Korea,0,94,0,94
18831,2020,Türkiye,Rep. of Korea,0,359,0,359
18832,2020,Uganda,Rep. of Korea,37,67,0,104
18833,2020,Ukraine,Rep. of Korea,14,30,0,44
18834,2020,United States of America,Rep. of Korea,0,5,0,5
18835,2020,Uzbekistan,Rep. of Korea,9,306,0,315
18836,2020,Venezuela (Bolivarian Republic of),Rep. of Korea,0,11,0,11
18837,2020,Yemen,Rep. of Korea,795,26,0,821
18838,2020,Zimbabwe,Rep. of Korea,0,11,0,11
18840,2020,Afghanistan,Kuwait,0,17,0,17
18841,2020,Egypt,Kuwait,5,19,0,24
18842,2020,Djibouti,Kuwait,0,5,0,5
18843,2020,Eritrea,Kuwait,5,28,0,33
18844,2020,Ethiopia,Kuwait,0,11,0,11
18845,2020,Palestinian,Kuwait,0,5,0,5
18846,2020,Iran (Islamic Rep. of),Kuwait,9,83,0,92
18847,2020,Iraq,Kuwait,351,299,0,650
18848,2020,Jordan,Kuwait,0,6,0,6
18849,2020,Lebanon,Kuwait,0,5,0,5
18850,2020,Sri Lanka,Kuwait,0,6,0,6
18851,2020,Pakistan,Kuwait,0,12,0,12
18852,2020,Philippines,Kuwait,0,5,0,5
18853,2020,Somalia,Kuwait,217,444,0,661
18854,2020,Sudan,Kuwait,0,17,0,17
18855,2020,Syrian Arab Rep.,Kuwait,139,77,0,216
18856,2020,Ukraine,Kuwait,0,5,0,5
18857,2020,Yemen,Kuwait,6,10,0,16
18859,2020,Burkina Faso,Liberia,0,5,0,5
18860,2020,Cameroon,Liberia,5,0,0,5
18861,2020,Dem. Rep. of the Congo,Liberia,21,0,0,21
18862,2020,Cote d'Ivoire,Liberia,8112,10643,0,18755
18863,2020,Mali,Liberia,19,0,0,19
18864,2020,Nigeria,Liberia,0,5,0,5
18865,2020,Pakistan,Liberia,5,0,0,5
18866,2020,Somalia,Liberia,5,0,0,5
18867,2020,Sudan,Liberia,8,0,0,8
18868,2020,South Sudan,Liberia,5,0,0,5
18869,2020,Syrian Arab Rep.,Liberia,12,15,0,27
18870,2020,Togo,Liberia,5,0,0,5
18871,2020,Türkiye,Liberia,16,0,0,16
18872,2020,Afghanistan,Libya,0,5,0,5
18873,2020,Burkina Faso,Libya,0,5,0,5
18874,2020,Chad,Libya,0,15,0,15
18875,2020,Congo,Libya,0,5,0,5
18876,2020,Dem. Rep. of the Congo,Libya,0,5,0,5
18877,2020,Eritrea,Libya,438,4994,0,5432
18878,2020,Ethiopia,Libya,25,1060,0,1085
18879,2020,Palestinian,Libya,1282,2541,0,3823
18880,2020,Cote d'Ivoire,Libya,0,5,0,5
18881,2020,Iraq,Libya,607,329,0,936
18882,2020,Libya,Libya,0,0,278177,0
18883,2020,Mali,Libya,0,26,0,26
18884,2020,Niger,Libya,0,5,0,5
18885,2020,Nigeria,Libya,0,38,0,38
18886,2020,Rwanda,Libya,5,0,0,5
18887,2020,Somalia,Libya,67,2514,0,2581
18888,2020,Sudan,Libya,1002,14297,0,15299
18889,2020,South Sudan,Libya,6,290,0,296
18890,2020,Syrian Arab Rep.,Libya,717,13819,0,14536
18891,2020,Yemen,Libya,0,86,0,86
18892,2020,Afghanistan,Lebanon,13,7,0,20
18893,2020,Algeria,Lebanon,6,7,0,13
18894,2020,Egypt,Lebanon,88,300,0,388
18895,2020,Armenia,Lebanon,0,6,0,6
18896,2020,Bahrain,Lebanon,16,6,0,22
18897,2020,Bangladesh,Lebanon,0,69,0,69
18898,2020,Cameroon,Lebanon,0,34,0,34
18899,2020,Congo,Lebanon,0,5,0,5
18900,2020,Dem. Rep. of the Congo,Lebanon,0,9,0,9
18901,2020,Eritrea,Lebanon,15,24,0,39
18902,2020,Ethiopia,Lebanon,39,696,0,735
18903,2020,Gambia,Lebanon,0,6,0,6
18904,2020,Palestinian,Lebanon,0,0,0,0
18905,2020,Ghana,Lebanon,0,5,0,5
18906,2020,Cote d'Ivoire,Lebanon,0,5,0,5
18907,2020,India,Lebanon,0,5,0,5
18908,2020,Iran (Islamic Rep. of),Lebanon,35,46,0,81
18909,2020,Iraq,Lebanon,4049,7350,0,11399
18910,2020,Jordan,Lebanon,31,88,0,119
18911,2020,Kenya,Lebanon,0,15,0,15
18912,2020,Kuwait,Lebanon,9,0,0,9
18913,2020,Libya,Lebanon,10,17,0,27
18914,2020,Lebanon,Lebanon,0,0,0,0
18915,2020,Sri Lanka,Lebanon,0,13,0,13
18916,2020,Madagascar,Lebanon,0,5,0,5
18917,2020,Morocco,Lebanon,0,7,0,7
18918,2020,Nigeria,Lebanon,0,45,0,45
18919,2020,Pakistan,Lebanon,6,10,0,16
18920,2020,Philippines,Lebanon,0,23,0,23
18921,2020,Saudi Arabia,Lebanon,12,9,0,21
18922,2020,Somalia,Lebanon,11,9,0,20
18923,2020,Sudan,Lebanon,668,1341,0,2009
18924,2020,South Sudan,Lebanon,37,0,0,37
18925,2020,Syrian Arab Rep.,Lebanon,865300,0,0,865300
18926,2020,Tunisia,Lebanon,11,0,0,11
18927,2020,Türkiye,Lebanon,7,7,0,14
18928,2020,Ukraine,Lebanon,0,0,0,0
18929,2020,Venezuela (Bolivarian Republic of),Lebanon,0,5,0,5
18930,2020,Yemen,Lebanon,25,104,0,129
18931,2020,Dem. Rep. of the Congo,Lesotho,192,131,0,323
18932,2020,Eritrea,Lesotho,37,28,0,65
18933,2020,Ethiopia,Lesotho,23,9,0,32
18934,2020,Nigeria,Lesotho,0,5,0,5
18935,2020,Somalia,Lesotho,0,6,0,6
18936,2020,Uganda,Lesotho,9,0,0,9
18937,2020,Zambia,Lesotho,5,0,0,5
18938,2020,Zimbabwe,Lesotho,5,0,0,5
18939,2020,Afghanistan,Liechtenstein,5,0,0,5
18940,2020,China,Liechtenstein,35,0,0,35
18941,2020,Eritrea,Liechtenstein,12,0,0,12
18942,2020,Iran (Islamic Rep. of),Liechtenstein,7,5,0,12
18943,2020,Iraq,Liechtenstein,7,5,0,12
18944,2020,Nigeria,Liechtenstein,0,5,0,5
18945,2020,Serbia and Kosovo: S/RES/1244 (1999),Liechtenstein,0,5,0,5
18946,2020,Somalia,Liechtenstein,26,0,0,26
18947,2020,Syrian Arab Rep.,Liechtenstein,32,0,0,32
18948,2020,Ukraine,Liechtenstein,5,0,0,5
18949,2020,Afghanistan,Sri Lanka,142,25,0,167
18950,2020,Bangladesh,Sri Lanka,0,5,0,5
18951,2020,Palestinian,Sri Lanka,5,5,0,10
18952,2020,Iran (Islamic Rep. of),Sri Lanka,25,7,0,32
18953,2020,Sri Lanka,Sri Lanka,0,0,25013,0
18954,2020,Myanmar,Sri Lanka,34,0,0,34
18955,2020,Nigeria,Sri Lanka,0,5,0,5
18956,2020,Pakistan,Sri Lanka,776,177,0,953
18957,2020,Sudan,Sri Lanka,5,0,0,5
18958,2020,Syrian Arab Rep.,Sri Lanka,5,0,0,5
18959,2020,Yemen,Sri Lanka,16,0,0,16
18961,2020,Afghanistan,Lithuania,230,9,0,239
18962,2020,Azerbaijan,Lithuania,17,0,0,17
18963,2020,Belarus,Lithuania,35,65,0,100
18964,2020,Chile,Lithuania,0,5,0,5
18965,2020,Cameroon,Lithuania,6,0,0,6
18966,2020,Cuba,Lithuania,5,0,0,5
18967,2020,Eritrea,Lithuania,40,0,0,40
18968,2020,Ethiopia,Lithuania,5,0,0,5
18969,2020,Georgia,Lithuania,5,0,0,5
18970,2020,Iran (Islamic Rep. of),Lithuania,13,0,0,13
18971,2020,Iraq,Lithuania,65,15,0,80
18972,2020,Sri Lanka,Lithuania,10,5,0,15
18973,2020,Nigeria,Lithuania,5,0,0,5
18974,2020,Pakistan,Lithuania,5,0,0,5
18975,2020,Russian Federation,Lithuania,688,8,0,696
18976,2020,Somalia,Lithuania,22,0,0,22
18977,2020,Syrian Arab Rep.,Lithuania,463,5,0,468
18978,2020,Tajikistan,Lithuania,85,5,0,90
18979,2020,Türkiye,Lithuania,63,0,0,63
18980,2020,Ukraine,Lithuania,64,5,0,69
18981,2020,Uzbekistan,Lithuania,17,0,0,17
18983,2020,Afghanistan,Luxembourg,317,146,0,463
18984,2020,Albania,Luxembourg,38,14,0,52
18985,2020,Algeria,Luxembourg,0,15,0,15
18986,2020,Angola,Luxembourg,9,5,0,14
18987,2020,Armenia,Luxembourg,5,0,0,5
18988,2020,Azerbaijan,Luxembourg,13,0,0,13
18989,2020,Burundi,Luxembourg,5,0,0,5
18990,2020,Benin,Luxembourg,0,5,0,5
18991,2020,Bhutan,Luxembourg,5,0,0,5
18992,2020,Belarus,Luxembourg,0,7,0,7
18993,2020,Bosnia and Herzegovina,Luxembourg,5,0,0,5
18994,2020,China,Luxembourg,7,0,0,7
18995,2020,Cameroon,Luxembourg,17,20,0,37
18996,2020,Dem. Rep. of the Congo,Luxembourg,43,6,0,49
18997,2020,Colombia,Luxembourg,0,10,0,10
18998,2020,Eritrea,Luxembourg,1044,317,0,1361
18999,2020,Ethiopia,Luxembourg,58,18,0,76
19000,2020,Gabon,Luxembourg,5,0,0,5
19001,2020,Gambia,Luxembourg,6,5,0,11
19002,2020,Palestinian,Luxembourg,0,27,0,27
19003,2020,Georgia,Luxembourg,0,5,0,5
19004,2020,Guinea,Luxembourg,12,22,0,34
19005,2020,Cote d'Ivoire,Luxembourg,5,10,0,15
19006,2020,Iran (Islamic Rep. of),Luxembourg,196,65,0,261
19007,2020,Iraq,Luxembourg,773,59,0,832
19008,2020,Dem. People's Rep. of Korea,Luxembourg,11,0,0,11
19009,2020,Kuwait,Luxembourg,0,5,0,5
19010,2020,Libya,Luxembourg,5,9,0,14
19011,2020,Lebanon,Luxembourg,5,5,0,10
19012,2020,Sri Lanka,Luxembourg,5,0,0,5
19013,2020,Mali,Luxembourg,0,5,0,5
19014,2020,Morocco,Luxembourg,0,14,0,14
19015,2020,Montenegro,Luxembourg,6,0,0,6
19016,2020,Nigeria,Luxembourg,9,0,0,9
19017,2020,Pakistan,Luxembourg,0,6,0,6
19018,2020,Russian Federation,Luxembourg,17,8,0,25
19019,2020,Rwanda,Luxembourg,13,0,0,13
19020,2020,Serbia and Kosovo: S/RES/1244 (1999),Luxembourg,130,0,0,130
19021,2020,Senegal,Luxembourg,5,5,0,10
19022,2020,Somalia,Luxembourg,47,31,0,78
19023,2020,Sudan,Luxembourg,46,28,0,74
19024,2020,South Sudan,Luxembourg,0,5,0,5
19025,2020,Syrian Arab Rep.,Luxembourg,2069,340,0,2409
19026,2020,Tajikistan,Luxembourg,0,5,0,5
19027,2020,Turkmenistan,Luxembourg,5,0,0,5
19028,2020,Togo,Luxembourg,8,0,0,8
19029,2020,Tunisia,Luxembourg,0,12,0,12
19030,2020,Türkiye,Luxembourg,68,77,0,145
19031,2020,Uganda,Luxembourg,5,0,0,5
19032,2020,Ukraine,Luxembourg,5,5,0,10
19033,2020,Venezuela (Bolivarian Republic of),Luxembourg,5,74,0,79
19034,2020,Yemen,Luxembourg,20,10,0,30
19037,2020,Afghanistan,Latvia,63,5,0,68
19038,2020,Egypt,Latvia,5,0,0,5
19039,2020,Azerbaijan,Latvia,11,5,0,16
19040,2020,Bangladesh,Latvia,0,5,0,5
19041,2020,Belarus,Latvia,12,33,0,45
19042,2020,China,Latvia,0,5,0,5
19043,2020,Eritrea,Latvia,35,0,0,35
19044,2020,Palestinian,Latvia,7,0,0,7
19045,2020,Georgia,Latvia,0,5,0,5
19046,2020,Iran (Islamic Rep. of),Latvia,20,0,0,20
19047,2020,Iraq,Latvia,39,0,0,39
19048,2020,Kazakhstan,Latvia,5,0,0,5
19049,2020,Kyrgyzstan,Latvia,5,0,0,5
19050,2020,Lebanon,Latvia,5,0,0,5
19051,2020,Sri Lanka,Latvia,5,0,0,5
19052,2020,Pakistan,Latvia,0,5,0,5
19053,2020,Russian Federation,Latvia,58,5,0,63
19054,2020,Somalia,Latvia,5,0,0,5
19055,2020,Syrian Arab Rep.,Latvia,314,5,0,319
19056,2020,Tajikistan,Latvia,5,0,0,5
19057,2020,Türkiye,Latvia,29,0,0,29
19058,2020,Uzbekistan,Latvia,14,0,0,14
19060,2020,Afghanistan,Madagascar,10,9,0,19
19061,2020,Burundi,Madagascar,5,0,0,5
19062,2020,Congo,Madagascar,0,5,0,5
19063,2020,Dem. Rep. of the Congo,Madagascar,10,0,0,10
19064,2020,Comoros,Madagascar,0,6,0,6
19065,2020,Guinea,Madagascar,0,5,0,5
19066,2020,Pakistan,Madagascar,53,150,0,203
19067,2020,Syrian Arab Rep.,Madagascar,5,0,0,5
19068,2020,Türkiye,Madagascar,9,5,0,14
19069,2020,Yemen,Madagascar,20,9,0,29
19070,2020,Benin,Mauritania,0,5,0,5
19071,2020,Burkina Faso,Mauritania,15,14,0,29
19072,2020,Central African Rep.,Mauritania,644,69,0,713
19073,2020,Chad,Mauritania,5,5,0,10
19074,2020,China,Mauritania,5,0,0,5
19075,2020,Cameroon,Mauritania,14,128,0,142
19076,2020,Congo,Mauritania,9,16,0,25
19077,2020,Dem. Rep. of the Congo,Mauritania,31,36,0,67
19078,2020,Ethiopia,Mauritania,7,0,0,7
19079,2020,Gambia,Mauritania,0,12,0,12
19080,2020,Palestinian,Mauritania,74,30,0,104
19081,2020,Ghana,Mauritania,0,12,0,12
19082,2020,Guinea-Bissau,Mauritania,0,10,0,10
19083,2020,Guinea,Mauritania,7,134,0,141
19084,2020,Cote d'Ivoire,Mauritania,278,138,0,416
19085,2020,Iraq,Mauritania,25,0,0,25
19086,2020,Liberia,Mauritania,7,21,0,28
19087,2020,Libya,Mauritania,0,17,0,17
19088,2020,Mali,Mauritania,65947,763,0,66710
19089,2020,Niger,Mauritania,0,5,0,5
19090,2020,Nigeria,Mauritania,11,86,0,97
19091,2020,Russian Federation,Mauritania,0,9,0,9
19092,2020,Senegal,Mauritania,88,131,0,219
19093,2020,Sierra Leone,Mauritania,0,75,0,75
19094,2020,Sudan,Mauritania,11,12,0,23
19095,2020,Syrian Arab Rep.,Mauritania,364,55,0,419
19096,2020,Togo,Mauritania,24,123,0,147
19097,2020,Türkiye,Mauritania,5,27,0,32
19098,2020,Western Sahara,Mauritania,26000,0,0,26000
19099,2020,Yemen,Mauritania,36,27,0,63
19100,2020,Afghanistan,North Macedonia,6,6,0,12
19101,2020,Congo,North Macedonia,5,0,0,5
19102,2020,Pakistan,North Macedonia,5,0,0,5
19103,2020,Serbia and Kosovo: S/RES/1244 (1999),North Macedonia,270,5,0,275
19104,2020,Syrian Arab Rep.,North Macedonia,17,5,0,22
19105,2020,Türkiye,North Macedonia,0,5,0,5
19108,2020,Afghanistan,Rep. of Moldova,24,0,0,24
19109,2020,Armenia,Rep. of Moldova,15,7,0,22
19110,2020,Azerbaijan,Rep. of Moldova,5,0,0,5
19111,2020,Bangladesh,Rep. of Moldova,0,7,0,7
19112,2020,Palestinian,Rep. of Moldova,5,0,0,5
19113,2020,Iran (Islamic Rep. of),Rep. of Moldova,5,0,0,5
19114,2020,Iraq,Rep. of Moldova,17,0,0,17
19115,2020,Kyrgyzstan,Rep. of Moldova,11,0,0,11
19116,2020,Libya,Rep. of Moldova,5,0,0,5
19117,2020,Russian Federation,Rep. of Moldova,5,0,0,5
19118,2020,Sudan,Rep. of Moldova,8,0,0,8
19119,2020,Syrian Arab Rep.,Rep. of Moldova,190,5,0,195
19120,2020,Tajikistan,Rep. of Moldova,8,5,0,13
19121,2020,Turkmenistan,Rep. of Moldova,5,0,0,5
19122,2020,Türkiye,Rep. of Moldova,53,23,0,76
19123,2020,Ukraine,Rep. of Moldova,33,5,0,38
19124,2020,Uzbekistan,Rep. of Moldova,8,7,0,15
19125,2020,Yemen,Rep. of Moldova,8,0,0,8
19127,2020,Afghanistan,Mexico,5,0,0,5
19128,2020,Albania,Mexico,8,0,0,8
19129,2020,Algeria,Mexico,5,0,0,5
19130,2020,Angola,Mexico,9,219,0,228
19131,2020,Egypt,Mexico,5,0,0,5
19132,2020,Argentina,Mexico,5,68,0,73
19133,2020,Benin,Mexico,0,8,0,8
19134,2020,Bangladesh,Mexico,7,26,0,33
19135,2020,Burkina Faso,Mexico,5,18,0,23
19136,2020,Bolivia (Plurinational State of),Mexico,0,16,0,16
19137,2020,Brazil,Mexico,60,757,0,817
19138,2020,Belize,Mexico,10,30,0,40
19139,2020,Cambodia,Mexico,24,45,0,69
19140,2020,Canada,Mexico,0,5,0,5
19141,2020,China,Mexico,5,20,0,25
19142,2020,Chile,Mexico,193,833,0,1026
19143,2020,Cameroon,Mexico,23,378,0,401
19144,2020,Congo,Mexico,21,73,0,94
19145,2020,Dem. Rep. of the Congo,Mexico,67,288,0,355
19146,2020,Colombia,Mexico,448,899,0,1347
19147,2020,Costa Rica,Mexico,5,62,0,67
19148,2020,Cuba,Mexico,1955,8370,0,10325
19149,2020,Dominica,Mexico,0,5,0,5
19150,2020,Dominican Rep.,Mexico,18,55,0,73
19151,2020,Ecuador,Mexico,19,131,0,150
19152,2020,Eritrea,Mexico,7,74,0,81
19153,2020,Ethiopia,Mexico,5,20,0,25
19154,2020,France,Mexico,0,5,0,5
19155,2020,Palestinian,Mexico,5,0,0,5
19156,2020,Ghana,Mexico,21,175,0,196
19157,2020,Guatemala,Mexico,1933,5118,0,7051
19158,2020,Guinea,Mexico,10,76,0,86
19159,2020,Guyana,Mexico,0,5,0,5
19160,2020,Haiti,Mexico,1342,8708,0,10050
19161,2020,Honduras,Mexico,15676,35871,0,51547
19162,2020,Cote d'Ivoire,Mexico,5,19,0,24
19163,2020,India,Mexico,13,66,0,79
19164,2020,Iran (Islamic Rep. of),Mexico,40,6,0,46
19165,2020,Iraq,Mexico,44,5,0,49
19166,2020,Italy,Mexico,0,5,0,5
19167,2020,Jamaica,Mexico,6,5,0,11
19168,2020,Kyrgyzstan,Mexico,5,11,0,16
19169,2020,Rep. of Korea,Mexico,0,5,0,5
19170,2020,Liberia,Mexico,0,5,0,5
19171,2020,Sri Lanka,Mexico,20,42,0,62
19172,2020,Mauritania,Mexico,0,29,0,29
19173,2020,Mali,Mexico,0,10,0,10
19174,2020,Morocco,Mexico,0,6,0,6
19175,2020,Nepal,Mexico,0,16,0,16
19176,2020,Nicaragua,Mexico,901,2461,0,3362
19177,2020,Nigeria,Mexico,44,22,0,66
19178,2020,Pakistan,Mexico,10,17,0,27
19179,2020,Panama,Mexico,20,58,0,78
19180,2020,Peru,Mexico,25,61,0,86
19181,2020,Portugal,Mexico,5,7,0,12
19182,2020,Romania,Mexico,7,5,0,12
19183,2020,South Africa,Mexico,0,11,0,11
19184,2020,Russian Federation,Mexico,41,24,0,65
19185,2020,El Salvador,Mexico,9231,10793,0,20024
19186,2020,Senegal,Mexico,0,14,0,14
19187,2020,Sierra Leone,Mexico,5,14,0,19
19188,2020,Somalia,Mexico,5,18,0,23
19189,2020,Spain,Mexico,0,10,0,10
19190,2020,Sudan,Mexico,0,10,0,10
19191,2020,Syrian Arab Rep.,Mexico,30,14,0,44
19192,2020,Tajikistan,Mexico,0,8,0,8
19193,2020,Togo,Mexico,0,24,0,24
19194,2020,Türkiye,Mexico,8,7,0,15
19195,2020,Uganda,Mexico,0,78,0,78
19196,2020,Ukraine,Mexico,17,5,0,22
19197,2020,Uruguay,Mexico,0,22,0,22
19198,2020,United States of America,Mexico,27,85,0,112
19199,2020,Uzbekistan,Mexico,0,16,0,16
19200,2020,Venezuela (Bolivarian Republic of),Mexico,13014,7362,0,20376
19201,2020,Yemen,Mexico,15,58,0,73
19204,2020,Burundi,Mali,12,6,0,18
19205,2020,Bangladesh,Mali,0,32,0,32
19206,2020,Burkina Faso,Mali,12890,0,0,12890
19207,2020,Central African Rep.,Mali,945,339,0,1284
19208,2020,Cameroon,Mali,5,7,0,12
19209,2020,Congo,Mali,30,5,0,35
19210,2020,Dem. Rep. of the Congo,Mali,272,60,0,332
19211,2020,Eritrea,Mali,5,0,0,5
19212,2020,Guinea,Mali,0,5,0,5
19213,2020,Cote d'Ivoire,Mali,520,44,0,564
19214,2020,Mauritania,Mali,15697,0,0,15697
19215,2020,Mali,Mali,0,0,332957,0
19216,2020,Niger,Mali,16938,0,0,16938
19217,2020,Nigeria,Mali,0,5,0,5
19218,2020,Pakistan,Mali,10,0,0,10
19219,2020,Rwanda,Mali,7,10,0,17
19220,2020,Syrian Arab Rep.,Mali,20,434,0,454
19221,2020,Togo,Mali,21,6,0,27
19222,2020,Türkiye,Mali,8,16,0,24
19223,2020,Afghanistan,Malaysia,1517,1153,0,2670
19224,2020,Algeria,Malaysia,0,8,0,8
19225,2020,Egypt,Malaysia,14,84,0,98
19226,2020,Australia,Malaysia,5,0,0,5
19227,2020,Bangladesh,Malaysia,38,15,0,53
19228,2020,Cambodia,Malaysia,77,11,0,88
19229,2020,Central African Rep.,Malaysia,5,0,0,5
19230,2020,China,Malaysia,44,5,0,49
19231,2020,Cameroon,Malaysia,5,23,0,28
19232,2020,Congo,Malaysia,0,5,0,5
19233,2020,Dem. Rep. of the Congo,Malaysia,0,7,0,7
19234,2020,Eritrea,Malaysia,9,19,0,28
19235,2020,Ethiopia,Malaysia,12,11,0,23
19236,2020,Palestinian,Malaysia,216,540,0,756
19237,2020,United Kingdom of Great Britain and Northern Ireland,Malaysia,6,0,0,6
19238,2020,Guinea,Malaysia,5,27,0,32
19239,2020,Cote d'Ivoire,Malaysia,5,0,0,5
19240,2020,India,Malaysia,5,12,0,17
19241,2020,Indonesia,Malaysia,985,5,0,990
19242,2020,Iran (Islamic Rep. of),Malaysia,253,188,0,441
19243,2020,Iraq,Malaysia,411,801,0,1212
19244,2020,Jordan,Malaysia,5,5,0,10
19245,2020,Liberia,Malaysia,20,9,0,29
19246,2020,Libya,Malaysia,11,18,0,29
19247,2020,Lebanon,Malaysia,5,6,0,11
19248,2020,Sri Lanka,Malaysia,794,947,0,1741
19249,2020,Mali,Malaysia,5,0,0,5
19250,2020,Morocco,Malaysia,5,0,0,5
19251,2020,Myanmar,Malaysia,119578,34459,0,154037
19252,2020,Nepal,Malaysia,11,0,0,11
19253,2020,Nigeria,Malaysia,5,36,0,41
19254,2020,Pakistan,Malaysia,3166,3453,0,6619
19255,2020,Philippines,Malaysia,20,0,0,20
19256,2020,Russian Federation,Malaysia,6,0,0,6
19257,2020,Sierra Leone,Malaysia,11,37,0,48
19258,2020,Somalia,Malaysia,1786,1445,0,3231
19259,2020,Viet Nam,Malaysia,5,0,0,5
19260,2020,Sudan,Malaysia,163,140,0,303
19261,2020,South Sudan,Malaysia,16,38,0,54
19262,2020,Syrian Arab Rep.,Malaysia,407,2850,0,3257
19263,2020,Thailand,Malaysia,27,23,0,50
19264,2020,Uganda,Malaysia,0,6,0,6
19265,2020,United States of America,Malaysia,7,0,0,7
19266,2020,Uzbekistan,Malaysia,0,8,0,8
19267,2020,Yemen,Malaysia,232,3423,0,3655
19268,2020,Zimbabwe,Malaysia,5,5,0,10
19270,2020,Burundi,Malawi,2701,8281,0,10982
19271,2020,Dem. Rep. of the Congo,Malawi,9837,20102,0,29939
19272,2020,Ethiopia,Malawi,8,53,0,61
19273,2020,Cote d'Ivoire,Malawi,5,0,0,5
19274,2020,Mozambique,Malawi,0,5,0,5
19275,2020,Rwanda,Malawi,2277,4559,0,6836
19276,2020,Somalia,Malawi,54,56,0,110
19277,2020,South Sudan,Malawi,5,0,0,5
19278,2020,United Rep. of Tanzania,Malawi,0,6,0,6
19279,2020,Türkiye,Malawi,0,47,0,47
19280,2020,Uganda,Malawi,5,13,0,18
19281,2020,Zimbabwe,Malawi,0,7,0,7
19282,2020,Afghanistan,Mongolia,0,5,0,5
19283,2020,China,Mongolia,0,5,0,5
19284,2020,Mongolia,Mongolia,0,0,0,0
19285,2020,Afghanistan,Morocco,5,5,0,10
19286,2020,Algeria,Morocco,9,14,0,23
19287,2020,Angola,Morocco,0,5,0,5
19288,2020,Egypt,Morocco,5,10,0,15
19289,2020,Burundi,Morocco,7,0,0,7
19290,2020,Bangladesh,Morocco,0,132,0,132
19291,2020,Burkina Faso,Morocco,0,35,0,35
19292,2020,Central African Rep.,Morocco,585,198,0,783
19293,2020,Chad,Morocco,5,23,0,28
19294,2020,Cameroon,Morocco,143,1005,0,1148
19295,2020,Congo,Morocco,20,45,0,65
19296,2020,Dem. Rep. of the Congo,Morocco,183,158,0,341
19297,2020,Eritrea,Morocco,19,11,0,30
19298,2020,Ethiopia,Morocco,0,5,0,5
19299,2020,Gambia,Morocco,0,54,0,54
19300,2020,Palestinian,Morocco,82,138,0,220
19301,2020,Ghana,Morocco,0,11,0,11
19302,2020,Guinea-Bissau,Morocco,0,24,0,24
19303,2020,Guinea,Morocco,109,1526,0,1635
19304,2020,Cote d'Ivoire,Morocco,359,713,0,1072
19305,2020,India,Morocco,0,5,0,5
19306,2020,Iraq,Morocco,131,6,0,137
19307,2020,Jordan,Morocco,0,5,0,5
19308,2020,Liberia,Morocco,7,57,0,64
19309,2020,Libya,Morocco,48,14,0,62
19310,2020,Lebanon,Morocco,5,20,0,25
19311,2020,Sri Lanka,Morocco,0,5,0,5
19312,2020,Mauritania,Morocco,6,9,0,15
19313,2020,Mali,Morocco,42,486,0,528
19314,2020,Niger,Morocco,0,9,0,9
19315,2020,Nigeria,Morocco,22,398,0,420
19316,2020,Pakistan,Morocco,16,6,0,22
19317,2020,Senegal,Morocco,86,412,0,498
19318,2020,Sierra Leone,Morocco,0,77,0,77
19319,2020,Somalia,Morocco,19,12,0,31
19320,2020,Sudan,Morocco,20,54,0,74
19321,2020,South Sudan,Morocco,25,321,0,346
19322,2020,Syrian Arab Rep.,Morocco,4528,0,0,4528
19323,2020,Togo,Morocco,0,13,0,13
19324,2020,Tunisia,Morocco,0,5,0,5
19325,2020,Türkiye,Morocco,5,21,0,26
19326,2020,Yemen,Morocco,14,964,0,978
19327,2020,Angola,Mozambique,5,0,0,5
19328,2020,Burundi,Mozambique,905,7875,0,8780
19329,2020,Central African Rep.,Mozambique,0,12,0,12
19330,2020,Congo,Mozambique,15,36,0,51
19331,2020,Dem. Rep. of the Congo,Mozambique,2959,7121,0,10080
19332,2020,Comoros,Mozambique,0,503,0,503
19333,2020,Eritrea,Mozambique,0,27,0,27
19334,2020,Ethiopia,Mozambique,8,15,0,23
19335,2020,Guinea,Mozambique,0,5,0,5
19336,2020,Mozambique,Mozambique,0,0,668038,0
19337,2020,Rwanda,Mozambique,699,3136,0,3835
19338,2020,Somalia,Mozambique,156,3641,0,3797
19339,2020,Sudan,Mozambique,5,30,0,35
19340,2020,South Sudan,Mozambique,0,5,0,5
19341,2020,Uganda,Mozambique,5,36,0,41
19342,2020,Algeria,Malta,0,28,0,28
19343,2020,Egypt,Malta,75,91,0,166
19344,2020,Bangladesh,Malta,12,134,0,146
19345,2020,Burkina Faso,Malta,5,12,0,17
19346,2020,Belarus,Malta,9,0,0,9
19347,2020,Central African Rep.,Malta,0,8,0,8
19348,2020,Chad,Malta,9,61,0,70
19349,2020,China,Malta,17,0,0,17
19350,2020,Cameroon,Malta,10,68,0,78
19351,2020,Dem. Rep. of the Congo,Malta,5,10,0,15
19352,2020,Comoros,Malta,0,5,0,5
19353,2020,Colombia,Malta,0,26,0,26
19354,2020,Eritrea,Malta,808,365,0,1173
19355,2020,Ethiopia,Malta,175,31,0,206
19356,2020,Gambia,Malta,27,12,0,39
19357,2020,Palestinian,Malta,70,15,0,85
19358,2020,Georgia,Malta,5,14,0,19
19359,2020,Ghana,Malta,8,21,0,29
19360,2020,Guinea-Bissau,Malta,0,7,0,7
19361,2020,Guinea,Malta,0,115,0,115
19362,2020,Cote d'Ivoire,Malta,12,169,0,181
19363,2020,India,Malta,0,5,0,5
19364,2020,Iran (Islamic Rep. of),Malta,31,7,0,38
19365,2020,Iraq,Malta,81,0,0,81
19366,2020,Jordan,Malta,5,0,0,5
19367,2020,Liberia,Malta,6,0,0,6
19368,2020,Libya,Malta,2815,264,0,3079
19369,2020,Sri Lanka,Malta,7,0,0,7
19370,2020,Mauritania,Malta,0,5,0,5
19371,2020,North Macedonia,Malta,5,0,0,5
19372,2020,Mali,Malta,19,146,0,165
19373,2020,Morocco,Malta,29,94,0,123
19374,2020,Nepal,Malta,0,19,0,19
19375,2020,Niger,Malta,0,21,0,21
19376,2020,Nigeria,Malta,124,206,0,330
19377,2020,Pakistan,Malta,58,62,0,120
19378,2020,South Africa,Malta,0,5,0,5
19379,2020,Russian Federation,Malta,18,5,0,23
19380,2020,El Salvador,Malta,0,5,0,5
19381,2020,Saudi Arabia,Malta,5,0,0,5
19382,2020,Serbia and Kosovo: S/RES/1244 (1999),Malta,7,5,0,12
19383,2020,Senegal,Malta,5,56,0,61
19384,2020,Sierra Leone,Malta,5,40,0,45
19385,2020,Somalia,Malta,1782,138,0,1920
19386,2020,Sudan,Malta,218,1119,0,1337
19387,2020,South Sudan,Malta,22,106,0,128
19388,2020,Syrian Arab Rep.,Malta,1871,381,0,2252
19389,2020,Togo,Malta,5,9,0,14
19390,2020,Tunisia,Malta,13,19,0,32
19391,2020,Türkiye,Malta,7,10,0,17
19392,2020,Uganda,Malta,0,5,0,5
19393,2020,Ukraine,Malta,141,44,0,185
19394,2020,Uzbekistan,Malta,0,5,0,5
19395,2020,Venezuela (Bolivarian Republic of),Malta,6,68,0,74
19396,2020,Yemen,Malta,5,6,0,11
19397,2020,Zimbabwe,Malta,5,0,0,5
19400,2020,Afghanistan,Montenegro,0,6,0,6
19401,2020,Algeria,Montenegro,0,10,0,10
19402,2020,Belarus,Montenegro,5,0,0,5
19403,2020,Bosnia and Herzegovina,Montenegro,5,0,0,5
19404,2020,Cuba,Montenegro,0,18,0,18
19405,2020,Ecuador,Montenegro,0,5,0,5
19406,2020,Palestinian,Montenegro,0,8,0,8
19407,2020,Ghana,Montenegro,5,0,0,5
19408,2020,Croatia,Montenegro,5,0,0,5
19409,2020,Iran (Islamic Rep. of),Montenegro,9,42,0,51
19410,2020,Morocco,Montenegro,0,56,0,56
19411,2020,Pakistan,Montenegro,0,9,0,9
19412,2020,Russian Federation,Montenegro,0,11,0,11
19413,2020,Serbia and Kosovo: S/RES/1244 (1999),Montenegro,130,0,0,130
19414,2020,Syrian Arab Rep.,Montenegro,0,9,0,9
19415,2020,Türkiye,Montenegro,0,14,0,14
19416,2020,Venezuela (Bolivarian Republic of),Montenegro,0,5,0,5
19417,2020,Yemen,Montenegro,7,0,0,7
19419,2020,Dem. Rep. of the Congo,Mauritius,10,0,0,10
19420,2020,Pakistan,Mauritius,5,0,0,5
19421,2020,South Africa,Mauritius,5,0,0,5
19422,2020,Myanmar,Myanmar,0,0,370320,0
19424,2020,Burundi,Namibia,296,165,0,461
19425,2020,Central African Rep.,Namibia,5,8,0,13
19426,2020,Cameroon,Namibia,22,21,0,43
19427,2020,Congo,Namibia,5,5,0,10
19428,2020,Dem. Rep. of the Congo,Namibia,3045,1909,0,4954
19429,2020,Kenya,Namibia,5,0,0,5
19430,2020,Nigeria,Namibia,0,6,0,6
19431,2020,Rwanda,Namibia,126,32,0,158
19432,2020,Somalia,Namibia,5,6,0,11
19433,2020,Sudan,Namibia,7,0,0,7
19434,2020,South Sudan,Namibia,0,5,0,5
19435,2020,Uganda,Namibia,5,5,0,10
19436,2020,Zimbabwe,Namibia,57,52,0,109
19437,2020,Afghanistan,Nepal,52,0,0,52
19438,2020,Bangladesh,Nepal,5,0,0,5
19439,2020,Bhutan,Nepal,6365,0,0,6365
19440,2020,India,Nepal,0,0,0,0
19441,2020,Iran (Islamic Rep. of),Nepal,9,0,0,9
19442,2020,Sri Lanka,Nepal,19,6,0,25
19443,2020,Myanmar,Nepal,359,25,0,384
19444,2020,Nepal,Nepal,0,0,0,0
19445,2020,Pakistan,Nepal,184,11,0,195
19446,2020,Somalia,Nepal,22,0,0,22
19449,2020,Afghanistan,Netherlands,5319,497,0,5816
19450,2020,Albania,Netherlands,7,10,0,17
19451,2020,Algeria,Netherlands,16,343,0,359
19452,2020,Angola,Netherlands,24,23,0,47
19453,2020,Egypt,Netherlands,233,197,0,430
19454,2020,Argentina,Netherlands,6,5,0,11
19455,2020,Armenia,Netherlands,207,21,0,228
19456,2020,Azerbaijan,Netherlands,181,66,0,247
19457,2020,Bahrain,Netherlands,10,0,0,10
19458,2020,Burundi,Netherlands,92,13,0,105
19459,2020,Bangladesh,Netherlands,31,30,0,61
19460,2020,Bhutan,Netherlands,97,0,0,97
19461,2020,Burkina Faso,Netherlands,14,5,0,19
19462,2020,Belarus,Netherlands,32,55,0,87
19463,2020,Bosnia and Herzegovina,Netherlands,8,0,0,8
19464,2020,Cambodia,Netherlands,6,0,0,6
19465,2020,Central African Rep.,Netherlands,7,0,0,7
19466,2020,Chad,Netherlands,5,5,0,10
19467,2020,China,Netherlands,879,108,0,987
19468,2020,Cameroon,Netherlands,65,44,0,109
19469,2020,Congo,Netherlands,308,27,0,335
19470,2020,Dem. Rep. of the Congo,Netherlands,114,9,0,123
19471,2020,Comoros,Netherlands,0,5,0,5
19472,2020,Colombia,Netherlands,43,160,0,203
19473,2020,Cuba,Netherlands,29,29,0,58
19474,2020,Ecuador,Netherlands,7,0,0,7
19475,2020,Eritrea,Netherlands,14785,394,0,15179
19476,2020,Ethiopia,Netherlands,433,72,0,505
19477,2020,Gambia,Netherlands,31,148,0,179
19478,2020,Palestinian,Netherlands,160,21,0,181
19479,2020,Georgia,Netherlands,30,23,0,53
19480,2020,Ghana,Netherlands,7,18,0,25
19481,2020,Guinea-Bissau,Netherlands,0,10,0,10
19482,2020,Guinea,Netherlands,464,127,0,591
19483,2020,Honduras,Netherlands,0,10,0,10
19484,2020,Cote d'Ivoire,Netherlands,168,20,0,188
19485,2020,India,Netherlands,6,13,0,19
19486,2020,Indonesia,Netherlands,0,19,0,19
19487,2020,Iran (Islamic Rep. of),Netherlands,4735,2041,0,6776
19488,2020,Iraq,Netherlands,7197,497,0,7694
19489,2020,Jamaica,Netherlands,187,5,0,192
19490,2020,Jordan,Netherlands,32,128,0,160
19491,2020,Kazakhstan,Netherlands,30,22,0,52
19492,2020,Kenya,Netherlands,27,15,0,42
19493,2020,Kyrgyzstan,Netherlands,21,0,0,21
19494,2020,Dem. People's Rep. of Korea,Netherlands,35,0,0,35
19495,2020,Kuwait,Netherlands,5,7,0,12
19496,2020,Lao People's Dem. Rep.,Netherlands,10,0,0,10
19497,2020,Liberia,Netherlands,40,10,0,50
19498,2020,Libya,Netherlands,246,133,0,379
19499,2020,Lebanon,Netherlands,65,124,0,189
19500,2020,Sri Lanka,Netherlands,409,53,0,462
19501,2020,Mauritania,Netherlands,5,5,0,10
19502,2020,North Macedonia,Netherlands,0,5,0,5
19503,2020,Rep. of Moldova,Netherlands,0,18,0,18
19504,2020,Mexico,Netherlands,0,5,0,5
19505,2020,Mali,Netherlands,16,7,0,23
19506,2020,Malaysia,Netherlands,7,0,0,7
19507,2020,Mongolia,Netherlands,33,5,0,38
19508,2020,Morocco,Netherlands,58,267,0,325
19509,2020,Myanmar,Netherlands,333,26,0,359
19510,2020,Nepal,Netherlands,149,5,0,154
19511,2020,Niger,Netherlands,5,17,0,22
19512,2020,Nicaragua,Netherlands,14,33,0,47
19513,2020,Nigeria,Netherlands,288,500,0,788
19514,2020,Pakistan,Netherlands,608,284,0,892
19515,2020,Peru,Netherlands,5,10,0,15
19516,2020,Philippines,Netherlands,6,0,0,6
19517,2020,Russian Federation,Netherlands,356,140,0,496
19518,2020,Rwanda,Netherlands,41,8,0,49
19519,2020,El Salvador,Netherlands,5,48,0,53
19520,2020,Saudi Arabia,Netherlands,25,6,0,31
19521,2020,Serbia and Kosovo: S/RES/1244 (1999),Netherlands,20,22,0,42
19522,2020,Senegal,Netherlands,18,25,0,43
19523,2020,Sierra Leone,Netherlands,339,75,0,414
19524,2020,Somalia,Netherlands,9467,220,0,9687
19525,2020,Viet Nam,Netherlands,11,15,0,26
19526,2020,Sudan,Netherlands,757,115,0,872
19527,2020,Suriname,Netherlands,0,13,0,13
19528,2020,South Sudan,Netherlands,0,9,0,9
19529,2020,Syrian Arab Rep.,Netherlands,35810,2280,0,38090
19530,2020,United Rep. of Tanzania,Netherlands,5,25,0,30
19531,2020,Tajikistan,Netherlands,28,16,0,44
19532,2020,Turkmenistan,Netherlands,7,5,0,12
19533,2020,Timor-Leste,Netherlands,0,6,0,6
19534,2020,Togo,Netherlands,18,0,0,18
19535,2020,Trinidad and Tobago,Netherlands,80,5,0,85
19536,2020,Tunisia,Netherlands,22,120,0,142
19537,2020,Türkiye,Netherlands,3183,707,0,3890
19538,2020,Uganda,Netherlands,452,224,0,676
19539,2020,Ukraine,Netherlands,21,21,0,42
19540,2020,United States of America,Netherlands,29,5,0,34
19541,2020,Uzbekistan,Netherlands,15,11,0,26
19542,2020,Venezuela (Bolivarian Republic of),Netherlands,30,197,0,227
19543,2020,Yemen,Netherlands,1392,229,0,1621
19544,2020,Zambia,Netherlands,8,0,0,8
19545,2020,Zimbabwe,Netherlands,23,27,0,50
19548,2020,Burkina Faso,Niger,0,0,0,0
19549,2020,Central African Rep.,Niger,159,32,0,191
19550,2020,Chad,Niger,171,1903,0,2074
19551,2020,Cameroon,Niger,19,195,0,214
19552,2020,Congo,Niger,5,6,0,11
19553,2020,Dem. Rep. of the Congo,Niger,81,13,0,94
19554,2020,Eritrea,Niger,272,91,0,363
19555,2020,Ethiopia,Niger,50,20,0,70
19556,2020,Guinea,Niger,0,11,0,11
19557,2020,Cote d'Ivoire,Niger,40,6,0,46
19558,2020,Iraq,Niger,6,0,0,6
19559,2020,Libya,Niger,8,6,0,14
19560,2020,Mali,Niger,60245,99,0,60344
19561,2020,Niger,Niger,0,0,298458,0
19562,2020,Nigeria,Niger,171014,14,0,171028
19563,2020,Pakistan,Niger,0,8,0,8
19564,2020,Rwanda,Niger,18,0,0,18
19565,2020,Somalia,Niger,140,24,0,164
19566,2020,Sudan,Niger,1042,836,0,1878
19567,2020,South Sudan,Niger,8,5,0,13
19568,2020,Syrian Arab Rep.,Niger,5,0,0,5
19569,2020,Togo,Niger,5,11,0,16
19570,2020,Yemen,Niger,5,5,0,10
19571,2020,Colombia,Nicaragua,6,0,0,6
19572,2020,Cuba,Nicaragua,14,0,0,14
19573,2020,Guatemala,Nicaragua,7,0,0,7
19574,2020,Honduras,Nicaragua,74,26,0,100
19575,2020,El Salvador,Nicaragua,210,100,0,310
19577,2020,Afghanistan,Nigeria,5,0,0,5
19578,2020,Egypt,Nigeria,0,5,0,5
19579,2020,Benin,Nigeria,5,0,0,5
19580,2020,Central African Rep.,Nigeria,711,335,0,1046
19581,2020,Chad,Nigeria,86,17,0,103
19582,2020,Cameroon,Nigeria,63634,538,0,64172
19583,2020,Congo,Nigeria,5,0,0,5
19584,2020,Dem. Rep. of the Congo,Nigeria,652,107,0,759
19585,2020,Eritrea,Nigeria,32,13,0,45
19586,2020,Ethiopia,Nigeria,5,0,0,5
19587,2020,Palestinian,Nigeria,14,15,0,29
19588,2020,Ghana,Nigeria,5,5,0,10
19589,2020,Guinea-Bissau,Nigeria,5,0,0,5
19590,2020,Guinea,Nigeria,17,5,0,22
19591,2020,Cote d'Ivoire,Nigeria,136,7,0,143
19592,2020,Liberia,Nigeria,10,5,0,15
19593,2020,Lebanon,Nigeria,0,11,0,11
19594,2020,Sri Lanka,Nigeria,5,0,0,5
19595,2020,Mali,Nigeria,145,15,0,160
19596,2020,Niger,Nigeria,6,1430,0,1436
19597,2020,Nigeria,Nigeria,0,0,2610278,0
19598,2020,Sierra Leone,Nigeria,23,5,0,28
19599,2020,Sudan,Nigeria,47,7,0,54
19600,2020,Syrian Arab Rep.,Nigeria,308,216,0,524
19601,2020,Togo,Nigeria,26,10,0,36
19602,2020,Türkiye,Nigeria,174,36,0,210
19603,2020,Yemen,Nigeria,0,5,0,5
19604,2020,Afghanistan,Norway,4007,65,0,4072
19605,2020,Albania,Norway,19,14,0,33
19606,2020,Algeria,Norway,6,5,0,11
19607,2020,Angola,Norway,11,6,0,17
19608,2020,Egypt,Norway,56,0,0,56
19609,2020,Armenia,Norway,5,0,0,5
19610,2020,Azerbaijan,Norway,20,0,0,20
19611,2020,Burundi,Norway,44,0,0,44
19612,2020,Bangladesh,Norway,6,0,0,6
19613,2020,Belarus,Norway,5,0,0,5
19614,2020,Bulgaria,Norway,5,0,0,5
19615,2020,Central African Rep.,Norway,15,0,0,15
19616,2020,China,Norway,465,5,0,470
19617,2020,Cameroon,Norway,15,10,0,25
19618,2020,Congo,Norway,5,0,0,5
19619,2020,Dem. Rep. of the Congo,Norway,391,5,0,396
19620,2020,Colombia,Norway,12,13,0,25
19621,2020,Djibouti,Norway,5,0,0,5
19622,2020,Eritrea,Norway,12520,92,0,12612
19623,2020,Ethiopia,Norway,1524,53,0,1577
19624,2020,Gambia,Norway,15,0,0,15
19625,2020,United Kingdom of Great Britain and Northern Ireland,Norway,0,5,0,5
19626,2020,Georgia,Norway,5,0,0,5
19627,2020,Ghana,Norway,7,0,0,7
19628,2020,Guinea-Bissau,Norway,5,0,0,5
19629,2020,Guinea,Norway,45,0,0,45
19630,2020,Honduras,Norway,5,0,0,5
19631,2020,Cote d'Ivoire,Norway,13,5,0,18
19632,2020,Iran (Islamic Rep. of),Norway,1647,130,0,1777
19633,2020,Iraq,Norway,1207,57,0,1264
19634,2020,Israel,Norway,8,0,0,8
19635,2020,Jordan,Norway,6,0,0,6
19636,2020,Kazakhstan,Norway,15,0,0,15
19637,2020,Kenya,Norway,8,0,0,8
19638,2020,Kyrgyzstan,Norway,13,0,0,13
19639,2020,Liberia,Norway,5,0,0,5
19640,2020,Libya,Norway,56,5,0,61
19641,2020,Lebanon,Norway,25,0,0,25
19642,2020,Sri Lanka,Norway,69,5,0,74
19643,2020,Mauritania,Norway,5,0,0,5
19644,2020,Rep. of Moldova,Norway,5,0,0,5
19645,2020,Mali,Norway,8,0,0,8
19646,2020,Morocco,Norway,17,0,0,17
19647,2020,Myanmar,Norway,49,5,0,54
19648,2020,Nepal,Norway,5,0,0,5
19649,2020,Nicaragua,Norway,0,8,0,8
19650,2020,Nigeria,Norway,144,11,0,155
19651,2020,Pakistan,Norway,87,11,0,98
19652,2020,Peru,Norway,0,5,0,5
19653,2020,Russian Federation,Norway,432,15,0,447
19654,2020,Rwanda,Norway,23,5,0,28
19655,2020,El Salvador,Norway,10,0,0,10
19656,2020,Saudi Arabia,Norway,8,0,0,8
19657,2020,Serbia and Kosovo: S/RES/1244 (1999),Norway,33,7,0,40
19658,2020,Sierra Leone,Norway,11,0,0,11
19659,2020,Somalia,Norway,5263,25,0,5288
19660,2020,Viet Nam,Norway,38,0,0,38
19661,2020,Sudan,Norway,1848,9,0,1857
19662,2020,South Sudan,Norway,50,0,0,50
19663,2020,Syrian Arab Rep.,Norway,15311,340,0,15651
19664,2020,Tajikistan,Norway,5,0,0,5
19665,2020,Turkmenistan,Norway,5,0,0,5
19666,2020,Tunisia,Norway,5,0,0,5
19667,2020,Türkiye,Norway,1029,62,0,1091
19668,2020,Uganda,Norway,116,5,0,121
19669,2020,Ukraine,Norway,10,9,0,19
19670,2020,Uzbekistan,Norway,182,5,0,187
19671,2020,Venezuela (Bolivarian Republic of),Norway,15,0,0,15
19672,2020,Yemen,Norway,192,12,0,204
19673,2020,Zimbabwe,Norway,11,0,0,11
19676,2020,Afghanistan,Nauru,29,0,0,29
19677,2020,Bangladesh,Nauru,19,20,0,39
19678,2020,India,Nauru,9,5,0,14
19679,2020,Indonesia,Nauru,5,5,0,10
19680,2020,Iran (Islamic Rep. of),Nauru,561,6,0,567
19681,2020,Iraq,Nauru,48,0,0,48
19682,2020,Kuwait,Nauru,5,0,0,5
19683,2020,Lebanon,Nauru,14,0,0,14
19684,2020,Sri Lanka,Nauru,102,18,0,120
19685,2020,Malaysia,Nauru,5,0,0,5
19686,2020,Myanmar,Nauru,74,0,0,74
19687,2020,Nepal,Nauru,11,6,0,17
19688,2020,Pakistan,Nauru,36,20,0,56
19689,2020,Somalia,Nauru,82,5,0,87
19690,2020,Sudan,Nauru,8,0,0,8
19691,2020,Syrian Arab Rep.,Nauru,0,5,0,5
19693,2020,Afghanistan,New Zealand,57,23,0,80
19694,2020,Egypt,New Zealand,33,0,0,33
19695,2020,Bahrain,New Zealand,26,0,0,26
19696,2020,Burundi,New Zealand,0,5,0,5
19697,2020,Bangladesh,New Zealand,9,14,0,23
19698,2020,Brazil,New Zealand,0,6,0,6
19699,2020,China,New Zealand,238,82,0,320
19700,2020,Chile,New Zealand,5,5,0,10
19701,2020,Cameroon,New Zealand,5,5,0,10
19702,2020,Dem. Rep. of the Congo,New Zealand,5,0,0,5
19703,2020,Colombia,New Zealand,29,16,0,45
19704,2020,Czechia,New Zealand,18,0,0,18
19705,2020,Eritrea,New Zealand,7,0,0,7
19706,2020,Ethiopia,New Zealand,11,5,0,16
19707,2020,Fiji,New Zealand,23,22,0,45
19708,2020,Palestinian,New Zealand,13,5,0,18
19709,2020,"China, Hong Kong SAR",New Zealand,0,5,0,5
19710,2020,Hungary,New Zealand,8,0,0,8
19711,2020,India,New Zealand,12,77,0,89
19712,2020,Indonesia,New Zealand,5,101,0,106
19713,2020,Ireland,New Zealand,0,5,0,5
19714,2020,Iran (Islamic Rep. of),New Zealand,126,19,0,145
19715,2020,Iraq,New Zealand,65,5,0,70
19716,2020,Jordan,New Zealand,8,0,0,8
19717,2020,Kuwait,New Zealand,5,0,0,5
19718,2020,Libya,New Zealand,22,0,0,22
19719,2020,Sri Lanka,New Zealand,45,40,0,85
19720,2020,Maldives,New Zealand,5,0,0,5
19721,2020,Mexico,New Zealand,5,0,0,5
19722,2020,Malaysia,New Zealand,11,43,0,54
19723,2020,Mongolia,New Zealand,6,6,0,12
19724,2020,Myanmar,New Zealand,12,0,0,12
19725,2020,Nepal,New Zealand,5,5,0,10
19726,2020,Pakistan,New Zealand,55,7,0,62
19727,2020,Philippines,New Zealand,7,14,0,21
19728,2020,Papua New Guinea,New Zealand,5,0,0,5
19729,2020,Portugal,New Zealand,0,5,0,5
19730,2020,South Africa,New Zealand,7,6,0,13
19731,2020,Russian Federation,New Zealand,27,16,0,43
19732,2020,El Salvador,New Zealand,5,0,0,5
19733,2020,Saudi Arabia,New Zealand,64,6,0,70
19734,2020,Somalia,New Zealand,11,0,0,11
19735,2020,Viet Nam,New Zealand,7,6,0,13
19736,2020,Sudan,New Zealand,6,5,0,11
19737,2020,Syrian Arab Rep.,New Zealand,72,0,0,72
19738,2020,Türkiye,New Zealand,54,10,0,64
19739,2020,Uganda,New Zealand,5,0,0,5
19740,2020,Uruguay,New Zealand,0,5,0,5
19741,2020,Uzbekistan,New Zealand,5,0,0,5
19742,2020,Samoa,New Zealand,0,5,0,5
19743,2020,Yemen,New Zealand,8,0,0,8
19744,2020,Zimbabwe,New Zealand,16,5,0,21
19746,2020,Iran (Islamic Rep. of),Oman,0,5,0,5
19747,2020,Iraq,Oman,295,303,0,598
19748,2020,Pakistan,Oman,5,0,0,5
19749,2020,Syrian Arab Rep.,Oman,8,22,0,30
19750,2020,Afghanistan,Pakistan,1438432,9668,0,1448100
19751,2020,Algeria,Pakistan,22,0,0,22
19752,2020,China,Pakistan,5,15,0,20
19753,2020,Palestinian,Pakistan,21,0,0,21
19754,2020,India,Pakistan,0,5,0,5
19755,2020,Iran (Islamic Rep. of),Pakistan,39,20,0,59
19756,2020,Iraq,Pakistan,22,7,0,29
19757,2020,Myanmar,Pakistan,23,31,0,54
19758,2020,Pakistan,Pakistan,0,0,98898,0
19759,2020,Russian Federation,Pakistan,6,0,0,6
19760,2020,Somalia,Pakistan,177,22,0,199
19761,2020,Syrian Arab Rep.,Pakistan,43,0,0,43
19762,2020,Tajikistan,Pakistan,7,0,0,7
19763,2020,Türkiye,Pakistan,6,0,0,6
19764,2020,Yemen,Pakistan,137,26,0,163
19766,2020,Afghanistan,Panama,5,6,0,11
19767,2020,Armenia,Panama,0,5,0,5
19768,2020,Bangladesh,Panama,0,15,0,15
19769,2020,Belarus,Panama,7,0,0,7
19770,2020,Bosnia and Herzegovina,Panama,5,0,0,5
19771,2020,Cameroon,Panama,9,5,0,14
19772,2020,Dem. Rep. of the Congo,Panama,5,0,0,5
19773,2020,Colombia,Panama,1698,1114,0,2812
19774,2020,Costa Rica,Panama,0,5,0,5
19775,2020,Cuba,Panama,120,2162,0,2282
19776,2020,Dominican Rep.,Panama,5,0,0,5
19777,2020,Ecuador,Panama,0,17,0,17
19778,2020,Eritrea,Panama,0,38,0,38
19779,2020,Guatemala,Panama,12,9,0,21
19780,2020,Haiti,Panama,19,0,0,19
19781,2020,Honduras,Panama,6,88,0,94
19782,2020,Croatia,Panama,5,0,0,5
19783,2020,Cote d'Ivoire,Panama,0,5,0,5
19784,2020,India,Panama,0,5,0,5
19785,2020,Iran (Islamic Rep. of),Panama,5,0,0,5
19786,2020,Italy,Panama,0,5,0,5
19787,2020,Jamaica,Panama,0,5,0,5
19788,2020,Liberia,Panama,5,0,0,5
19789,2020,Sri Lanka,Panama,0,7,0,7
19790,2020,Mexico,Panama,6,0,0,6
19791,2020,Nepal,Panama,0,14,0,14
19792,2020,Nicaragua,Panama,179,5662,0,5841
19793,2020,Nigeria,Panama,10,34,0,44
19794,2020,Pakistan,Panama,0,17,0,17
19795,2020,Peru,Panama,23,0,0,23
19796,2020,El Salvador,Panama,363,972,0,1335
19797,2020,Sierra Leone,Panama,5,0,0,5
19798,2020,Somalia,Panama,0,101,0,101
19799,2020,Sudan,Panama,5,0,0,5
19800,2020,Ukraine,Panama,0,5,0,5
19801,2020,Venezuela (Bolivarian Republic of),Panama,65,2596,0,2661
19802,2020,Argentina,Paraguay,0,6,0,6
19803,2020,Bolivia (Plurinational State of),Paraguay,16,5,0,21
19804,2020,Brazil,Paraguay,0,5,0,5
19805,2020,Cameroon,Paraguay,0,5,0,5
19806,2020,Colombia,Paraguay,17,40,0,57
19807,2020,Cuba,Paraguay,280,559,0,839
19808,2020,Iraq,Paraguay,6,0,0,6
19809,2020,Lebanon,Paraguay,0,5,0,5
19810,2020,Sri Lanka,Paraguay,5,0,0,5
19811,2020,Nigeria,Paraguay,0,5,0,5
19812,2020,Peru,Paraguay,5,5,0,10
19813,2020,El Salvador,Paraguay,13,5,0,18
19814,2020,Syrian Arab Rep.,Paraguay,88,17,0,105
19815,2020,Türkiye,Paraguay,5,0,0,5
19816,2020,Venezuela (Bolivarian Republic of),Paraguay,1251,795,0,2046
19817,2020,Afghanistan,Peru,0,5,0,5
19818,2020,Angola,Peru,0,10,0,10
19819,2020,Argentina,Peru,0,14,0,14
19820,2020,Bangladesh,Peru,26,0,0,26
19821,2020,Bolivia (Plurinational State of),Peru,20,22,0,42
19822,2020,Brazil,Peru,5,12,0,17
19823,2020,China,Peru,0,13,0,13
19824,2020,Chile,Peru,0,12,0,12
19825,2020,Cameroon,Peru,20,0,0,20
19826,2020,Congo,Peru,0,9,0,9
19827,2020,Dem. Rep. of the Congo,Peru,8,0,0,8
19828,2020,Colombia,Peru,706,1646,0,2352
19829,2020,Costa Rica,Peru,0,5,0,5
19830,2020,Cuba,Peru,494,2775,0,3269
19831,2020,Dominica,Peru,0,5,0,5
19832,2020,Dominican Rep.,Peru,19,56,0,75
19833,2020,Ecuador,Peru,0,264,0,264
19834,2020,Ethiopia,Peru,5,0,0,5
19835,2020,Gambia,Peru,5,0,0,5
19836,2020,Palestinian,Peru,41,8,0,49
19837,2020,Germany,Peru,0,5,0,5
19838,2020,Ghana,Peru,5,0,0,5
19839,2020,Haiti,Peru,80,60,0,140
19840,2020,Honduras,Peru,0,7,0,7
19841,2020,India,Peru,6,5,0,11
19842,2020,Iran (Islamic Rep. of),Peru,6,0,0,6
19843,2020,Iraq,Peru,42,0,0,42
19844,2020,Italy,Peru,0,5,0,5
19845,2020,Jordan,Peru,0,5,0,5
19846,2020,Sri Lanka,Peru,0,7,0,7
19847,2020,Mexico,Peru,0,13,0,13
19848,2020,Morocco,Peru,0,5,0,5
19849,2020,Nepal,Peru,0,5,0,5
19850,2020,Nicaragua,Peru,7,8,0,15
19851,2020,Nigeria,Peru,24,18,0,42
19852,2020,Pakistan,Peru,0,10,0,10
19853,2020,Panama,Peru,0,11,0,11
19854,2020,Paraguay,Peru,0,5,0,5
19855,2020,Peru,Peru,0,0,0,0
19856,2020,Philippines,Peru,0,21,0,21
19857,2020,Poland,Peru,0,5,0,5
19858,2020,Portugal,Peru,0,16,0,16
19859,2020,Russian Federation,Peru,0,5,0,5
19860,2020,El Salvador,Peru,9,5,0,14
19861,2020,Spain,Peru,0,20,0,20
19862,2020,Syrian Arab Rep.,Peru,42,14,0,56
19863,2020,Turkmenistan,Peru,0,8,0,8
19864,2020,Türkiye,Peru,42,47,0,89
19865,2020,Ukraine,Peru,17,0,0,17
19866,2020,Uruguay,Peru,0,5,0,5
19867,2020,United States of America,Peru,0,5,0,5
19868,2020,Venezuela (Bolivarian Republic of),Peru,2628,532303,0,534931
19869,2020,Yemen,Peru,0,63,0,63
19870,2020,Anguilla,Peru,0,5,0,5
19872,2020,Afghanistan,Philippines,9,0,0,9
19873,2020,Egypt,Philippines,0,5,0,5
19874,2020,Burundi,Philippines,13,0,0,13
19875,2020,Cambodia,Philippines,13,0,0,13
19876,2020,Chad,Philippines,0,5,0,5
19877,2020,China,Philippines,5,5,0,10
19878,2020,Cameroon,Philippines,34,40,0,74
19879,2020,Congo,Philippines,5,8,0,13
19880,2020,Dem. Rep. of the Congo,Philippines,5,0,0,5
19881,2020,Eritrea,Philippines,20,14,0,34
19882,2020,Ethiopia,Philippines,5,0,0,5
19883,2020,Palestinian,Philippines,50,11,0,61
19884,2020,Ghana,Philippines,5,0,0,5
19885,2020,Guinea,Philippines,0,5,0,5
19886,2020,Cote d'Ivoire,Philippines,28,21,0,49
19887,2020,Iran (Islamic Rep. of),Philippines,56,14,0,70
19888,2020,Iraq,Philippines,36,10,0,46
19889,2020,Liberia,Philippines,5,5,0,10
19890,2020,Libya,Philippines,0,5,0,5
19891,2020,Lebanon,Philippines,5,8,0,13
19892,2020,Sri Lanka,Philippines,5,0,0,5
19893,2020,Morocco,Philippines,5,0,0,5
19894,2020,Myanmar,Philippines,5,0,0,5
19895,2020,Nigeria,Philippines,5,13,0,18
19896,2020,Pakistan,Philippines,102,25,0,127
19897,2020,Philippines,Philippines,0,0,150368,0
19898,2020,Russian Federation,Philippines,5,0,0,5
19899,2020,Rwanda,Philippines,9,0,0,9
19900,2020,Somalia,Philippines,29,25,0,54
19901,2020,Viet Nam,Philippines,16,5,0,21
19902,2020,Sudan,Philippines,6,32,0,38
19903,2020,Syrian Arab Rep.,Philippines,134,40,0,174
19904,2020,Thailand,Philippines,5,0,0,5
19905,2020,Türkiye,Philippines,54,19,0,73
19906,2020,United Arab Emirates,Philippines,5,7,0,12
19907,2020,United States of America,Philippines,0,5,0,5
19908,2020,Yemen,Philippines,30,65,0,95
19911,2020,Afghanistan,Papua New Guinea,35,0,0,35
19912,2020,Bangladesh,Papua New Guinea,15,5,0,20
19913,2020,India,Papua New Guinea,0,5,0,5
19914,2020,Indonesia,Papua New Guinea,10501,0,0,10501
19915,2020,Iran (Islamic Rep. of),Papua New Guinea,90,88,0,178
19916,2020,Iraq,Papua New Guinea,32,5,0,37
19917,2020,Sri Lanka,Papua New Guinea,10,0,0,10
19918,2020,Myanmar,Papua New Guinea,5,0,0,5
19919,2020,Pakistan,Papua New Guinea,32,5,0,37
19920,2020,Papua New Guinea,Papua New Guinea,0,0,14000,0
19921,2020,Somalia,Papua New Guinea,14,0,0,14
19922,2020,Sudan,Papua New Guinea,42,0,0,42
19924,2020,Afghanistan,Poland,92,52,0,144
19925,2020,Algeria,Poland,0,5,0,5
19926,2020,Egypt,Poland,40,5,0,45
19927,2020,Armenia,Poland,5,28,0,33
19928,2020,Azerbaijan,Poland,10,8,0,18
19929,2020,Bangladesh,Poland,6,5,0,11
19930,2020,Belarus,Poland,116,304,0,420
19931,2020,Bosnia and Herzegovina,Poland,7,0,0,7
19932,2020,Central African Rep.,Poland,5,0,0,5
19933,2020,China,Poland,16,0,0,16
19934,2020,Congo,Poland,6,5,0,11
19935,2020,Cuba,Poland,7,5,0,12
19936,2020,Eritrea,Poland,5,5,0,10
19937,2020,Ethiopia,Poland,5,0,0,5
19938,2020,Palestinian,Poland,5,5,0,10
19939,2020,Georgia,Poland,5,65,0,70
19940,2020,Guinea,Poland,5,0,0,5
19941,2020,India,Poland,0,5,0,5
19942,2020,Iran (Islamic Rep. of),Poland,48,13,0,61
19943,2020,Iraq,Poland,111,31,0,142
19944,2020,Jordan,Poland,0,5,0,5
19945,2020,Kazakhstan,Poland,39,19,0,58
19946,2020,Kyrgyzstan,Poland,28,42,0,70
19947,2020,Lao People's Dem. Rep.,Poland,5,0,0,5
19948,2020,Libya,Poland,19,6,0,25
19949,2020,Lebanon,Poland,0,7,0,7
19950,2020,Sri Lanka,Poland,11,8,0,19
19951,2020,Rep. of Moldova,Poland,0,5,0,5
19952,2020,Mongolia,Poland,0,5,0,5
19953,2020,Morocco,Poland,0,5,0,5
19954,2020,Nepal,Poland,7,0,0,7
19955,2020,Nigeria,Poland,6,5,0,11
19956,2020,Pakistan,Poland,27,17,0,44
19957,2020,Russian Federation,Poland,1052,2419,0,3471
19958,2020,Rwanda,Poland,5,0,0,5
19959,2020,Sierra Leone,Poland,7,0,0,7
19960,2020,Somalia,Poland,13,0,0,13
19961,2020,Viet Nam,Poland,5,7,0,12
19962,2020,Syrian Arab Rep.,Poland,237,39,0,276
19963,2020,United Rep. of Tanzania,Poland,0,5,0,5
19964,2020,Tajikistan,Poland,125,88,0,213
19965,2020,Turkmenistan,Poland,33,0,0,33
19966,2020,Türkiye,Poland,162,37,0,199
19967,2020,Ukraine,Poland,416,305,0,721
19968,2020,Uzbekistan,Poland,16,7,0,23
19969,2020,Venezuela (Bolivarian Republic of),Poland,0,5,0,5
19970,2020,Yemen,Poland,13,9,0,22
19973,2020,Afghanistan,Portugal,21,30,0,51
19974,2020,Albania,Portugal,0,5,0,5
19975,2020,Algeria,Portugal,0,9,0,9
19976,2020,Angola,Portugal,0,224,0,224
19977,2020,Egypt,Portugal,0,18,0,18
19978,2020,Armenia,Portugal,5,0,0,5
19979,2020,Benin,Portugal,0,5,0,5
19980,2020,Bangladesh,Portugal,5,7,0,12
19981,2020,Belarus,Portugal,16,0,0,16
19982,2020,Brazil,Portugal,0,13,0,13
19983,2020,Bosnia and Herzegovina,Portugal,10,0,0,10
19984,2020,Central African Rep.,Portugal,8,0,0,8
19985,2020,Cameroon,Portugal,13,30,0,43
19986,2020,Congo,Portugal,10,8,0,18
19987,2020,Dem. Rep. of the Congo,Portugal,52,44,0,96
19988,2020,Comoros,Portugal,0,5,0,5
19989,2020,Colombia,Portugal,33,14,0,47
19990,2020,Cuba,Portugal,5,7,0,12
19991,2020,Eritrea,Portugal,191,0,0,191
19992,2020,Ethiopia,Portugal,9,0,0,9
19993,2020,Gambia,Portugal,5,75,0,80
19994,2020,Palestinian,Portugal,5,5,0,10
19995,2020,Georgia,Portugal,0,5,0,5
19996,2020,Ghana,Portugal,0,23,0,23
19997,2020,Guinea-Bissau,Portugal,9,93,0,102
19998,2020,Guinea,Portugal,91,65,0,156
19999,2020,Cote d'Ivoire,Portugal,32,15,0,47
20000,2020,Iran (Islamic Rep. of),Portugal,43,27,0,70
20001,2020,Iraq,Portugal,187,0,0,187
20002,2020,Jordan,Portugal,0,13,0,13
20003,2020,Kenya,Portugal,6,0,0,6
20004,2020,Libya,Portugal,15,0,0,15
20005,2020,Sri Lanka,Portugal,31,5,0,36
20006,2020,Mauritania,Portugal,0,5,0,5
20007,2020,Mali,Portugal,14,31,0,45
20008,2020,Morocco,Portugal,9,52,0,61
20009,2020,Mauritius,Portugal,0,5,0,5
20010,2020,Nigeria,Portugal,23,59,0,82
20011,2020,Pakistan,Portugal,82,9,0,91
20012,2020,Russian Federation,Portugal,23,5,0,28
20013,2020,Senegal,Portugal,5,44,0,49
20014,2020,Sierra Leone,Portugal,25,23,0,48
20015,2020,Somalia,Portugal,34,0,0,34
20016,2020,Sudan,Portugal,52,15,0,67
20017,2020,South Sudan,Portugal,30,0,0,30
20018,2020,Syrian Arab Rep.,Portugal,789,0,0,789
20019,2020,Togo,Portugal,6,13,0,19
20020,2020,Türkiye,Portugal,23,0,0,23
20021,2020,Uganda,Portugal,5,0,0,5
20022,2020,Ukraine,Portugal,443,59,0,502
20023,2020,United States of America,Portugal,0,5,0,5
20024,2020,Venezuela (Bolivarian Republic of),Portugal,0,76,0,76
20025,2020,Yemen,Portugal,9,0,0,9
20028,2020,Egypt,Qatar,13,21,0,34
20029,2020,Eritrea,Qatar,0,5,0,5
20030,2020,Palestinian,Qatar,0,7,0,7
20031,2020,Iraq,Qatar,141,89,0,230
20032,2020,Martinique,Qatar,0,5,0,5
20033,2020,Somalia,Qatar,8,5,0,13
20034,2020,Sudan,Qatar,0,13,0,13
20035,2020,Syrian Arab Rep.,Qatar,34,89,0,123
20036,2020,Yemen,Qatar,5,9,0,14
20038,2020,Afghanistan,Romania,170,1484,0,1654
20039,2020,Algeria,Romania,0,12,0,12
20040,2020,Angola,Romania,5,0,0,5
20041,2020,Egypt,Romania,17,10,0,27
20042,2020,Burundi,Romania,8,0,0,8
20043,2020,Bangladesh,Romania,7,43,0,50
20044,2020,Central African Rep.,Romania,5,0,0,5
20045,2020,China,Romania,5,0,0,5
20046,2020,Cameroon,Romania,21,21,0,42
20047,2020,Congo,Romania,7,0,0,7
20048,2020,Dem. Rep. of the Congo,Romania,15,0,0,15
20049,2020,Comoros,Romania,5,0,0,5
20050,2020,Cuba,Romania,0,6,0,6
20051,2020,Eritrea,Romania,42,16,0,58
20052,2020,Ethiopia,Romania,6,5,0,11
20053,2020,Gambia,Romania,5,0,0,5
20054,2020,Palestinian,Romania,55,8,0,63
20055,2020,Ghana,Romania,0,5,0,5
20056,2020,Guinea,Romania,11,0,0,11
20057,2020,Haiti,Romania,0,6,0,6
20058,2020,India,Romania,0,5,0,5
20059,2020,Iran (Islamic Rep. of),Romania,121,12,0,133
20060,2020,Iraq,Romania,594,170,0,764
20061,2020,Jordan,Romania,6,0,0,6
20062,2020,Kuwait,Romania,0,5,0,5
20063,2020,Libya,Romania,5,8,0,13
20064,2020,Lebanon,Romania,5,0,0,5
20065,2020,Sri Lanka,Romania,0,10,0,10
20066,2020,Morocco,Romania,0,20,0,20
20067,2020,Myanmar,Romania,24,0,0,24
20068,2020,Nigeria,Romania,8,6,0,14
20069,2020,Pakistan,Romania,37,91,0,128
20070,2020,Rwanda,Romania,7,5,0,12
20071,2020,Sierra Leone,Romania,5,0,0,5
20072,2020,Somalia,Romania,147,23,0,170
20073,2020,Sudan,Romania,16,6,0,22
20074,2020,Syrian Arab Rep.,Romania,2002,215,0,2217
20075,2020,Tunisia,Romania,5,5,0,10
20076,2020,Türkiye,Romania,51,40,0,91
20077,2020,Uganda,Romania,5,0,0,5
20078,2020,Ukraine,Romania,20,5,0,25
20079,2020,Yemen,Romania,41,0,0,41
20080,2020,Zimbabwe,Romania,6,0,0,6
20082,2020,Afghanistan,South Africa,5,20,0,25
20083,2020,Algeria,South Africa,5,198,0,203
20084,2020,Angola,South Africa,24,12,0,36
20085,2020,Egypt,South Africa,7,240,0,247
20086,2020,Bahrain,South Africa,0,10,0,10
20087,2020,Burundi,South Africa,2636,6927,0,9563
20088,2020,Benin,South Africa,5,36,0,41
20089,2020,Bangladesh,South Africa,202,25482,0,25684
20090,2020,Bahamas,South Africa,0,14,0,14
20091,2020,Burkina Faso,South Africa,0,43,0,43
20092,2020,Bulgaria,South Africa,5,0,0,5
20093,2020,Central African Rep.,South Africa,9,5,0,14
20094,2020,Chad,South Africa,5,5,0,10
20095,2020,China,South Africa,0,70,0,70
20096,2020,Cameroon,South Africa,326,1814,0,2140
20097,2020,Congo,South Africa,4463,7878,0,12341
20098,2020,Dem. Rep. of the Congo,South Africa,22816,34779,0,57595
20099,2020,Comoros,South Africa,0,14,0,14
20100,2020,Eritrea,South Africa,1469,1058,0,2527
20101,2020,Estonia,South Africa,5,7,0,12
20102,2020,Ethiopia,South Africa,15629,48099,0,63728
20103,2020,Gabon,South Africa,0,12,0,12
20104,2020,Gambia,South Africa,0,10,0,10
20105,2020,Palestinian,South Africa,37,11,0,48
20106,2020,Ghana,South Africa,7,1464,0,1471
20107,2020,Guinea-Bissau,South Africa,0,9,0,9
20108,2020,Guinea,South Africa,0,54,0,54
20109,2020,Cote d'Ivoire,South Africa,27,171,0,198
20110,2020,India,South Africa,5,4112,0,4117
20111,2020,Iraq,South Africa,14,6,0,20
20112,2020,Jordan,South Africa,5,5,0,10
20113,2020,Kenya,South Africa,140,966,0,1106
20114,2020,Liberia,South Africa,47,55,0,102
20115,2020,Lesotho,South Africa,0,20,0,20
20116,2020,Sri Lanka,South Africa,10,18,0,28
20117,2020,Mali,South Africa,5,123,0,128
20118,2020,Malawi,South Africa,8,1611,0,1619
20119,2020,Morocco,South Africa,5,11,0,16
20120,2020,Mozambique,South Africa,0,290,0,290
20121,2020,Nepal,South Africa,0,96,0,96
20122,2020,Niger,South Africa,0,700,0,700
20123,2020,Nigeria,South Africa,11,5519,0,5530
20124,2020,Pakistan,South Africa,10,8858,0,8868
20125,2020,Russian Federation,South Africa,10,0,0,10
20126,2020,Rwanda,South Africa,1016,1056,0,2072
20127,2020,Senegal,South Africa,5,833,0,838
20128,2020,Sierra Leone,South Africa,19,13,0,32
20129,2020,Solomon Islands,South Africa,7,0,0,7
20130,2020,Somalia,South Africa,23054,4736,0,27790
20131,2020,Sudan,South Africa,93,60,0,153
20132,2020,Eswatini,South Africa,7,18,0,25
20133,2020,Syrian Arab Rep.,South Africa,38,20,0,58
20134,2020,United Rep. of Tanzania,South Africa,33,519,0,552
20135,2020,Thailand,South Africa,0,52,0,52
20136,2020,Timor-Leste,South Africa,0,7,0,7
20137,2020,Togo,South Africa,12,30,0,42
20138,2020,Türkiye,South Africa,5,10,0,15
20139,2020,Uganda,South Africa,459,4061,0,4520
20140,2020,Ukraine,South Africa,5,0,0,5
20141,2020,Yemen,South Africa,5,10,0,15
20142,2020,Zambia,South Africa,60,209,0,269
20143,2020,Zimbabwe,South Africa,3954,10995,0,14949
20145,2020,Afghanistan,Russian Federation,770,174,0,944
20146,2020,Egypt,Russian Federation,5,0,0,5
20147,2020,Armenia,Russian Federation,6,6,0,12
20148,2020,Azerbaijan,Russian Federation,20,7,0,27
20149,2020,Belgium,Russian Federation,0,17,0,17
20150,2020,Bangladesh,Russian Federation,5,0,0,5
20151,2020,China,Russian Federation,19,295,0,314
20152,2020,Cameroon,Russian Federation,5,5,0,10
20153,2020,Congo,Russian Federation,5,0,0,5
20154,2020,Dem. Rep. of the Congo,Russian Federation,7,5,0,12
20155,2020,Cuba,Russian Federation,5,0,0,5
20156,2020,Estonia,Russian Federation,5,0,0,5
20157,2020,Palestinian,Russian Federation,5,0,0,5
20158,2020,Georgia,Russian Federation,142,5,0,147
20159,2020,Germany,Russian Federation,15,0,0,15
20160,2020,Cote d'Ivoire,Russian Federation,5,0,0,5
20161,2020,Iran (Islamic Rep. of),Russian Federation,5,5,0,10
20162,2020,Iraq,Russian Federation,16,0,0,16
20163,2020,Kazakhstan,Russian Federation,12,10,0,22
20164,2020,Kyrgyzstan,Russian Federation,29,5,0,34
20165,2020,Rep. of Korea,Russian Federation,5,0,0,5
20166,2020,Dem. People's Rep. of Korea,Russian Federation,53,5,0,58
20167,2020,Lebanon,Russian Federation,6,0,0,6
20168,2020,Latvia,Russian Federation,7,0,0,7
20169,2020,Rep. of Moldova,Russian Federation,29,5,0,34
20170,2020,Nigeria,Russian Federation,0,5,0,5
20171,2020,Pakistan,Russian Federation,5,0,0,5
20172,2020,Philippines,Russian Federation,5,0,0,5
20173,2020,Sudan,Russian Federation,5,0,0,5
20174,2020,South Sudan,Russian Federation,5,0,0,5
20175,2020,Syrian Arab Rep.,Russian Federation,361,54,0,415
20176,2020,Tajikistan,Russian Federation,42,14,0,56
20177,2020,Turkmenistan,Russian Federation,24,5,0,29
20178,2020,Türkiye,Russian Federation,5,0,0,5
20179,2020,Ukraine,Russian Federation,18428,148,0,18576
20180,2020,United States of America,Russian Federation,5,0,0,5
20181,2020,Uzbekistan,Russian Federation,75,16,0,91
20182,2020,Yemen,Russian Federation,88,11,0,99
20185,2020,Angola,Rwanda,9,0,0,9
20186,2020,Burundi,Rwanda,65037,64,0,65101
20187,2020,Chad,Rwanda,5,0,0,5
20188,2020,Cameroon,Rwanda,0,7,0,7
20189,2020,Dem. Rep. of the Congo,Rwanda,74303,188,0,74491
20190,2020,Eritrea,Rwanda,80,97,0,177
20191,2020,Ethiopia,Rwanda,8,0,0,8
20192,2020,Rwanda,Rwanda,0,0,0,0
20193,2020,Somalia,Rwanda,32,15,0,47
20194,2020,Sudan,Rwanda,11,89,0,100
20195,2020,South Sudan,Rwanda,6,5,0,11
20196,2020,Colombia,El Salvador,5,7,0,12
20197,2020,Guatemala,El Salvador,0,5,0,5
20198,2020,Honduras,El Salvador,19,12,0,31
20199,2020,Iraq,El Salvador,5,0,0,5
20200,2020,Mexico,El Salvador,5,0,0,5
20201,2020,Nicaragua,El Salvador,9,13,0,22
20202,2020,El Salvador,El Salvador,0,0,71500,0
20203,2020,Syrian Arab Rep.,El Salvador,5,0,0,5
20204,2020,Venezuela (Bolivarian Republic of),El Salvador,0,16,0,16
20205,2020,Afghanistan,Saudi Arabia,0,61,0,61
20206,2020,Egypt,Saudi Arabia,0,16,0,16
20207,2020,Burkina Faso,Saudi Arabia,0,11,0,11
20208,2020,Chad,Saudi Arabia,9,70,0,79
20209,2020,China,Saudi Arabia,14,23,0,37
20210,2020,Eritrea,Saudi Arabia,36,122,0,158
20211,2020,Palestinian,Saudi Arabia,8,326,0,334
20212,2020,Iraq,Saudi Arabia,32,191,0,223
20213,2020,Jordan,Saudi Arabia,0,8,0,8
20214,2020,Liberia,Saudi Arabia,9,0,0,9
20215,2020,Libya,Saudi Arabia,0,8,0,8
20216,2020,Lebanon,Saudi Arabia,0,13,0,13
20217,2020,Mali,Saudi Arabia,0,5,0,5
20218,2020,Myanmar,Saudi Arabia,0,87,0,87
20219,2020,Nigeria,Saudi Arabia,0,5,0,5
20220,2020,Oman,Saudi Arabia,0,5,0,5
20221,2020,Pakistan,Saudi Arabia,0,21,0,21
20222,2020,Somalia,Saudi Arabia,16,50,0,66
20223,2020,Sudan,Saudi Arabia,0,74,0,74
20224,2020,South Sudan,Saudi Arabia,0,7,0,7
20225,2020,Syrian Arab Rep.,Saudi Arabia,173,7671,0,7844
20226,2020,Tunisia,Saudi Arabia,7,0,0,7
20227,2020,Yemen,Saudi Arabia,26,635,0,661
20230,2020,Afghanistan,Serbia and Kosovo: S/RES/1244 (1999),27,5,0,32
20231,2020,Algeria,Serbia and Kosovo: S/RES/1244 (1999),0,20,0,20
20232,2020,Burundi,Serbia and Kosovo: S/RES/1244 (1999),5,17,0,22
20233,2020,Bangladesh,Serbia and Kosovo: S/RES/1244 (1999),0,0,0,0
20234,2020,Bosnia and Herzegovina,Serbia and Kosovo: S/RES/1244 (1999),8124,0,0,8124
20235,2020,China,Serbia and Kosovo: S/RES/1244 (1999),0,5,0,5
20236,2020,Congo,Serbia and Kosovo: S/RES/1244 (1999),0,6,0,6
20237,2020,Cuba,Serbia and Kosovo: S/RES/1244 (1999),7,0,0,7
20238,2020,Ethiopia,Serbia and Kosovo: S/RES/1244 (1999),5,0,0,5
20239,2020,Palestinian,Serbia and Kosovo: S/RES/1244 (1999),0,20,0,20
20240,2020,Ghana,Serbia and Kosovo: S/RES/1244 (1999),0,7,0,7
20241,2020,Croatia,Serbia and Kosovo: S/RES/1244 (1999),17675,0,0,17675
20242,2020,Iran (Islamic Rep. of),Serbia and Kosovo: S/RES/1244 (1999),18,31,0,49
20243,2020,Iraq,Serbia and Kosovo: S/RES/1244 (1999),13,21,0,34
20244,2020,Jordan,Serbia and Kosovo: S/RES/1244 (1999),0,7,0,7
20245,2020,Libya,Serbia and Kosovo: S/RES/1244 (1999),45,29,0,74
20246,2020,Lebanon,Serbia and Kosovo: S/RES/1244 (1999),0,5,0,5
20247,2020,North Macedonia,Serbia and Kosovo: S/RES/1244 (1999),0,0,0,0
20248,2020,Morocco,Serbia and Kosovo: S/RES/1244 (1999),0,29,0,29
20249,2020,Nigeria,Serbia and Kosovo: S/RES/1244 (1999),0,9,0,9
20250,2020,Pakistan,Serbia and Kosovo: S/RES/1244 (1999),5,0,0,5
20251,2020,Russian Federation,Serbia and Kosovo: S/RES/1244 (1999),5,5,0,10
20252,2020,Serbia and Kosovo: S/RES/1244 (1999),Serbia and Kosovo: S/RES/1244 (1999),0,0,213018,0
20253,2020,Somalia,Serbia and Kosovo: S/RES/1244 (1999),6,18,0,24
20254,2020,Sudan,Serbia and Kosovo: S/RES/1244 (1999),5,0,0,5
20255,2020,Syrian Arab Rep.,Serbia and Kosovo: S/RES/1244 (1999),31,40,0,71
20256,2020,Türkiye,Serbia and Kosovo: S/RES/1244 (1999),99,23,0,122
20257,2020,Ukraine,Serbia and Kosovo: S/RES/1244 (1999),15,0,0,15
20260,2020,Burundi,Senegal,8,8,0,16
20261,2020,Benin,Senegal,0,5,0,5
20262,2020,Burkina Faso,Senegal,0,5,0,5
20263,2020,Central African Rep.,Senegal,155,468,0,623
20264,2020,Chad,Senegal,5,23,0,28
20265,2020,Cameroon,Senegal,0,27,0,27
20266,2020,Congo,Senegal,0,91,0,91
20267,2020,Dem. Rep. of the Congo,Senegal,11,190,0,201
20268,2020,Eritrea,Senegal,0,14,0,14
20269,2020,Gambia,Senegal,19,354,0,373
20270,2020,Ghana,Senegal,0,5,0,5
20271,2020,Guinea-Bissau,Senegal,0,5,0,5
20272,2020,Guinea,Senegal,0,115,0,115
20273,2020,Haiti,Senegal,0,5,0,5
20274,2020,Cote d'Ivoire,Senegal,25,163,0,188
20275,2020,Liberia,Senegal,0,66,0,66
20276,2020,Sri Lanka,Senegal,0,6,0,6
20277,2020,Mauritania,Senegal,14115,72,0,14187
20278,2020,Mali,Senegal,0,69,0,69
20279,2020,Nigeria,Senegal,0,61,0,61
20280,2020,Pakistan,Senegal,0,12,0,12
20281,2020,Rwanda,Senegal,13,7,0,20
20282,2020,Sierra Leone,Senegal,0,40,0,40
20283,2020,Sudan,Senegal,5,8,0,13
20284,2020,Syrian Arab Rep.,Senegal,0,14,0,14
20285,2020,Togo,Senegal,0,31,0,31
20286,2020,Türkiye,Senegal,5,49,0,54
20288,2020,Cote d'Ivoire,Sierra Leone,10,0,0,10
20289,2020,Liberia,Sierra Leone,332,0,0,332
20290,2020,Bangladesh,Somalia,6,0,0,6
20291,2020,Cameroon,Somalia,5,0,0,5
20292,2020,Djibouti,Somalia,0,6,0,6
20293,2020,Eritrea,Somalia,51,37,0,88
20294,2020,Ethiopia,Somalia,4177,13022,0,17199
20295,2020,Palestinian,Somalia,7,0,0,7
20296,2020,Mozambique,Somalia,0,5,0,5
20297,2020,Somalia,Somalia,0,0,2967500,0
20298,2020,Sudan,Somalia,0,7,0,7
20299,2020,Syrian Arab Rep.,Somalia,603,15,0,618
20300,2020,United Rep. of Tanzania,Somalia,0,118,0,118
20301,2020,Yemen,Somalia,6371,19,0,6390
20302,2020,Afghanistan,Spain,468,185,0,653
20303,2020,Albania,Spain,0,130,0,130
20304,2020,Algeria,Spain,65,1280,0,1345
20305,2020,Angola,Spain,26,60,0,86
20306,2020,Egypt,Spain,71,100,0,171
20307,2020,Argentina,Spain,17,445,0,462
20308,2020,Armenia,Spain,37,305,0,342
20309,2020,Azerbaijan,Spain,50,65,0,115
20310,2020,Burundi,Spain,6,0,0,6
20311,2020,Benin,Spain,5,20,0,25
20312,2020,Bangladesh,Spain,20,205,0,225
20313,2020,Burkina Faso,Spain,0,115,0,115
20314,2020,Belarus,Spain,12,105,0,117
20315,2020,Bolivia (Plurinational State of),Spain,9,170,0,179
20316,2020,Brazil,Spain,39,975,0,1014
20317,2020,Canada,Spain,0,10,0,10
20318,2020,Central African Rep.,Spain,111,40,0,151
20319,2020,Chad,Spain,7,10,0,17
20320,2020,China,Spain,27,980,0,1007
20321,2020,Chile,Spain,13,240,0,253
20322,2020,Cameroon,Spain,110,850,0,960
20323,2020,Congo,Spain,49,45,0,94
20324,2020,Dem. Rep. of the Congo,Spain,77,125,0,202
20325,2020,Colombia,Spain,985,23735,0,24720
20326,2020,Costa Rica,Spain,5,65,0,70
20327,2020,Cuba,Spain,660,2845,0,3505
20328,2020,Djibouti,Spain,0,5,0,5
20329,2020,Dominican Rep.,Spain,11,200,0,211
20330,2020,Ecuador,Spain,6,415,0,421
20331,2020,Equatorial Guinea,Spain,30,80,0,110
20332,2020,Eritrea,Spain,296,60,0,356
20333,2020,Ethiopia,Spain,53,25,0,78
20334,2020,Gabon,Spain,0,10,0,10
20335,2020,Gambia,Spain,45,415,0,460
20336,2020,Palestinian,Spain,1295,540,0,1835
20337,2020,United Kingdom of Great Britain and Northern Ireland,Spain,0,5,0,5
20338,2020,Georgia,Spain,25,2545,0,2570
20339,2020,Ghana,Spain,5,280,0,285
20340,2020,Guinea-Bissau,Spain,5,90,0,95
20341,2020,Guatemala,Spain,77,620,0,697
20342,2020,Guinea,Spain,83,1495,0,1578
20343,2020,Haiti,Spain,10,50,0,60
20344,2020,Honduras,Spain,974,8685,0,9659
20345,2020,Cote d'Ivoire,Spain,357,470,0,827
20346,2020,India,Spain,6,60,0,66
20347,2020,Iran (Islamic Rep. of),Spain,87,205,0,292
20348,2020,Iraq,Spain,295,220,0,515
20349,2020,Israel,Spain,0,15,0,15
20350,2020,Jamaica,Spain,58,5,0,63
20351,2020,Jordan,Spain,30,30,0,60
20352,2020,Kazakhstan,Spain,18,45,0,63
20353,2020,Kenya,Spain,0,20,0,20
20354,2020,Kyrgyzstan,Spain,10,25,0,35
20355,2020,Kuwait,Spain,0,5,0,5
20356,2020,Liberia,Spain,7,40,0,47
20357,2020,Libya,Spain,133,55,0,188
20358,2020,Lebanon,Spain,28,95,0,123
20359,2020,Sri Lanka,Spain,75,20,0,95
20360,2020,Mauritania,Spain,18,75,0,93
20361,2020,North Macedonia,Spain,0,20,0,20
20362,2020,Rep. of Moldova,Spain,0,60,0,60
20363,2020,Mexico,Spain,16,265,0,281
20364,2020,Mali,Spain,334,2755,0,3089
20365,2020,Mongolia,Spain,5,15,0,20
20366,2020,Morocco,Spain,544,2105,0,2649
20367,2020,Myanmar,Spain,9,0,0,9
20368,2020,Nepal,Spain,0,10,0,10
20369,2020,Niger,Spain,0,25,0,25
20370,2020,Nicaragua,Spain,1303,5640,0,6943
20371,2020,Nigeria,Spain,122,1345,0,1467
20372,2020,Oman,Spain,0,5,0,5
20373,2020,Pakistan,Spain,407,1100,0,1507
20374,2020,Panama,Spain,12,95,0,107
20375,2020,Paraguay,Spain,54,545,0,599
20376,2020,Peru,Spain,139,5040,0,5179
20377,2020,Philippines,Spain,0,5,0,5
20378,2020,South Africa,Spain,5,5,0,10
20379,2020,Russian Federation,Spain,356,1855,0,2211
20380,2020,Rwanda,Spain,0,5,0,5
20381,2020,El Salvador,Spain,698,4370,0,5068
20382,2020,Saudi Arabia,Spain,5,5,0,10
20383,2020,Serbia and Kosovo: S/RES/1244 (1999),Spain,5,30,0,35
20384,2020,Senegal,Spain,26,1275,0,1301
20385,2020,Sierra Leone,Spain,11,120,0,131
20386,2020,Somalia,Spain,719,175,0,894
20387,2020,Viet Nam,Spain,0,65,0,65
20388,2020,Sudan,Spain,161,40,0,201
20389,2020,South Sudan,Spain,5,5,0,10
20390,2020,Syrian Arab Rep.,Spain,14660,1545,0,16205
20391,2020,United Rep. of Tanzania,Spain,0,5,0,5
20392,2020,Tajikistan,Spain,5,15,0,20
20393,2020,Togo,Spain,8,45,0,53
20394,2020,Trinidad and Tobago,Spain,5,0,0,5
20395,2020,Tunisia,Spain,29,255,0,284
20396,2020,Türkiye,Spain,109,345,0,454
20397,2020,Uganda,Spain,6,5,0,11
20398,2020,Ukraine,Spain,922,4290,0,5212
20399,2020,Uruguay,Spain,0,230,0,230
20400,2020,United States of America,Spain,11,100,0,111
20401,2020,Uzbekistan,Spain,10,20,0,30
20402,2020,Venezuela (Bolivarian Republic of),Spain,75640,19065,0,94705
20403,2020,Western Sahara,Spain,24,20,0,44
20404,2020,Yemen,Spain,316,410,0,726
20405,2020,Zimbabwe,Spain,0,5,0,5
20410,2020,Venezuela (Bolivarian Republic of),Saint Kitts and Nevis,0,0,0,0
20411,2020,Afghanistan,Sudan,0,0,0,0
20412,2020,Egypt,Sudan,17,11,0,28
20413,2020,Argentina,Sudan,0,0,0,0
20414,2020,Burundi,Sudan,17,12,0,29
20415,2020,Central African Rep.,Sudan,26928,0,0,26928
20416,2020,Chad,Sudan,3502,5,0,3507
20417,2020,Cameroon,Sudan,7,0,0,7
20418,2020,Congo,Sudan,11,5,0,16
20419,2020,Dem. Rep. of the Congo,Sudan,309,428,0,737
20420,2020,Eritrea,Sudan,114867,7598,0,122465
20421,2020,Ethiopia,Sudan,62498,7353,0,69851
20422,2020,Palestinian,Sudan,0,0,0,0
20423,2020,Iraq,Sudan,9,13,0,22
20424,2020,Jordan,Sudan,0,0,0,0
20425,2020,Kuwait,Sudan,0,0,0,0
20426,2020,Nigeria,Sudan,12,0,0,12
20427,2020,Somalia,Sudan,312,176,0,488
20428,2020,Sudan,Sudan,0,0,2552174,0
20429,2020,South Sudan,Sudan,736685,0,0,736685
20430,2020,Syrian Arab Rep.,Sudan,93498,0,0,93498
20431,2020,Türkiye,Sudan,5,0,0,5
20432,2020,Uganda,Sudan,5,0,0,5
20433,2020,Yemen,Sudan,1551,386,0,1937
20435,2020,Colombia,Suriname,0,5,0,5
20436,2020,Cuba,Suriname,7,1703,0,1710
20437,2020,Dominican Rep.,Suriname,0,8,0,8
20438,2020,Nigeria,Suriname,0,5,0,5
20439,2020,Venezuela (Bolivarian Republic of),Suriname,12,267,0,279
20440,2020,Burundi,South Sudan,103,847,0,950
20441,2020,Central African Rep.,South Sudan,2135,0,0,2135
20442,2020,Cameroon,South Sudan,0,5,0,5
20443,2020,Dem. Rep. of the Congo,South Sudan,16498,7,0,16505
20444,2020,Eritrea,South Sudan,259,2486,0,2745
20445,2020,Ethiopia,South Sudan,4194,374,0,4568
20446,2020,Somalia,South Sudan,0,30,0,30
20447,2020,Sudan,South Sudan,291249,14,0,291263
20448,2020,South Sudan,South Sudan,0,0,1600254,0
20450,2020,Afghanistan,Slovakia,298,0,0,298
20451,2020,Algeria,Slovakia,0,6,0,6
20452,2020,Angola,Slovakia,24,0,0,24
20453,2020,Egypt,Slovakia,5,5,0,10
20454,2020,Armenia,Slovakia,34,0,0,34
20455,2020,Burundi,Slovakia,5,0,0,5
20456,2020,Bangladesh,Slovakia,0,5,0,5
20457,2020,Bosnia and Herzegovina,Slovakia,36,0,0,36
20458,2020,Bulgaria,Slovakia,8,0,0,8
20459,2020,Cambodia,Slovakia,5,0,0,5
20460,2020,China,Slovakia,5,0,0,5
20461,2020,Cameroon,Slovakia,9,0,0,9
20462,2020,Dem. Rep. of the Congo,Slovakia,16,0,0,16
20463,2020,Cuba,Slovakia,32,0,0,32
20464,2020,Palestinian,Slovakia,7,0,0,7
20465,2020,Iran (Islamic Rep. of),Slovakia,31,0,0,31
20466,2020,Iraq,Slovakia,214,0,0,214
20467,2020,Liberia,Slovakia,5,0,0,5
20468,2020,Libya,Slovakia,6,0,0,6
20469,2020,Morocco,Slovakia,0,10,0,10
20470,2020,Pakistan,Slovakia,7,0,0,7
20471,2020,Romania,Slovakia,37,0,0,37
20472,2020,Russian Federation,Slovakia,38,0,0,38
20473,2020,Serbia and Kosovo: S/RES/1244 (1999),Slovakia,46,0,0,46
20474,2020,Somalia,Slovakia,32,0,0,32
20475,2020,Viet Nam,Slovakia,16,0,0,16
20476,2020,Syrian Arab Rep.,Slovakia,21,5,0,26
20477,2020,Türkiye,Slovakia,5,13,0,18
20478,2020,Uganda,Slovakia,5,0,0,5
20479,2020,Ukraine,Slovakia,24,0,0,24
20480,2020,Uzbekistan,Slovakia,5,0,0,5
20481,2020,Yemen,Slovakia,21,0,0,21
20483,2020,Afghanistan,Slovenia,56,155,0,211
20484,2020,Algeria,Slovenia,0,5,0,5
20485,2020,Azerbaijan,Slovenia,0,5,0,5
20486,2020,Bangladesh,Slovenia,0,5,0,5
20487,2020,Bosnia and Herzegovina,Slovenia,6,0,0,6
20488,2020,Cameroon,Slovenia,5,0,0,5
20489,2020,Dem. Rep. of the Congo,Slovenia,6,5,0,11
20490,2020,Eritrea,Slovenia,86,0,0,86
20491,2020,Palestinian,Slovenia,25,5,0,30
20492,2020,Iran (Islamic Rep. of),Slovenia,77,28,0,105
20493,2020,Iraq,Slovenia,53,6,0,59
20494,2020,Kazakhstan,Slovenia,20,0,0,20
20495,2020,Libya,Slovenia,0,5,0,5
20496,2020,Morocco,Slovenia,0,8,0,8
20497,2020,Nigeria,Slovenia,6,0,0,6
20498,2020,Pakistan,Slovenia,5,18,0,23
20499,2020,Russian Federation,Slovenia,21,5,0,26
20500,2020,Serbia and Kosovo: S/RES/1244 (1999),Slovenia,10,6,0,16
20501,2020,Somalia,Slovenia,50,0,0,50
20502,2020,Sudan,Slovenia,6,0,0,6
20503,2020,Syrian Arab Rep.,Slovenia,322,16,0,338
20504,2020,Türkiye,Slovenia,58,5,0,63
20505,2020,Ukraine,Slovenia,5,0,0,5
20506,2020,Yemen,Slovenia,6,0,0,6
20509,2020,Angola,Eswatini,13,0,0,13
20510,2020,Burundi,Eswatini,184,148,0,332
20511,2020,Cameroon,Eswatini,0,8,0,8
20512,2020,Congo,Eswatini,23,108,0,131
20513,2020,Dem. Rep. of the Congo,Eswatini,399,316,0,715
20514,2020,Eritrea,Eswatini,0,5,0,5
20515,2020,Ethiopia,Eswatini,11,82,0,93
20516,2020,Guinea,Eswatini,5,0,0,5
20517,2020,Cote d'Ivoire,Eswatini,0,5,0,5
20518,2020,Kenya,Eswatini,5,0,0,5
20519,2020,Sri Lanka,Eswatini,5,0,0,5
20520,2020,Rwanda,Eswatini,185,104,0,289
20521,2020,Somalia,Eswatini,101,318,0,419
20522,2020,United Rep. of Tanzania,Eswatini,0,5,0,5
20523,2020,Uganda,Eswatini,6,0,0,6
20524,2020,Zimbabwe,Eswatini,8,5,0,13
20525,2020,Afghanistan,Sweden,29927,1358,0,31285
20526,2020,Albania,Sweden,310,206,0,516
20527,2020,Algeria,Sweden,61,62,0,123
20528,2020,Angola,Sweden,23,35,0,58
20529,2020,Egypt,Sweden,409,295,0,704
20530,2020,Armenia,Sweden,340,133,0,473
20531,2020,Azerbaijan,Sweden,624,293,0,917
20532,2020,Bahrain,Sweden,17,5,0,22
20533,2020,Burundi,Sweden,215,71,0,286
20534,2020,Benin,Sweden,10,0,0,10
20535,2020,Bangladesh,Sweden,241,273,0,514
20536,2020,Burkina Faso,Sweden,5,0,0,5
20537,2020,Belarus,Sweden,105,92,0,197
20538,2020,Bolivia (Plurinational State of),Sweden,56,6,0,62
20539,2020,Brazil,Sweden,8,22,0,30
20540,2020,Bosnia and Herzegovina,Sweden,77,86,0,163
20541,2020,Bulgaria,Sweden,16,0,0,16
20542,2020,Central African Rep.,Sweden,71,0,0,71
20543,2020,Chad,Sweden,19,0,0,19
20544,2020,China,Sweden,276,46,0,322
20545,2020,Chile,Sweden,12,28,0,40
20546,2020,Cameroon,Sweden,210,195,0,405
20547,2020,Congo,Sweden,36,20,0,56
20548,2020,Dem. Rep. of the Congo,Sweden,861,99,0,960
20549,2020,Comoros,Sweden,5,0,0,5
20550,2020,Colombia,Sweden,40,101,0,141
20551,2020,Cuba,Sweden,31,22,0,53
20552,2020,Djibouti,Sweden,31,20,0,51
20553,2020,Ecuador,Sweden,5,5,0,10
20554,2020,Equatorial Guinea,Sweden,5,9,0,14
20555,2020,Eritrea,Sweden,27421,461,0,27882
20556,2020,Ethiopia,Sweden,2532,477,0,3009
20557,2020,France,Sweden,5,0,0,5
20558,2020,Gambia,Sweden,180,105,0,285
20559,2020,Palestinian,Sweden,1256,698,0,1954
20560,2020,United Kingdom of Great Britain and Northern Ireland,Sweden,5,0,0,5
20561,2020,Georgia,Sweden,95,266,0,361
20562,2020,Ghana,Sweden,65,70,0,135
20563,2020,Guinea-Bissau,Sweden,8,5,0,13
20564,2020,Greece,Sweden,18,0,0,18
20565,2020,Guatemala,Sweden,10,7,0,17
20566,2020,Guinea,Sweden,71,21,0,92
20567,2020,Honduras,Sweden,27,12,0,39
20568,2020,Croatia,Sweden,0,5,0,5
20569,2020,Hungary,Sweden,5,0,0,5
20570,2020,Cote d'Ivoire,Sweden,45,13,0,58
20571,2020,India,Sweden,19,58,0,77
20572,2020,Indonesia,Sweden,16,0,0,16
20573,2020,Iran (Islamic Rep. of),Sweden,7507,1757,0,9264
20574,2020,Iraq,Sweden,11635,1430,0,13065
20575,2020,Israel,Sweden,24,10,0,34
20576,2020,Jordan,Sweden,279,185,0,464
20577,2020,Kazakhstan,Sweden,231,159,0,390
20578,2020,Kenya,Sweden,94,54,0,148
20579,2020,Kyrgyzstan,Sweden,177,139,0,316
20580,2020,Rep. of Korea,Sweden,7,6,0,13
20581,2020,Kuwait,Sweden,33,15,0,48
20582,2020,Liberia,Sweden,13,7,0,20
20583,2020,Libya,Sweden,384,65,0,449
20584,2020,Lebanon,Sweden,523,267,0,790
20585,2020,Sri Lanka,Sweden,28,45,0,73
20586,2020,Lithuania,Sweden,0,7,0,7
20587,2020,Mauritania,Sweden,13,0,0,13
20588,2020,North Macedonia,Sweden,44,35,0,79
20589,2020,Rep. of Moldova,Sweden,8,10,0,18
20590,2020,Mali,Sweden,43,5,0,48
20591,2020,Malaysia,Sweden,14,10,0,24
20592,2020,Mongolia,Sweden,260,318,0,578
20593,2020,Morocco,Sweden,259,176,0,435
20594,2020,Mozambique,Sweden,0,6,0,6
20595,2020,Montenegro,Sweden,28,13,0,41
20596,2020,Myanmar,Sweden,9,9,0,18
20597,2020,Nepal,Sweden,11,14,0,25
20598,2020,Niger,Sweden,5,0,0,5
20599,2020,Nicaragua,Sweden,63,72,0,135
20600,2020,Nigeria,Sweden,590,439,0,1029
20601,2020,Pakistan,Sweden,622,342,0,964
20602,2020,Peru,Sweden,9,41,0,50
20603,2020,Philippines,Sweden,6,9,0,15
20604,2020,Poland,Sweden,5,0,0,5
20605,2020,Romania,Sweden,45,0,0,45
20606,2020,South Africa,Sweden,0,7,0,7
20607,2020,Russian Federation,Sweden,1427,415,0,1842
20608,2020,Rwanda,Sweden,55,57,0,112
20609,2020,El Salvador,Sweden,146,74,0,220
20610,2020,Saudi Arabia,Sweden,62,5,0,67
20611,2020,Serbia and Kosovo: S/RES/1244 (1999),Sweden,687,311,0,998
20612,2020,Senegal,Sweden,57,25,0,82
20613,2020,Sierra Leone,Sweden,71,17,0,88
20614,2020,Somalia,Sweden,12784,683,0,13467
20615,2020,Viet Nam,Sweden,34,22,0,56
20616,2020,Sudan,Sweden,1132,142,0,1274
20617,2020,South Sudan,Sweden,63,0,0,63
20618,2020,Slovakia,Sweden,5,5,0,10
20619,2020,Eswatini,Sweden,5,5,0,10
20620,2020,Syrian Arab Rep.,Sweden,114609,1544,0,116153
20621,2020,United Rep. of Tanzania,Sweden,62,67,0,129
20622,2020,Thailand,Sweden,0,8,0,8
20623,2020,Tajikistan,Sweden,65,97,0,162
20624,2020,Turkmenistan,Sweden,13,10,0,23
20625,2020,Togo,Sweden,5,5,0,10
20626,2020,Tunisia,Sweden,51,53,0,104
20627,2020,Türkiye,Sweden,2015,619,0,2634
20628,2020,United Arab Emirates,Sweden,5,0,0,5
20629,2020,Uganda,Sweden,768,142,0,910
20630,2020,Ukraine,Sweden,232,390,0,622
20631,2020,United States of America,Sweden,22,14,0,36
20632,2020,Uzbekistan,Sweden,535,1366,0,1901
20633,2020,Venezuela (Bolivarian Republic of),Sweden,28,94,0,122
20634,2020,Yemen,Sweden,1822,83,0,1905
20635,2020,Zambia,Sweden,13,5,0,18
20636,2020,Zimbabwe,Sweden,18,10,0,28
20639,2020,Afghanistan,Switzerland,14523,844,0,15367
20640,2020,Albania,Switzerland,113,49,0,162
20641,2020,Algeria,Switzerland,178,234,0,412
20642,2020,Angola,Switzerland,721,67,0,788
20643,2020,Egypt,Switzerland,120,17,0,137
20644,2020,Armenia,Switzerland,161,33,0,194
20645,2020,Azerbaijan,Switzerland,190,88,0,278
20646,2020,Burundi,Switzerland,173,7,0,180
20647,2020,Benin,Switzerland,22,0,0,22
20648,2020,Bangladesh,Switzerland,49,6,0,55
20649,2020,Burkina Faso,Switzerland,19,6,0,25
20650,2020,Belarus,Switzerland,54,21,0,75
20651,2020,Brazil,Switzerland,12,5,0,17
20652,2020,Bosnia and Herzegovina,Switzerland,1558,5,0,1563
20653,2020,Bulgaria,Switzerland,6,0,0,6
20654,2020,Cambodia,Switzerland,281,0,0,281
20655,2020,Central African Rep.,Switzerland,19,0,0,19
20656,2020,Chad,Switzerland,39,14,0,53
20657,2020,China,Switzerland,2665,86,0,2751
20658,2020,Chile,Switzerland,10,0,0,10
20659,2020,Cameroon,Switzerland,192,55,0,247
20660,2020,Congo,Switzerland,51,5,0,56
20661,2020,Dem. Rep. of the Congo,Switzerland,1255,82,0,1337
20662,2020,Colombia,Switzerland,275,69,0,344
20663,2020,Cuba,Switzerland,35,10,0,45
20664,2020,Czechia,Switzerland,5,0,0,5
20665,2020,Djibouti,Switzerland,17,0,0,17
20666,2020,Ecuador,Switzerland,5,0,0,5
20667,2020,Equatorial Guinea,Switzerland,5,0,0,5
20668,2020,Eritrea,Switzerland,37816,401,0,38217
20669,2020,Ethiopia,Switzerland,1748,125,0,1873
20670,2020,France,Switzerland,7,0,0,7
20671,2020,Gabon,Switzerland,5,0,0,5
20672,2020,Gambia,Switzerland,54,10,0,64
20673,2020,Georgia,Switzerland,217,122,0,339
20674,2020,Germany,Switzerland,5,0,0,5
20675,2020,Ghana,Switzerland,21,12,0,33
20676,2020,Guinea-Bissau,Switzerland,51,5,0,56
20677,2020,Guatemala,Switzerland,7,0,0,7
20678,2020,Guinea,Switzerland,180,35,0,215
20679,2020,Honduras,Switzerland,5,0,0,5
20680,2020,Croatia,Switzerland,16,0,0,16
20681,2020,Hungary,Switzerland,5,0,0,5
20682,2020,Cote d'Ivoire,Switzerland,194,27,0,221
20683,2020,India,Switzerland,34,6,0,40
20684,2020,Iran (Islamic Rep. of),Switzerland,2089,737,0,2826
20685,2020,Iraq,Switzerland,4635,324,0,4959
20686,2020,Israel,Switzerland,6,0,0,6
20687,2020,Italy,Switzerland,5,0,0,5
20688,2020,Jamaica,Switzerland,7,0,0,7
20689,2020,Jordan,Switzerland,57,0,0,57
20690,2020,Kazakhstan,Switzerland,20,13,0,33
20691,2020,Kenya,Switzerland,43,5,0,48
20692,2020,Kyrgyzstan,Switzerland,18,5,0,23
20693,2020,Lao People's Dem. Rep.,Switzerland,114,0,0,114
20694,2020,Liberia,Switzerland,33,0,0,33
20695,2020,Libya,Switzerland,310,42,0,352
20696,2020,Lebanon,Switzerland,44,23,0,67
20697,2020,Sri Lanka,Switzerland,6016,809,0,6825
20698,2020,Madagascar,Switzerland,6,0,0,6
20699,2020,Mauritania,Switzerland,8,0,0,8
20700,2020,North Macedonia,Switzerland,158,13,0,171
20701,2020,Rep. of Moldova,Switzerland,10,0,0,10
20702,2020,Mali,Switzerland,31,5,0,36
20703,2020,Mongolia,Switzerland,164,18,0,182
20704,2020,Morocco,Switzerland,79,93,0,172
20705,2020,Montenegro,Switzerland,53,0,0,53
20706,2020,Myanmar,Switzerland,30,0,0,30
20707,2020,Nepal,Switzerland,17,8,0,25
20708,2020,Niger,Switzerland,7,0,0,7
20709,2020,Nicaragua,Switzerland,5,15,0,20
20710,2020,Nigeria,Switzerland,278,100,0,378
20711,2020,Pakistan,Switzerland,273,87,0,360
20712,2020,Paraguay,Switzerland,5,0,0,5
20713,2020,Peru,Switzerland,5,0,0,5
20714,2020,Philippines,Switzerland,11,5,0,16
20715,2020,Portugal,Switzerland,5,0,0,5
20716,2020,Romania,Switzerland,17,0,0,17
20717,2020,South Africa,Switzerland,10,0,0,10
20718,2020,Russian Federation,Switzerland,753,65,0,818
20719,2020,Rwanda,Switzerland,110,5,0,115
20720,2020,El Salvador,Switzerland,8,5,0,13
20721,2020,Saudi Arabia,Switzerland,17,0,0,17
20722,2020,Serbia and Kosovo: S/RES/1244 (1999),Switzerland,2263,71,0,2334
20723,2020,Senegal,Switzerland,63,12,0,75
20724,2020,Sierra Leone,Switzerland,36,9,0,45
20725,2020,Somalia,Switzerland,4662,107,0,4769
20726,2020,Spain,Switzerland,5,0,0,5
20727,2020,Viet Nam,Switzerland,791,0,0,791
20728,2020,Sudan,Switzerland,324,27,0,351
20729,2020,South Sudan,Switzerland,19,0,0,19
20730,2020,Syrian Arab Rep.,Switzerland,19869,236,0,20105
20731,2020,United Rep. of Tanzania,Switzerland,14,0,0,14
20732,2020,Tajikistan,Switzerland,22,5,0,27
20733,2020,Turkmenistan,Switzerland,5,0,0,5
20734,2020,Togo,Switzerland,556,21,0,577
20735,2020,Tunisia,Switzerland,185,45,0,230
20736,2020,Türkiye,Switzerland,5447,1024,0,6471
20737,2020,Uganda,Switzerland,51,21,0,72
20738,2020,Ukraine,Switzerland,80,25,0,105
20739,2020,Uzbekistan,Switzerland,60,0,0,60
20740,2020,Venezuela (Bolivarian Republic of),Switzerland,39,23,0,62
20741,2020,Western Sahara,Switzerland,9,5,0,14
20742,2020,Yemen,Switzerland,341,5,0,346
20743,2020,Zimbabwe,Switzerland,12,5,0,17
20746,2020,Afghanistan,Syrian Arab Rep.,1107,40,0,1147
20747,2020,Algeria,Syrian Arab Rep.,5,0,0,5
20748,2020,Egypt,Syrian Arab Rep.,32,10,0,42
20749,2020,Bahrain,Syrian Arab Rep.,0,5,0,5
20750,2020,Chad,Syrian Arab Rep.,9,6,0,15
20751,2020,Eritrea,Syrian Arab Rep.,19,0,0,19
20752,2020,Ethiopia,Syrian Arab Rep.,15,0,0,15
20753,2020,Guinea,Syrian Arab Rep.,54,5,0,59
20754,2020,Iran (Islamic Rep. of),Syrian Arab Rep.,45,12,0,57
20755,2020,Iraq,Syrian Arab Rep.,12399,8383,0,20782
20756,2020,Jordan,Syrian Arab Rep.,19,0,0,19
20757,2020,Libya,Syrian Arab Rep.,11,10,0,21
20758,2020,Lebanon,Syrian Arab Rep.,22,6,0,28
20759,2020,Sri Lanka,Syrian Arab Rep.,0,5,0,5
20760,2020,Morocco,Syrian Arab Rep.,0,5,0,5
20761,2020,Pakistan,Syrian Arab Rep.,214,10,0,224
20762,2020,Saudi Arabia,Syrian Arab Rep.,6,0,0,6
20763,2020,Sierra Leone,Syrian Arab Rep.,19,0,0,19
20764,2020,Somalia,Syrian Arab Rep.,354,40,0,394
20765,2020,Sudan,Syrian Arab Rep.,719,94,0,813
20766,2020,South Sudan,Syrian Arab Rep.,81,0,0,81
20767,2020,Syrian Arab Rep.,Syrian Arab Rep.,0,0,6701972,0
20768,2020,United Rep. of Tanzania,Syrian Arab Rep.,0,7,0,7
20769,2020,Tunisia,Syrian Arab Rep.,5,5,0,10
20770,2020,Türkiye,Syrian Arab Rep.,6,8,0,14
20771,2020,Yemen,Syrian Arab Rep.,158,118,0,276
20774,2020,Burundi,United Rep. of Tanzania,183515,10539,0,194054
20775,2020,Dem. Rep. of the Congo,United Rep. of Tanzania,50860,18075,0,68935
20776,2020,Iran (Islamic Rep. of),United Rep. of Tanzania,0,5,0,5
20777,2020,Lebanon,United Rep. of Tanzania,0,0,0,0
20778,2020,Rwanda,United Rep. of Tanzania,67,33,0,100
20779,2020,Somalia,United Rep. of Tanzania,160,5,0,165
20780,2020,Sudan,United Rep. of Tanzania,0,8,0,8
20781,2020,South Sudan,United Rep. of Tanzania,10,0,0,10
20782,2020,Syrian Arab Rep.,United Rep. of Tanzania,5,17,0,22
20783,2020,United Rep. of Tanzania,United Rep. of Tanzania,5,0,0,5
20784,2020,Türkiye,United Rep. of Tanzania,0,10,0,10
20785,2020,Uganda,United Rep. of Tanzania,14,5,0,19
20786,2020,Yemen,United Rep. of Tanzania,9,51,0,60
20787,2020,Sri Lanka,Turks and Caicos Islands,8,0,0,8
20788,2020,Afghanistan,Thailand,160,18,0,178
20789,2020,Egypt,Thailand,20,0,0,20
20790,2020,Cambodia,Thailand,260,112,0,372
20791,2020,China,Thailand,177,17,0,194
20792,2020,Cameroon,Thailand,46,10,0,56
20793,2020,Dem. Rep. of the Congo,Thailand,18,5,0,23
20794,2020,Ethiopia,Thailand,18,10,0,28
20795,2020,Palestinian,Thailand,290,5,0,295
20796,2020,Guinea,Thailand,0,5,0,5
20797,2020,Cote d'Ivoire,Thailand,18,0,0,18
20798,2020,Iran (Islamic Rep. of),Thailand,76,38,0,114
20799,2020,Iraq,Thailand,168,5,0,173
20800,2020,Jordan,Thailand,5,0,0,5
20801,2020,Lao People's Dem. Rep.,Thailand,8,0,0,8
20802,2020,Sri Lanka,Thailand,119,16,0,135
20803,2020,Myanmar,Thailand,91805,0,0,91805
20804,2020,Nepal,Thailand,5,0,0,5
20805,2020,Nigeria,Thailand,5,0,0,5
20806,2020,Pakistan,Thailand,1662,104,0,1766
20807,2020,Somalia,Thailand,208,11,0,219
20808,2020,Viet Nam,Thailand,834,485,0,1319
20809,2020,Syrian Arab Rep.,Thailand,226,6,0,232
20810,2020,United Rep. of Tanzania,Thailand,5,0,0,5
20811,2020,Yemen,Thailand,37,5,0,42
20812,2020,Zimbabwe,Thailand,9,0,0,9
20814,2020,Afghanistan,Tajikistan,5573,408,0,5981
20815,2020,Iran (Islamic Rep. of),Tajikistan,5,0,0,5
20817,2020,Afghanistan,Turkmenistan,14,0,0,14
20818,2020,Azerbaijan,Turkmenistan,6,0,0,6
20820,2020,Burundi,Togo,5,0,0,5
20821,2020,Benin,Togo,0,11,0,11
20822,2020,Central African Rep.,Togo,242,223,0,465
20823,2020,Chad,Togo,12,12,0,24
20824,2020,Cameroon,Togo,7,14,0,21
20825,2020,Congo,Togo,32,21,0,53
20826,2020,Dem. Rep. of the Congo,Togo,106,89,0,195
20827,2020,Gabon,Togo,0,6,0,6
20828,2020,Ghana,Togo,8513,0,0,8513
20829,2020,Cote d'Ivoire,Togo,1589,202,0,1791
20830,2020,Iraq,Togo,5,0,0,5
20831,2020,Liberia,Togo,0,6,0,6
20832,2020,Lebanon,Togo,5,0,0,5
20833,2020,Sri Lanka,Togo,0,5,0,5
20834,2020,Mali,Togo,78,41,0,119
20835,2020,Nigeria,Togo,9,7,0,16
20836,2020,Rwanda,Togo,116,7,0,123
20837,2020,Syrian Arab Rep.,Togo,16,6,0,22
20838,2020,Türkiye,Togo,63,10,0,73
20839,2020,Bangladesh,Trinidad and Tobago,8,90,0,98
20840,2020,China,Trinidad and Tobago,0,127,0,127
20841,2020,Cameroon,Trinidad and Tobago,0,9,0,9
20842,2020,Colombia,Trinidad and Tobago,12,60,0,72
20843,2020,Cuba,Trinidad and Tobago,171,2348,0,2519
20844,2020,Dominican Rep.,Trinidad and Tobago,0,136,0,136
20845,2020,Ghana,Trinidad and Tobago,0,45,0,45
20846,2020,Grenada,Trinidad and Tobago,0,5,0,5
20847,2020,Guyana,Trinidad and Tobago,19,56,0,75
20848,2020,Haiti,Trinidad and Tobago,0,15,0,15
20849,2020,India,Trinidad and Tobago,0,5,0,5
20850,2020,Jamaica,Trinidad and Tobago,37,124,0,161
20851,2020,Mexico,Trinidad and Tobago,6,0,0,6
20852,2020,Nicaragua,Trinidad and Tobago,0,5,0,5
20853,2020,Nigeria,Trinidad and Tobago,5,158,0,163
20854,2020,Pakistan,Trinidad and Tobago,9,19,0,28
20855,2020,Peru,Trinidad and Tobago,0,5,0,5
20856,2020,Philippines,Trinidad and Tobago,0,5,0,5
20857,2020,Viet Nam,Trinidad and Tobago,0,7,0,7
20858,2020,Syrian Arab Rep.,Trinidad and Tobago,66,38,0,104
20859,2020,Tajikistan,Trinidad and Tobago,0,5,0,5
20860,2020,Trinidad and Tobago,Trinidad and Tobago,0,0,0,0
20861,2020,Saint Vincent and the Grenadines,Trinidad and Tobago,5,0,0,5
20862,2020,Venezuela (Bolivarian Republic of),Trinidad and Tobago,2841,16664,0,19505
20863,2020,Algeria,Tunisia,9,16,0,25
20864,2020,Egypt,Tunisia,0,10,0,10
20865,2020,Burundi,Tunisia,0,7,0,7
20866,2020,Benin,Tunisia,0,6,0,6
20867,2020,Bangladesh,Tunisia,0,17,0,17
20868,2020,Burkina Faso,Tunisia,0,46,0,46
20869,2020,Central African Rep.,Tunisia,10,21,0,31
20870,2020,Chad,Tunisia,0,18,0,18
20871,2020,Cameroon,Tunisia,17,194,0,211
20872,2020,Congo,Tunisia,0,7,0,7
20873,2020,Dem. Rep. of the Congo,Tunisia,0,81,0,81
20874,2020,Comoros,Tunisia,0,5,0,5
20875,2020,Eritrea,Tunisia,197,49,0,246
20876,2020,Ethiopia,Tunisia,0,48,0,48
20877,2020,Gambia,Tunisia,0,5,0,5
20878,2020,Palestinian,Tunisia,35,13,0,48
20879,2020,Ghana,Tunisia,0,5,0,5
20880,2020,Guinea,Tunisia,7,255,0,262
20881,2020,Cote d'Ivoire,Tunisia,33,2210,0,2243
20882,2020,Iran (Islamic Rep. of),Tunisia,8,0,0,8
20883,2020,Iraq,Tunisia,20,10,0,30
20884,2020,Liberia,Tunisia,0,38,0,38
20885,2020,Libya,Tunisia,14,127,0,141
20886,2020,Lebanon,Tunisia,6,20,0,26
20887,2020,Mauritania,Tunisia,0,6,0,6
20888,2020,Mali,Tunisia,6,55,0,61
20889,2020,Morocco,Tunisia,0,0,0,0
20890,2020,Niger,Tunisia,0,6,0,6
20891,2020,Nigeria,Tunisia,5,35,0,40
20892,2020,Rwanda,Tunisia,6,0,0,6
20893,2020,Senegal,Tunisia,0,15,0,15
20894,2020,Sierra Leone,Tunisia,5,36,0,41
20895,2020,Somalia,Tunisia,35,142,0,177
20896,2020,Sudan,Tunisia,144,138,0,282
20897,2020,South Sudan,Tunisia,5,21,0,26
20898,2020,Syrian Arab Rep.,Tunisia,1997,0,0,1997
20899,2020,Togo,Tunisia,0,5,0,5
20900,2020,Türkiye,Tunisia,10,5,0,15
20901,2020,Yemen,Tunisia,11,28,0,39
20902,2020,Afghanistan,Türkiye,4219,125104,0,129323
20903,2020,Iran (Islamic Rep. of),Türkiye,1693,24300,0,25993
20904,2020,Iraq,Türkiye,4565,162760,0,167325
20905,2020,Syrian Arab Rep.,Türkiye,3641370,0,0,3641370
20907,2020,Afghanistan,United Arab Emirates,5,25,0,30
20908,2020,Algeria,United Arab Emirates,0,0,0,0
20909,2020,Egypt,United Arab Emirates,5,8,0,13
20910,2020,Chad,United Arab Emirates,6,0,0,6
20911,2020,Eritrea,United Arab Emirates,0,7,0,7
20912,2020,Ethiopia,United Arab Emirates,8,5,0,13
20913,2020,Palestinian,United Arab Emirates,15,0,0,15
20914,2020,Iran (Islamic Rep. of),United Arab Emirates,7,7,0,14
20915,2020,Iraq,United Arab Emirates,809,554,0,1363
20916,2020,Jordan,United Arab Emirates,7,0,0,7
20917,2020,Kuwait,United Arab Emirates,5,0,0,5
20918,2020,Libya,United Arab Emirates,0,5,0,5
20919,2020,Lebanon,United Arab Emirates,18,5,0,23
20920,2020,Morocco,United Arab Emirates,0,0,0,0
20921,2020,Pakistan,United Arab Emirates,5,0,0,5
20922,2020,Philippines,United Arab Emirates,0,0,0,0
20923,2020,Russian Federation,United Arab Emirates,0,5,0,5
20924,2020,Saudi Arabia,United Arab Emirates,5,0,0,5
20925,2020,Somalia,United Arab Emirates,18,0,0,18
20926,2020,Sudan,United Arab Emirates,13,7,0,20
20927,2020,Syrian Arab Rep.,United Arab Emirates,383,6551,0,6934
20928,2020,Yemen,United Arab Emirates,6,50,0,56
20930,2020,Egypt,Uganda,7,5,0,12
20931,2020,Burundi,Uganda,48466,1262,0,49728
20932,2020,Central African Rep.,Uganda,30,0,0,30
20933,2020,Chad,Uganda,7,0,0,7
20934,2020,Cameroon,Uganda,5,0,0,5
20935,2020,Congo,Uganda,22,0,0,22
20936,2020,Dem. Rep. of the Congo,Uganda,417407,4156,0,421563
20937,2020,Eritrea,Uganda,8650,7796,0,16446
20938,2020,Ethiopia,Uganda,2222,1012,0,3234
20939,2020,Palestinian,Uganda,5,0,0,5
20940,2020,Guinea,Uganda,5,0,0,5
20941,2020,Kenya,Uganda,204,19,0,223
20942,2020,Mali,Uganda,0,5,0,5
20943,2020,Pakistan,Uganda,235,17,0,252
20944,2020,Rwanda,Uganda,15978,1905,0,17883
20945,2020,Senegal,Uganda,10,0,0,10
20946,2020,Somalia,Uganda,37536,6943,0,44479
20947,2020,Sudan,Uganda,2790,501,0,3291
20948,2020,South Sudan,Uganda,887452,1602,0,889054
20949,2020,Syrian Arab Rep.,Uganda,16,8,0,24
20950,2020,United Rep. of Tanzania,Uganda,10,0,0,10
20951,2020,Türkiye,Uganda,49,0,0,49
20952,2020,Uganda,Uganda,0,0,0,0
20953,2020,Yemen,Uganda,27,5,0,32
20954,2020,Afghanistan,Ukraine,822,673,0,1495
20955,2020,Algeria,Ukraine,0,9,0,9
20956,2020,Angola,Ukraine,24,0,0,24
20957,2020,Egypt,Ukraine,5,15,0,20
20958,2020,Armenia,Ukraine,46,10,0,56
20959,2020,Azerbaijan,Ukraine,70,25,0,95
20960,2020,Bangladesh,Ukraine,5,147,0,152
20961,2020,Belarus,Ukraine,26,26,0,52
20962,2020,Chad,Ukraine,7,0,0,7
20963,2020,China,Ukraine,0,5,0,5
20964,2020,Cameroon,Ukraine,5,29,0,34
20965,2020,Congo,Ukraine,26,14,0,40
20966,2020,Dem. Rep. of the Congo,Ukraine,25,39,0,64
20967,2020,Eritrea,Ukraine,11,28,0,39
20968,2020,Ethiopia,Ukraine,26,5,0,31
20969,2020,Palestinian,Ukraine,10,40,0,50
20970,2020,Georgia,Ukraine,25,0,0,25
20971,2020,Ghana,Ukraine,0,12,0,12
20972,2020,Guinea,Ukraine,5,22,0,27
20973,2020,Haiti,Ukraine,0,5,0,5
20974,2020,Cote d'Ivoire,Ukraine,0,17,0,17
20975,2020,India,Ukraine,7,26,0,33
20976,2020,Iran (Islamic Rep. of),Ukraine,72,49,0,121
20977,2020,Iraq,Ukraine,79,75,0,154
20978,2020,Jordan,Ukraine,5,5,0,10
20979,2020,Kazakhstan,Ukraine,9,16,0,25
20980,2020,Kyrgyzstan,Ukraine,9,31,0,40
20981,2020,Libya,Ukraine,5,13,0,18
20982,2020,Lebanon,Ukraine,8,14,0,22
20983,2020,Sri Lanka,Ukraine,7,29,0,36
20984,2020,Rep. of Moldova,Ukraine,0,5,0,5
20985,2020,Mali,Ukraine,0,5,0,5
20986,2020,Morocco,Ukraine,0,11,0,11
20987,2020,Myanmar,Ukraine,0,6,0,6
20988,2020,Nigeria,Ukraine,6,38,0,44
20989,2020,Pakistan,Ukraine,7,69,0,76
20990,2020,Russian Federation,Ukraine,165,161,0,326
20991,2020,Rwanda,Ukraine,5,0,0,5
20992,2020,Serbia and Kosovo: S/RES/1244 (1999),Ukraine,5,0,0,5
20993,2020,Senegal,Ukraine,0,5,0,5
20994,2020,Sierra Leone,Ukraine,5,0,0,5
20995,2020,Somalia,Ukraine,81,109,0,190
20996,2020,Viet Nam,Ukraine,0,13,0,13
20997,2020,Sudan,Ukraine,27,25,0,52
20998,2020,Syrian Arab Rep.,Ukraine,491,171,0,662
20999,2020,Tajikistan,Ukraine,22,184,0,206
21000,2020,Turkmenistan,Ukraine,7,0,0,7
21001,2020,Tunisia,Ukraine,0,5,0,5
21002,2020,Türkiye,Ukraine,5,12,0,17
21003,2020,Ukraine,Ukraine,0,0,734000,0
21004,2020,Uzbekistan,Ukraine,32,95,0,127
21005,2020,Yemen,Ukraine,5,46,0,51
21006,2020,Zambia,Ukraine,0,5,0,5
21008,2020,Afghanistan,Uruguay,0,7,0,7
21009,2020,Angola,Uruguay,14,0,0,14
21010,2020,Egypt,Uruguay,0,5,0,5
21011,2020,Argentina,Uruguay,0,7,0,7
21012,2020,Bangladesh,Uruguay,0,128,0,128
21013,2020,Bolivia (Plurinational State of),Uruguay,5,5,0,10
21014,2020,Brazil,Uruguay,0,15,0,15
21015,2020,Chile,Uruguay,0,5,0,5
21016,2020,Cameroon,Uruguay,12,5,0,17
21017,2020,Congo,Uruguay,5,0,0,5
21018,2020,Colombia,Uruguay,162,51,0,213
21019,2020,Cuba,Uruguay,26,9109,0,9135
21020,2020,Dominican Rep.,Uruguay,0,255,0,255
21021,2020,Ecuador,Uruguay,7,9,0,16
21022,2020,Ghana,Uruguay,0,26,0,26
21023,2020,Guinea-Bissau,Uruguay,0,5,0,5
21024,2020,Guatemala,Uruguay,5,0,0,5
21025,2020,Guinea,Uruguay,0,9,0,9
21026,2020,Haiti,Uruguay,0,15,0,15
21027,2020,Libya,Uruguay,5,0,0,5
21028,2020,Latvia,Uruguay,5,0,0,5
21029,2020,Mexico,Uruguay,5,0,0,5
21030,2020,Morocco,Uruguay,0,10,0,10
21031,2020,Nicaragua,Uruguay,9,0,0,9
21032,2020,Nigeria,Uruguay,22,19,0,41
21033,2020,Pakistan,Uruguay,0,33,0,33
21034,2020,Paraguay,Uruguay,5,0,0,5
21035,2020,Peru,Uruguay,6,5,0,11
21036,2020,Russian Federation,Uruguay,12,5,0,17
21037,2020,El Salvador,Uruguay,42,13,0,55
21038,2020,Senegal,Uruguay,0,238,0,238
21039,2020,Somalia,Uruguay,5,0,0,5
21040,2020,Syrian Arab Rep.,Uruguay,63,6,0,69
21041,2020,Türkiye,Uruguay,13,5,0,18
21042,2020,Ukraine,Uruguay,11,5,0,16
21043,2020,Venezuela (Bolivarian Republic of),Uruguay,225,636,0,861
21044,2020,Afghanistan,United States of America,1592,796,0,2388
21045,2020,Albania,United States of America,1314,2129,0,3443
21046,2020,Algeria,United States of America,155,434,0,589
21047,2020,Angola,United States of America,264,2095,0,2359
21048,2020,Antigua and Barbuda,United States of America,7,13,0,20
21049,2020,Egypt,United States of America,14359,5461,0,19820
21050,2020,Argentina,United States of America,32,313,0,345
21051,2020,Armenia,United States of America,1360,3468,0,4828
21052,2020,Australia,United States of America,5,12,0,17
21053,2020,Austria,United States of America,13,0,0,13
21054,2020,Azerbaijan,United States of America,487,1195,0,1682
21055,2020,Bahrain,United States of America,43,38,0,81
21056,2020,Barbados,United States of America,0,5,0,5
21057,2020,Burundi,United States of America,849,621,0,1470
21058,2020,Belgium,United States of America,17,34,0,51
21059,2020,Benin,United States of America,82,240,0,322
21060,2020,Bangladesh,United States of America,2162,7952,0,10114
21061,2020,Bahamas,United States of America,181,127,0,308
21062,2020,Bhutan,United States of America,34,358,0,392
21063,2020,Burkina Faso,United States of America,1377,3335,0,4712
21064,2020,Belarus,United States of America,1547,2477,0,4024
21065,2020,Bolivia (Plurinational State of),United States of America,96,483,0,579
21066,2020,Botswana,United States of America,0,5,0,5
21067,2020,Brazil,United States of America,989,13245,0,14234
21068,2020,Bosnia and Herzegovina,United States of America,92,200,0,292
21069,2020,Bulgaria,United States of America,200,283,0,483
21070,2020,Belize,United States of America,39,279,0,318
21071,2020,Cambodia,United States of America,128,71,0,199
21072,2020,Canada,United States of America,26,65,0,91
21073,2020,Central African Rep.,United States of America,181,111,0,292
21074,2020,Cayman Islands,United States of America,5,0,0,5
21075,2020,Chad,United States of America,242,241,0,483
21076,2020,China,United States of America,74948,75843,0,150791
21077,2020,Chile,United States of America,21,418,0,439
21078,2020,Cameroon,United States of America,5204,5274,0,10478
21079,2020,Congo,United States of America,1120,2029,0,3149
21080,2020,Dem. Rep. of the Congo,United States of America,1469,1975,0,3444
21081,2020,Comoros,United States of America,5,5,0,10
21082,2020,Colombia,United States of America,2668,16868,0,19536
21083,2020,Costa Rica,United States of America,171,601,0,772
21084,2020,Cuba,United States of America,2591,9751,0,12342
21085,2020,Cabo Verde,United States of America,0,33,0,33
21086,2020,Cyprus,United States of America,0,7,0,7
21087,2020,Czechia,United States of America,8,59,0,67
21088,2020,Denmark,United States of America,0,5,0,5
21089,2020,Djibouti,United States of America,361,469,0,830
21090,2020,Dominica,United States of America,15,25,0,40
21091,2020,Dominican Rep.,United States of America,255,1141,0,1396
21092,2020,Ecuador,United States of America,1453,20863,0,22316
21093,2020,Equatorial Guinea,United States of America,17,71,0,88
21094,2020,Eritrea,United States of America,5765,1019,0,6784
21095,2020,Estonia,United States of America,252,36,0,288
21096,2020,Ethiopia,United States of America,8245,5885,0,14130
21097,2020,French Guiana,United States of America,0,8,0,8
21098,2020,Fiji,United States of America,126,323,0,449
21099,2020,France,United States of America,21,77,0,98
21100,2020,Gabon,United States of America,53,284,0,337
21101,2020,Gambia,United States of America,1449,815,0,2264
21102,2020,Palestinian,United States of America,21,102,0,123
21103,2020,United Kingdom of Great Britain and Northern Ireland,United States of America,30,113,0,143
21104,2020,Georgia,United States of America,456,2005,0,2461
21105,2020,Germany,United States of America,36,132,0,168
21106,2020,Ghana,United States of America,491,963,0,1454
21107,2020,Guinea-Bissau,United States of America,18,37,0,55
21108,2020,Greece,United States of America,14,77,0,91
21109,2020,Grenada,United States of America,20,38,0,58
21110,2020,Guatemala,United States of America,21951,139527,0,161478
21111,2020,Guinea,United States of America,1755,1164,0,2919
21112,2020,Guyana,United States of America,106,437,0,543
21113,2020,Haiti,United States of America,15125,25292,0,40417
21114,2020,"China, Hong Kong SAR",United States of America,5,69,0,74
21115,2020,Honduras,United States of America,15940,101617,0,117557
21116,2020,Croatia,United States of America,27,37,0,64
21117,2020,Hungary,United States of America,12,297,0,309
21118,2020,Cote d'Ivoire,United States of America,1096,1302,0,2398
21119,2020,India,United States of America,8677,37896,0,46573
21120,2020,Indonesia,United States of America,1084,2492,0,3576
21121,2020,Ireland,United States of America,0,28,0,28
21122,2020,Iran (Islamic Rep. of),United States of America,5582,2944,0,8526
21123,2020,Iraq,United States of America,5437,3432,0,8869
21124,2020,Israel,United States of America,115,476,0,591
21125,2020,Italy,United States of America,17,299,0,316
21126,2020,Jamaica,United States of America,896,1164,0,2060
21127,2020,Jordan,United States of America,619,2658,0,3277
21128,2020,Japan,United States of America,6,81,0,87
21129,2020,Kazakhstan,United States of America,1056,2860,0,3916
21130,2020,Kenya,United States of America,1735,5586,0,7321
21131,2020,Kyrgyzstan,United States of America,1612,1876,0,3488
21132,2020,Rep. of Korea,United States of America,27,246,0,273
21133,2020,Dem. People's Rep. of Korea,United States of America,6,26,0,32
21134,2020,Kuwait,United States of America,144,198,0,342
21135,2020,Lao People's Dem. Rep.,United States of America,65,170,0,235
21136,2020,Liberia,United States of America,1239,1154,0,2393
21137,2020,Libya,United States of America,416,1028,0,1444
21138,2020,Saint Lucia,United States of America,6,24,0,30
21139,2020,Lebanon,United States of America,381,1078,0,1459
21140,2020,Lesotho,United States of America,6,0,0,6
21141,2020,Sri Lanka,United States of America,1096,1890,0,2986
21142,2020,Lithuania,United States of America,21,59,0,80
21143,2020,Latvia,United States of America,21,82,0,103
21145,2020,Madagascar,United States of America,8,15,0,23
21146,2020,Mauritania,United States of America,956,1077,0,2033
21147,2020,North Macedonia,United States of America,110,220,0,330
21148,2020,Rep. of Moldova,United States of America,1466,2324,0,3790
21149,2020,Maldives,United States of America,5,0,0,5
21150,2020,Mexico,United States of America,12076,104529,0,116605
21151,2020,Marshall Islands,United States of America,7,0,0,7
21152,2020,Mali,United States of America,1015,604,0,1619
21153,2020,Malaysia,United States of America,93,374,0,467
21154,2020,Malawi,United States of America,35,137,0,172
21155,2020,Mongolia,United States of America,726,2234,0,2960
21156,2020,Morocco,United States of America,124,243,0,367
21157,2020,Mozambique,United States of America,24,38,0,62
21158,2020,Malta,United States of America,0,5,0,5
21159,2020,Montenegro,United States of America,95,447,0,542
21160,2020,Mauritius,United States of America,34,36,0,70
21161,2020,Myanmar,United States of America,1272,2190,0,3462
21162,2020,Namibia,United States of America,43,29,0,72
21163,2020,Nepal,United States of America,6742,6953,0,13695
21164,2020,Netherlands,United States of America,7,67,0,74
21165,2020,Niger,United States of America,144,331,0,475
21166,2020,Nicaragua,United States of America,1754,8373,0,10127
21167,2020,Nigeria,United States of America,2523,14651,0,17174
21168,2020,Niue,United States of America,18,7,0,25
21169,2020,Oman,United States of America,14,28,0,42
21170,2020,Pakistan,United States of America,3887,6081,0,9968
21171,2020,Panama,United States of America,12,126,0,138
21172,2020,Paraguay,United States of America,15,102,0,117
21173,2020,Peru,United States of America,498,3422,0,3920
21174,2020,Philippines,United States of America,166,1558,0,1724
21175,2020,Poland,United States of America,9,898,0,907
21176,2020,Portugal,United States of America,5,197,0,202
21177,2020,Qatar,United States of America,20,25,0,45
21178,2020,Romania,United States of America,437,3094,0,3531
21179,2020,South Africa,United States of America,51,769,0,820
21180,2020,Russian Federation,United States of America,6530,12806,0,19336
21181,2020,Rwanda,United States of America,1219,1154,0,2373
21182,2020,El Salvador,United States of America,27434,126248,0,153682
21183,2020,Saudi Arabia,United States of America,594,787,0,1381
21184,2020,Serbia and Kosovo: S/RES/1244 (1999),United States of America,712,1772,0,2484
21185,2020,Senegal,United States of America,398,663,0,1061
21186,2020,Singapore,United States of America,8,39,0,47
21187,2020,Sierra Leone,United States of America,424,376,0,800
21188,2020,Somalia,United States of America,1698,335,0,2033
21189,2020,Spain,United States of America,9,155,0,164
21190,2020,Viet Nam,United States of America,396,1310,0,1706
21191,2020,Saint Kitts and Nevis,United States of America,5,5,0,10
21192,2020,Sudan,United States of America,1412,876,0,2288
21193,2020,Suriname,United States of America,12,44,0,56
21194,2020,South Sudan,United States of America,48,57,0,105
21195,2020,Slovakia,United States of America,5,51,0,56
21196,2020,Slovenia,United States of America,5,5,0,10
21197,2020,Eswatini,United States of America,5,15,0,20
21198,2020,Sweden,United States of America,0,24,0,24
21199,2020,Switzerland,United States of America,5,11,0,16
21200,2020,Syrian Arab Rep.,United States of America,8616,2630,0,11246
21201,2020,United Rep. of Tanzania,United States of America,126,244,0,370
21202,2020,Turks and Caicos Islands,United States of America,14,0,0,14
21203,2020,Thailand,United States of America,35,480,0,515
21204,2020,Tajikistan,United States of America,317,531,0,848
21205,2020,Turkmenistan,United States of America,205,342,0,547
21206,2020,Timor-Leste,United States of America,0,12,0,12
21207,2020,Togo,United States of America,529,648,0,1177
21208,2020,Tonga,United States of America,0,5,0,5
21209,2020,Trinidad and Tobago,United States of America,42,234,0,276
21210,2020,Tunisia,United States of America,94,264,0,358
21211,2020,Türkiye,United States of America,3062,4227,0,7289
21212,2020,United Arab Emirates,United States of America,73,146,0,219
21213,2020,Uganda,United States of America,1783,3311,0,5094
21214,2020,Ukraine,United States of America,2581,8222,0,10803
21215,2020,Uruguay,United States of America,5,131,0,136
21216,2020,Uzbekistan,United States of America,1282,2458,0,3740
21217,2020,Vanuatu,United States of America,0,20,0,20
21218,2020,Saint Vincent and the Grenadines,United States of America,30,17,0,47
21219,2020,Venezuela (Bolivarian Republic of),United States of America,17292,129667,0,146959
21220,2020,Yemen,United States of America,705,830,0,1535
21221,2020,Zambia,United States of America,45,119,0,164
21222,2020,Zimbabwe,United States of America,756,1041,0,1797
21224,2020,Guadeloupe,United States of America,0,86,0,86
21225,2020,Curacao ,United States of America,35,0,0,35
21227,2020,Afghanistan,Uzbekistan,13,0,0,13
21229,2020,Venezuela (Bolivarian Republic of),Saint Vincent and the Grenadines,0,0,0,0
21230,2020,Afghanistan,Venezuela (Bolivarian Republic of),10,0,0,10
21231,2020,Chile,Venezuela (Bolivarian Republic of),10,0,0,10
21232,2020,Congo,Venezuela (Bolivarian Republic of),5,0,0,5
21233,2020,Colombia,Venezuela (Bolivarian Republic of),67935,284,0,68219
21234,2020,Palestinian,Venezuela (Bolivarian Republic of),7,0,0,7
21235,2020,Haiti,Venezuela (Bolivarian Republic of),7,0,0,7
21236,2020,Iraq,Venezuela (Bolivarian Republic of),18,0,0,18
21237,2020,Liberia,Venezuela (Bolivarian Republic of),9,0,0,9
21238,2020,Libya,Venezuela (Bolivarian Republic of),5,0,0,5
21239,2020,Lebanon,Venezuela (Bolivarian Republic of),12,0,0,12
21240,2020,Nigeria,Venezuela (Bolivarian Republic of),7,0,0,7
21241,2020,Peru,Venezuela (Bolivarian Republic of),5,0,0,5
21242,2020,Rwanda,Venezuela (Bolivarian Republic of),5,0,0,5
21243,2020,Sierra Leone,Venezuela (Bolivarian Republic of),5,0,0,5
21244,2020,Syrian Arab Rep.,Venezuela (Bolivarian Republic of),32,0,0,32
21245,2020,Türkiye,Venezuela (Bolivarian Republic of),6,0,0,6
21246,2020,Venezuela (Bolivarian Republic of),Venezuela (Bolivarian Republic of),0,0,0,0
21247,2020,Western Sahara,Venezuela (Bolivarian Republic of),11,0,0,11
21248,2020,Egypt,Yemen,16,10,0,26
21249,2020,Cameroon,Yemen,0,5,0,5
21250,2020,Djibouti,Yemen,5,6,0,11
21251,2020,Eritrea,Yemen,1370,475,0,1845
21252,2020,Ethiopia,Yemen,6644,8699,0,15343
21253,2020,Palestinian,Yemen,630,307,0,937
21254,2020,Iran (Islamic Rep. of),Yemen,5,0,0,5
21255,2020,Iraq,Yemen,3321,73,0,3394
21256,2020,Jordan,Yemen,17,8,0,25
21257,2020,Mali,Yemen,0,5,0,5
21258,2020,Pakistan,Yemen,0,9,0,9
21259,2020,Somalia,Yemen,151155,155,0,151310
21260,2020,Viet Nam,Yemen,15,0,0,15
21261,2020,Sudan,Yemen,119,522,0,641
21262,2020,Syrian Arab Rep.,Yemen,3609,419,0,4028
21263,2020,United Rep. of Tanzania,Yemen,0,0,0,0
21264,2020,Yemen,Yemen,0,0,4002012,0
21265,2020,Angola,Zambia,0,0,0,0
21266,2020,Burundi,Zambia,6743,939,0,7682
21267,2020,Central African Rep.,Zambia,0,5,0,5
21268,2020,Cameroon,Zambia,5,37,0,42
21269,2020,Congo,Zambia,16,0,0,16
21270,2020,Dem. Rep. of the Congo,Zambia,54715,2779,0,57494
21271,2020,Eritrea,Zambia,31,18,0,49
21272,2020,Ethiopia,Zambia,30,8,0,38
21273,2020,Palestinian,Zambia,14,0,0,14
21274,2020,Liberia,Zambia,8,0,0,8
21275,2020,Nigeria,Zambia,0,5,0,5
21276,2020,South Africa,Zambia,6,0,0,6
21277,2020,Rwanda,Zambia,777,27,0,804
21278,2020,Sierra Leone,Zambia,5,0,0,5
21279,2020,Somalia,Zambia,3414,404,0,3818
21280,2020,Sudan,Zambia,28,0,0,28
21281,2020,South Sudan,Zambia,5,6,0,11
21282,2020,Syrian Arab Rep.,Zambia,20,6,0,26
21283,2020,Türkiye,Zambia,74,5,0,79
21284,2020,Uganda,Zambia,108,54,0,162
21286,2020,Burundi,Zimbabwe,676,227,0,903
21287,2020,Central African Rep.,Zimbabwe,0,5,0,5
21288,2020,Cameroon,Zimbabwe,0,7,0,7
21289,2020,Congo,Zimbabwe,20,0,0,20
21290,2020,Dem. Rep. of the Congo,Zimbabwe,7757,3260,0,11017
21291,2020,Eritrea,Zimbabwe,20,5,0,25
21292,2020,Ethiopia,Zimbabwe,71,13,0,84
21293,2020,Cote d'Ivoire,Zimbabwe,12,20,0,32
21294,2020,Kenya,Zimbabwe,0,8,0,8
21295,2020,Mali,Zimbabwe,6,89,0,95
21296,2020,Mozambique,Zimbabwe,0,8172,0,8172
21297,2020,South Africa,Zimbabwe,0,0,0,0
21298,2020,Rwanda,Zimbabwe,662,80,0,742
21299,2020,Somalia,Zimbabwe,13,19,0,32
21300,2020,Sudan,Zimbabwe,7,0,0,7
21301,2020,South Sudan,Zimbabwe,8,24,0,32
21302,2020,Uganda,Zimbabwe,9,0,0,9
21303,2020,Zambia,Zimbabwe,0,0,0,0
21304,2020,Zimbabwe,Zimbabwe,0,0,0,0
21305,2020,Venezuela (Bolivarian Republic of),Anguilla,0,0,0,0
21306,2020,Colombia,Aruba,0,0,0,0
21307,2020,Venezuela (Bolivarian Republic of),Aruba,0,0,0,0
21308,2020,Colombia,Curacao ,44,33,0,77
21309,2020,Venezuela (Bolivarian Republic of),Curacao ,24,285,0,309
21310,2020,Venezuela (Bolivarian Republic of),Sint Maarten (Dutch part),0,8,0,8
21311,2021,Afghanistan,Afghanistan,0,0,3457744,0
21312,2021,Bangladesh,Afghanistan,0,5,0,5
21313,2021,Iran (Islamic Rep. of),Afghanistan,38,25,0,63
21314,2021,Pakistan,Afghanistan,66911,215,0,67126
21315,2021,Tajikistan,Afghanistan,0,6,0,6
21316,2021,Afghanistan,Albania,5,0,0,5
21317,2021,Egypt,Albania,0,0,0,0
21318,2021,China,Albania,14,0,0,14
21319,2021,Palestinian,Albania,8,0,0,8
21320,2021,Serbia and Kosovo: S/RES/1244 (1999),Albania,57,0,0,57
21321,2021,Syrian Arab Rep.,Albania,15,6,0,21
21322,2021,Uzbekistan,Albania,5,0,0,5
21323,2021,Venezuela (Bolivarian Republic of),Albania,5,0,0,5
21325,2021,Benin,Algeria,5,53,0,58
21326,2021,Burkina Faso,Algeria,9,10,0,19
21327,2021,Central African Rep.,Algeria,103,34,0,137
21328,2021,Chad,Algeria,5,30,0,35
21329,2021,Cameroon,Algeria,154,382,0,536
21330,2021,Congo,Algeria,0,5,0,5
21331,2021,Dem. Rep. of the Congo,Algeria,81,109,0,190
21332,2021,Eritrea,Algeria,5,5,0,10
21333,2021,Gambia,Algeria,0,5,0,5
21334,2021,Palestinian,Algeria,185,0,0,185
21335,2021,Ghana,Algeria,0,7,0,7
21336,2021,Guinea-Bissau,Algeria,0,5,0,5
21337,2021,Guinea,Algeria,44,345,0,389
21338,2021,Cote d'Ivoire,Algeria,81,222,0,303
21339,2021,Iraq,Algeria,13,5,0,18
21340,2021,Liberia,Algeria,0,50,0,50
21341,2021,Libya,Algeria,21,17,0,38
21342,2021,Mali,Algeria,206,387,0,593
21343,2021,Niger,Algeria,9,126,0,135
21344,2021,Nigeria,Algeria,5,239,0,244
21345,2021,Senegal,Algeria,0,7,0,7
21346,2021,Sierra Leone,Algeria,0,23,0,23
21347,2021,Somalia,Algeria,5,0,0,5
21348,2021,Sudan,Algeria,33,28,0,61
21349,2021,Syrian Arab Rep.,Algeria,6659,0,0,6659
21350,2021,Togo,Algeria,0,14,0,14
21351,2021,Türkiye,Algeria,0,22,0,22
21352,2021,Western Sahara,Algeria,90000,0,0,90000
21353,2021,Yemen,Algeria,267,0,0,267
21354,2021,Angola,Angola,0,0,0,0
21355,2021,Burundi,Angola,18,99,0,117
21356,2021,Central African Rep.,Angola,7,77,0,84
21357,2021,Chad,Angola,189,779,0,968
21358,2021,Congo,Angola,65,58,0,123
21359,2021,Dem. Rep. of the Congo,Angola,23163,500,0,23663
21360,2021,Eritrea,Angola,83,1791,0,1874
21361,2021,Ethiopia,Angola,0,57,0,57
21362,2021,Guinea-Bissau,Angola,7,268,0,275
21363,2021,Guinea,Angola,126,9146,0,9272
21364,2021,Cote d'Ivoire,Angola,417,5940,0,6357
21365,2021,Liberia,Angola,164,478,0,642
21366,2021,Mauritania,Angola,323,5402,0,5725
21367,2021,Rwanda,Angola,499,141,0,640
21368,2021,Sierra Leone,Angola,413,1497,0,1910
21369,2021,Somalia,Angola,271,1731,0,2002
21370,2021,Sudan,Angola,279,1670,0,1949
21371,2021,Syrian Arab Rep.,Angola,0,5,0,5
21372,2021,United Rep. of Tanzania,Angola,5,0,0,5
21373,2021,Türkiye,Angola,0,38,0,38
21374,2021,Uganda,Angola,0,6,0,6
21375,2021,Western Sahara,Angola,16,596,0,612
21376,2021,Afghanistan,Egypt,43,49,0,92
21377,2021,Burundi,Egypt,55,62,0,117
21378,2021,Bangladesh,Egypt,0,5,0,5
21379,2021,Central African Rep.,Egypt,45,30,0,75
21380,2021,Chad,Egypt,60,54,0,114
21381,2021,China,Egypt,0,80,0,80
21382,2021,Cameroon,Egypt,17,38,0,55
21383,2021,Congo,Egypt,14,25,0,39
21384,2021,Dem. Rep. of the Congo,Egypt,47,28,0,75
21385,2021,Djibouti,Egypt,24,11,0,35
21386,2021,Eritrea,Egypt,14141,6785,0,20926
21387,2021,Ethiopia,Egypt,5589,9895,0,15484
21388,2021,Palestinian,Egypt,70021,0,0,70021
21389,2021,Guinea,Egypt,11,55,0,66
21390,2021,Cote d'Ivoire,Egypt,96,10,0,106
21391,2021,Iraq,Egypt,4629,2178,0,6807
21392,2021,Jordan,Egypt,9,9,0,18
21393,2021,Kenya,Egypt,9,12,0,21
21394,2021,Liberia,Egypt,0,10,0,10
21395,2021,Libya,Egypt,5,0,0,5
21396,2021,Lebanon,Egypt,0,6,0,6
21397,2021,Sri Lanka,Egypt,0,10,0,10
21398,2021,Mali,Egypt,0,10,0,10
21399,2021,Nigeria,Egypt,25,196,0,221
21400,2021,Russian Federation,Egypt,9,16,0,25
21401,2021,Rwanda,Egypt,5,0,0,5
21402,2021,Saudi Arabia,Egypt,15,7,0,22
21403,2021,Sierra Leone,Egypt,5,8,0,13
21404,2021,Somalia,Egypt,4698,2067,0,6765
21405,2021,Sudan,Egypt,25476,26527,0,52003
21406,2021,South Sudan,Egypt,18673,2040,0,20713
21407,2021,Syrian Arab Rep.,Egypt,136727,0,0,136727
21408,2021,United Rep. of Tanzania,Egypt,5,0,0,5
21409,2021,Tajikistan,Egypt,12,10,0,22
21410,2021,Turkmenistan,Egypt,5,0,0,5
21411,2021,Togo,Egypt,0,6,0,6
21412,2021,Tunisia,Egypt,5,0,0,5
21413,2021,Türkiye,Egypt,0,360,0,360
21414,2021,Uganda,Egypt,13,19,0,32
21415,2021,Uzbekistan,Egypt,0,17,0,17
21416,2021,Yemen,Egypt,156,9735,0,9891
21417,2021,Zimbabwe,Egypt,42,17,0,59
21420,2021,Afghanistan,Argentina,12,0,0,12
21421,2021,Albania,Argentina,18,0,0,18
21422,2021,Algeria,Argentina,30,20,0,50
21423,2021,Angola,Argentina,14,15,0,29
21424,2021,Egypt,Argentina,5,19,0,24
21425,2021,Armenia,Argentina,77,183,0,260
21426,2021,Burundi,Argentina,5,0,0,5
21427,2021,Bangladesh,Argentina,5,90,0,95
21428,2021,Bolivia (Plurinational State of),Argentina,63,62,0,125
21429,2021,Brazil,Argentina,0,18,0,18
21430,2021,Bosnia and Herzegovina,Argentina,6,0,0,6
21431,2021,China,Argentina,0,115,0,115
21432,2021,Chile,Argentina,34,7,0,41
21433,2021,Cameroon,Argentina,11,39,0,50
21434,2021,Dem. Rep. of the Congo,Argentina,26,28,0,54
21435,2021,Colombia,Argentina,561,258,0,819
21436,2021,Costa Rica,Argentina,5,0,0,5
21437,2021,Cuba,Argentina,263,819,0,1082
21438,2021,Cabo Verde,Argentina,0,5,0,5
21439,2021,Czechia,Argentina,0,5,0,5
21440,2021,Dominican Rep.,Argentina,9,568,0,577
21441,2021,Ecuador,Argentina,16,31,0,47
21442,2021,Eritrea,Argentina,0,5,0,5
21443,2021,Ethiopia,Argentina,5,0,0,5
21444,2021,Gambia,Argentina,0,10,0,10
21445,2021,Palestinian,Argentina,21,12,0,33
21446,2021,Georgia,Argentina,5,0,0,5
21447,2021,Ghana,Argentina,37,148,0,185
21448,2021,Guinea-Bissau,Argentina,8,5,0,13
21449,2021,Guatemala,Argentina,8,0,0,8
21450,2021,Guinea,Argentina,10,9,0,19
21451,2021,Haiti,Argentina,76,781,0,857
21452,2021,Honduras,Argentina,6,10,0,16
21453,2021,Hungary,Argentina,0,5,0,5
21454,2021,Cote d'Ivoire,Argentina,20,5,0,25
21455,2021,India,Argentina,23,127,0,150
21456,2021,Iran (Islamic Rep. of),Argentina,30,7,0,37
21457,2021,Iraq,Argentina,22,0,0,22
21458,2021,Jamaica,Argentina,13,0,0,13
21459,2021,Jordan,Argentina,5,5,0,10
21460,2021,Kazakhstan,Argentina,18,13,0,31
21461,2021,Kyrgyzstan,Argentina,5,0,0,5
21462,2021,Liberia,Argentina,42,0,0,42
21463,2021,Libya,Argentina,5,5,0,10
21464,2021,Sri Lanka,Argentina,36,0,0,36
21465,2021,North Macedonia,Argentina,9,0,0,9
21466,2021,Mexico,Argentina,0,6,0,6
21467,2021,Mali,Argentina,9,0,0,9
21468,2021,Morocco,Argentina,0,13,0,13
21469,2021,Nepal,Argentina,0,5,0,5
21470,2021,Nicaragua,Argentina,16,15,0,31
21471,2021,Nigeria,Argentina,42,71,0,113
21472,2021,Pakistan,Argentina,39,18,0,57
21473,2021,Paraguay,Argentina,19,19,0,38
21474,2021,Peru,Argentina,548,84,0,632
21475,2021,Philippines,Argentina,0,5,0,5
21476,2021,Romania,Argentina,51,0,0,51
21477,2021,South Africa,Argentina,0,12,0,12
21478,2021,Russian Federation,Argentina,81,94,0,175
21479,2021,El Salvador,Argentina,47,36,0,83
21480,2021,Senegal,Argentina,43,1383,0,1426
21481,2021,Sierra Leone,Argentina,37,5,0,42
21482,2021,Somalia,Argentina,5,0,0,5
21483,2021,Spain,Argentina,0,5,0,5
21484,2021,Sudan,Argentina,5,0,0,5
21485,2021,Syrian Arab Rep.,Argentina,433,98,0,531
21486,2021,Tunisia,Argentina,0,5,0,5
21487,2021,Türkiye,Argentina,7,0,0,7
21488,2021,Ukraine,Argentina,121,84,0,205
21489,2021,United States of America,Argentina,5,12,0,17
21490,2021,Venezuela (Bolivarian Republic of),Argentina,315,5580,0,5895
21491,2021,Yemen,Argentina,21,0,0,21
21493,2021,Afghanistan,Armenia,5,0,0,5
21494,2021,Egypt,Armenia,5,0,0,5
21495,2021,Azerbaijan,Armenia,27933,0,0,27933
21496,2021,Congo,Armenia,5,0,0,5
21497,2021,Cuba,Armenia,5,13,0,18
21498,2021,Palestinian,Armenia,7,0,0,7
21499,2021,Georgia,Armenia,8,5,0,13
21500,2021,Cote d'Ivoire,Armenia,6,0,0,6
21501,2021,Iran (Islamic Rep. of),Armenia,139,88,0,227
21502,2021,Iraq,Armenia,1095,39,0,1134
21503,2021,Lebanon,Armenia,26,5,0,31
21504,2021,Myanmar,Armenia,0,5,0,5
21505,2021,Nigeria,Armenia,5,0,0,5
21506,2021,Russian Federation,Armenia,0,6,0,6
21507,2021,Syrian Arab Rep.,Armenia,5335,8,0,5343
21508,2021,Türkiye,Armenia,16,12,0,28
21509,2021,Ukraine,Armenia,117,0,0,117
21510,2021,Yemen,Armenia,21,0,0,21
21512,2021,Afghanistan,Australia,9648,2670,0,12318
21513,2021,Albania,Australia,37,96,0,133
21514,2021,Algeria,Australia,9,23,0,32
21515,2021,Egypt,Australia,1320,256,0,1576
21516,2021,Argentina,Australia,0,29,0,29
21517,2021,Azerbaijan,Australia,9,12,0,21
21518,2021,Bahrain,Australia,48,6,0,54
21519,2021,Burundi,Australia,48,28,0,76
21520,2021,Bangladesh,Australia,393,1344,0,1737
21521,2021,Bhutan,Australia,5,17,0,22
21522,2021,Belarus,Australia,6,0,0,6
21523,2021,Brazil,Australia,8,194,0,202
21524,2021,Brunei Darussalam,Australia,0,5,0,5
21525,2021,Bosnia and Herzegovina,Australia,0,5,0,5
21526,2021,Cambodia,Australia,67,561,0,628
21527,2021,China,Australia,1579,15774,0,17353
21528,2021,Chile,Australia,0,62,0,62
21529,2021,Cameroon,Australia,28,59,0,87
21530,2021,Congo,Australia,27,34,0,61
21531,2021,Dem. Rep. of the Congo,Australia,64,34,0,98
21532,2021,Colombia,Australia,87,312,0,399
21533,2021,Czechia,Australia,0,5,0,5
21534,2021,Djibouti,Australia,5,0,0,5
21535,2021,Eritrea,Australia,96,11,0,107
21536,2021,Ethiopia,Australia,342,223,0,565
21537,2021,Fiji,Australia,276,2522,0,2798
21538,2021,France,Australia,0,23,0,23
21539,2021,Gambia,Australia,8,11,0,19
21540,2021,Palestinian,Australia,477,185,0,662
21541,2021,United Kingdom of Great Britain and Northern Ireland,Australia,6,96,0,102
21542,2021,Georgia,Australia,13,26,0,39
21543,2021,Germany,Australia,10,5,0,15
21544,2021,Ghana,Australia,41,211,0,252
21545,2021,Greece,Australia,6,49,0,55
21546,2021,Guinea,Australia,8,5,0,13
21547,2021,"China, Hong Kong SAR",Australia,5,442,0,447
21548,2021,Honduras,Australia,5,6,0,11
21549,2021,Hungary,Australia,0,5,0,5
21550,2021,India,Australia,475,6995,0,7470
21551,2021,Indonesia,Australia,235,2328,0,2563
21552,2021,Ireland,Australia,0,79,0,79
21553,2021,Iran (Islamic Rep. of),Australia,12701,3040,0,15741
21554,2021,Iraq,Australia,4488,1119,0,5607
21555,2021,Israel,Australia,9,17,0,26
21556,2021,Italy,Australia,5,50,0,55
21557,2021,Jamaica,Australia,5,0,0,5
21558,2021,Jordan,Australia,136,197,0,333
21559,2021,Japan,Australia,9,22,0,31
21560,2021,Kazakhstan,Australia,5,0,0,5
21561,2021,Kenya,Australia,99,342,0,441
21562,2021,Kyrgyzstan,Australia,12,0,0,12
21563,2021,Rep. of Korea,Australia,24,259,0,283
21564,2021,Dem. People's Rep. of Korea,Australia,0,9,0,9
21565,2021,Kuwait,Australia,26,0,0,26
21566,2021,Lao People's Dem. Rep.,Australia,5,288,0,293
21567,2021,Liberia,Australia,44,18,0,62
21568,2021,Libya,Australia,1245,54,0,1299
21569,2021,Lebanon,Australia,476,957,0,1433
21570,2021,Sri Lanka,Australia,3935,2686,0,6621
21571,2021,North Macedonia,Australia,5,86,0,91
21572,2021,Maldives,Australia,13,16,0,29
21573,2021,Mexico,Australia,14,31,0,45
21574,2021,Malaysia,Australia,687,19065,0,19752
21575,2021,Mongolia,Australia,15,369,0,384
21576,2021,Morocco,Australia,12,19,0,31
21577,2021,Mozambique,Australia,0,5,0,5
21578,2021,Mauritius,Australia,10,140,0,150
21579,2021,Myanmar,Australia,407,777,0,1184
21580,2021,Nepal,Australia,100,641,0,741
21581,2021,Nigeria,Australia,247,537,0,784
21582,2021,Nauru,Australia,5,16,0,21
21583,2021,New Zealand,Australia,26,27,0,53
21584,2021,Oman,Australia,5,0,0,5
21585,2021,Pakistan,Australia,5348,2329,0,7677
21586,2021,Peru,Australia,19,70,0,89
21587,2021,Philippines,Australia,43,1693,0,1736
21588,2021,Papua New Guinea,Australia,497,636,0,1133
21589,2021,Poland,Australia,0,19,0,19
21590,2021,Portugal,Australia,0,12,0,12
21591,2021,Romania,Australia,0,5,0,5
21592,2021,South Africa,Australia,26,469,0,495
21593,2021,Russian Federation,Australia,53,88,0,141
21594,2021,Rwanda,Australia,90,54,0,144
21595,2021,El Salvador,Australia,12,30,0,42
21596,2021,Saudi Arabia,Australia,200,69,0,269
21597,2021,Serbia and Kosovo: S/RES/1244 (1999),Australia,0,21,0,21
21598,2021,Singapore,Australia,6,37,0,43
21599,2021,Sierra Leone,Australia,30,134,0,164
21600,2021,Solomon Islands,Australia,25,314,0,339
21601,2021,Somalia,Australia,524,141,0,665
21602,2021,Viet Nam,Australia,323,3469,0,3792
21603,2021,Sudan,Australia,556,187,0,743
21604,2021,South Sudan,Australia,20,42,0,62
21605,2021,Eswatini,Australia,0,21,0,21
21606,2021,Syrian Arab Rep.,Australia,640,53,0,693
21607,2021,United Rep. of Tanzania,Australia,8,34,0,42
21608,2021,Thailand,Australia,22,2233,0,2255
21609,2021,Timor-Leste,Australia,6,347,0,353
21610,2021,Tonga,Australia,28,811,0,839
21611,2021,Tunisia,Australia,0,9,0,9
21612,2021,Türkiye,Australia,805,502,0,1307
21613,2021,United Arab Emirates,Australia,5,0,0,5
21614,2021,Uganda,Australia,59,91,0,150
21615,2021,Ukraine,Australia,18,99,0,117
21616,2021,United States of America,Australia,17,58,0,75
21617,2021,Uzbekistan,Australia,19,54,0,73
21618,2021,Vanuatu,Australia,0,86,0,86
21619,2021,Venezuela (Bolivarian Republic of),Australia,143,336,0,479
21620,2021,Samoa,Australia,5,150,0,155
21621,2021,Yemen,Australia,181,94,0,275
21622,2021,Zambia,Australia,19,19,0,38
21623,2021,Zimbabwe,Australia,312,196,0,508
21627,2021,Afghanistan,Austria,42685,5600,0,48285
21628,2021,Albania,Austria,52,23,0,75
21629,2021,Algeria,Austria,28,173,0,201
21630,2021,Angola,Austria,36,7,0,43
21631,2021,Egypt,Austria,217,387,0,604
21632,2021,Armenia,Austria,307,154,0,461
21633,2021,Azerbaijan,Austria,150,107,0,257
21634,2021,Burundi,Austria,15,0,0,15
21635,2021,Benin,Austria,5,15,0,20
21636,2021,Bangladesh,Austria,360,250,0,610
21637,2021,Burkina Faso,Austria,5,7,0,12
21638,2021,Belarus,Austria,31,20,0,51
21639,2021,Bosnia and Herzegovina,Austria,58,7,0,65
21640,2021,Canada,Austria,5,0,0,5
21641,2021,China,Austria,642,87,0,729
21642,2021,Cameroon,Austria,186,49,0,235
21643,2021,Congo,Austria,80,11,0,91
21644,2021,Dem. Rep. of the Congo,Austria,329,59,0,388
21645,2021,Colombia,Austria,5,13,0,18
21646,2021,Cuba,Austria,15,5,0,20
21647,2021,Eritrea,Austria,471,49,0,520
21648,2021,Ethiopia,Austria,241,67,0,308
21649,2021,Gabon,Austria,5,0,0,5
21650,2021,Gambia,Austria,112,66,0,178
21651,2021,United Kingdom of Great Britain and Northern Ireland,Austria,5,0,0,5
21652,2021,Georgia,Austria,309,211,0,520
21653,2021,Germany,Austria,0,5,0,5
21654,2021,Ghana,Austria,17,23,0,40
21655,2021,Guinea-Bissau,Austria,5,5,0,10
21656,2021,Guatemala,Austria,6,0,0,6
21657,2021,Guinea,Austria,125,30,0,155
21658,2021,Hungary,Austria,0,5,0,5
21659,2021,Cote d'Ivoire,Austria,42,17,0,59
21660,2021,India,Austria,37,595,0,632
21661,2021,Iran (Islamic Rep. of),Austria,7209,1167,0,8376
21662,2021,Iraq,Austria,9959,1637,0,11596
21663,2021,Israel,Austria,10,0,0,10
21664,2021,Jordan,Austria,78,38,0,116
21665,2021,Kazakhstan,Austria,108,23,0,131
21666,2021,Kenya,Austria,17,7,0,24
21667,2021,Kyrgyzstan,Austria,117,19,0,136
21668,2021,Kuwait,Austria,10,9,0,19
21669,2021,Liberia,Austria,10,0,0,10
21670,2021,Libya,Austria,144,68,0,212
21671,2021,Lebanon,Austria,122,117,0,239
21672,2021,Sri Lanka,Austria,71,21,0,92
21673,2021,Mauritania,Austria,5,0,0,5
21674,2021,North Macedonia,Austria,12,52,0,64
21675,2021,Rep. of Moldova,Austria,17,195,0,212
21676,2021,Mali,Austria,14,12,0,26
21677,2021,Mongolia,Austria,116,70,0,186
21678,2021,Morocco,Austria,42,523,0,565
21679,2021,Montenegro,Austria,5,0,0,5
21680,2021,Myanmar,Austria,32,9,0,41
21681,2021,Nepal,Austria,18,31,0,49
21682,2021,Nicaragua,Austria,5,0,0,5
21683,2021,Nigeria,Austria,425,334,0,759
21684,2021,Pakistan,Austria,375,591,0,966
21685,2021,Philippines,Austria,19,13,0,32
21686,2021,Romania,Austria,5,0,0,5
21687,2021,South Africa,Austria,0,8,0,8
21688,2021,Russian Federation,Austria,6526,702,0,7228
21689,2021,Rwanda,Austria,12,5,0,17
21690,2021,Saudi Arabia,Austria,7,0,0,7
21691,2021,Serbia and Kosovo: S/RES/1244 (1999),Austria,437,136,0,573
21692,2021,Senegal,Austria,14,8,0,22
21693,2021,Sierra Leone,Austria,19,8,0,27
21694,2021,Somalia,Austria,8414,1518,0,9932
21695,2021,Viet Nam,Austria,5,9,0,14
21696,2021,Sudan,Austria,296,30,0,326
21697,2021,South Sudan,Austria,6,0,0,6
21698,2021,Syrian Arab Rep.,Austria,62408,10558,0,72966
21699,2021,Tajikistan,Austria,260,24,0,284
21700,2021,Turkmenistan,Austria,8,0,0,8
21701,2021,Togo,Austria,7,6,0,13
21702,2021,Tunisia,Austria,13,243,0,256
21703,2021,Türkiye,Austria,671,671,0,1342
21704,2021,Uganda,Austria,35,6,0,41
21705,2021,Ukraine,Austria,253,113,0,366
21706,2021,United States of America,Austria,5,0,0,5
21707,2021,Uzbekistan,Austria,44,64,0,108
21708,2021,Venezuela (Bolivarian Republic of),Austria,83,32,0,115
21709,2021,Yemen,Austria,426,177,0,603
21710,2021,Zambia,Austria,5,0,0,5
21713,2021,Afghanistan,Azerbaijan,1189,26,0,1215
21714,2021,Azerbaijan,Azerbaijan,0,0,654839,0
21715,2021,Palestinian,Azerbaijan,5,0,0,5
21716,2021,Iran (Islamic Rep. of),Azerbaijan,52,0,0,52
21717,2021,Iraq,Azerbaijan,10,0,0,10
21718,2021,Libya,Azerbaijan,5,0,0,5
21719,2021,Pakistan,Azerbaijan,45,0,0,45
21720,2021,Russian Federation,Azerbaijan,317,8,0,325
21721,2021,Syrian Arab Rep.,Azerbaijan,33,0,0,33
21722,2021,Ukraine,Azerbaijan,5,0,0,5
21723,2021,Uzbekistan,Azerbaijan,5,0,0,5
21724,2021,Yemen,Azerbaijan,10,0,0,10
21726,2021,Egypt,Bahrain,0,5,0,5
21727,2021,Palestinian,Bahrain,0,15,0,15
21728,2021,Iraq,Bahrain,242,117,0,359
21729,2021,Jordan,Bahrain,0,6,0,6
21730,2021,Syrian Arab Rep.,Bahrain,5,36,0,41
21731,2021,Tunisia,Bahrain,0,6,0,6
21732,2021,Yemen,Bahrain,9,5,0,14
21733,2021,Guyana,Barbados,0,5,0,5
21734,2021,Venezuela (Bolivarian Republic of),Barbados,0,5,0,5
21735,2021,Burundi,Burundi,0,0,19176,0
21736,2021,Belgium,Burundi,0,0,0,0
21737,2021,Dem. Rep. of the Congo,Burundi,80817,3899,0,84716
21738,2021,Kenya,Burundi,5,0,0,5
21739,2021,Mali,Burundi,13,0,0,13
21740,2021,Oman,Burundi,0,0,0,0
21741,2021,Pakistan,Burundi,9,0,0,9
21742,2021,Rwanda,Burundi,614,393,0,1007
21743,2021,Somalia,Burundi,5,0,0,5
21744,2021,United Rep. of Tanzania,Burundi,7,0,0,7
21745,2021,Uganda,Burundi,21,5,0,26
21746,2021,Afghanistan,Belgium,5859,7375,0,13234
21747,2021,Albania,Belgium,689,470,0,1159
21748,2021,Algeria,Belgium,70,220,0,290
21749,2021,Angola,Belgium,93,225,0,318
21750,2021,Egypt,Belgium,98,105,0,203
21751,2021,Armenia,Belgium,154,285,0,439
21752,2021,Azerbaijan,Belgium,90,50,0,140
21753,2021,Burundi,Belgium,2246,415,0,2661
21754,2021,Benin,Belgium,38,60,0,98
21755,2021,Bangladesh,Belgium,21,15,0,36
21756,2021,Burkina Faso,Belgium,116,110,0,226
21757,2021,Belarus,Belgium,46,105,0,151
21758,2021,Brazil,Belgium,15,45,0,60
21759,2021,Bosnia and Herzegovina,Belgium,44,65,0,109
21760,2021,Bulgaria,Belgium,17,0,0,17
21761,2021,Cambodia,Belgium,13,0,0,13
21762,2021,Central African Rep.,Belgium,62,25,0,87
21763,2021,Chad,Belgium,46,55,0,101
21764,2021,China,Belgium,1206,80,0,1286
21765,2021,Chile,Belgium,44,10,0,54
21766,2021,Cameroon,Belgium,593,795,0,1388
21767,2021,Congo,Belgium,25,35,0,60
21768,2021,Dem. Rep. of the Congo,Belgium,1573,780,0,2353
21769,2021,Colombia,Belgium,135,240,0,375
21770,2021,Cuba,Belgium,10,5,0,15
21771,2021,Czechia,Belgium,5,0,0,5
21772,2021,Djibouti,Belgium,383,60,0,443
21773,2021,Ecuador,Belgium,0,15,0,15
21774,2021,Eritrea,Belgium,3974,1320,0,5294
21775,2021,Ethiopia,Belgium,175,175,0,350
21776,2021,France,Belgium,0,5,0,5
21777,2021,Gabon,Belgium,26,30,0,56
21778,2021,Gambia,Belgium,36,110,0,146
21779,2021,Palestinian,Belgium,3109,2030,0,5139
21780,2021,Georgia,Belgium,159,435,0,594
21781,2021,Ghana,Belgium,19,70,0,89
21782,2021,Guinea-Bissau,Belgium,7,10,0,17
21783,2021,Guatemala,Belgium,39,35,0,74
21784,2021,Guinea,Belgium,3656,1050,0,4706
21785,2021,Guyana,Belgium,5,0,0,5
21786,2021,Haiti,Belgium,5,5,0,10
21787,2021,Honduras,Belgium,18,25,0,43
21788,2021,Croatia,Belgium,5,0,0,5
21789,2021,Hungary,Belgium,29,0,0,29
21790,2021,Cote d'Ivoire,Belgium,238,210,0,448
21791,2021,India,Belgium,14,10,0,24
21792,2021,Iran (Islamic Rep. of),Belgium,1843,545,0,2388
21793,2021,Iraq,Belgium,5655,995,0,6650
21794,2021,Jamaica,Belgium,5,0,0,5
21795,2021,Jordan,Belgium,23,65,0,88
21796,2021,Kazakhstan,Belgium,60,25,0,85
21797,2021,Kenya,Belgium,15,10,0,25
21798,2021,Kyrgyzstan,Belgium,70,40,0,110
21799,2021,Dem. People's Rep. of Korea,Belgium,32,10,0,42
21800,2021,Kuwait,Belgium,6,5,0,11
21801,2021,Lao People's Dem. Rep.,Belgium,10,0,0,10
21802,2021,Liberia,Belgium,15,35,0,50
21803,2021,Libya,Belgium,145,160,0,305
21804,2021,Lebanon,Belgium,115,155,0,270
21805,2021,Sri Lanka,Belgium,309,50,0,359
21806,2021,Lithuania,Belgium,5,0,0,5
21807,2021,Madagascar,Belgium,0,5,0,5
21808,2021,Mauritania,Belgium,274,200,0,474
21809,2021,North Macedonia,Belgium,133,145,0,278
21810,2021,Rep. of Moldova,Belgium,5,235,0,240
21811,2021,Mali,Belgium,99,85,0,184
21812,2021,Mongolia,Belgium,0,10,0,10
21813,2021,Morocco,Belgium,167,340,0,507
21814,2021,Mozambique,Belgium,0,10,0,10
21815,2021,Montenegro,Belgium,13,10,0,23
21816,2021,Myanmar,Belgium,8,5,0,13
21817,2021,Nepal,Belgium,6,5,0,11
21818,2021,Niger,Belgium,136,125,0,261
21819,2021,Nicaragua,Belgium,26,10,0,36
21820,2021,Nigeria,Belgium,55,310,0,365
21821,2021,Pakistan,Belgium,345,140,0,485
21822,2021,Peru,Belgium,0,70,0,70
21823,2021,Philippines,Belgium,0,5,0,5
21824,2021,Poland,Belgium,98,0,0,98
21825,2021,Romania,Belgium,36,10,0,46
21826,2021,South Africa,Belgium,5,0,0,5
21827,2021,Russian Federation,Belgium,2665,405,0,3070
21828,2021,Rwanda,Belgium,826,325,0,1151
21829,2021,El Salvador,Belgium,542,595,0,1137
21830,2021,Saudi Arabia,Belgium,8,5,0,13
21831,2021,Serbia and Kosovo: S/RES/1244 (1999),Belgium,908,270,0,1178
21832,2021,Senegal,Belgium,396,300,0,696
21833,2021,Sierra Leone,Belgium,27,55,0,82
21834,2021,Somalia,Belgium,2551,1380,0,3931
21835,2021,Spain,Belgium,0,10,0,10
21836,2021,Viet Nam,Belgium,23,25,0,48
21837,2021,Sudan,Belgium,299,165,0,464
21838,2021,Suriname,Belgium,0,15,0,15
21839,2021,South Sudan,Belgium,5,20,0,25
21840,2021,Slovakia,Belgium,0,5,0,5
21841,2021,Syrian Arab Rep.,Belgium,19188,1980,0,21168
21842,2021,United Rep. of Tanzania,Belgium,43,30,0,73
21843,2021,Tajikistan,Belgium,11,5,0,16
21844,2021,Togo,Belgium,163,125,0,288
21845,2021,Tunisia,Belgium,68,120,0,188
21846,2021,Türkiye,Belgium,3031,1005,0,4036
21847,2021,Uganda,Belgium,24,25,0,49
21848,2021,Ukraine,Belgium,289,155,0,444
21849,2021,United States of America,Belgium,0,10,0,10
21850,2021,Uzbekistan,Belgium,37,10,0,47
21851,2021,Venezuela (Bolivarian Republic of),Belgium,479,250,0,729
21852,2021,Yemen,Belgium,257,160,0,417
21856,2021,Burundi,Benin,5,0,0,5
21857,2021,Burkina Faso,Benin,189,5,0,194
21858,2021,Central African Rep.,Benin,1122,156,0,1278
21859,2021,Chad,Benin,17,35,0,52
21860,2021,Cameroon,Benin,79,75,0,154
21861,2021,Congo,Benin,0,11,0,11
21862,2021,Dem. Rep. of the Congo,Benin,24,55,0,79
21863,2021,Eritrea,Benin,5,0,0,5
21864,2021,Guinea,Benin,0,14,0,14
21865,2021,Cote d'Ivoire,Benin,160,27,0,187
21866,2021,Liberia,Benin,0,5,0,5
21867,2021,Sri Lanka,Benin,5,0,0,5
21868,2021,Mali,Benin,48,14,0,62
21869,2021,Niger,Benin,0,22,0,22
21870,2021,Nigeria,Benin,0,37,0,37
21871,2021,Pakistan,Benin,5,0,0,5
21872,2021,Rwanda,Benin,0,5,0,5
21873,2021,Sudan,Benin,18,7,0,25
21874,2021,Syrian Arab Rep.,Benin,32,12,0,44
21875,2021,Togo,Benin,0,26,0,26
21876,2021,Türkiye,Benin,10,0,0,10
21877,2021,Yemen,Benin,17,0,0,17
21878,2021,Afghanistan,Bangladesh,0,5,0,5
21879,2021,Bangladesh,Bangladesh,0,0,0,0
21880,2021,Myanmar,Bangladesh,918898,0,0,918898
21881,2021,Somalia,Bangladesh,9,33,0,42
21882,2021,Türkiye,Bangladesh,0,10,0,10
21884,2021,Cameroon,Bahamas,5,0,0,5
21885,2021,Cuba,Bahamas,0,5,0,5
21886,2021,Jamaica,Bahamas,5,0,0,5
21887,2021,South Africa,Bahamas,0,8,0,8
21888,2021,Burundi,Burkina Faso,28,0,0,28
21889,2021,Benin,Burkina Faso,8,0,0,8
21890,2021,Burkina Faso,Burkina Faso,0,0,1579976,0
21891,2021,Central African Rep.,Burkina Faso,187,122,0,309
21892,2021,Chad,Burkina Faso,74,0,0,74
21893,2021,Cameroon,Burkina Faso,7,0,0,7
21894,2021,Congo,Burkina Faso,26,0,0,26
21895,2021,Dem. Rep. of the Congo,Burkina Faso,30,0,0,30
21896,2021,Cote d'Ivoire,Burkina Faso,5,0,0,5
21897,2021,Mali,Burkina Faso,24560,9209,0,33769
21898,2021,Rwanda,Burkina Faso,16,0,0,16
21899,2021,South Sudan,Burkina Faso,5,0,0,5
21900,2021,Syrian Arab Rep.,Burkina Faso,5,0,0,5
21901,2021,Togo,Burkina Faso,15,0,0,15
21902,2021,Türkiye,Burkina Faso,44,82,0,126
21903,2021,Afghanistan,Belarus,127,14,0,141
21904,2021,Armenia,Belarus,5,0,0,5
21905,2021,Azerbaijan,Belarus,5,0,0,5
21906,2021,Cameroon,Belarus,0,5,0,5
21907,2021,Dem. Rep. of the Congo,Belarus,0,5,0,5
21908,2021,Cuba,Belarus,0,7,0,7
21909,2021,Ethiopia,Belarus,5,5,0,10
21910,2021,Palestinian,Belarus,0,6,0,6
21911,2021,Georgia,Belarus,48,0,0,48
21912,2021,Iran (Islamic Rep. of),Belarus,5,21,0,26
21913,2021,Iraq,Belarus,11,5,0,16
21914,2021,Libya,Belarus,7,0,0,7
21915,2021,Lebanon,Belarus,5,0,0,5
21916,2021,Nigeria,Belarus,0,14,0,14
21917,2021,Russian Federation,Belarus,5,0,0,5
21918,2021,Syrian Arab Rep.,Belarus,68,8,0,76
21919,2021,Tajikistan,Belarus,10,0,0,10
21920,2021,Türkiye,Belarus,18,5,0,23
21921,2021,Ukraine,Belarus,2378,14,0,2392
21922,2021,Yemen,Belarus,32,5,0,37
21924,2021,Argentina,Bolivia (Plurinational State of),13,0,0,13
21925,2021,Colombia,Bolivia (Plurinational State of),200,21,0,221
21926,2021,Cuba,Bolivia (Plurinational State of),48,0,0,48
21927,2021,Ecuador,Bolivia (Plurinational State of),5,6,0,11
21928,2021,Cote d'Ivoire,Bolivia (Plurinational State of),5,0,0,5
21929,2021,Iraq,Bolivia (Plurinational State of),16,0,0,16
21930,2021,Niger,Bolivia (Plurinational State of),5,0,0,5
21931,2021,Pakistan,Bolivia (Plurinational State of),5,0,0,5
21932,2021,Peru,Bolivia (Plurinational State of),525,0,0,525
21933,2021,Russian Federation,Bolivia (Plurinational State of),14,0,0,14
21934,2021,Syrian Arab Rep.,Bolivia (Plurinational State of),22,0,0,22
21935,2021,Ukraine,Bolivia (Plurinational State of),5,0,0,5
21936,2021,Uruguay,Bolivia (Plurinational State of),10,0,0,10
21937,2021,Venezuela (Bolivarian Republic of),Bolivia (Plurinational State of),243,0,0,243
21939,2021,Angola,Botswana,0,0,0,0
21940,2021,Burundi,Botswana,58,0,0,58
21941,2021,Dem. Rep. of the Congo,Botswana,239,41,0,280
21942,2021,Ethiopia,Botswana,5,0,0,5
21943,2021,Kenya,Botswana,5,0,0,5
21944,2021,Namibia,Botswana,6,0,0,6
21945,2021,Rwanda,Botswana,17,0,0,17
21946,2021,Somalia,Botswana,314,5,0,319
21947,2021,Sudan,Botswana,5,0,0,5
21948,2021,South Sudan,Botswana,5,0,0,5
21949,2021,Uganda,Botswana,19,7,0,26
21950,2021,Zimbabwe,Botswana,15,5,0,20
21951,2021,Afghanistan,Brazil,149,167,0,316
21952,2021,Albania,Brazil,0,7,0,7
21953,2021,Algeria,Brazil,8,36,0,44
21954,2021,Andorra,Brazil,0,5,0,5
21955,2021,Angola,Brazil,1157,5767,0,6924
21956,2021,Egypt,Brazil,62,487,0,549
21957,2021,Argentina,Brazil,6,153,0,159
21958,2021,Armenia,Brazil,5,7,0,12
21959,2021,Burundi,Brazil,46,24,0,70
21960,2021,Belgium,Brazil,0,7,0,7
21961,2021,Benin,Brazil,5,288,0,293
21962,2021,Bangladesh,Brazil,23,5715,0,5738
21963,2021,Bhutan,Brazil,31,35,0,66
21964,2021,Burkina Faso,Brazil,5,315,0,320
21965,2021,Bolivia (Plurinational State of),Brazil,154,462,0,616
21966,2021,Brazil,Brazil,0,0,0,0
21967,2021,Bosnia and Herzegovina,Brazil,5,0,0,5
21968,2021,Bulgaria,Brazil,0,5,0,5
21969,2021,Cambodia,Brazil,0,5,0,5
21970,2021,Canada,Brazil,0,5,0,5
21971,2021,Central African Rep.,Brazil,5,8,0,13
21972,2021,China,Brazil,23,5324,0,5347
21973,2021,Chile,Brazil,21,138,0,159
21974,2021,Cameroon,Brazil,87,607,0,694
21975,2021,Congo,Brazil,20,110,0,130
21976,2021,Dem. Rep. of the Congo,Brazil,1689,2640,0,4329
21977,2021,Colombia,Brazil,1300,2027,0,3327
21978,2021,Costa Rica,Brazil,0,18,0,18
21979,2021,Cuba,Brazil,722,15339,0,16061
21980,2021,Cabo Verde,Brazil,0,211,0,211
21981,2021,Cyprus,Brazil,0,5,0,5
21982,2021,Czechia,Brazil,0,6,0,6
21983,2021,Denmark,Brazil,0,12,0,12
21984,2021,Djibouti,Brazil,0,11,0,11
21985,2021,Dominica,Brazil,0,18,0,18
21986,2021,Dominican Rep.,Brazil,6,1293,0,1299
21987,2021,Ecuador,Brazil,58,105,0,163
21988,2021,Equatorial Guinea,Brazil,0,14,0,14
21989,2021,Eritrea,Brazil,25,119,0,144
21990,2021,Ethiopia,Brazil,27,89,0,116
21991,2021,French Guiana,Brazil,0,19,0,19
21992,2021,Fiji,Brazil,0,21,0,21
21993,2021,France,Brazil,0,44,0,44
21994,2021,Gambia,Brazil,7,353,0,360
21995,2021,Palestinian,Brazil,578,369,0,947
21996,2021,United Kingdom of Great Britain and Northern Ireland,Brazil,0,15,0,15
21997,2021,Georgia,Brazil,11,5,0,16
21998,2021,Germany,Brazil,0,9,0,9
21999,2021,Ghana,Brazil,42,2490,0,2532
22000,2021,Guinea-Bissau,Brazil,25,1668,0,1693
22001,2021,Greece,Brazil,0,6,0,6
22002,2021,Guatemala,Brazil,0,24,0,24
22003,2021,Guinea,Brazil,111,966,0,1077
22004,2021,Guyana,Brazil,5,158,0,163
22005,2021,Haiti,Brazil,8,38709,0,38717
22006,2021,Honduras,Brazil,5,15,0,20
22007,2021,Croatia,Brazil,5,5,0,10
22008,2021,Hungary,Brazil,5,5,0,10
22009,2021,Cote d'Ivoire,Brazil,56,187,0,243
22010,2021,India,Brazil,15,1166,0,1181
22011,2021,Indonesia,Brazil,0,8,0,8
22012,2021,Iran (Islamic Rep. of),Brazil,69,194,0,263
22013,2021,Iraq,Brazil,350,383,0,733
22014,2021,Israel,Brazil,0,33,0,33
22015,2021,Italy,Brazil,0,32,0,32
22016,2021,Jamaica,Brazil,0,11,0,11
22017,2021,Jordan,Brazil,12,99,0,111
22018,2021,Japan,Brazil,0,5,0,5
22019,2021,Kazakhstan,Brazil,0,11,0,11
22020,2021,Kenya,Brazil,10,79,0,89
22021,2021,Rep. of Korea,Brazil,0,285,0,285
22022,2021,Kuwait,Brazil,0,7,0,7
22023,2021,Liberia,Brazil,259,34,0,293
22024,2021,Libya,Brazil,7,59,0,66
22025,2021,Lebanon,Brazil,414,1935,0,2349
22026,2021,Lesotho,Brazil,0,5,0,5
22027,2021,Sri Lanka,Brazil,19,77,0,96
22028,2021,Lithuania,Brazil,0,8,0,8
22030,2021,Mauritania,Brazil,60,243,0,303
22031,2021,North Macedonia,Brazil,6,5,0,11
22032,2021,Mexico,Brazil,8,47,0,55
22033,2021,Mali,Brazil,95,432,0,527
22034,2021,Malaysia,Brazil,0,5,0,5
22035,2021,Mongolia,Brazil,0,7,0,7
22036,2021,Morocco,Brazil,30,746,0,776
22037,2021,Mozambique,Brazil,5,87,0,92
22038,2021,Malta,Brazil,0,5,0,5
22039,2021,Myanmar,Brazil,0,6,0,6
22040,2021,Namibia,Brazil,0,41,0,41
22041,2021,Nepal,Brazil,12,416,0,428
22042,2021,Netherlands,Brazil,0,8,0,8
22043,2021,Niger,Brazil,0,8,0,8
22044,2021,Nicaragua,Brazil,21,20,0,41
22045,2021,Nigeria,Brazil,148,3534,0,3682
22046,2021,Norway,Brazil,0,6,0,6
22047,2021,New Zealand,Brazil,0,5,0,5
22048,2021,Pakistan,Brazil,376,1764,0,2140
22049,2021,Panama,Brazil,0,9,0,9
22050,2021,Paraguay,Brazil,5,179,0,184
22051,2021,Peru,Brazil,46,264,0,310
22052,2021,Philippines,Brazil,5,573,0,578
22053,2021,Poland,Brazil,0,13,0,13
22054,2021,Portugal,Brazil,0,108,0,108
22055,2021,Romania,Brazil,0,15,0,15
22056,2021,South Africa,Brazil,6,463,0,469
22057,2021,Russian Federation,Brazil,21,51,0,72
22058,2021,Rwanda,Brazil,18,5,0,23
22059,2021,El Salvador,Brazil,59,6,0,65
22060,2021,Saudi Arabia,Brazil,0,27,0,27
22061,2021,Serbia and Kosovo: S/RES/1244 (1999),Brazil,92,7,0,99
22062,2021,Senegal,Brazil,15,6389,0,6404
22063,2021,Sierra Leone,Brazil,166,361,0,527
22064,2021,Somalia,Brazil,51,588,0,639
22065,2021,Spain,Brazil,0,55,0,55
22066,2021,Viet Nam,Brazil,5,5,0,10
22067,2021,Sao Tome and Principe,Brazil,0,25,0,25
22068,2021,Sudan,Brazil,77,141,0,218
22069,2021,Suriname,Brazil,0,23,0,23
22070,2021,Sweden,Brazil,0,5,0,5
22071,2021,Switzerland,Brazil,0,5,0,5
22072,2021,Syrian Arab Rep.,Brazil,3920,3969,0,7889
22073,2021,United Rep. of Tanzania,Brazil,8,114,0,122
22074,2021,Thailand,Brazil,0,48,0,48
22075,2021,Togo,Brazil,61,636,0,697
22076,2021,Trinidad and Tobago,Brazil,0,7,0,7
22077,2021,Tunisia,Brazil,6,139,0,145
22078,2021,Türkiye,Brazil,11,280,0,291
22079,2021,Uganda,Brazil,6,36,0,42
22080,2021,Ukraine,Brazil,20,83,0,103
22081,2021,Uruguay,Brazil,0,36,0,36
22082,2021,United States of America,Brazil,0,56,0,56
22083,2021,Uzbekistan,Brazil,0,5,0,5
22084,2021,Vanuatu,Brazil,0,57,0,57
22085,2021,Holy See,Brazil,0,12,0,12
22086,2021,Venezuela (Bolivarian Republic of),Brazil,48931,85738,0,134669
22087,2021,Yemen,Brazil,9,149,0,158
22088,2021,Zambia,Brazil,0,7,0,7
22089,2021,Zimbabwe,Brazil,5,13,0,18
22093,2021,Afghanistan,Bosnia and Herzegovina,0,25,0,25
22094,2021,Algeria,Bosnia and Herzegovina,0,0,0,0
22095,2021,Egypt,Bosnia and Herzegovina,0,0,0,0
22096,2021,Azerbaijan,Bosnia and Herzegovina,5,0,0,5
22097,2021,Bangladesh,Bosnia and Herzegovina,0,0,0,0
22098,2021,Bosnia and Herzegovina,Bosnia and Herzegovina,0,0,96305,0
22099,2021,China,Bosnia and Herzegovina,0,0,0,0
22100,2021,Cameroon,Bosnia and Herzegovina,0,0,0,0
22101,2021,Congo,Bosnia and Herzegovina,0,0,0,0
22102,2021,Cuba,Bosnia and Herzegovina,0,0,0,0
22103,2021,Gambia,Bosnia and Herzegovina,0,0,0,0
22104,2021,Palestinian,Bosnia and Herzegovina,5,0,0,5
22105,2021,Ghana,Bosnia and Herzegovina,0,0,0,0
22106,2021,Croatia,Bosnia and Herzegovina,114,0,0,114
22107,2021,India,Bosnia and Herzegovina,0,5,0,5
22108,2021,Iran (Islamic Rep. of),Bosnia and Herzegovina,5,30,0,35
22109,2021,Iraq,Bosnia and Herzegovina,0,6,0,6
22110,2021,Jordan,Bosnia and Herzegovina,0,0,0,0
22111,2021,Libya,Bosnia and Herzegovina,0,0,0,0
22112,2021,Sri Lanka,Bosnia and Herzegovina,0,0,0,0
22113,2021,Mali,Bosnia and Herzegovina,0,0,0,0
22114,2021,Morocco,Bosnia and Herzegovina,0,7,0,7
22115,2021,Nepal,Bosnia and Herzegovina,0,0,0,0
22116,2021,Nigeria,Bosnia and Herzegovina,0,0,0,0
22117,2021,Pakistan,Bosnia and Herzegovina,5,22,0,27
22118,2021,Serbia and Kosovo: S/RES/1244 (1999),Bosnia and Herzegovina,44,5,0,49
22119,2021,Somalia,Bosnia and Herzegovina,0,0,0,0
22120,2021,Syrian Arab Rep.,Bosnia and Herzegovina,28,5,0,33
22121,2021,Togo,Bosnia and Herzegovina,0,0,0,0
22122,2021,Tunisia,Bosnia and Herzegovina,0,5,0,5
22123,2021,Türkiye,Bosnia and Herzegovina,34,35,0,69
22124,2021,Western Sahara,Bosnia and Herzegovina,0,5,0,5
22127,2021,Afghanistan,Bulgaria,300,4545,0,4845
22128,2021,Albania,Bulgaria,0,5,0,5
22129,2021,Algeria,Bulgaria,0,27,0,27
22130,2021,Egypt,Bulgaria,17,6,0,23
22131,2021,Armenia,Bulgaria,11,5,0,16
22132,2021,Bangladesh,Bulgaria,8,24,0,32
22133,2021,Cameroon,Bulgaria,0,5,0,5
22134,2021,Congo,Bulgaria,9,0,0,9
22135,2021,Cuba,Bulgaria,0,5,0,5
22136,2021,Eritrea,Bulgaria,12,5,0,17
22137,2021,Ethiopia,Bulgaria,9,0,0,9
22138,2021,Georgia,Bulgaria,0,5,0,5
22139,2021,Guinea,Bulgaria,5,0,0,5
22140,2021,Cote d'Ivoire,Bulgaria,5,0,0,5
22141,2021,India,Bulgaria,5,0,0,5
22142,2021,Iran (Islamic Rep. of),Bulgaria,81,44,0,125
22143,2021,Iraq,Bulgaria,1127,200,0,1327
22144,2021,Jordan,Bulgaria,6,0,0,6
22145,2021,Lebanon,Bulgaria,22,6,0,28
22146,2021,Mauritania,Bulgaria,0,5,0,5
22147,2021,Mali,Bulgaria,5,0,0,5
22148,2021,Morocco,Bulgaria,5,129,0,134
22149,2021,Nigeria,Bulgaria,0,5,0,5
22150,2021,Pakistan,Bulgaria,30,56,0,86
22151,2021,Russian Federation,Bulgaria,12,0,0,12
22152,2021,Serbia and Kosovo: S/RES/1244 (1999),Bulgaria,0,5,0,5
22153,2021,Senegal,Bulgaria,0,5,0,5
22154,2021,Somalia,Bulgaria,47,5,0,52
22155,2021,Sudan,Bulgaria,12,0,0,12
22156,2021,Syrian Arab Rep.,Bulgaria,20067,2368,0,22435
22157,2021,Tunisia,Bulgaria,0,19,0,19
22158,2021,Türkiye,Bulgaria,9,13,0,22
22159,2021,Ukraine,Bulgaria,0,6,0,6
22160,2021,Venezuela (Bolivarian Republic of),Bulgaria,0,5,0,5
22161,2021,Yemen,Bulgaria,23,9,0,32
22163,2021,Cuba,Belize,0,5,0,5
22164,2021,Guatemala,Belize,0,416,0,416
22165,2021,Honduras,Belize,11,433,0,444
22166,2021,Nicaragua,Belize,5,0,0,5
22167,2021,Peru,Belize,0,5,0,5
22168,2021,El Salvador,Belize,70,1156,0,1226
22170,2021,Myanmar,Cambodia,8,7,0,15
22171,2021,Pakistan,Cambodia,0,5,0,5
22172,2021,Viet Nam,Cambodia,16,0,0,16
22174,2021,Afghanistan,Canada,2263,399,0,2662
22175,2021,Albania,Canada,749,183,0,932
22176,2021,Algeria,Canada,872,615,0,1487
22177,2021,Angola,Canada,594,816,0,1410
22178,2021,Antigua and Barbuda,Canada,94,33,0,127
22179,2021,Egypt,Canada,3339,335,0,3674
22180,2021,Argentina,Canada,15,58,0,73
22181,2021,Armenia,Canada,32,11,0,43
22182,2021,Australia,Canada,0,7,0,7
22183,2021,Austria,Canada,5,0,0,5
22184,2021,Azerbaijan,Canada,723,52,0,775
22185,2021,Bahrain,Canada,65,5,0,70
22186,2021,Barbados,Canada,250,74,0,324
22187,2021,Burundi,Canada,2870,191,0,3061
22188,2021,Belgium,Canada,9,13,0,22
22189,2021,Benin,Canada,60,65,0,125
22190,2021,Bangladesh,Canada,1840,947,0,2787
22191,2021,Bahamas,Canada,555,404,0,959
22192,2021,Burkina Faso,Canada,116,117,0,233
22193,2021,Belarus,Canada,46,12,0,58
22194,2021,Bolivia (Plurinational State of),Canada,27,30,0,57
22195,2021,Botswana,Canada,71,5,0,76
22196,2021,Brazil,Canada,165,384,0,549
22197,2021,Bosnia and Herzegovina,Canada,5,0,0,5
22198,2021,Bulgaria,Canada,106,18,0,124
22199,2021,Belize,Canada,19,6,0,25
22200,2021,Cambodia,Canada,49,14,0,63
22201,2021,Central African Rep.,Canada,53,32,0,85
22202,2021,Chad,Canada,784,251,0,1035
22203,2021,China,Canada,5925,1318,0,7243
22204,2021,Chile,Canada,104,401,0,505
22205,2021,Cameroon,Canada,1140,401,0,1541
22206,2021,Congo,Canada,300,146,0,446
22207,2021,Dem. Rep. of the Congo,Canada,1361,1602,0,2963
22208,2021,Comoros,Canada,5,5,0,10
22209,2021,Colombia,Canada,5835,3706,0,9541
22210,2021,Costa Rica,Canada,13,52,0,65
22211,2021,Cuba,Canada,458,297,0,755
22212,2021,Cabo Verde,Canada,0,5,0,5
22213,2021,Cyprus,Canada,5,5,0,10
22214,2021,Czechia,Canada,324,66,0,390
22215,2021,Denmark,Canada,8,8,0,16
22216,2021,Djibouti,Canada,1154,36,0,1190
22217,2021,Dominica,Canada,8,5,0,13
22218,2021,Dominican Rep.,Canada,129,169,0,298
22219,2021,Ecuador,Canada,54,114,0,168
22220,2021,Equatorial Guinea,Canada,19,0,0,19
22221,2021,Eritrea,Canada,2086,201,0,2287
22222,2021,Estonia,Canada,6,5,0,11
22223,2021,Ethiopia,Canada,1715,324,0,2039
22224,2021,Fiji,Canada,0,6,0,6
22225,2021,Finland,Canada,5,0,0,5
22226,2021,France,Canada,0,53,0,53
22227,2021,Gabon,Canada,41,39,0,80
22228,2021,Gambia,Canada,101,77,0,178
22229,2021,Palestinian,Canada,2374,242,0,2616
22230,2021,United Kingdom of Great Britain and Northern Ireland,Canada,5,12,0,17
22231,2021,Georgia,Canada,408,170,0,578
22232,2021,Germany,Canada,0,19,0,19
22233,2021,Ghana,Canada,372,285,0,657
22234,2021,Guinea-Bissau,Canada,5,0,0,5
22235,2021,Greece,Canada,0,13,0,13
22236,2021,Grenada,Canada,10,9,0,19
22237,2021,Guatemala,Canada,358,237,0,595
22238,2021,Guinea,Canada,440,295,0,735
22239,2021,Guyana,Canada,90,60,0,150
22240,2021,Haiti,Canada,4295,3057,0,7352
22241,2021,"China, Hong Kong SAR",Canada,17,24,0,41
22242,2021,Honduras,Canada,975,336,0,1311
22243,2021,Croatia,Canada,251,9,0,260
22244,2021,Hungary,Canada,4290,173,0,4463
22245,2021,Iceland,Canada,5,7,0,12
22246,2021,Cote d'Ivoire,Canada,211,162,0,373
22247,2021,India,Canada,2638,9722,0,12360
22248,2021,Indonesia,Canada,106,37,0,143
22249,2021,Ireland,Canada,5,24,0,29
22250,2021,Iran (Islamic Rep. of),Canada,7134,1422,0,8556
22251,2021,Iraq,Canada,123,157,0,280
22252,2021,Israel,Canada,125,33,0,158
22253,2021,Italy,Canada,5,66,0,71
22254,2021,Jamaica,Canada,824,390,0,1214
22255,2021,Jordan,Canada,697,368,0,1065
22256,2021,Japan,Canada,0,5,0,5
22257,2021,Kazakhstan,Canada,165,38,0,203
22258,2021,Kenya,Canada,340,271,0,611
22259,2021,Kyrgyzstan,Canada,70,5,0,75
22260,2021,Rep. of Korea,Canada,33,29,0,62
22261,2021,Dem. People's Rep. of Korea,Canada,255,17,0,272
22262,2021,Kuwait,Canada,61,10,0,71
22263,2021,Lao People's Dem. Rep.,Canada,5,0,0,5
22264,2021,Liberia,Canada,64,107,0,171
22265,2021,Libya,Canada,1862,142,0,2004
22266,2021,Saint Lucia,Canada,419,23,0,442
22267,2021,Lebanon,Canada,989,551,0,1540
22268,2021,Lesotho,Canada,0,5,0,5
22269,2021,Sri Lanka,Canada,2455,625,0,3080
22270,2021,Lithuania,Canada,18,7,0,25
22271,2021,Latvia,Canada,48,5,0,53
22272,2021,Madagascar,Canada,20,20,0,40
22273,2021,Mauritania,Canada,225,109,0,334
22274,2021,North Macedonia,Canada,8,5,0,13
22275,2021,Rep. of Moldova,Canada,45,7,0,52
22276,2021,Mexico,Canada,3609,6212,0,9821
22277,2021,Mali,Canada,238,145,0,383
22278,2021,Malaysia,Canada,0,20,0,20
22279,2021,Malawi,Canada,29,42,0,71
22280,2021,Mongolia,Canada,149,24,0,173
22281,2021,Morocco,Canada,155,160,0,315
22282,2021,Malta,Canada,7,0,0,7
22283,2021,Mauritius,Canada,13,16,0,29
22284,2021,Myanmar,Canada,9,22,0,31
22285,2021,Namibia,Canada,225,14,0,239
22286,2021,Nepal,Canada,25,89,0,114
22287,2021,Netherlands,Canada,10,11,0,21
22288,2021,Niger,Canada,66,71,0,137
22289,2021,Nicaragua,Canada,684,191,0,875
22290,2021,Nigeria,Canada,10172,3847,0,14019
22291,2021,Norway,Canada,0,7,0,7
22292,2021,Pakistan,Canada,7171,1489,0,8660
22293,2021,Panama,Canada,24,14,0,38
22294,2021,Paraguay,Canada,9,6,0,15
22295,2021,Peru,Canada,144,321,0,465
22296,2021,Philippines,Canada,73,162,0,235
22297,2021,Papua New Guinea,Canada,5,0,0,5
22298,2021,Poland,Canada,72,88,0,160
22299,2021,Portugal,Canada,5,26,0,31
22300,2021,Qatar,Canada,5,0,0,5
22301,2021,Romania,Canada,482,330,0,812
22302,2021,South Africa,Canada,66,121,0,187
22303,2021,Russian Federation,Canada,665,91,0,756
22304,2021,Rwanda,Canada,995,422,0,1417
22305,2021,El Salvador,Canada,1604,431,0,2035
22306,2021,Saudi Arabia,Canada,552,70,0,622
22307,2021,Serbia and Kosovo: S/RES/1244 (1999),Canada,183,39,0,222
22308,2021,Senegal,Canada,277,200,0,477
22309,2021,Seychelles,Canada,5,0,0,5
22310,2021,Singapore,Canada,10,0,0,10
22311,2021,Sierra Leone,Canada,28,61,0,89
22312,2021,Somalia,Canada,1498,346,0,1844
22313,2021,Spain,Canada,11,36,0,47
22314,2021,Viet Nam,Canada,30,159,0,189
22315,2021,Saint Kitts and Nevis,Canada,36,6,0,42
22316,2021,Sudan,Canada,2185,199,0,2384
22317,2021,Suriname,Canada,0,5,0,5
22318,2021,South Sudan,Canada,19,14,0,33
22319,2021,Slovakia,Canada,1207,119,0,1326
22320,2021,Slovenia,Canada,6,5,0,11
22321,2021,Eswatini,Canada,70,0,0,70
22322,2021,Syrian Arab Rep.,Canada,190,164,0,354
22323,2021,United Rep. of Tanzania,Canada,171,109,0,280
22324,2021,Thailand,Canada,0,5,0,5
22325,2021,Tajikistan,Canada,42,5,0,47
22326,2021,Turkmenistan,Canada,29,0,0,29
22327,2021,Timor-Leste,Canada,5,0,0,5
22328,2021,Togo,Canada,102,80,0,182
22329,2021,Trinidad and Tobago,Canada,51,37,0,88
22330,2021,Tunisia,Canada,174,160,0,334
22331,2021,Türkiye,Canada,7085,928,0,8013
22332,2021,United Arab Emirates,Canada,14,27,0,41
22333,2021,Uganda,Canada,974,267,0,1241
22334,2021,Ukraine,Canada,1228,98,0,1326
22335,2021,Uruguay,Canada,5,18,0,23
22336,2021,United States of America,Canada,53,1056,0,1109
22337,2021,Uzbekistan,Canada,121,6,0,127
22338,2021,Saint Vincent and the Grenadines,Canada,388,33,0,421
22339,2021,Venezuela (Bolivarian Republic of),Canada,4108,748,0,4856
22340,2021,Yemen,Canada,2127,76,0,2203
22341,2021,Zambia,Canada,7,11,0,18
22342,2021,Zimbabwe,Canada,590,142,0,732
22345,2021,Angola,Central African Rep.,12,0,0,12
22346,2021,Burundi,Central African Rep.,24,0,0,24
22347,2021,Central African Rep.,Central African Rep.,0,0,691791,0
22348,2021,Chad,Central African Rep.,1094,54,0,1148
22349,2021,Cameroon,Central African Rep.,42,26,0,68
22350,2021,Congo,Central African Rep.,16,8,0,24
22351,2021,Dem. Rep. of the Congo,Central African Rep.,5577,222,0,5799
22352,2021,Guinea,Central African Rep.,6,0,0,6
22353,2021,Cote d'Ivoire,Central African Rep.,7,0,0,7
22354,2021,Liberia,Central African Rep.,5,0,0,5
22355,2021,Rwanda,Central African Rep.,219,0,0,219
22356,2021,Sudan,Central African Rep.,394,17,0,411
22357,2021,South Sudan,Central African Rep.,1894,438,0,2332
22358,2021,Türkiye,Central African Rep.,8,0,0,8
22359,2021,Uganda,Central African Rep.,7,0,0,7
22360,2021,Cuba,Cayman Islands,57,30,0,87
22361,2021,Venezuela (Bolivarian Republic of),Cayman Islands,0,0,0,0
22362,2021,Burundi,Chad,6,0,0,6
22363,2021,Central African Rep.,Chad,123320,2375,0,125695
22364,2021,Chad,Chad,0,0,406573,0
22365,2021,Cameroon,Chad,35878,20,0,35898
22366,2021,Congo,Chad,11,5,0,16
22367,2021,Dem. Rep. of the Congo,Chad,254,27,0,281
22368,2021,Eritrea,Chad,7,14,0,21
22369,2021,Ethiopia,Chad,19,9,0,28
22370,2021,Cote d'Ivoire,Chad,5,0,0,5
22371,2021,Iran (Islamic Rep. of),Chad,5,0,0,5
22372,2021,Libya,Chad,25,19,0,44
22373,2021,Mali,Chad,7,0,0,7
22374,2021,Niger,Chad,839,0,0,839
22375,2021,Nigeria,Chad,19321,337,0,19658
22376,2021,Rwanda,Chad,15,0,0,15
22377,2021,Somalia,Chad,7,0,0,7
22378,2021,Sudan,Chad,375999,1867,0,377866
22379,2021,South Sudan,Chad,11,5,0,16
22380,2021,Syrian Arab Rep.,Chad,48,19,0,67
22381,2021,Yemen,Chad,5,8,0,13
22382,2021,Afghanistan,China,30,22,0,52
22383,2021,Cameroon,China,22,358,0,380
22384,2021,Dem. Rep. of the Congo,China,10,17,0,27
22385,2021,Eritrea,China,6,0,0,6
22386,2021,Ethiopia,China,0,8,0,8
22387,2021,Palestinian,China,12,10,0,22
22388,2021,Ghana,China,0,22,0,22
22389,2021,Guinea,China,0,5,0,5
22390,2021,Cote d'Ivoire,China,0,23,0,23
22391,2021,Iran (Islamic Rep. of),China,5,0,0,5
22392,2021,Iraq,China,16,0,0,16
22393,2021,Kenya,China,0,16,0,16
22394,2021,Liberia,China,0,6,0,6
22395,2021,Nigeria,China,0,65,0,65
22396,2021,Pakistan,China,32,9,0,41
22397,2021,Rwanda,China,0,9,0,9
22398,2021,Somalia,China,111,5,0,116
22399,2021,Viet Nam,China,303107,0,0,303107
22400,2021,Syrian Arab Rep.,China,43,5,0,48
22401,2021,Uganda,China,5,116,0,121
22402,2021,Yemen,China,31,10,0,41
22403,2021,Zambia,China,0,5,0,5
22404,2021,Zimbabwe,China,6,74,0,80
22405,2021,Afghanistan,Chile,13,87,0,100
22406,2021,Angola,Chile,0,5,0,5
22407,2021,Bangladesh,Chile,0,7,0,7
22408,2021,Bolivia (Plurinational State of),Chile,0,21,0,21
22409,2021,Congo,Chile,8,5,0,13
22410,2021,Dem. Rep. of the Congo,Chile,5,0,0,5
22411,2021,Colombia,Chile,1234,3289,0,4523
22412,2021,Costa Rica,Chile,5,0,0,5
22413,2021,Cuba,Chile,19,1590,0,1609
22414,2021,Dominican Rep.,Chile,0,128,0,128
22415,2021,Ecuador,Chile,23,29,0,52
22416,2021,Palestinian,Chile,15,7,0,22
22417,2021,Ghana,Chile,0,8,0,8
22418,2021,Guatemala,Chile,0,5,0,5
22419,2021,Haiti,Chile,0,55,0,55
22420,2021,Honduras,Chile,5,0,0,5
22421,2021,Iraq,Chile,0,14,0,14
22422,2021,Kenya,Chile,5,0,0,5
22423,2021,Rep. of Korea,Chile,0,5,0,5
22424,2021,Sri Lanka,Chile,5,0,0,5
22425,2021,Nicaragua,Chile,0,5,0,5
22426,2021,Pakistan,Chile,0,7,0,7
22427,2021,Peru,Chile,113,51,0,164
22428,2021,Russian Federation,Chile,5,7,0,12
22429,2021,El Salvador,Chile,9,27,0,36
22430,2021,Senegal,Chile,5,0,0,5
22431,2021,Sierra Leone,Chile,0,5,0,5
22432,2021,Syrian Arab Rep.,Chile,113,32,0,145
22433,2021,Türkiye,Chile,27,5,0,32
22434,2021,United States of America,Chile,0,5,0,5
22435,2021,Venezuela (Bolivarian Republic of),Chile,22,4714,0,4736
22437,2021,Angola,Cameroon,5,0,0,5
22438,2021,Burundi,Cameroon,54,20,0,74
22439,2021,Burkina Faso,Cameroon,0,26,0,26
22440,2021,Central African Rep.,Cameroon,333878,5623,0,339501
22441,2021,Chad,Cameroon,1445,417,0,1862
22442,2021,Cameroon,Cameroon,0,0,933138,0
22443,2021,Congo,Cameroon,40,9,0,49
22444,2021,Dem. Rep. of the Congo,Cameroon,460,136,0,596
22445,2021,Gambia,Cameroon,0,5,0,5
22446,2021,Guinea,Cameroon,7,208,0,215
22447,2021,Cote d'Ivoire,Cameroon,57,42,0,99
22448,2021,Iran (Islamic Rep. of),Cameroon,5,0,0,5
22449,2021,Liberia,Cameroon,9,5,0,14
22450,2021,Mauritania,Cameroon,5,5,0,10
22451,2021,Mali,Cameroon,16,360,0,376
22452,2021,Morocco,Cameroon,7,0,0,7
22453,2021,Niger,Cameroon,0,915,0,915
22454,2021,Nigeria,Cameroon,120928,31,0,120959
22455,2021,Rwanda,Cameroon,260,152,0,412
22456,2021,Senegal,Cameroon,0,8,0,8
22457,2021,Sierra Leone,Cameroon,0,5,0,5
22458,2021,Sudan,Cameroon,65,26,0,91
22459,2021,Syrian Arab Rep.,Cameroon,5,10,0,15
22460,2021,Togo,Cameroon,18,15,0,33
22461,2021,Yemen,Cameroon,5,0,0,5
22462,2021,Angola,Congo,7,45,0,52
22463,2021,Egypt,Congo,0,0,0,0
22464,2021,Burundi,Congo,75,8,0,83
22465,2021,Central African Rep.,Congo,25918,2997,0,28915
22466,2021,Chad,Congo,28,27,0,55
22467,2021,Cameroon,Congo,5,22,0,27
22468,2021,Congo,Congo,0,0,134430,0
22469,2021,Dem. Rep. of the Congo,Congo,12121,9982,0,22103
22470,2021,Guinea,Congo,0,5,0,5
22471,2021,Cote d'Ivoire,Congo,5,5,0,10
22472,2021,Mauritania,Congo,5,45,0,50
22473,2021,Mali,Congo,5,0,0,5
22474,2021,Nigeria,Congo,5,0,0,5
22475,2021,Rwanda,Congo,2556,480,0,3036
22476,2021,Sudan,Congo,30,41,0,71
22477,2021,Syrian Arab Rep.,Congo,5,13,0,18
22478,2021,Angola,Dem. Rep. of the Congo,417,25,0,442
22479,2021,Burundi,Dem. Rep. of the Congo,41031,1114,0,42145
22480,2021,Central African Rep.,Dem. Rep. of the Congo,212630,63,0,212693
22481,2021,Chad,Dem. Rep. of the Congo,5,15,0,20
22482,2021,Cameroon,Dem. Rep. of the Congo,0,19,0,19
22483,2021,Congo,Dem. Rep. of the Congo,647,25,0,672
22484,2021,Dem. Rep. of the Congo,Dem. Rep. of the Congo,0,0,5407840,0
22485,2021,Eritrea,Dem. Rep. of the Congo,7,0,0,7
22486,2021,Ethiopia,Dem. Rep. of the Congo,0,5,0,5
22487,2021,Palestinian,Dem. Rep. of the Congo,0,6,0,6
22488,2021,Cote d'Ivoire,Dem. Rep. of the Congo,12,8,0,20
22489,2021,Liberia,Dem. Rep. of the Congo,5,10,0,15
22490,2021,Lebanon,Dem. Rep. of the Congo,0,5,0,5
22491,2021,Mali,Dem. Rep. of the Congo,0,11,0,11
22492,2021,Niger,Dem. Rep. of the Congo,0,5,0,5
22493,2021,Romania,Dem. Rep. of the Congo,0,5,0,5
22494,2021,Rwanda,Dem. Rep. of the Congo,210978,74,0,211052
22495,2021,Somalia,Dem. Rep. of the Congo,15,73,0,88
22496,2021,Sudan,Dem. Rep. of the Congo,2023,7,0,2030
22497,2021,South Sudan,Dem. Rep. of the Congo,56341,731,0,57072
22498,2021,Syrian Arab Rep.,Dem. Rep. of the Congo,12,12,0,24
22499,2021,Uganda,Dem. Rep. of the Congo,25,0,0,25
22500,2021,Zimbabwe,Dem. Rep. of the Congo,0,5,0,5
22501,2021,Dem. Rep. of the Congo,Comoros,27,0,0,27
22502,2021,Afghanistan,Colombia,9,0,0,9
22503,2021,Bolivia (Plurinational State of),Colombia,5,0,0,5
22504,2021,Colombia,Colombia,0,0,6766002,0
22505,2021,Cuba,Colombia,88,98,0,186
22506,2021,Ecuador,Colombia,5,7,0,12
22507,2021,Eritrea,Colombia,5,0,0,5
22508,2021,Ethiopia,Colombia,7,0,0,7
22509,2021,Ghana,Colombia,5,0,0,5
22510,2021,Haiti,Colombia,0,5,0,5
22511,2021,Honduras,Colombia,5,0,0,5
22512,2021,Hungary,Colombia,5,0,0,5
22513,2021,Iraq,Colombia,8,0,0,8
22514,2021,Liberia,Colombia,5,0,0,5
22515,2021,Nicaragua,Colombia,10,0,0,10
22516,2021,El Salvador,Colombia,7,5,0,12
22517,2021,Serbia and Kosovo: S/RES/1244 (1999),Colombia,5,0,0,5
22518,2021,Sierra Leone,Colombia,5,0,0,5
22519,2021,Somalia,Colombia,11,0,0,11
22520,2021,Syrian Arab Rep.,Colombia,11,7,0,18
22521,2021,Türkiye,Colombia,6,8,0,14
22522,2021,Venezuela (Bolivarian Republic of),Colombia,1297,28785,0,30082
22523,2021,Yemen,Colombia,0,5,0,5
22526,2021,Angola,Costa Rica,0,62,0,62
22527,2021,Argentina,Costa Rica,0,37,0,37
22528,2021,Burundi,Costa Rica,9,0,0,9
22529,2021,Bangladesh,Costa Rica,0,16,0,16
22530,2021,Burkina Faso,Costa Rica,0,5,0,5
22531,2021,Belarus,Costa Rica,0,5,0,5
22532,2021,Bolivia (Plurinational State of),Costa Rica,0,13,0,13
22533,2021,Brazil,Costa Rica,0,165,0,165
22534,2021,China,Costa Rica,0,309,0,309
22535,2021,Chile,Costa Rica,0,55,0,55
22536,2021,Cameroon,Costa Rica,0,22,0,22
22537,2021,Congo,Costa Rica,0,57,0,57
22538,2021,Dem. Rep. of the Congo,Costa Rica,12,65,0,77
22539,2021,Colombia,Costa Rica,2317,1535,0,3852
22540,2021,Costa Rica,Costa Rica,0,0,0,0
22541,2021,Cuba,Costa Rica,463,2795,0,3258
22542,2021,Dominican Rep.,Costa Rica,0,105,0,105
22543,2021,Ecuador,Costa Rica,0,58,0,58
22544,2021,Eritrea,Costa Rica,0,7,0,7
22545,2021,Ethiopia,Costa Rica,5,0,0,5
22546,2021,French Guiana,Costa Rica,0,5,0,5
22547,2021,Gambia,Costa Rica,0,5,0,5
22548,2021,Germany,Costa Rica,0,19,0,19
22549,2021,Ghana,Costa Rica,0,58,0,58
22550,2021,Greece,Costa Rica,0,5,0,5
22551,2021,Guatemala,Costa Rica,25,108,0,133
22552,2021,Guyana,Costa Rica,0,9,0,9
22553,2021,Haiti,Costa Rica,12,910,0,922
22554,2021,Honduras,Costa Rica,207,966,0,1173
22555,2021,Cote d'Ivoire,Costa Rica,0,6,0,6
22556,2021,India,Costa Rica,0,6,0,6
22557,2021,Indonesia,Costa Rica,5,0,0,5
22558,2021,Iran (Islamic Rep. of),Costa Rica,5,0,0,5
22559,2021,Iraq,Costa Rica,5,0,0,5
22560,2021,Israel,Costa Rica,0,6,0,6
22561,2021,Italy,Costa Rica,0,6,0,6
22562,2021,Jamaica,Costa Rica,0,32,0,32
22563,2021,Lebanon,Costa Rica,0,5,0,5
22564,2021,Latvia,Costa Rica,0,5,0,5
22565,2021,Mexico,Costa Rica,13,53,0,66
22566,2021,Nepal,Costa Rica,0,102,0,102
22567,2021,Niger,Costa Rica,0,5,0,5
22568,2021,Nicaragua,Costa Rica,4027,137274,0,141301
22569,2021,Nigeria,Costa Rica,17,5,0,22
22570,2021,Pakistan,Costa Rica,5,11,0,16
22571,2021,Panama,Costa Rica,6,56,0,62
22572,2021,Peru,Costa Rica,13,53,0,66
22573,2021,Poland,Costa Rica,0,5,0,5
22574,2021,Romania,Costa Rica,0,5,0,5
22575,2021,South Africa,Costa Rica,0,6,0,6
22576,2021,Russian Federation,Costa Rica,27,24,0,51
22577,2021,El Salvador,Costa Rica,1529,53,0,1582
22578,2021,Senegal,Costa Rica,0,5,0,5
22579,2021,Somalia,Costa Rica,7,7,0,14
22580,2021,Spain,Costa Rica,0,9,0,9
22581,2021,Syrian Arab Rep.,Costa Rica,5,25,0,30
22582,2021,Türkiye,Costa Rica,0,5,0,5
22583,2021,Ukraine,Costa Rica,13,5,0,18
22584,2021,Uruguay,Costa Rica,0,5,0,5
22585,2021,United States of America,Costa Rica,5,39,0,44
22586,2021,Venezuela (Bolivarian Republic of),Costa Rica,1492,7288,0,8780
22587,2021,Zimbabwe,Costa Rica,0,5,0,5
22589,2021,Afghanistan,Cuba,17,0,0,17
22590,2021,Cuba,Cuba,0,0,0,0
22591,2021,Eritrea,Cuba,5,0,0,5
22592,2021,Ethiopia,Cuba,6,0,0,6
22593,2021,Haiti,Cuba,5,0,0,5
22594,2021,Iran (Islamic Rep. of),Cuba,7,5,0,12
22595,2021,Sudan,Cuba,10,0,0,10
22596,2021,Syrian Arab Rep.,Cuba,36,9,0,45
22597,2021,Western Sahara,Cuba,99,0,0,99
22598,2021,Yemen,Cuba,14,0,0,14
22600,2021,Afghanistan,Cyprus,17,143,0,160
22601,2021,Albania,Cyprus,0,5,0,5
22602,2021,Algeria,Cyprus,8,0,0,8
22603,2021,Angola,Cyprus,0,15,0,15
22604,2021,Egypt,Cyprus,120,477,0,597
22605,2021,Armenia,Cyprus,26,16,0,42
22606,2021,Burundi,Cyprus,0,11,0,11
22607,2021,Bangladesh,Cyprus,10,1807,0,1817
22608,2021,Burkina Faso,Cyprus,0,10,0,10
22609,2021,Belarus,Cyprus,0,6,0,6
22610,2021,Bosnia and Herzegovina,Cyprus,15,0,0,15
22611,2021,Central African Rep.,Cyprus,0,5,0,5
22612,2021,China,Cyprus,5,9,0,14
22613,2021,Cameroon,Cyprus,131,2826,0,2957
22614,2021,Congo,Cyprus,10,160,0,170
22615,2021,Dem. Rep. of the Congo,Cyprus,36,2313,0,2349
22616,2021,Comoros,Cyprus,0,11,0,11
22617,2021,Djibouti,Cyprus,0,9,0,9
22618,2021,Eritrea,Cyprus,53,5,0,58
22619,2021,Ethiopia,Cyprus,10,14,0,24
22620,2021,Gabon,Cyprus,0,5,0,5
22621,2021,Gambia,Cyprus,6,50,0,56
22622,2021,Palestinian,Cyprus,2208,125,0,2333
22623,2021,Georgia,Cyprus,85,584,0,669
22624,2021,Ghana,Cyprus,0,31,0,31
22625,2021,Guinea-Bissau,Cyprus,0,5,0,5
22626,2021,Guinea,Cyprus,6,439,0,445
22627,2021,Haiti,Cyprus,0,5,0,5
22628,2021,Cote d'Ivoire,Cyprus,5,94,0,99
22629,2021,India,Cyprus,10,1971,0,1981
22630,2021,Iran (Islamic Rep. of),Cyprus,624,521,0,1145
22631,2021,Iraq,Cyprus,988,113,0,1101
22632,2021,Jordan,Cyprus,50,83,0,133
22633,2021,Kazakhstan,Cyprus,5,0,0,5
22634,2021,Kenya,Cyprus,0,5,0,5
22635,2021,Kyrgyzstan,Cyprus,5,0,0,5
22636,2021,Liberia,Cyprus,0,168,0,168
22637,2021,Libya,Cyprus,12,5,0,17
22638,2021,Lebanon,Cyprus,53,112,0,165
22639,2021,Sri Lanka,Cyprus,29,430,0,459
22640,2021,Rep. of Moldova,Cyprus,18,15,0,33
22641,2021,Mali,Cyprus,0,6,0,6
22642,2021,Mongolia,Cyprus,0,5,0,5
22643,2021,Morocco,Cyprus,0,11,0,11
22644,2021,Nepal,Cyprus,0,990,0,990
22645,2021,Niger,Cyprus,0,5,0,5
22646,2021,Nigeria,Cyprus,23,2139,0,2162
22647,2021,Pakistan,Cyprus,21,1460,0,1481
22648,2021,Philippines,Cyprus,12,180,0,192
22649,2021,South Africa,Cyprus,0,5,0,5
22650,2021,Russian Federation,Cyprus,77,75,0,152
22651,2021,Rwanda,Cyprus,5,6,0,11
22652,2021,Serbia and Kosovo: S/RES/1244 (1999),Cyprus,59,9,0,68
22653,2021,Senegal,Cyprus,0,39,0,39
22654,2021,Sierra Leone,Cyprus,24,616,0,640
22655,2021,Somalia,Cyprus,371,874,0,1245
22656,2021,Viet Nam,Cyprus,5,271,0,276
22657,2021,Sudan,Cyprus,14,8,0,22
22658,2021,Syrian Arab Rep.,Cyprus,10735,5545,0,16280
22659,2021,Turkmenistan,Cyprus,0,5,0,5
22660,2021,Togo,Cyprus,0,15,0,15
22661,2021,Türkiye,Cyprus,243,262,0,505
22662,2021,Ukraine,Cyprus,31,64,0,95
22663,2021,Uzbekistan,Cyprus,5,5,0,10
22664,2021,Yemen,Cyprus,41,28,0,69
22665,2021,Zimbabwe,Cyprus,0,23,0,23
22668,2021,Afghanistan,Czechia,150,36,0,186
22669,2021,Algeria,Czechia,0,8,0,8
22670,2021,Egypt,Czechia,7,10,0,17
22671,2021,Armenia,Czechia,21,6,0,27
22672,2021,Azerbaijan,Czechia,26,18,0,44
22673,2021,Burundi,Czechia,5,0,0,5
22674,2021,Belarus,Czechia,169,38,0,207
22675,2021,China,Czechia,62,0,0,62
22676,2021,Cameroon,Czechia,0,5,0,5
22677,2021,Dem. Rep. of the Congo,Czechia,6,5,0,11
22678,2021,Colombia,Czechia,0,5,0,5
22679,2021,Cuba,Czechia,36,11,0,47
22680,2021,Eritrea,Czechia,11,0,0,11
22681,2021,Ethiopia,Czechia,5,5,0,10
22682,2021,Georgia,Czechia,12,51,0,63
22683,2021,Guinea,Czechia,5,0,0,5
22684,2021,India,Czechia,0,5,0,5
22685,2021,Iran (Islamic Rep. of),Czechia,6,8,0,14
22686,2021,Iraq,Czechia,89,8,0,97
22687,2021,Kazakhstan,Czechia,76,17,0,93
22688,2021,Kyrgyzstan,Czechia,18,6,0,24
22689,2021,Libya,Czechia,22,5,0,27
22690,2021,Lebanon,Czechia,5,0,0,5
22691,2021,Sri Lanka,Czechia,7,0,0,7
22692,2021,Rep. of Moldova,Czechia,17,18,0,35
22693,2021,Mongolia,Czechia,10,8,0,18
22694,2021,Myanmar,Czechia,149,0,0,149
22695,2021,Nigeria,Czechia,8,9,0,17
22696,2021,Pakistan,Czechia,8,9,0,17
22697,2021,Russian Federation,Czechia,173,19,0,192
22698,2021,Saudi Arabia,Czechia,5,0,0,5
22699,2021,Serbia and Kosovo: S/RES/1244 (1999),Czechia,5,0,0,5
22700,2021,Sierra Leone,Czechia,5,0,0,5
22701,2021,Somalia,Czechia,16,10,0,26
22702,2021,Viet Nam,Czechia,14,28,0,42
22703,2021,Sudan,Czechia,9,0,0,9
22704,2021,Syrian Arab Rep.,Czechia,358,0,0,358
22705,2021,Tajikistan,Czechia,5,0,0,5
22706,2021,Turkmenistan,Czechia,7,0,0,7
22707,2021,Tunisia,Czechia,0,6,0,6
22708,2021,Türkiye,Czechia,11,27,0,38
22709,2021,Uganda,Czechia,5,0,0,5
22710,2021,Ukraine,Czechia,225,120,0,345
22711,2021,Uzbekistan,Czechia,35,17,0,52
22712,2021,Venezuela (Bolivarian Republic of),Czechia,7,8,0,15
22713,2021,Yemen,Czechia,24,5,0,29
22716,2021,Afghanistan,Denmark,1696,540,0,2236
22717,2021,Algeria,Denmark,0,10,0,10
22718,2021,Egypt,Denmark,17,6,0,23
22719,2021,Armenia,Denmark,76,17,0,93
22720,2021,Azerbaijan,Denmark,30,0,0,30
22721,2021,Bahrain,Denmark,0,5,0,5
22722,2021,Burundi,Denmark,5,0,0,5
22723,2021,Bangladesh,Denmark,19,0,0,19
22724,2021,Belarus,Denmark,5,12,0,17
22725,2021,Bosnia and Herzegovina,Denmark,5,0,0,5
22726,2021,China,Denmark,19,7,0,26
22727,2021,Cameroon,Denmark,8,5,0,13
22728,2021,Dem. Rep. of the Congo,Denmark,66,12,0,78
22729,2021,Colombia,Denmark,5,12,0,17
22730,2021,Eritrea,Denmark,5813,139,0,5952
22731,2021,Ethiopia,Denmark,94,13,0,107
22732,2021,Gambia,Denmark,5,5,0,10
22733,2021,Palestinian,Denmark,5,0,0,5
22734,2021,Georgia,Denmark,0,38,0,38
22735,2021,Ghana,Denmark,5,5,0,10
22736,2021,Guinea-Bissau,Denmark,5,0,0,5
22737,2021,Cote d'Ivoire,Denmark,14,0,0,14
22738,2021,India,Denmark,5,8,0,13
22739,2021,Iran (Islamic Rep. of),Denmark,2790,108,0,2898
22740,2021,Iraq,Denmark,274,54,0,328
22741,2021,Jordan,Denmark,0,10,0,10
22742,2021,Kenya,Denmark,5,0,0,5
22743,2021,Kyrgyzstan,Denmark,5,0,0,5
22744,2021,Libya,Denmark,5,5,0,10
22745,2021,Lebanon,Denmark,30,5,0,35
22746,2021,Sri Lanka,Denmark,35,0,0,35
22747,2021,North Macedonia,Denmark,0,5,0,5
22748,2021,Mongolia,Denmark,0,5,0,5
22749,2021,Morocco,Denmark,10,34,0,44
22750,2021,Myanmar,Denmark,13,5,0,18
22751,2021,Nepal,Denmark,5,0,0,5
22752,2021,Nicaragua,Denmark,13,0,0,13
22753,2021,Nigeria,Denmark,11,5,0,16
22754,2021,Pakistan,Denmark,66,20,0,86
22755,2021,Russian Federation,Denmark,630,29,0,659
22756,2021,Rwanda,Denmark,13,5,0,18
22757,2021,El Salvador,Denmark,5,0,0,5
22758,2021,Serbia and Kosovo: S/RES/1244 (1999),Denmark,0,5,0,5
22759,2021,Somalia,Denmark,1360,21,0,1381
22760,2021,Sudan,Denmark,53,9,0,62
22761,2021,Syrian Arab Rep.,Denmark,19706,222,0,19928
22762,2021,Thailand,Denmark,5,0,0,5
22763,2021,Tajikistan,Denmark,6,0,0,6
22764,2021,Tunisia,Denmark,5,10,0,15
22765,2021,Türkiye,Denmark,22,33,0,55
22766,2021,Uganda,Denmark,73,5,0,78
22767,2021,Ukraine,Denmark,29,14,0,43
22768,2021,United States of America,Denmark,0,5,0,5
22769,2021,Uzbekistan,Denmark,9,5,0,14
22770,2021,Venezuela (Bolivarian Republic of),Denmark,5,0,0,5
22771,2021,Yemen,Denmark,7,0,0,7
22772,2021,Zambia,Denmark,5,0,0,5
22773,2021,Zimbabwe,Denmark,8,0,0,8
22775,2021,Dem. Rep. of the Congo,Djibouti,0,18,0,18
22776,2021,Djibouti,Djibouti,0,0,0,0
22777,2021,Eritrea,Djibouti,617,381,0,998
22778,2021,Ethiopia,Djibouti,2158,10908,0,13066
22779,2021,Iraq,Djibouti,19,0,0,19
22780,2021,Mali,Djibouti,5,5,0,10
22781,2021,Somalia,Djibouti,14178,141,0,14319
22782,2021,Sudan,Djibouti,9,5,0,14
22783,2021,Syrian Arab Rep.,Djibouti,14,5,0,19
22784,2021,Yemen,Djibouti,6232,0,0,6232
22785,2021,Afghanistan,Dominican Rep.,0,8,0,8
22786,2021,Colombia,Dominican Rep.,0,5,0,5
22787,2021,Cuba,Dominican Rep.,0,51,0,51
22788,2021,Haiti,Dominican Rep.,162,285,0,447
22789,2021,Honduras,Dominican Rep.,0,5,0,5
22790,2021,Sri Lanka,Dominican Rep.,0,5,0,5
22791,2021,Nicaragua,Dominican Rep.,0,5,0,5
22792,2021,Venezuela (Bolivarian Republic of),Dominican Rep.,0,278,0,278
22793,2021,Afghanistan,Ecuador,147,0,0,147
22794,2021,Albania,Ecuador,6,0,0,6
22795,2021,Angola,Ecuador,5,0,0,5
22796,2021,Egypt,Ecuador,5,7,0,12
22797,2021,Bangladesh,Ecuador,5,0,0,5
22798,2021,Burkina Faso,Ecuador,5,0,0,5
22799,2021,Brazil,Ecuador,5,0,0,5
22800,2021,China,Ecuador,12,0,0,12
22801,2021,Chile,Ecuador,5,0,0,5
22802,2021,Cameroon,Ecuador,20,6,0,26
22803,2021,Congo,Ecuador,5,0,0,5
22804,2021,Dem. Rep. of the Congo,Ecuador,8,5,0,13
22805,2021,Colombia,Ecuador,54491,2719,0,57210
22806,2021,Cuba,Ecuador,219,61,0,280
22807,2021,Dominican Rep.,Ecuador,5,0,0,5
22808,2021,Eritrea,Ecuador,11,5,0,16
22809,2021,Ethiopia,Ecuador,5,0,0,5
22810,2021,Palestinian,Ecuador,11,6,0,17
22811,2021,Ghana,Ecuador,5,0,0,5
22812,2021,Guinea,Ecuador,9,0,0,9
22813,2021,Haiti,Ecuador,22,0,0,22
22814,2021,Cote d'Ivoire,Ecuador,5,0,0,5
22815,2021,India,Ecuador,5,5,0,10
22816,2021,Iran (Islamic Rep. of),Ecuador,67,5,0,72
22817,2021,Iraq,Ecuador,55,0,0,55
22818,2021,Liberia,Ecuador,6,0,0,6
22819,2021,Lebanon,Ecuador,19,12,0,31
22820,2021,Sri Lanka,Ecuador,18,5,0,23
22821,2021,Mali,Ecuador,5,0,0,5
22822,2021,Morocco,Ecuador,5,0,0,5
22823,2021,Nepal,Ecuador,5,0,0,5
22824,2021,Nicaragua,Ecuador,5,0,0,5
22825,2021,Nigeria,Ecuador,40,5,0,45
22826,2021,Pakistan,Ecuador,29,0,0,29
22827,2021,Panama,Ecuador,5,0,0,5
22828,2021,Peru,Ecuador,82,8,0,90
22829,2021,South Africa,Ecuador,0,5,0,5
22830,2021,Russian Federation,Ecuador,36,5,0,41
22831,2021,Rwanda,Ecuador,5,0,0,5
22832,2021,El Salvador,Ecuador,27,5,0,32
22833,2021,Saudi Arabia,Ecuador,8,0,0,8
22834,2021,Somalia,Ecuador,8,0,0,8
22835,2021,Spain,Ecuador,5,0,0,5
22836,2021,Viet Nam,Ecuador,5,0,0,5
22837,2021,Sudan,Ecuador,5,0,0,5
22838,2021,Syrian Arab Rep.,Ecuador,157,0,0,157
22839,2021,Türkiye,Ecuador,5,0,0,5
22840,2021,United Arab Emirates,Ecuador,5,0,0,5
22841,2021,Ukraine,Ecuador,15,0,0,15
22842,2021,United States of America,Ecuador,8,0,0,8
22843,2021,Uzbekistan,Ecuador,5,0,0,5
22844,2021,Venezuela (Bolivarian Republic of),Ecuador,798,4255,0,5053
22845,2021,Western Sahara,Ecuador,5,0,0,5
22846,2021,Yemen,Ecuador,117,12,0,129
22847,2021,Zimbabwe,Ecuador,6,6,0,12
22849,2021,Eritrea,Eritrea,0,0,0,0
22850,2021,Ethiopia,Eritrea,15,0,0,15
22851,2021,Sudan,Eritrea,99,0,0,99
22852,2021,South Sudan,Eritrea,7,0,0,7
22853,2021,Afghanistan,Estonia,20,5,0,25
22854,2021,Egypt,Estonia,5,0,0,5
22855,2021,Azerbaijan,Estonia,5,0,0,5
22856,2021,Belarus,Estonia,5,0,0,5
22857,2021,Eritrea,Estonia,10,0,0,10
22858,2021,Georgia,Estonia,5,0,0,5
22859,2021,Iran (Islamic Rep. of),Estonia,5,0,0,5
22860,2021,Iraq,Estonia,23,0,0,23
22861,2021,Sri Lanka,Estonia,5,0,0,5
22862,2021,Russian Federation,Estonia,53,5,0,58
22863,2021,Serbia and Kosovo: S/RES/1244 (1999),Estonia,6,0,0,6
22864,2021,Sudan,Estonia,16,0,0,16
22865,2021,Syrian Arab Rep.,Estonia,105,0,0,105
22866,2021,Türkiye,Estonia,25,5,0,30
22867,2021,Ukraine,Estonia,28,0,0,28
22868,2021,Yemen,Estonia,5,0,0,5
22870,2021,Egypt,Ethiopia,5,0,0,5
22871,2021,Burundi,Ethiopia,55,74,0,129
22872,2021,Chad,Ethiopia,0,5,0,5
22873,2021,Cameroon,Ethiopia,0,5,0,5
22874,2021,Dem. Rep. of the Congo,Ethiopia,769,294,0,1063
22875,2021,Cuba,Ethiopia,5,0,0,5
22876,2021,Djibouti,Ethiopia,56,5,0,61
22877,2021,Eritrea,Ethiopia,158294,236,0,158530
22878,2021,Ethiopia,Ethiopia,0,0,3646267,0
22879,2021,Palestinian,Ethiopia,0,14,0,14
22880,2021,Cote d'Ivoire,Ethiopia,5,0,0,5
22881,2021,Iraq,Ethiopia,10,0,0,10
22882,2021,Jordan,Ethiopia,0,19,0,19
22883,2021,Kenya,Ethiopia,4033,0,0,4033
22884,2021,Lebanon,Ethiopia,0,18,0,18
22885,2021,Mali,Ethiopia,0,5,0,5
22886,2021,Nigeria,Ethiopia,5,5,0,10
22887,2021,Rwanda,Ethiopia,11,7,0,18
22888,2021,Somalia,Ethiopia,223018,44,0,223062
22889,2021,Sudan,Ethiopia,45843,590,0,46433
22890,2021,South Sudan,Ethiopia,386750,179,0,386929
22891,2021,Syrian Arab Rep.,Ethiopia,38,629,0,667
22892,2021,Uganda,Ethiopia,13,5,0,18
22893,2021,Yemen,Ethiopia,2373,117,0,2490
22894,2021,Afghanistan,Fiji,8,0,0,8
22895,2021,Bangladesh,Fiji,5,0,0,5
22896,2021,Pakistan,Fiji,5,0,0,5
22897,2021,Afghanistan,Finland,3652,526,0,4178
22898,2021,Albania,Finland,5,5,0,10
22899,2021,Algeria,Finland,7,6,0,13
22900,2021,Angola,Finland,60,5,0,65
22901,2021,Egypt,Finland,40,5,0,45
22902,2021,Armenia,Finland,0,5,0,5
22903,2021,Azerbaijan,Finland,70,5,0,75
22904,2021,Burundi,Finland,6,0,0,6
22905,2021,Bangladesh,Finland,25,5,0,30
22906,2021,Burkina Faso,Finland,5,0,0,5
22907,2021,Belarus,Finland,16,5,0,21
22908,2021,Brazil,Finland,0,5,0,5
22909,2021,Cambodia,Finland,5,0,0,5
22910,2021,Central African Rep.,Finland,6,0,0,6
22911,2021,China,Finland,190,11,0,201
22912,2021,Cameroon,Finland,123,37,0,160
22913,2021,Congo,Finland,5,0,0,5
22914,2021,Dem. Rep. of the Congo,Finland,99,14,0,113
22915,2021,Colombia,Finland,0,11,0,11
22916,2021,Cuba,Finland,5,6,0,11
22917,2021,Dominican Rep.,Finland,5,0,0,5
22918,2021,Eritrea,Finland,869,6,0,875
22919,2021,Ethiopia,Finland,151,19,0,170
22920,2021,Gambia,Finland,28,9,0,37
22921,2021,Georgia,Finland,0,46,0,46
22922,2021,Ghana,Finland,35,12,0,47
22923,2021,Guatemala,Finland,5,0,0,5
22924,2021,Guinea,Finland,24,0,0,24
22925,2021,Honduras,Finland,28,17,0,45
22926,2021,Cote d'Ivoire,Finland,7,5,0,12
22927,2021,India,Finland,5,0,0,5
22928,2021,Indonesia,Finland,5,0,0,5
22929,2021,Iran (Islamic Rep. of),Finland,966,85,0,1051
22930,2021,Iraq,Finland,9166,590,0,9756
22931,2021,Jordan,Finland,6,5,0,11
22932,2021,Kazakhstan,Finland,8,0,0,8
22933,2021,Kenya,Finland,17,12,0,29
22934,2021,Kyrgyzstan,Finland,20,0,0,20
22935,2021,Liberia,Finland,6,0,0,6
22936,2021,Libya,Finland,34,6,0,40
22937,2021,Lebanon,Finland,13,6,0,19
22938,2021,Sri Lanka,Finland,33,6,0,39
22939,2021,Rep. of Moldova,Finland,6,0,0,6
22940,2021,Mali,Finland,8,0,0,8
22941,2021,Morocco,Finland,39,16,0,55
22942,2021,Myanmar,Finland,32,5,0,37
22943,2021,Nicaragua,Finland,63,36,0,99
22944,2021,Nigeria,Finland,139,57,0,196
22945,2021,Pakistan,Finland,75,23,0,98
22946,2021,Russian Federation,Finland,844,184,0,1028
22947,2021,Rwanda,Finland,39,28,0,67
22948,2021,El Salvador,Finland,10,5,0,15
22949,2021,Serbia and Kosovo: S/RES/1244 (1999),Finland,36,7,0,43
22950,2021,Senegal,Finland,5,0,0,5
22951,2021,Sierra Leone,Finland,5,10,0,15
22952,2021,Somalia,Finland,2512,226,0,2738
22953,2021,Viet Nam,Finland,8,0,0,8
22954,2021,Sudan,Finland,55,5,0,60
22955,2021,South Sudan,Finland,8,0,0,8
22956,2021,Syrian Arab Rep.,Finland,2660,66,0,2726
22957,2021,United Rep. of Tanzania,Finland,6,0,0,6
22958,2021,Tajikistan,Finland,9,0,0,9
22959,2021,Togo,Finland,5,0,0,5
22960,2021,Tunisia,Finland,5,0,0,5
22961,2021,Türkiye,Finland,819,149,0,968
22962,2021,Uganda,Finland,36,6,0,42
22963,2021,Ukraine,Finland,11,14,0,25
22964,2021,United States of America,Finland,0,5,0,5
22965,2021,Uzbekistan,Finland,10,0,0,10
22966,2021,Venezuela (Bolivarian Republic of),Finland,7,6,0,13
22967,2021,Yemen,Finland,311,12,0,323
22968,2021,Zimbabwe,Finland,6,0,0,6
22971,2021,Afghanistan,France,49990,9494,0,59484
22972,2021,Albania,France,9860,2932,0,12792
22973,2021,Algeria,France,3209,484,0,3693
22974,2021,Angola,France,6704,966,0,7670
22975,2021,Egypt,France,1586,395,0,1981
22976,2021,Argentina,France,12,5,0,17
22977,2021,Armenia,France,6407,659,0,7066
22978,2021,Azerbaijan,France,4667,241,0,4908
22979,2021,Bahrain,France,21,0,0,21
22980,2021,Burundi,France,1769,648,0,2417
22981,2021,Benin,France,162,277,0,439
22982,2021,Bangladesh,France,8608,5309,0,13917
22983,2021,Bhutan,France,173,0,0,173
22984,2021,Burkina Faso,France,492,322,0,814
22985,2021,Belarus,France,810,46,0,856
22986,2021,Bolivia (Plurinational State of),France,65,7,0,72
22987,2021,Brazil,France,57,26,0,83
22988,2021,Bosnia and Herzegovina,France,6921,192,0,7113
22989,2021,Bulgaria,France,70,0,0,70
22990,2021,Cambodia,France,11059,5,0,11064
22991,2021,Canada,France,5,0,0,5
22992,2021,Central African Rep.,France,5069,362,0,5431
22993,2021,Chad,France,3106,1210,0,4316
22994,2021,China,France,10015,248,0,10263
22995,2021,Chile,France,153,0,0,153
22996,2021,Cameroon,France,2485,1355,0,3840
22997,2021,Congo,France,5661,794,0,6455
22998,2021,Dem. Rep. of the Congo,France,31133,2940,0,34073
22999,2021,Comoros,France,1633,1209,0,2842
23000,2021,Colombia,France,1036,634,0,1670
23001,2021,Cuba,France,304,180,0,484
23002,2021,Cabo Verde,France,0,5,0,5
23003,2021,Djibouti,France,518,141,0,659
23004,2021,Dominica,France,5,0,0,5
23005,2021,Dominican Rep.,France,136,36,0,172
23006,2021,Ecuador,France,37,0,0,37
23007,2021,Equatorial Guinea,France,60,0,0,60
23008,2021,Eritrea,France,10723,944,0,11667
23009,2021,Estonia,France,5,0,0,5
23010,2021,Ethiopia,France,2899,499,0,3398
23011,2021,Gabon,France,457,404,0,861
23012,2021,Gambia,France,506,345,0,851
23013,2021,Palestinian,France,1954,38,0,1992
23014,2021,Georgia,France,5760,2274,0,8034
23015,2021,Ghana,France,589,53,0,642
23016,2021,Guinea-Bissau,France,1287,35,0,1322
23017,2021,Guatemala,France,21,5,0,26
23018,2021,Guinea,France,19979,3216,0,23195
23019,2021,Guyana,France,29,0,0,29
23020,2021,Haiti,France,6666,629,0,7295
23021,2021,Honduras,France,48,6,0,54
23022,2021,Croatia,France,63,0,0,63
23023,2021,Hungary,France,74,0,0,74
23024,2021,Cote d'Ivoire,France,10842,4019,0,14861
23025,2021,India,France,319,25,0,344
23026,2021,Indonesia,France,9,0,0,9
23027,2021,Iran (Islamic Rep. of),France,3967,391,0,4358
23028,2021,Iraq,France,13830,751,0,14581
23029,2021,Israel,France,9,0,0,9
23030,2021,Jamaica,France,39,0,0,39
23031,2021,Jordan,France,61,5,0,66
23032,2021,Kazakhstan,France,1047,37,0,1084
23033,2021,Kenya,France,190,0,0,190
23034,2021,Kyrgyzstan,France,526,30,0,556
23035,2021,Kuwait,France,435,64,0,499
23036,2021,Lao People's Dem. Rep.,France,6532,0,0,6532
23037,2021,Liberia,France,334,22,0,356
23038,2021,Libya,France,2259,269,0,2528
23039,2021,Saint Lucia,France,7,0,0,7
23040,2021,Lebanon,France,301,160,0,461
23041,2021,Sri Lanka,France,33792,614,0,34406
23042,2021,Lithuania,France,6,0,0,6
23043,2021,Latvia,France,38,0,0,38
23044,2021,Madagascar,France,388,295,0,683
23045,2021,Mauritania,France,7860,1123,0,8983
23046,2021,North Macedonia,France,723,254,0,977
23047,2021,Rep. of Moldova,France,449,282,0,731
23048,2021,Maldives,France,6,0,0,6
23049,2021,Mexico,France,36,5,0,41
23050,2021,Mali,France,7561,1881,0,9442
23051,2021,Malaysia,France,28,5,0,33
23052,2021,Mongolia,France,832,48,0,880
23053,2021,Morocco,France,1296,207,0,1503
23054,2021,Mozambique,France,19,0,0,19
23055,2021,Montenegro,France,197,6,0,203
23056,2021,Mauritius,France,44,0,0,44
23057,2021,Myanmar,France,355,12,0,367
23058,2021,Nepal,France,217,35,0,252
23059,2021,Niger,France,197,34,0,231
23060,2021,Nicaragua,France,68,7,0,75
23061,2021,Nigeria,France,5491,4010,0,9501
23062,2021,Pakistan,France,2742,1810,0,4552
23063,2021,Paraguay,France,9,5,0,14
23064,2021,Peru,France,473,41,0,514
23065,2021,Philippines,France,7,6,0,13
23066,2021,Poland,France,135,0,0,135
23067,2021,Romania,France,171,5,0,176
23068,2021,South Africa,France,142,7,0,149
23069,2021,Russian Federation,France,32918,1281,0,34199
23070,2021,Rwanda,France,4432,412,0,4844
23071,2021,El Salvador,France,111,5,0,116
23072,2021,Saudi Arabia,France,42,0,0,42
23073,2021,Serbia and Kosovo: S/RES/1244 (1999),France,17972,1190,0,19162
23074,2021,Senegal,France,2682,1136,0,3818
23075,2021,Sierra Leone,France,1117,326,0,1443
23076,2021,Somalia,France,9048,4209,0,13257
23077,2021,Viet Nam,France,8018,0,0,8018
23078,2021,Sudan,France,23719,1238,0,24957
23079,2021,Suriname,France,11,17,0,28
23080,2021,South Sudan,France,218,0,0,218
23081,2021,Slovakia,France,142,0,0,142
23082,2021,Syrian Arab Rep.,France,37375,1369,0,38744
23083,2021,United Rep. of Tanzania,France,27,8,0,35
23084,2021,Thailand,France,15,5,0,20
23085,2021,Tajikistan,France,121,25,0,146
23086,2021,Turkmenistan,France,41,0,0,41
23087,2021,Togo,France,1091,213,0,1304
23088,2021,Tunisia,France,563,91,0,654
23089,2021,Türkiye,France,16053,5211,0,21264
23090,2021,Uganda,France,215,15,0,230
23091,2021,Ukraine,France,2801,588,0,3389
23092,2021,United States of America,France,9,5,0,14
23093,2021,Uzbekistan,France,300,5,0,305
23094,2021,Venezuela (Bolivarian Republic of),France,1232,425,0,1657
23095,2021,Western Sahara,France,855,83,0,938
23096,2021,Yemen,France,921,95,0,1016
23097,2021,Zimbabwe,France,85,5,0,90
23101,2021,Burundi,Gabon,6,0,0,6
23102,2021,Central African Rep.,Gabon,19,10,0,29
23103,2021,Chad,Gabon,86,13,0,99
23104,2021,Cameroon,Gabon,5,5,0,10
23105,2021,Congo,Gabon,60,0,0,60
23106,2021,Dem. Rep. of the Congo,Gabon,73,25,0,98
23107,2021,Mauritania,Gabon,6,0,0,6
23108,2021,Sao Tome and Principe,Gabon,6,0,0,6
23109,2021,Sudan,Gabon,5,0,0,5
23110,2021,Togo,Gabon,6,0,0,6
23111,2021,Central African Rep.,Gambia,8,8,0,16
23112,2021,Congo,Gambia,6,5,0,11
23113,2021,Dem. Rep. of the Congo,Gambia,61,7,0,68
23114,2021,Guinea-Bissau,Gambia,0,6,0,6
23115,2021,Guinea,Gambia,5,5,0,10
23116,2021,Cote d'Ivoire,Gambia,150,6,0,156
23117,2021,Liberia,Gambia,15,0,0,15
23118,2021,Rwanda,Gambia,5,0,0,5
23119,2021,Senegal,Gambia,4045,159,0,4204
23120,2021,Sierra Leone,Gambia,105,11,0,116
23121,2021,Togo,Gambia,18,0,0,18
23122,2021,Afghanistan,United Kingdom of Great Britain and Northern Ireland,9642,4943,0,14585
23123,2021,Albania,United Kingdom of Great Britain and Northern Ireland,4153,12103,0,16256
23124,2021,Algeria,United Kingdom of Great Britain and Northern Ireland,312,529,0,841
23125,2021,Angola,United Kingdom of Great Britain and Northern Ireland,139,154,0,293
23126,2021,Antigua and Barbuda,United Kingdom of Great Britain and Northern Ireland,5,12,0,17
23127,2021,Egypt,United Kingdom of Great Britain and Northern Ireland,978,1039,0,2017
23128,2021,Argentina,United Kingdom of Great Britain and Northern Ireland,0,22,0,22
23129,2021,Armenia,United Kingdom of Great Britain and Northern Ireland,56,10,0,66
23130,2021,Australia,United Kingdom of Great Britain and Northern Ireland,5,0,0,5
23131,2021,Azerbaijan,United Kingdom of Great Britain and Northern Ireland,143,71,0,214
23132,2021,Bahrain,United Kingdom of Great Britain and Northern Ireland,116,6,0,122
23133,2021,Barbados,United Kingdom of Great Britain and Northern Ireland,15,17,0,32
23134,2021,Burundi,United Kingdom of Great Britain and Northern Ireland,52,19,0,71
23135,2021,Benin,United Kingdom of Great Britain and Northern Ireland,9,29,0,38
23136,2021,Bangladesh,United Kingdom of Great Britain and Northern Ireland,1781,3114,0,4895
23137,2021,Bhutan,United Kingdom of Great Britain and Northern Ireland,23,0,0,23
23138,2021,Burkina Faso,United Kingdom of Great Britain and Northern Ireland,12,12,0,24
23139,2021,Belarus,United Kingdom of Great Britain and Northern Ireland,101,72,0,173
23140,2021,Bolivia (Plurinational State of),United Kingdom of Great Britain and Northern Ireland,19,19,0,38
23141,2021,Botswana,United Kingdom of Great Britain and Northern Ireland,33,105,0,138
23142,2021,Brazil,United Kingdom of Great Britain and Northern Ireland,39,273,0,312
23143,2021,Bosnia and Herzegovina,United Kingdom of Great Britain and Northern Ireland,12,5,0,17
23144,2021,Belize,United Kingdom of Great Britain and Northern Ireland,0,5,0,5
23145,2021,Canada,United Kingdom of Great Britain and Northern Ireland,11,15,0,26
23146,2021,Central African Rep.,United Kingdom of Great Britain and Northern Ireland,10,16,0,26
23147,2021,Chad,United Kingdom of Great Britain and Northern Ireland,107,282,0,389
23148,2021,China,United Kingdom of Great Britain and Northern Ireland,1026,2428,0,3454
23149,2021,Chile,United Kingdom of Great Britain and Northern Ireland,0,10,0,10
23150,2021,Cameroon,United Kingdom of Great Britain and Northern Ireland,776,378,0,1154
23151,2021,Congo,United Kingdom of Great Britain and Northern Ireland,89,60,0,149
23152,2021,Dem. Rep. of the Congo,United Kingdom of Great Britain and Northern Ireland,929,225,0,1154
23153,2021,Comoros,United Kingdom of Great Britain and Northern Ireland,5,0,0,5
23154,2021,Colombia,United Kingdom of Great Britain and Northern Ireland,15,58,0,73
23155,2021,Costa Rica,United Kingdom of Great Britain and Northern Ireland,0,7,0,7
23156,2021,Cuba,United Kingdom of Great Britain and Northern Ireland,12,16,0,28
23157,2021,Cabo Verde,United Kingdom of Great Britain and Northern Ireland,5,0,0,5
23158,2021,Cyprus,United Kingdom of Great Britain and Northern Ireland,0,5,0,5
23159,2021,Djibouti,United Kingdom of Great Britain and Northern Ireland,6,5,0,11
23160,2021,Dominica,United Kingdom of Great Britain and Northern Ireland,22,25,0,47
23161,2021,Dominican Rep.,United Kingdom of Great Britain and Northern Ireland,0,5,0,5
23162,2021,Ecuador,United Kingdom of Great Britain and Northern Ireland,5,18,0,23
23163,2021,Equatorial Guinea,United Kingdom of Great Britain and Northern Ireland,0,9,0,9
23164,2021,Eritrea,United Kingdom of Great Britain and Northern Ireland,14753,6489,0,21242
23165,2021,Ethiopia,United Kingdom of Great Britain and Northern Ireland,1921,1323,0,3244
23166,2021,Fiji,United Kingdom of Great Britain and Northern Ireland,8,0,0,8
23167,2021,Gabon,United Kingdom of Great Britain and Northern Ireland,8,7,0,15
23168,2021,Gambia,United Kingdom of Great Britain and Northern Ireland,923,276,0,1199
23169,2021,Palestinian,United Kingdom of Great Britain and Northern Ireland,599,548,0,1147
23170,2021,United Kingdom of Great Britain and Northern Ireland,United Kingdom of Great Britain and Northern Ireland,20,0,0,20
23171,2021,Georgia,United Kingdom of Great Britain and Northern Ireland,74,715,0,789
23172,2021,Ghana,United Kingdom of Great Britain and Northern Ireland,364,426,0,790
23173,2021,Guinea-Bissau,United Kingdom of Great Britain and Northern Ireland,7,8,0,15
23174,2021,Greece,United Kingdom of Great Britain and Northern Ireland,5,5,0,10
23175,2021,Grenada,United Kingdom of Great Britain and Northern Ireland,24,43,0,67
23176,2021,Guatemala,United Kingdom of Great Britain and Northern Ireland,9,26,0,35
23177,2021,Guinea,United Kingdom of Great Britain and Northern Ireland,210,146,0,356
23178,2021,Guyana,United Kingdom of Great Britain and Northern Ireland,20,6,0,26
23179,2021,Haiti,United Kingdom of Great Britain and Northern Ireland,0,11,0,11
23180,2021,"China, Hong Kong SAR",United Kingdom of Great Britain and Northern Ireland,15,0,0,15
23181,2021,Honduras,United Kingdom of Great Britain and Northern Ireland,119,765,0,884
23182,2021,Cote d'Ivoire,United Kingdom of Great Britain and Northern Ireland,197,109,0,306
23183,2021,India,United Kingdom of Great Britain and Northern Ireland,508,2679,0,3187
23184,2021,Indonesia,United Kingdom of Great Britain and Northern Ireland,41,89,0,130
23185,2021,Iran (Islamic Rep. of),United Kingdom of Great Britain and Northern Ireland,21434,13754,0,35188
23186,2021,Iraq,United Kingdom of Great Britain and Northern Ireland,7263,12068,0,19331
23187,2021,Israel,United Kingdom of Great Britain and Northern Ireland,120,15,0,135
23188,2021,Italy,United Kingdom of Great Britain and Northern Ireland,5,0,0,5
23189,2021,Jamaica,United Kingdom of Great Britain and Northern Ireland,264,201,0,465
23190,2021,Jordan,United Kingdom of Great Britain and Northern Ireland,110,132,0,242
23191,2021,Japan,United Kingdom of Great Britain and Northern Ireland,0,7,0,7
23192,2021,Kazakhstan,United Kingdom of Great Britain and Northern Ireland,42,66,0,108
23193,2021,Kenya,United Kingdom of Great Britain and Northern Ireland,316,342,0,658
23194,2021,Kyrgyzstan,United Kingdom of Great Britain and Northern Ireland,38,20,0,58
23195,2021,Rep. of Korea,United Kingdom of Great Britain and Northern Ireland,5,0,0,5
23196,2021,Dem. People's Rep. of Korea,United Kingdom of Great Britain and Northern Ireland,51,21,0,72
23197,2021,Kuwait,United Kingdom of Great Britain and Northern Ireland,692,1062,0,1754
23198,2021,Lao People's Dem. Rep.,United Kingdom of Great Britain and Northern Ireland,5,0,0,5
23199,2021,Liberia,United Kingdom of Great Britain and Northern Ireland,29,28,0,57
23200,2021,Libya,United Kingdom of Great Britain and Northern Ireland,4468,856,0,5324
23201,2021,Saint Lucia,United Kingdom of Great Britain and Northern Ireland,26,44,0,70
23202,2021,Lebanon,United Kingdom of Great Britain and Northern Ireland,205,176,0,381
23203,2021,Sri Lanka,United Kingdom of Great Britain and Northern Ireland,4668,1591,0,6259
23204,2021,Lithuania,United Kingdom of Great Britain and Northern Ireland,0,5,0,5
23205,2021,Mauritania,United Kingdom of Great Britain and Northern Ireland,7,7,0,14
23206,2021,North Macedonia,United Kingdom of Great Britain and Northern Ireland,15,11,0,26
23207,2021,Rep. of Moldova,United Kingdom of Great Britain and Northern Ireland,5,5,0,10
23208,2021,Maldives,United Kingdom of Great Britain and Northern Ireland,46,0,0,46
23209,2021,Mexico,United Kingdom of Great Britain and Northern Ireland,16,75,0,91
23210,2021,Mali,United Kingdom of Great Britain and Northern Ireland,28,67,0,95
23211,2021,Malaysia,United Kingdom of Great Britain and Northern Ireland,307,417,0,724
23212,2021,Malawi,United Kingdom of Great Britain and Northern Ireland,293,73,0,366
23213,2021,Mongolia,United Kingdom of Great Britain and Northern Ireland,53,66,0,119
23214,2021,Morocco,United Kingdom of Great Britain and Northern Ireland,221,368,0,589
23215,2021,Mozambique,United Kingdom of Great Britain and Northern Ireland,7,5,0,12
23216,2021,Mauritius,United Kingdom of Great Britain and Northern Ireland,69,106,0,175
23217,2021,Myanmar,United Kingdom of Great Britain and Northern Ireland,367,87,0,454
23218,2021,Namibia,United Kingdom of Great Britain and Northern Ireland,193,784,0,977
23219,2021,Nepal,United Kingdom of Great Britain and Northern Ireland,63,447,0,510
23220,2021,Netherlands,United Kingdom of Great Britain and Northern Ireland,5,0,0,5
23221,2021,Niger,United Kingdom of Great Britain and Northern Ireland,194,24,0,218
23222,2021,Nicaragua,United Kingdom of Great Britain and Northern Ireland,54,165,0,219
23223,2021,Nigeria,United Kingdom of Great Britain and Northern Ireland,3101,3001,0,6102
23224,2021,Norway,United Kingdom of Great Britain and Northern Ireland,5,0,0,5
23225,2021,Oman,United Kingdom of Great Britain and Northern Ireland,22,24,0,46
23226,2021,Pakistan,United Kingdom of Great Britain and Northern Ireland,8245,4420,0,12665
23227,2021,Peru,United Kingdom of Great Britain and Northern Ireland,0,9,0,9
23228,2021,Philippines,United Kingdom of Great Britain and Northern Ireland,61,592,0,653
23229,2021,Poland,United Kingdom of Great Britain and Northern Ireland,0,5,0,5
23230,2021,Qatar,United Kingdom of Great Britain and Northern Ireland,17,11,0,28
23231,2021,Romania,United Kingdom of Great Britain and Northern Ireland,0,11,0,11
23232,2021,South Africa,United Kingdom of Great Britain and Northern Ireland,126,119,0,245
23233,2021,Russian Federation,United Kingdom of Great Britain and Northern Ireland,876,704,0,1580
23234,2021,Rwanda,United Kingdom of Great Britain and Northern Ireland,98,38,0,136
23235,2021,El Salvador,United Kingdom of Great Britain and Northern Ireland,820,2287,0,3107
23236,2021,Saudi Arabia,United Kingdom of Great Britain and Northern Ireland,288,195,0,483
23237,2021,Serbia and Kosovo: S/RES/1244 (1999),United Kingdom of Great Britain and Northern Ireland,77,56,0,133
23238,2021,Senegal,United Kingdom of Great Britain and Northern Ireland,98,66,0,164
23239,2021,Seychelles,United Kingdom of Great Britain and Northern Ireland,9,0,0,9
23240,2021,Singapore,United Kingdom of Great Britain and Northern Ireland,5,10,0,15
23241,2021,Sierra Leone,United Kingdom of Great Britain and Northern Ireland,328,309,0,637
23242,2021,Somalia,United Kingdom of Great Britain and Northern Ireland,2488,1141,0,3629
23243,2021,Viet Nam,United Kingdom of Great Britain and Northern Ireland,2772,3904,0,6676
23244,2021,Saint Kitts and Nevis,United Kingdom of Great Britain and Northern Ireland,6,21,0,27
23245,2021,Sudan,United Kingdom of Great Britain and Northern Ireland,11305,3577,0,14882
23246,2021,South Sudan,United Kingdom of Great Britain and Northern Ireland,78,135,0,213
23247,2021,Eswatini,United Kingdom of Great Britain and Northern Ireland,55,5,0,60
23248,2021,Sweden,United Kingdom of Great Britain and Northern Ireland,0,5,0,5
23249,2021,Syrian Arab Rep.,United Kingdom of Great Britain and Northern Ireland,11980,4795,0,16775
23250,2021,United Rep. of Tanzania,United Kingdom of Great Britain and Northern Ireland,106,91,0,197
23251,2021,Thailand,United Kingdom of Great Britain and Northern Ireland,36,115,0,151
23252,2021,Tajikistan,United Kingdom of Great Britain and Northern Ireland,14,10,0,24
23253,2021,Turkmenistan,United Kingdom of Great Britain and Northern Ireland,21,41,0,62
23254,2021,Togo,United Kingdom of Great Britain and Northern Ireland,15,35,0,50
23255,2021,Trinidad and Tobago,United Kingdom of Great Britain and Northern Ireland,99,154,0,253
23256,2021,Tunisia,United Kingdom of Great Britain and Northern Ireland,66,106,0,172
23257,2021,Türkiye,United Kingdom of Great Britain and Northern Ireland,2646,1756,0,4402
23258,2021,United Arab Emirates,United Kingdom of Great Britain and Northern Ireland,22,14,0,36
23259,2021,Uganda,United Kingdom of Great Britain and Northern Ireland,1157,265,0,1422
23260,2021,Ukraine,United Kingdom of Great Britain and Northern Ireland,225,266,0,491
23261,2021,United States of America,United Kingdom of Great Britain and Northern Ireland,67,121,0,188
23262,2021,Uzbekistan,United Kingdom of Great Britain and Northern Ireland,70,67,0,137
23263,2021,Vanuatu,United Kingdom of Great Britain and Northern Ireland,0,6,0,6
23264,2021,Saint Vincent and the Grenadines,United Kingdom of Great Britain and Northern Ireland,39,33,0,72
23265,2021,Venezuela (Bolivarian Republic of),United Kingdom of Great Britain and Northern Ireland,67,31,0,98
23266,2021,Samoa,United Kingdom of Great Britain and Northern Ireland,0,5,0,5
23267,2021,Western Sahara,United Kingdom of Great Britain and Northern Ireland,12,5,0,17
23268,2021,Yemen,United Kingdom of Great Britain and Northern Ireland,1251,769,0,2020
23269,2021,Zambia,United Kingdom of Great Britain and Northern Ireland,82,53,0,135
23270,2021,Zimbabwe,United Kingdom of Great Britain and Northern Ireland,1174,442,0,1616
23273,2021,Afghanistan,Georgia,20,49,0,69
23274,2021,Algeria,Georgia,0,5,0,5
23275,2021,Egypt,Georgia,65,61,0,126
23276,2021,Azerbaijan,Georgia,0,5,0,5
23277,2021,Belarus,Georgia,0,12,0,12
23278,2021,Cameroon,Georgia,0,5,0,5
23279,2021,Dem. Rep. of the Congo,Georgia,5,5,0,10
23280,2021,Eritrea,Georgia,10,20,0,30
23281,2021,Ethiopia,Georgia,0,5,0,5
23282,2021,Palestinian,Georgia,0,15,0,15
23283,2021,Georgia,Georgia,0,0,290156,0
23284,2021,Ghana,Georgia,0,5,0,5
23285,2021,India,Georgia,0,9,0,9
23286,2021,Iran (Islamic Rep. of),Georgia,44,472,0,516
23287,2021,Iraq,Georgia,401,45,0,446
23288,2021,Jordan,Georgia,0,77,0,77
23289,2021,Kazakhstan,Georgia,5,12,0,17
23290,2021,Lebanon,Georgia,10,37,0,47
23291,2021,Sri Lanka,Georgia,0,5,0,5
23292,2021,Morocco,Georgia,0,5,0,5
23293,2021,Nigeria,Georgia,0,35,0,35
23294,2021,Pakistan,Georgia,11,10,0,21
23295,2021,South Africa,Georgia,0,5,0,5
23296,2021,Russian Federation,Georgia,223,81,0,304
23297,2021,Saudi Arabia,Georgia,0,6,0,6
23298,2021,Somalia,Georgia,5,10,0,15
23299,2021,Sudan,Georgia,6,7,0,13
23300,2021,Syrian Arab Rep.,Georgia,444,18,0,462
23301,2021,Thailand,Georgia,0,5,0,5
23302,2021,Tajikistan,Georgia,5,7,0,12
23303,2021,Turkmenistan,Georgia,0,6,0,6
23304,2021,Türkiye,Georgia,0,147,0,147
23305,2021,Ukraine,Georgia,481,0,0,481
23306,2021,Yemen,Georgia,55,20,0,75
23309,2021,Afghanistan,Germany,159409,43964,0,203373
23310,2021,Albania,Germany,1274,1676,0,2950
23311,2021,Algeria,Germany,630,1223,0,1853
23312,2021,Angola,Germany,835,401,0,1236
23313,2021,Egypt,Germany,2259,1179,0,3438
23314,2021,Argentina,Germany,14,19,0,33
23315,2021,Armenia,Germany,2744,1896,0,4640
23316,2021,Australia,Germany,6,0,0,6
23317,2021,Austria,Germany,5,0,0,5
23318,2021,Azerbaijan,Germany,3878,2468,0,6346
23319,2021,Bahrain,Germany,74,5,0,79
23320,2021,Burundi,Germany,145,54,0,199
23321,2021,Belgium,Germany,7,0,0,7
23322,2021,Benin,Germany,107,125,0,232
23323,2021,Bangladesh,Germany,816,361,0,1177
23324,2021,Bhutan,Germany,21,0,0,21
23325,2021,Burkina Faso,Germany,106,158,0,264
23326,2021,Belarus,Germany,195,312,0,507
23327,2021,Bolivia (Plurinational State of),Germany,6,6,0,12
23328,2021,Botswana,Germany,7,0,0,7
23329,2021,Brazil,Germany,36,46,0,82
23330,2021,Bosnia and Herzegovina,Germany,1316,1000,0,2316
23331,2021,Bulgaria,Germany,70,5,0,75
23332,2021,Cambodia,Germany,30,46,0,76
23333,2021,Canada,Germany,24,0,0,24
23334,2021,Central African Rep.,Germany,51,15,0,66
23335,2021,Chad,Germany,123,202,0,325
23336,2021,China,Germany,2019,379,0,2398
23337,2021,Chile,Germany,156,5,0,161
23338,2021,Cameroon,Germany,927,1642,0,2569
23339,2021,Congo,Germany,285,57,0,342
23340,2021,Dem. Rep. of the Congo,Germany,1761,541,0,2302
23341,2021,Comoros,Germany,0,13,0,13
23342,2021,Colombia,Germany,79,880,0,959
23343,2021,Cuba,Germany,84,46,0,130
23344,2021,Cabo Verde,Germany,0,5,0,5
23345,2021,Czechia,Germany,404,5,0,409
23346,2021,Djibouti,Germany,38,14,0,52
23347,2021,Dominica,Germany,5,0,0,5
23348,2021,Dominican Rep.,Germany,8,5,0,13
23349,2021,Ecuador,Germany,12,5,0,17
23350,2021,Equatorial Guinea,Germany,27,5,0,32
23351,2021,Eritrea,Germany,63128,3038,0,66166
23352,2021,Ethiopia,Germany,6508,3388,0,9896
23353,2021,France,Germany,13,0,0,13
23354,2021,Gabon,Germany,15,28,0,43
23355,2021,Gambia,Germany,1369,1300,0,2669
23356,2021,Palestinian,Germany,2025,905,0,2930
23357,2021,United Kingdom of Great Britain and Northern Ireland,Germany,22,10,0,32
23358,2021,Georgia,Germany,711,4285,0,4996
23359,2021,Ghana,Germany,678,782,0,1460
23360,2021,Guinea-Bissau,Germany,125,93,0,218
23361,2021,Greece,Germany,44,5,0,49
23362,2021,Guatemala,Germany,5,9,0,14
23363,2021,Guinea,Germany,4054,3160,0,7214
23364,2021,Haiti,Germany,14,23,0,37
23365,2021,Honduras,Germany,80,75,0,155
23366,2021,Croatia,Germany,265,5,0,270
23367,2021,Hungary,Germany,223,5,0,228
23368,2021,Cote d'Ivoire,Germany,760,1116,0,1876
23369,2021,India,Germany,414,566,0,980
23370,2021,Indonesia,Germany,16,7,0,23
23371,2021,Iran (Islamic Rep. of),Germany,46223,14128,0,60351
23372,2021,Iraq,Germany,147869,29206,0,177075
23373,2021,Israel,Germany,31,19,0,50
23374,2021,Italy,Germany,31,0,0,31
23375,2021,Jamaica,Germany,72,42,0,114
23376,2021,Jordan,Germany,496,405,0,901
23377,2021,Japan,Germany,23,5,0,28
23378,2021,Kazakhstan,Germany,112,157,0,269
23379,2021,Kenya,Germany,163,543,0,706
23380,2021,Kyrgyzstan,Germany,248,130,0,378
23381,2021,Rep. of Korea,Germany,22,5,0,27
23382,2021,Dem. People's Rep. of Korea,Germany,89,5,0,94
23383,2021,Kuwait,Germany,48,58,0,106
23384,2021,Lao People's Dem. Rep.,Germany,40,0,0,40
23385,2021,Liberia,Germany,135,289,0,424
23386,2021,Libya,Germany,2687,983,0,3670
23387,2021,Lebanon,Germany,1872,1836,0,3708
23388,2021,Sri Lanka,Germany,3591,487,0,4078
23389,2021,Lithuania,Germany,5,0,0,5
23390,2021,Latvia,Germany,6,0,0,6
23391,2021,Madagascar,Germany,5,9,0,14
23392,2021,Mauritania,Germany,65,74,0,139
23393,2021,North Macedonia,Germany,607,3007,0,3614
23394,2021,Rep. of Moldova,Germany,129,2364,0,2493
23395,2021,Mexico,Germany,24,7,0,31
23396,2021,Mali,Germany,392,364,0,756
23397,2021,Malaysia,Germany,19,10,0,29
23398,2021,Malawi,Germany,7,5,0,12
23399,2021,Mongolia,Germany,235,204,0,439
23400,2021,Morocco,Germany,866,1156,0,2022
23401,2021,Mozambique,Germany,13,32,0,45
23402,2021,Montenegro,Germany,212,207,0,419
23403,2021,Mauritius,Germany,5,5,0,10
23404,2021,Myanmar,Germany,890,472,0,1362
23405,2021,Namibia,Germany,0,47,0,47
23406,2021,Nepal,Germany,61,23,0,84
23407,2021,Netherlands,Germany,31,5,0,36
23408,2021,Niger,Germany,60,93,0,153
23409,2021,Nicaragua,Germany,5,202,0,207
23410,2021,Nigeria,Germany,10023,11392,0,21415
23411,2021,Norway,Germany,0,10,0,10
23412,2021,New Zealand,Germany,7,0,0,7
23413,2021,Oman,Germany,8,10,0,18
23414,2021,Pakistan,Germany,8788,4457,0,13245
23415,2021,Panama,Germany,0,5,0,5
23416,2021,Paraguay,Germany,5,9,0,14
23417,2021,Peru,Germany,31,12,0,43
23418,2021,Philippines,Germany,37,24,0,61
23419,2021,Poland,Germany,573,0,0,573
23420,2021,Portugal,Germany,6,0,0,6
23421,2021,Qatar,Germany,5,0,0,5
23422,2021,Romania,Germany,129,10,0,139
23423,2021,South Africa,Germany,20,54,0,74
23424,2021,Russian Federation,Germany,9584,10362,0,19946
23425,2021,Rwanda,Germany,324,447,0,771
23426,2021,El Salvador,Germany,143,65,0,208
23427,2021,Saudi Arabia,Germany,175,23,0,198
23428,2021,Serbia and Kosovo: S/RES/1244 (1999),Germany,6387,2182,0,8569
23429,2021,Senegal,Germany,202,318,0,520
23430,2021,Singapore,Germany,7,5,0,12
23431,2021,Sierra Leone,Germany,825,622,0,1447
23432,2021,Solomon Islands,Germany,6,0,0,6
23433,2021,Somalia,Germany,30283,5913,0,36196
23434,2021,Spain,Germany,21,12,0,33
23435,2021,Viet Nam,Germany,1096,276,0,1372
23436,2021,Sudan,Germany,2909,941,0,3850
23437,2021,South Sudan,Germany,249,72,0,321
23438,2021,Slovakia,Germany,72,0,0,72
23439,2021,Slovenia,Germany,6,0,0,6
23440,2021,Eswatini,Germany,5,5,0,10
23441,2021,Sweden,Germany,9,0,0,9
23442,2021,Syrian Arab Rep.,Germany,621740,53750,0,675490
23443,2021,United Rep. of Tanzania,Germany,79,286,0,365
23444,2021,Thailand,Germany,27,14,0,41
23445,2021,Tajikistan,Germany,1178,809,0,1987
23446,2021,Turkmenistan,Germany,90,119,0,209
23447,2021,Togo,Germany,986,400,0,1386
23448,2021,Trinidad and Tobago,Germany,7,5,0,12
23449,2021,Tunisia,Germany,251,784,0,1035
23450,2021,Türkiye,Germany,35953,14831,0,50784
23451,2021,United Arab Emirates,Germany,33,0,0,33
23452,2021,Uganda,Germany,247,337,0,584
23453,2021,Ukraine,Germany,918,1328,0,2246
23454,2021,United States of America,Germany,125,23,0,148
23455,2021,Uzbekistan,Germany,154,69,0,223
23456,2021,Saint Vincent and the Grenadines,Germany,5,0,0,5
23457,2021,Venezuela (Bolivarian Republic of),Germany,1113,728,0,1841
23458,2021,Yemen,Germany,3082,1173,0,4255
23459,2021,Zambia,Germany,5,9,0,14
23460,2021,Zimbabwe,Germany,312,211,0,523
23463,2021,Egypt,Ghana,0,16,0,16
23464,2021,Burundi,Ghana,14,15,0,29
23465,2021,Benin,Ghana,11,5,0,16
23466,2021,Central African Rep.,Ghana,149,93,0,242
23467,2021,Chad,Ghana,38,21,0,59
23468,2021,Cameroon,Ghana,270,270,0,540
23469,2021,Congo,Ghana,7,5,0,12
23470,2021,Dem. Rep. of the Congo,Ghana,59,19,0,78
23471,2021,Eritrea,Ghana,102,78,0,180
23472,2021,Ethiopia,Ghana,8,6,0,14
23473,2021,Palestinian,Ghana,18,10,0,28
23474,2021,Cote d'Ivoire,Ghana,5968,988,0,6956
23475,2021,Iraq,Ghana,12,5,0,17
23476,2021,Liberia,Ghana,661,0,0,661
23477,2021,Libya,Ghana,7,6,0,13
23478,2021,Lebanon,Ghana,8,0,0,8
23479,2021,Mali,Ghana,0,5,0,5
23480,2021,Nigeria,Ghana,9,11,0,20
23481,2021,Pakistan,Ghana,60,5,0,65
23482,2021,Rwanda,Ghana,29,5,0,34
23483,2021,Sierra Leone,Ghana,87,20,0,107
23484,2021,Somalia,Ghana,67,29,0,96
23485,2021,Sudan,Ghana,584,109,0,693
23486,2021,South Sudan,Ghana,7,5,0,12
23487,2021,Syrian Arab Rep.,Ghana,229,70,0,299
23488,2021,Togo,Ghana,3407,69,0,3476
23489,2021,Türkiye,Ghana,52,9,0,61
23490,2021,Uganda,Ghana,9,0,0,9
23491,2021,Uzbekistan,Ghana,9,0,0,9
23492,2021,Yemen,Ghana,13,5,0,18
23493,2021,Burundi,Guinea-Bissau,5,0,0,5
23494,2021,Cote d'Ivoire,Guinea-Bissau,6,6,0,12
23495,2021,Liberia,Guinea-Bissau,7,0,0,7
23496,2021,Nigeria,Guinea-Bissau,0,6,0,6
23497,2021,Senegal,Guinea-Bissau,1818,8,0,1826
23498,2021,Sierra Leone,Guinea-Bissau,10,5,0,15
23499,2021,Türkiye,Guinea-Bissau,0,5,0,5
23500,2021,Afghanistan,Greece,28543,9142,0,37685
23501,2021,Albania,Greece,182,917,0,1099
23502,2021,Algeria,Greece,132,132,0,264
23503,2021,Angola,Greece,16,64,0,80
23504,2021,Egypt,Greece,418,1561,0,1979
23505,2021,Armenia,Greece,12,45,0,57
23506,2021,Azerbaijan,Greece,5,0,0,5
23507,2021,Burundi,Greece,73,23,0,96
23508,2021,Benin,Greece,0,5,0,5
23509,2021,Bangladesh,Greece,328,3564,0,3892
23510,2021,Burkina Faso,Greece,40,35,0,75
23511,2021,Belarus,Greece,5,5,0,10
23512,2021,Brazil,Greece,0,6,0,6
23513,2021,Bosnia and Herzegovina,Greece,0,5,0,5
23514,2021,Central African Rep.,Greece,20,5,0,25
23515,2021,Chad,Greece,11,0,0,11
23516,2021,China,Greece,114,222,0,336
23517,2021,Cameroon,Greece,929,529,0,1458
23518,2021,Congo,Greece,162,53,0,215
23519,2021,Dem. Rep. of the Congo,Greece,1994,2555,0,4549
23520,2021,Comoros,Greece,7,33,0,40
23521,2021,Colombia,Greece,0,5,0,5
23522,2021,Cuba,Greece,7,79,0,86
23523,2021,Djibouti,Greece,12,8,0,20
23524,2021,Dominican Rep.,Greece,10,5,0,15
23525,2021,Ecuador,Greece,0,5,0,5
23526,2021,Equatorial Guinea,Greece,5,0,0,5
23527,2021,Eritrea,Greece,1354,182,0,1536
23528,2021,Ethiopia,Greece,501,42,0,543
23529,2021,Gabon,Greece,5,9,0,14
23530,2021,Gambia,Greece,99,77,0,176
23531,2021,Palestinian,Greece,5508,385,0,5893
23532,2021,Georgia,Greece,262,705,0,967
23533,2021,Ghana,Greece,89,277,0,366
23534,2021,Guinea,Greece,192,109,0,301
23535,2021,Haiti,Greece,38,14,0,52
23536,2021,Cote d'Ivoire,Greece,105,38,0,143
23537,2021,India,Greece,40,333,0,373
23538,2021,Indonesia,Greece,14,17,0,31
23539,2021,Iran (Islamic Rep. of),Greece,3201,971,0,4172
23540,2021,Iraq,Greece,13634,1646,0,15280
23541,2021,Jordan,Greece,44,0,0,44
23542,2021,Kazakhstan,Greece,5,0,0,5
23543,2021,Kenya,Greece,30,10,0,40
23544,2021,Kyrgyzstan,Greece,0,5,0,5
23545,2021,Kuwait,Greece,153,21,0,174
23546,2021,Liberia,Greece,5,0,0,5
23547,2021,Libya,Greece,65,19,0,84
23548,2021,Lebanon,Greece,84,26,0,110
23549,2021,Sri Lanka,Greece,55,43,0,98
23550,2021,Mauritania,Greece,68,0,0,68
23551,2021,North Macedonia,Greece,0,5,0,5
23552,2021,Rep. of Moldova,Greece,13,63,0,76
23553,2021,Mali,Greece,145,59,0,204
23554,2021,Morocco,Greece,230,117,0,347
23555,2021,Myanmar,Greece,100,7,0,107
23556,2021,Nepal,Greece,28,88,0,116
23557,2021,Niger,Greece,19,6,0,25
23558,2021,Nigeria,Greece,374,158,0,532
23559,2021,Pakistan,Greece,1279,3790,0,5069
23560,2021,Philippines,Greece,7,5,0,12
23561,2021,Russian Federation,Greece,21,35,0,56
23562,2021,Rwanda,Greece,10,0,0,10
23563,2021,El Salvador,Greece,12,0,0,12
23564,2021,Saudi Arabia,Greece,8,0,0,8
23565,2021,Serbia and Kosovo: S/RES/1244 (1999),Greece,23,6,0,29
23566,2021,Senegal,Greece,63,41,0,104
23567,2021,Sierra Leone,Greece,206,111,0,317
23568,2021,Somalia,Greece,4131,1292,0,5423
23569,2021,Viet Nam,Greece,5,5,0,10
23570,2021,Sudan,Greece,561,53,0,614
23571,2021,South Sudan,Greece,50,9,0,59
23572,2021,Syrian Arab Rep.,Greece,39372,3933,0,43305
23573,2021,United Rep. of Tanzania,Greece,13,5,0,18
23574,2021,Tajikistan,Greece,5,6,0,11
23575,2021,Turkmenistan,Greece,7,5,0,12
23576,2021,Togo,Greece,88,87,0,175
23577,2021,Tunisia,Greece,28,19,0,47
23578,2021,Türkiye,Greece,1219,2983,0,4202
23579,2021,Uganda,Greece,71,42,0,113
23580,2021,Ukraine,Greece,169,99,0,268
23581,2021,Uzbekistan,Greece,12,0,0,12
23582,2021,Venezuela (Bolivarian Republic of),Greece,14,5,0,19
23583,2021,Western Sahara,Greece,10,0,0,10
23584,2021,Yemen,Greece,933,26,0,959
23585,2021,Zimbabwe,Greece,13,5,0,18
23588,2021,Venezuela (Bolivarian Republic of),Grenada,0,0,0,0
23589,2021,Belize,Guatemala,0,5,0,5
23590,2021,Colombia,Guatemala,10,16,0,26
23591,2021,Cuba,Guatemala,8,22,0,30
23592,2021,Guatemala,Guatemala,0,0,0,0
23593,2021,Haiti,Guatemala,0,0,0,0
23594,2021,Honduras,Guatemala,72,574,0,646
23595,2021,Sri Lanka,Guatemala,0,5,0,5
23596,2021,Mexico,Guatemala,0,11,0,11
23597,2021,Nicaragua,Guatemala,70,221,0,291
23598,2021,Panama,Guatemala,0,5,0,5
23599,2021,Russian Federation,Guatemala,5,0,0,5
23600,2021,El Salvador,Guatemala,278,485,0,763
23601,2021,Venezuela (Bolivarian Republic of),Guatemala,36,126,0,162
23602,2021,Burundi,Guinea,6,0,0,6
23603,2021,Central African Rep.,Guinea,30,0,0,30
23604,2021,Cameroon,Guinea,5,0,0,5
23605,2021,Congo,Guinea,8,0,0,8
23606,2021,Dem. Rep. of the Congo,Guinea,58,0,0,58
23607,2021,Eritrea,Guinea,14,0,0,14
23608,2021,Gambia,Guinea,5,0,0,5
23609,2021,Guinea,Guinea,0,0,0,0
23610,2021,Cote d'Ivoire,Guinea,3559,200,0,3759
23611,2021,Liberia,Guinea,338,20,0,358
23612,2021,Sri Lanka,Guinea,10,0,0,10
23613,2021,Mali,Guinea,9,0,0,9
23614,2021,Nigeria,Guinea,10,0,0,10
23615,2021,Rwanda,Guinea,10,0,0,10
23616,2021,Sierra Leone,Guinea,1651,33,0,1684
23617,2021,Somalia,Guinea,6,0,0,6
23618,2021,Syrian Arab Rep.,Guinea,14,0,0,14
23619,2021,Togo,Guinea,8,0,0,8
23620,2021,Cameroon,Guyana,0,5,0,5
23621,2021,Cuba,Guyana,40,78,0,118
23622,2021,Guyana,Guyana,0,0,0,0
23623,2021,Haiti,Guyana,0,11,0,11
23624,2021,Venezuela (Bolivarian Republic of),Guyana,0,0,0,0
23625,2021,Afghanistan,"China, Hong Kong SAR",11,0,0,11
23626,2021,Egypt,"China, Hong Kong SAR",13,0,0,13
23627,2021,Burundi,"China, Hong Kong SAR",12,0,0,12
23628,2021,Bangladesh,"China, Hong Kong SAR",13,0,0,13
23629,2021,Central African Rep.,"China, Hong Kong SAR",5,0,0,5
23630,2021,Cameroon,"China, Hong Kong SAR",5,0,0,5
23631,2021,Dem. Rep. of the Congo,"China, Hong Kong SAR",5,0,0,5
23632,2021,Ethiopia,"China, Hong Kong SAR",7,0,0,7
23633,2021,Palestinian,"China, Hong Kong SAR",5,0,0,5
23634,2021,Indonesia,"China, Hong Kong SAR",12,0,0,12
23635,2021,Sri Lanka,"China, Hong Kong SAR",20,0,0,20
23636,2021,Nepal,"China, Hong Kong SAR",8,0,0,8
23637,2021,Pakistan,"China, Hong Kong SAR",25,0,0,25
23638,2021,Philippines,"China, Hong Kong SAR",8,0,0,8
23639,2021,Rwanda,"China, Hong Kong SAR",35,0,0,35
23640,2021,Somalia,"China, Hong Kong SAR",36,0,0,36
23641,2021,Sudan,"China, Hong Kong SAR",5,0,0,5
23642,2021,Uganda,"China, Hong Kong SAR",5,0,0,5
23643,2021,Yemen,"China, Hong Kong SAR",36,0,0,36
23644,2021,Zimbabwe,"China, Hong Kong SAR",5,0,0,5
23645,2021,Cuba,Honduras,0,0,0,0
23646,2021,Haiti,Honduras,0,10,0,10
23647,2021,Honduras,Honduras,0,0,247090,0
23648,2021,Mexico,Honduras,0,5,0,5
23649,2021,Nicaragua,Honduras,113,68,0,181
23650,2021,El Salvador,Honduras,22,0,0,22
23651,2021,Venezuela (Bolivarian Republic of),Honduras,9,16,0,25
23653,2021,Afghanistan,Croatia,93,397,0,490
23654,2021,Egypt,Croatia,8,0,0,8
23655,2021,Azerbaijan,Croatia,5,0,0,5
23656,2021,Bangladesh,Croatia,7,6,0,13
23657,2021,Belarus,Croatia,5,0,0,5
23658,2021,China,Croatia,0,0,0,0
23659,2021,Cameroon,Croatia,5,0,0,5
23660,2021,Congo,Croatia,5,0,0,5
23661,2021,Dem. Rep. of the Congo,Croatia,7,0,0,7
23662,2021,Cuba,Croatia,0,11,0,11
23663,2021,Eritrea,Croatia,24,0,0,24
23664,2021,Gambia,Croatia,0,0,0,0
23665,2021,Georgia,Croatia,5,0,0,5
23666,2021,Croatia,Croatia,0,0,0,0
23667,2021,Iran (Islamic Rep. of),Croatia,41,43,0,84
23668,2021,Iraq,Croatia,119,18,0,137
23669,2021,Kazakhstan,Croatia,5,0,0,5
23670,2021,Libya,Croatia,5,0,0,5
23671,2021,Mauritania,Croatia,5,0,0,5
23672,2021,Montenegro,Croatia,0,5,0,5
23673,2021,Nigeria,Croatia,12,0,0,12
23674,2021,Pakistan,Croatia,10,20,0,30
23675,2021,Russian Federation,Croatia,15,6,0,21
23676,2021,Serbia and Kosovo: S/RES/1244 (1999),Croatia,5,0,0,5
23677,2021,Somalia,Croatia,29,0,0,29
23678,2021,Sudan,Croatia,5,0,0,5
23679,2021,Syrian Arab Rep.,Croatia,548,12,0,560
23680,2021,Türkiye,Croatia,26,39,0,65
23681,2021,Ukraine,Croatia,8,0,0,8
23682,2021,United States of America,Croatia,0,5,0,5
23683,2021,Uzbekistan,Croatia,5,0,0,5
23684,2021,Yemen,Croatia,7,0,0,7
23686,2021,Afghanistan,Hungary,1467,0,0,1467
23687,2021,Algeria,Hungary,14,0,0,14
23688,2021,Angola,Hungary,5,0,0,5
23689,2021,Egypt,Hungary,11,0,0,11
23690,2021,Armenia,Hungary,39,0,0,39
23691,2021,Azerbaijan,Hungary,12,0,0,12
23692,2021,Bangladesh,Hungary,11,0,0,11
23693,2021,China,Hungary,5,0,0,5
23694,2021,Cameroon,Hungary,43,0,0,43
23695,2021,Congo,Hungary,15,0,0,15
23696,2021,Dem. Rep. of the Congo,Hungary,25,0,0,25
23697,2021,Cuba,Hungary,76,0,0,76
23698,2021,Eritrea,Hungary,47,0,0,47
23699,2021,Ethiopia,Hungary,43,0,0,43
23700,2021,Palestinian,Hungary,87,0,0,87
23701,2021,Georgia,Hungary,59,0,0,59
23702,2021,Ghana,Hungary,5,0,0,5
23703,2021,Guinea,Hungary,5,0,0,5
23704,2021,Cote d'Ivoire,Hungary,15,0,0,15
23705,2021,Iran (Islamic Rep. of),Hungary,193,5,0,198
23706,2021,Iraq,Hungary,608,0,0,608
23707,2021,Libya,Hungary,7,0,0,7
23708,2021,Lebanon,Hungary,5,0,0,5
23709,2021,Sri Lanka,Hungary,11,0,0,11
23710,2021,Rep. of Moldova,Hungary,5,0,0,5
23711,2021,Nepal,Hungary,10,0,0,10
23712,2021,Nigeria,Hungary,53,0,0,53
23713,2021,Pakistan,Hungary,92,0,0,92
23714,2021,Russian Federation,Hungary,37,0,0,37
23715,2021,Serbia and Kosovo: S/RES/1244 (1999),Hungary,41,0,0,41
23716,2021,Sierra Leone,Hungary,5,0,0,5
23717,2021,Somalia,Hungary,606,0,0,606
23718,2021,Sudan,Hungary,65,0,0,65
23719,2021,Syrian Arab Rep.,Hungary,869,0,0,869
23720,2021,Tunisia,Hungary,7,0,0,7
23721,2021,Türkiye,Hungary,33,0,0,33
23722,2021,Uganda,Hungary,7,0,0,7
23723,2021,Ukraine,Hungary,13,0,0,13
23724,2021,Uzbekistan,Hungary,6,0,0,6
23725,2021,Yemen,Hungary,16,0,0,16
23726,2021,Zimbabwe,Hungary,5,0,0,5
23729,2021,Afghanistan,Iceland,179,18,0,197
23730,2021,Albania,Iceland,5,5,0,10
23731,2021,Egypt,Iceland,10,0,0,10
23732,2021,Azerbaijan,Iceland,5,0,0,5
23733,2021,Bangladesh,Iceland,5,0,0,5
23734,2021,Belarus,Iceland,0,5,0,5
23735,2021,Chad,Iceland,5,0,0,5
23736,2021,China,Iceland,5,0,0,5
23737,2021,Cameroon,Iceland,5,0,0,5
23738,2021,Dem. Rep. of the Congo,Iceland,5,0,0,5
23739,2021,Colombia,Iceland,0,11,0,11
23740,2021,Eritrea,Iceland,9,0,0,9
23741,2021,Ethiopia,Iceland,6,6,0,12
23742,2021,Palestinian,Iceland,133,14,0,147
23743,2021,Georgia,Iceland,5,0,0,5
23744,2021,Ghana,Iceland,5,0,0,5
23745,2021,Honduras,Iceland,12,0,0,12
23746,2021,Cote d'Ivoire,Iceland,5,0,0,5
23747,2021,Iran (Islamic Rep. of),Iceland,95,0,0,95
23748,2021,Iraq,Iceland,314,26,0,340
23749,2021,Kazakhstan,Iceland,5,0,0,5
23750,2021,Kenya,Iceland,5,0,0,5
23751,2021,Libya,Iceland,13,0,0,13
23752,2021,Sri Lanka,Iceland,5,0,0,5
23753,2021,North Macedonia,Iceland,5,0,0,5
23754,2021,Mali,Iceland,5,0,0,5
23755,2021,Morocco,Iceland,8,0,0,8
23756,2021,Mozambique,Iceland,5,0,0,5
23757,2021,Nigeria,Iceland,65,5,0,70
23758,2021,Pakistan,Iceland,22,0,0,22
23759,2021,Peru,Iceland,5,0,0,5
23760,2021,Russian Federation,Iceland,20,0,0,20
23761,2021,El Salvador,Iceland,20,0,0,20
23762,2021,Senegal,Iceland,5,0,0,5
23763,2021,Somalia,Iceland,97,10,0,107
23764,2021,Sudan,Iceland,7,0,0,7
23765,2021,South Sudan,Iceland,5,0,0,5
23766,2021,Syrian Arab Rep.,Iceland,195,16,0,211
23767,2021,Tajikistan,Iceland,5,0,0,5
23768,2021,Tunisia,Iceland,5,0,0,5
23769,2021,Türkiye,Iceland,10,0,0,10
23770,2021,Uganda,Iceland,17,0,0,17
23771,2021,Ukraine,Iceland,20,0,0,20
23772,2021,Venezuela (Bolivarian Republic of),Iceland,429,190,0,619
23773,2021,Yemen,Iceland,12,0,0,12
23776,2021,Egypt,Cote d'Ivoire,5,0,0,5
23777,2021,Burundi,Cote d'Ivoire,34,0,0,34
23778,2021,Benin,Cote d'Ivoire,0,7,0,7
23779,2021,Burkina Faso,Cote d'Ivoire,2127,0,0,2127
23780,2021,Cambodia,Cote d'Ivoire,8,0,0,8
23781,2021,Central African Rep.,Cote d'Ivoire,550,25,0,575
23782,2021,Chad,Cote d'Ivoire,5,0,0,5
23783,2021,Cameroon,Cote d'Ivoire,6,10,0,16
23784,2021,Congo,Cote d'Ivoire,82,7,0,89
23785,2021,Dem. Rep. of the Congo,Cote d'Ivoire,122,18,0,140
23786,2021,Eritrea,Cote d'Ivoire,8,0,0,8
23787,2021,Ethiopia,Cote d'Ivoire,5,5,0,10
23788,2021,Guinea,Cote d'Ivoire,0,5,0,5
23789,2021,Cote d'Ivoire,Cote d'Ivoire,0,0,0,0
23790,2021,Iran (Islamic Rep. of),Cote d'Ivoire,7,0,0,7
23791,2021,Iraq,Cote d'Ivoire,5,0,0,5
23792,2021,Liberia,Cote d'Ivoire,1071,21,0,1092
23793,2021,Lebanon,Cote d'Ivoire,5,0,0,5
23794,2021,Mauritania,Cote d'Ivoire,5,5,0,10
23795,2021,Mali,Cote d'Ivoire,25,5,0,30
23796,2021,Nigeria,Cote d'Ivoire,6,0,0,6
23797,2021,Rwanda,Cote d'Ivoire,49,5,0,54
23798,2021,Somalia,Cote d'Ivoire,5,0,0,5
23799,2021,Viet Nam,Cote d'Ivoire,5,0,0,5
23800,2021,Sudan,Cote d'Ivoire,9,0,0,9
23801,2021,Syrian Arab Rep.,Cote d'Ivoire,148,9,0,157
23802,2021,Togo,Cote d'Ivoire,18,7,0,25
23803,2021,Türkiye,Cote d'Ivoire,34,0,0,34
23804,2021,Yemen,Cote d'Ivoire,5,0,0,5
23806,2021,Afghanistan,India,9678,6569,0,16247
23807,2021,Egypt,India,0,10,0,10
23808,2021,Burundi,India,0,5,0,5
23809,2021,Bangladesh,India,8,0,0,8
23810,2021,China,India,73407,0,0,73407
23811,2021,Cameroon,India,17,207,0,224
23812,2021,Congo,India,8,36,0,44
23813,2021,Dem. Rep. of the Congo,India,54,127,0,181
23814,2021,Eritrea,India,13,10,0,23
23815,2021,Ethiopia,India,23,35,0,58
23816,2021,Palestinian,India,52,11,0,63
23817,2021,Ghana,India,0,69,0,69
23818,2021,Guinea,India,0,11,0,11
23819,2021,Cote d'Ivoire,India,5,176,0,181
23820,2021,Iran (Islamic Rep. of),India,58,44,0,102
23821,2021,Iraq,India,150,47,0,197
23822,2021,Kenya,India,0,35,0,35
23823,2021,Liberia,India,0,5,0,5
23824,2021,Libya,India,8,6,0,14
23825,2021,Sri Lanka,India,92431,0,0,92431
23826,2021,Maldives,India,5,0,0,5
23827,2021,Myanmar,India,35832,3785,0,39617
23828,2021,Nigeria,India,0,552,0,552
23829,2021,Russian Federation,India,0,15,0,15
23830,2021,Rwanda,India,5,10,0,15
23831,2021,Saudi Arabia,India,5,0,0,5
23832,2021,Senegal,India,0,28,0,28
23833,2021,Sierra Leone,India,0,8,0,8
23834,2021,Somalia,India,497,279,0,776
23835,2021,Sudan,India,61,144,0,205
23836,2021,South Sudan,India,5,100,0,105
23837,2021,Syrian Arab Rep.,India,69,64,0,133
23838,2021,United Rep. of Tanzania,India,0,13,0,13
23839,2021,Tajikistan,India,0,5,0,5
23840,2021,Turkmenistan,India,0,5,0,5
23841,2021,Türkiye,India,8,0,0,8
23842,2021,Uganda,India,0,38,0,38
23843,2021,Ukraine,India,0,5,0,5
23844,2021,Uzbekistan,India,0,10,0,10
23845,2021,Venezuela (Bolivarian Republic of),India,5,6,0,11
23846,2021,Yemen,India,9,898,0,907
23848,2021,Afghanistan,Indonesia,5828,1610,0,7438
23849,2021,Angola,Indonesia,7,0,0,7
23850,2021,Egypt,Indonesia,18,15,0,33
23851,2021,China,Indonesia,11,5,0,16
23852,2021,Cameroon,Indonesia,0,17,0,17
23853,2021,Dem. Rep. of the Congo,Indonesia,10,0,0,10
23854,2021,Eritrea,Indonesia,133,123,0,256
23855,2021,Ethiopia,Indonesia,125,35,0,160
23856,2021,Palestinian,Indonesia,208,87,0,295
23857,2021,Cote d'Ivoire,Indonesia,0,5,0,5
23858,2021,Indonesia,Indonesia,0,0,0,0
23859,2021,Iran (Islamic Rep. of),Indonesia,300,21,0,321
23860,2021,Iraq,Indonesia,466,195,0,661
23861,2021,Kuwait,Indonesia,5,0,0,5
23862,2021,Liberia,Indonesia,0,5,0,5
23863,2021,Libya,Indonesia,14,5,0,19
23864,2021,Sri Lanka,Indonesia,407,31,0,438
23865,2021,Mali,Indonesia,0,5,0,5
23866,2021,Myanmar,Indonesia,480,202,0,682
23867,2021,Nigeria,Indonesia,0,5,0,5
23868,2021,Pakistan,Indonesia,281,16,0,297
23869,2021,Russian Federation,Indonesia,5,5,0,10
23870,2021,Saudi Arabia,Indonesia,0,6,0,6
23871,2021,Somalia,Indonesia,1146,210,0,1356
23872,2021,Viet Nam,Indonesia,15,0,0,15
23873,2021,Sudan,Indonesia,397,102,0,499
23874,2021,Syrian Arab Rep.,Indonesia,20,24,0,44
23875,2021,Türkiye,Indonesia,0,11,0,11
23876,2021,Uganda,Indonesia,5,22,0,27
23877,2021,Venezuela (Bolivarian Republic of),Indonesia,0,5,0,5
23878,2021,Yemen,Indonesia,101,349,0,450
23880,2021,Afghanistan,Ireland,549,170,0,719
23881,2021,Albania,Ireland,206,413,0,619
23882,2021,Algeria,Ireland,68,301,0,369
23883,2021,Angola,Ireland,52,25,0,77
23884,2021,Egypt,Ireland,51,64,0,115
23885,2021,Armenia,Ireland,14,0,0,14
23886,2021,Azerbaijan,Ireland,5,0,0,5
23887,2021,Bahrain,Ireland,5,6,0,11
23888,2021,Burundi,Ireland,29,5,0,34
23889,2021,Benin,Ireland,5,0,0,5
23890,2021,Bangladesh,Ireland,101,192,0,293
23891,2021,Bhutan,Ireland,10,0,0,10
23892,2021,Belarus,Ireland,18,8,0,26
23893,2021,Bolivia (Plurinational State of),Ireland,23,41,0,64
23894,2021,Botswana,Ireland,11,88,0,99
23895,2021,Brazil,Ireland,22,148,0,170
23896,2021,Bosnia and Herzegovina,Ireland,5,0,0,5
23897,2021,Chad,Ireland,5,0,0,5
23898,2021,China,Ireland,71,60,0,131
23899,2021,Cameroon,Ireland,104,31,0,135
23900,2021,Congo,Ireland,15,5,0,20
23901,2021,Dem. Rep. of the Congo,Ireland,458,132,0,590
23902,2021,Colombia,Ireland,0,5,0,5
23903,2021,Cuba,Ireland,5,0,0,5
23904,2021,Eritrea,Ireland,96,15,0,111
23905,2021,Ethiopia,Ireland,58,23,0,81
23906,2021,Gambia,Ireland,0,6,0,6
23907,2021,Palestinian,Ireland,130,24,0,154
23908,2021,Georgia,Ireland,152,801,0,953
23909,2021,Ghana,Ireland,36,70,0,106
23910,2021,Guatemala,Ireland,5,10,0,15
23911,2021,Guinea,Ireland,17,12,0,29
23912,2021,Honduras,Ireland,0,6,0,6
23913,2021,Cote d'Ivoire,Ireland,15,9,0,24
23914,2021,India,Ireland,16,68,0,84
23915,2021,Indonesia,Ireland,5,0,0,5
23916,2021,Iran (Islamic Rep. of),Ireland,155,15,0,170
23917,2021,Iraq,Ireland,398,59,0,457
23918,2021,Israel,Ireland,12,9,0,21
23919,2021,Jordan,Ireland,7,16,0,23
23920,2021,Kazakhstan,Ireland,18,0,0,18
23921,2021,Kenya,Ireland,53,27,0,80
23922,2021,Kyrgyzstan,Ireland,5,0,0,5
23923,2021,Dem. People's Rep. of Korea,Ireland,9,0,0,9
23924,2021,Kuwait,Ireland,51,11,0,62
23925,2021,Liberia,Ireland,12,0,0,12
23926,2021,Libya,Ireland,236,8,0,244
23927,2021,Lebanon,Ireland,9,13,0,22
23928,2021,Lesotho,Ireland,0,7,0,7
23929,2021,Sri Lanka,Ireland,25,7,0,32
23930,2021,North Macedonia,Ireland,6,0,0,6
23931,2021,Rep. of Moldova,Ireland,51,0,0,51
23932,2021,Mexico,Ireland,9,10,0,19
23933,2021,Mali,Ireland,5,0,0,5
23934,2021,Malaysia,Ireland,9,18,0,27
23935,2021,Malawi,Ireland,142,125,0,267
23936,2021,Mongolia,Ireland,8,5,0,13
23937,2021,Morocco,Ireland,14,70,0,84
23938,2021,Mozambique,Ireland,5,0,0,5
23939,2021,Montenegro,Ireland,5,0,0,5
23940,2021,Mauritius,Ireland,21,24,0,45
23941,2021,Myanmar,Ireland,13,5,0,18
23942,2021,Nepal,Ireland,9,20,0,29
23943,2021,Niger,Ireland,5,0,0,5
23944,2021,Nicaragua,Ireland,11,15,0,26
23945,2021,Nigeria,Ireland,396,1021,0,1417
23946,2021,Pakistan,Ireland,391,479,0,870
23947,2021,South Africa,Ireland,163,475,0,638
23948,2021,Russian Federation,Ireland,83,15,0,98
23949,2021,Rwanda,Ireland,35,0,0,35
23950,2021,El Salvador,Ireland,34,42,0,76
23951,2021,Saudi Arabia,Ireland,20,0,0,20
23952,2021,Serbia and Kosovo: S/RES/1244 (1999),Ireland,55,31,0,86
23953,2021,Senegal,Ireland,5,5,0,10
23954,2021,Sierra Leone,Ireland,63,32,0,95
23955,2021,Somalia,Ireland,493,338,0,831
23956,2021,Viet Nam,Ireland,10,33,0,43
23957,2021,Sudan,Ireland,229,14,0,243
23958,2021,South Sudan,Ireland,5,0,0,5
23959,2021,Eswatini,Ireland,18,21,0,39
23960,2021,Syrian Arab Rep.,Ireland,2832,53,0,2885
23961,2021,United Rep. of Tanzania,Ireland,5,11,0,16
23962,2021,Turks and Caicos Islands,Ireland,0,5,0,5
23963,2021,Togo,Ireland,19,31,0,50
23964,2021,Tunisia,Ireland,6,5,0,11
23965,2021,Türkiye,Ireland,20,27,0,47
23966,2021,Uganda,Ireland,45,41,0,86
23967,2021,Ukraine,Ireland,79,15,0,94
23968,2021,United States of America,Ireland,0,21,0,21
23969,2021,Uzbekistan,Ireland,17,0,0,17
23970,2021,Venezuela (Bolivarian Republic of),Ireland,140,61,0,201
23971,2021,Yemen,Ireland,27,8,0,35
23972,2021,Zambia,Ireland,6,0,0,6
23973,2021,Zimbabwe,Ireland,703,539,0,1242
23976,2021,Afghanistan,Iran (Islamic Rep. of),778054,0,0,778054
23977,2021,Iraq,Iran (Islamic Rep. of),20264,0,0,20264
23978,2021,Kuwait,Iran (Islamic Rep. of),8,0,0,8
23979,2021,Myanmar,Iran (Islamic Rep. of),0,34,0,34
23980,2021,Pakistan,Iran (Islamic Rep. of),10,0,0,10
23981,2021,Uzbekistan,Iran (Islamic Rep. of),7,0,0,7
23983,2021,Afghanistan,Iraq,11,96,0,107
23984,2021,Egypt,Iraq,0,22,0,22
23985,2021,Bahrain,Iraq,0,25,0,25
23986,2021,Eritrea,Iraq,5,28,0,33
23987,2021,Ethiopia,Iraq,0,7,0,7
23988,2021,Palestinian,Iraq,7885,142,0,8027
23989,2021,Indonesia,Iraq,0,5,0,5
23990,2021,Iran (Islamic Rep. of),Iraq,4116,5851,0,9967
23991,2021,Iraq,Iraq,0,0,1186556,0
23992,2021,Kazakhstan,Iraq,0,5,0,5
23993,2021,Kyrgyzstan,Iraq,0,15,0,15
23994,2021,Kuwait,Iraq,0,301,0,301
23995,2021,Lebanon,Iraq,0,10,0,10
23996,2021,Pakistan,Iraq,0,33,0,33
23997,2021,Saudi Arabia,Iraq,0,6,0,6
23998,2021,Somalia,Iraq,6,5,0,11
23999,2021,Sudan,Iraq,92,692,0,784
24000,2021,South Sudan,Iraq,0,15,0,15
24001,2021,Syrian Arab Rep.,Iraq,254561,0,0,254561
24002,2021,Tunisia,Iraq,0,5,0,5
24003,2021,Türkiye,Iraq,13396,4080,0,17476
24004,2021,Yemen,Iraq,0,165,0,165
24006,2021,Albania,Israel,0,12,0,12
24007,2021,Armenia,Israel,0,31,0,31
24008,2021,Azerbaijan,Israel,0,39,0,39
24009,2021,Benin,Israel,0,5,0,5
24010,2021,Burkina Faso,Israel,0,6,0,6
24011,2021,Belarus,Israel,5,618,0,623
24012,2021,Bolivia (Plurinational State of),Israel,0,5,0,5
24013,2021,Botswana,Israel,0,5,0,5
24014,2021,Brazil,Israel,0,5,0,5
24015,2021,Cambodia,Israel,0,5,0,5
24016,2021,Central African Rep.,Israel,0,15,0,15
24017,2021,Chad,Israel,5,5,0,10
24018,2021,China,Israel,0,563,0,563
24019,2021,Cameroon,Israel,0,43,0,43
24020,2021,Congo,Israel,0,25,0,25
24021,2021,Dem. Rep. of the Congo,Israel,0,204,0,204
24022,2021,Colombia,Israel,0,189,0,189
24023,2021,Ecuador,Israel,0,21,0,21
24024,2021,Eritrea,Israel,221,11018,0,11239
24025,2021,Ethiopia,Israel,106,813,0,919
24026,2021,Georgia,Israel,5,204,0,209
24027,2021,Ghana,Israel,0,316,0,316
24028,2021,Honduras,Israel,0,7,0,7
24029,2021,Cote d'Ivoire,Israel,7,12,0,19
24030,2021,India,Israel,0,1116,0,1116
24031,2021,Iran (Islamic Rep. of),Israel,6,0,0,6
24032,2021,Iraq,Israel,10,0,0,10
24033,2021,Kazakhstan,Israel,0,105,0,105
24034,2021,Kenya,Israel,0,105,0,105
24035,2021,Kyrgyzstan,Israel,0,46,0,46
24036,2021,Dem. People's Rep. of Korea,Israel,5,0,0,5
24037,2021,Lesotho,Israel,0,6,0,6
24038,2021,Sri Lanka,Israel,0,957,0,957
24039,2021,North Macedonia,Israel,0,23,0,23
24040,2021,Rep. of Moldova,Israel,0,361,0,361
24041,2021,Mexico,Israel,0,5,0,5
24042,2021,Mali,Israel,0,5,0,5
24043,2021,Malawi,Israel,0,75,0,75
24044,2021,Mozambique,Israel,0,5,0,5
24045,2021,Montenegro,Israel,0,7,0,7
24046,2021,Myanmar,Israel,0,104,0,104
24047,2021,Nepal,Israel,0,81,0,81
24048,2021,Nigeria,Israel,8,877,0,885
24049,2021,Peru,Israel,0,9,0,9
24050,2021,Philippines,Israel,0,51,0,51
24051,2021,Romania,Israel,0,21,0,21
24052,2021,South Africa,Israel,0,391,0,391
24053,2021,Russian Federation,Israel,5,2537,0,2542
24054,2021,Rwanda,Israel,0,18,0,18
24055,2021,Serbia and Kosovo: S/RES/1244 (1999),Israel,0,81,0,81
24056,2021,Sierra Leone,Israel,5,12,0,17
24057,2021,Somalia,Israel,0,11,0,11
24058,2021,Viet Nam,Israel,0,9,0,9
24059,2021,Sudan,Israel,490,4391,0,4881
24060,2021,South Sudan,Israel,72,89,0,161
24061,2021,United Rep. of Tanzania,Israel,0,6,0,6
24062,2021,Thailand,Israel,0,19,0,19
24063,2021,Tajikistan,Israel,0,5,0,5
24064,2021,Turkmenistan,Israel,0,5,0,5
24065,2021,Togo,Israel,0,6,0,6
24066,2021,Türkiye,Israel,5,211,0,216
24067,2021,Uganda,Israel,0,203,0,203
24068,2021,Ukraine,Israel,27,544,0,571
24069,2021,Uzbekistan,Israel,0,349,0,349
24070,2021,Venezuela (Bolivarian Republic of),Israel,0,5,0,5
24071,2021,Zambia,Israel,0,5,0,5
24072,2021,Zimbabwe,Israel,0,19,0,19
24075,2021,Afghanistan,Italy,15561,2375,0,17936
24076,2021,Albania,Italy,860,336,0,1196
24077,2021,Algeria,Italy,27,124,0,151
24078,2021,Angola,Italy,5,11,0,16
24079,2021,Egypt,Italy,868,2332,0,3200
24080,2021,Argentina,Italy,10,25,0,35
24081,2021,Armenia,Italy,213,119,0,332
24082,2021,Azerbaijan,Italy,6,24,0,30
24083,2021,Burundi,Italy,5,5,0,10
24084,2021,Benin,Italy,164,41,0,205
24085,2021,Bangladesh,Italy,5046,5416,0,10462
24086,2021,Burkina Faso,Italy,786,220,0,1006
24087,2021,Belarus,Italy,46,41,0,87
24088,2021,Bolivia (Plurinational State of),Italy,5,0,0,5
24089,2021,Brazil,Italy,342,170,0,512
24090,2021,Bosnia and Herzegovina,Italy,90,61,0,151
24091,2021,Central African Rep.,Italy,0,22,0,22
24092,2021,Chad,Italy,0,56,0,56
24093,2021,China,Italy,397,0,0,397
24094,2021,Chile,Italy,13,13,0,26
24095,2021,Cameroon,Italy,1687,384,0,2071
24096,2021,Congo,Italy,320,19,0,339
24097,2021,Dem. Rep. of the Congo,Italy,709,19,0,728
24098,2021,Comoros,Italy,0,5,0,5
24099,2021,Colombia,Italy,950,374,0,1324
24100,2021,Cuba,Italy,54,110,0,164
24101,2021,Cabo Verde,Italy,5,0,0,5
24102,2021,Dominican Rep.,Italy,12,12,0,24
24103,2021,Ecuador,Italy,11,23,0,34
24104,2021,Eritrea,Italy,3236,9330,0,12566
24105,2021,Ethiopia,Italy,969,75,0,1044
24106,2021,Gabon,Italy,0,6,0,6
24107,2021,Gambia,Italy,6056,691,0,6747
24108,2021,Palestinian,Italy,716,138,0,854
24109,2021,Georgia,Italy,623,1174,0,1797
24110,2021,Ghana,Italy,2704,403,0,3107
24111,2021,Guinea-Bissau,Italy,464,57,0,521
24112,2021,Guatemala,Italy,12,9,0,21
24113,2021,Guinea,Italy,2460,674,0,3134
24114,2021,"China, Hong Kong SAR",Italy,48,168,0,216
24115,2021,Honduras,Italy,464,48,0,512
24116,2021,Cote d'Ivoire,Italy,4182,1226,0,5408
24117,2021,India,Italy,252,337,0,589
24118,2021,Iran (Islamic Rep. of),Italy,1278,164,0,1442
24119,2021,Iraq,Italy,5311,1029,0,6340
24120,2021,Israel,Italy,0,5,0,5
24121,2021,Jordan,Italy,5,8,0,13
24122,2021,Kazakhstan,Italy,0,12,0,12
24123,2021,Kenya,Italy,16,11,0,27
24124,2021,Kyrgyzstan,Italy,5,6,0,11
24125,2021,Liberia,Italy,342,40,0,382
24126,2021,Libya,Italy,1141,241,0,1382
24127,2021,Lebanon,Italy,14,59,0,73
24128,2021,Liechtenstein,Italy,5,5,0,10
24129,2021,Sri Lanka,Italy,362,184,0,546
24130,2021,Madagascar,Italy,0,5,0,5
24131,2021,Mauritania,Italy,273,5,0,278
24132,2021,North Macedonia,Italy,15,63,0,78
24133,2021,Rep. of Moldova,Italy,36,104,0,140
24134,2021,Mexico,Italy,0,5,0,5
24135,2021,Mali,Italy,11375,1135,0,12510
24136,2021,Malaysia,Italy,0,5,0,5
24137,2021,Morocco,Italy,920,887,0,1807
24138,2021,Montenegro,Italy,13,10,0,23
24139,2021,Mauritius,Italy,5,9,0,14
24140,2021,Myanmar,Italy,5,9,0,14
24141,2021,Nepal,Italy,15,72,0,87
24142,2021,Niger,Italy,478,40,0,518
24143,2021,Nicaragua,Italy,9,5,0,14
24144,2021,Nigeria,Italy,20557,3983,0,24540
24145,2021,Pakistan,Italy,16570,9262,0,25832
24146,2021,Paraguay,Italy,0,9,0,9
24147,2021,Peru,Italy,669,470,0,1139
24148,2021,Philippines,Italy,17,43,0,60
24149,2021,South Africa,Italy,0,10,0,10
24150,2021,Russian Federation,Italy,248,83,0,331
24151,2021,El Salvador,Italy,3718,634,0,4352
24152,2021,Serbia and Kosovo: S/RES/1244 (1999),Italy,1373,321,0,1694
24153,2021,Senegal,Italy,4647,561,0,5208
24154,2021,Sierra Leone,Italy,438,100,0,538
24155,2021,Somalia,Italy,8151,973,0,9124
24156,2021,Sudan,Italy,1211,340,0,1551
24157,2021,South Sudan,Italy,0,15,0,15
24158,2021,Syrian Arab Rep.,Italy,3527,903,0,4430
24159,2021,United Rep. of Tanzania,Italy,0,7,0,7
24160,2021,Thailand,Italy,0,5,0,5
24161,2021,Turkmenistan,Italy,0,5,0,5
24162,2021,Togo,Italy,755,78,0,833
24163,2021,Tunisia,Italy,537,1103,0,1640
24164,2021,Türkiye,Italy,1610,378,0,1988
24165,2021,Uganda,Italy,7,0,0,7
24166,2021,Ukraine,Italy,3379,680,0,4059
24167,2021,Uruguay,Italy,5,5,0,10
24168,2021,United States of America,Italy,5,0,0,5
24169,2021,Venezuela (Bolivarian Republic of),Italy,2906,391,0,3297
24170,2021,Western Sahara,Italy,5,0,0,5
24171,2021,Yemen,Italy,0,42,0,42
24174,2021,Haiti,Jamaica,31,5,0,36
24175,2021,Venezuela (Bolivarian Republic of),Jamaica,0,0,0,0
24176,2021,Afghanistan,Jordan,8,10,0,18
24177,2021,Algeria,Jordan,0,5,0,5
24178,2021,Egypt,Jordan,128,507,0,635
24179,2021,Bangladesh,Jordan,0,10,0,10
24180,2021,Bosnia and Herzegovina,Jordan,9,0,0,9
24181,2021,Bulgaria,Jordan,0,0,0,0
24182,2021,Central African Rep.,Jordan,7,0,0,7
24183,2021,Chad,Jordan,11,15,0,26
24184,2021,Comoros,Jordan,0,5,0,5
24185,2021,Eritrea,Jordan,38,5,0,43
24186,2021,Ethiopia,Jordan,19,21,0,40
24187,2021,Palestinian,Jordan,0,0,0,0
24188,2021,Ghana,Jordan,0,5,0,5
24189,2021,India,Jordan,0,5,0,5
24190,2021,Iran (Islamic Rep. of),Jordan,5,0,0,5
24191,2021,Iraq,Jordan,34204,32159,0,66363
24192,2021,Jordan,Jordan,0,0,0,0
24193,2021,Kenya,Jordan,5,5,0,10
24194,2021,Libya,Jordan,40,112,0,152
24195,2021,Lebanon,Jordan,5,105,0,110
24196,2021,Sri Lanka,Jordan,9,5,0,14
24197,2021,Morocco,Jordan,0,10,0,10
24198,2021,Niger,Jordan,0,5,0,5
24199,2021,Nigeria,Jordan,5,62,0,67
24200,2021,Pakistan,Jordan,5,22,0,27
24201,2021,Philippines,Jordan,5,0,0,5
24202,2021,Russian Federation,Jordan,24,7,0,31
24203,2021,Saudi Arabia,Jordan,0,0,0,0
24204,2021,Senegal,Jordan,0,5,0,5
24205,2021,Somalia,Jordan,601,55,0,656
24206,2021,Sudan,Jordan,3697,2196,0,5893
24207,2021,South Sudan,Jordan,11,8,0,19
24208,2021,Syrian Arab Rep.,Jordan,672952,0,0,672952
24209,2021,Tajikistan,Jordan,0,15,0,15
24210,2021,Tunisia,Jordan,11,8,0,19
24211,2021,Ukraine,Jordan,0,9,0,9
24212,2021,United States of America,Jordan,0,0,0,0
24213,2021,Venezuela (Bolivarian Republic of),Jordan,0,5,0,5
24214,2021,Yemen,Jordan,1024,11753,0,12777
24216,2021,Afghanistan,Japan,84,0,0,84
24217,2021,Burundi,Japan,9,0,0,9
24218,2021,Bangladesh,Japan,18,0,0,18
24219,2021,China,Japan,77,0,0,77
24220,2021,Cameroon,Japan,19,0,0,19
24221,2021,Dem. Rep. of the Congo,Japan,23,0,0,23
24222,2021,Ethiopia,Japan,32,0,0,32
24223,2021,Guinea,Japan,5,0,0,5
24224,2021,Iran (Islamic Rep. of),Japan,19,0,0,19
24225,2021,Iraq,Japan,17,0,0,17
24226,2021,Sri Lanka,Japan,59,0,0,59
24227,2021,Myanmar,Japan,583,0,0,583
24228,2021,Nigeria,Japan,5,0,0,5
24229,2021,Pakistan,Japan,34,0,0,34
24230,2021,Rwanda,Japan,5,0,0,5
24231,2021,Somalia,Japan,5,0,0,5
24232,2021,Sudan,Japan,16,0,0,16
24233,2021,Syrian Arab Rep.,Japan,93,0,0,93
24234,2021,Türkiye,Japan,46,0,0,46
24235,2021,Uganda,Japan,6,0,0,6
24236,2021,Yemen,Japan,15,0,0,15
24239,2021,Afghanistan,Kazakhstan,327,287,0,614
24240,2021,China,Kazakhstan,6,7,0,13
24241,2021,Syrian Arab Rep.,Kazakhstan,14,11,0,25
24242,2021,Uzbekistan,Kazakhstan,5,0,0,5
24244,2021,Afghanistan,Kenya,12,5,0,17
24245,2021,Egypt,Kenya,0,16,0,16
24246,2021,Burundi,Kenya,7203,11950,0,19153
24247,2021,Central African Rep.,Kenya,0,11,0,11
24248,2021,Chad,Kenya,0,5,0,5
24249,2021,Cameroon,Kenya,0,54,0,54
24250,2021,Congo,Kenya,93,79,0,172
24251,2021,Dem. Rep. of the Congo,Kenya,30411,17873,0,48284
24252,2021,Eritrea,Kenya,902,1298,0,2200
24253,2021,Ethiopia,Kenya,20647,9720,0,30367
24254,2021,Cote d'Ivoire,Kenya,0,5,0,5
24255,2021,India,Kenya,0,5,0,5
24256,2021,Iraq,Kenya,5,0,0,5
24257,2021,Kenya,Kenya,0,0,0,0
24258,2021,Sri Lanka,Kenya,9,0,0,9
24259,2021,Mozambique,Kenya,8,0,0,8
24260,2021,Nigeria,Kenya,6,9,0,15
24261,2021,Pakistan,Kenya,9,12,0,21
24262,2021,Rwanda,Kenya,766,1223,0,1989
24263,2021,Somalia,Kenya,280479,8176,0,288655
24264,2021,Sudan,Kenya,4213,5766,0,9979
24265,2021,South Sudan,Kenya,135255,96,0,135351
24266,2021,Syrian Arab Rep.,Kenya,5,5,0,10
24267,2021,United Rep. of Tanzania,Kenya,11,104,0,115
24268,2021,Türkiye,Kenya,121,80,0,201
24269,2021,Uganda,Kenya,794,2292,0,3086
24270,2021,Yemen,Kenya,93,211,0,304
24271,2021,Zimbabwe,Kenya,6,6,0,12
24273,2021,Afghanistan,Kyrgyzstan,213,309,0,522
24274,2021,Iraq,Kyrgyzstan,6,0,0,6
24275,2021,Pakistan,Kyrgyzstan,0,6,0,6
24276,2021,Syrian Arab Rep.,Kyrgyzstan,75,6,0,81
24277,2021,Turkmenistan,Kyrgyzstan,5,0,0,5
24278,2021,Türkiye,Kyrgyzstan,0,350,0,350
24279,2021,Ukraine,Kyrgyzstan,18,0,0,18
24280,2021,Venezuela (Bolivarian Republic of),Kyrgyzstan,0,5,0,5
24281,2021,Yemen,Kyrgyzstan,0,5,0,5
24283,2021,Afghanistan,Rep. of Korea,46,59,0,105
24284,2021,Algeria,Rep. of Korea,6,73,0,79
24285,2021,Angola,Rep. of Korea,9,18,0,27
24286,2021,Egypt,Rep. of Korea,72,753,0,825
24287,2021,Argentina,Rep. of Korea,0,8,0,8
24288,2021,Azerbaijan,Rep. of Korea,0,8,0,8
24289,2021,Burundi,Rep. of Korea,47,15,0,62
24290,2021,Bangladesh,Rep. of Korea,129,1004,0,1133
24291,2021,Burkina Faso,Rep. of Korea,0,5,0,5
24292,2021,Bolivia (Plurinational State of),Rep. of Korea,0,5,0,5
24293,2021,Brazil,Rep. of Korea,0,13,0,13
24294,2021,Cambodia,Rep. of Korea,0,47,0,47
24295,2021,China,Rep. of Korea,50,1121,0,1171
24296,2021,Cameroon,Rep. of Korea,23,164,0,187
24297,2021,Congo,Rep. of Korea,0,8,0,8
24298,2021,Dem. Rep. of the Congo,Rep. of Korea,62,24,0,86
24299,2021,Colombia,Rep. of Korea,0,5,0,5
24300,2021,Eritrea,Rep. of Korea,10,0,0,10
24301,2021,Ethiopia,Rep. of Korea,171,164,0,335
24302,2021,Gambia,Rep. of Korea,0,44,0,44
24303,2021,Palestinian,Rep. of Korea,8,6,0,14
24304,2021,Ghana,Rep. of Korea,7,195,0,202
24305,2021,Guinea,Rep. of Korea,5,116,0,121
24306,2021,Haiti,Rep. of Korea,0,23,0,23
24307,2021,Cote d'Ivoire,Rep. of Korea,38,22,0,60
24308,2021,India,Rep. of Korea,0,1294,0,1294
24309,2021,Indonesia,Rep. of Korea,0,29,0,29
24310,2021,Iran (Islamic Rep. of),Rep. of Korea,62,54,0,116
24311,2021,Iraq,Rep. of Korea,28,84,0,112
24312,2021,Jordan,Rep. of Korea,7,16,0,23
24313,2021,Kazakhstan,Rep. of Korea,5,669,0,674
24314,2021,Kenya,Rep. of Korea,5,36,0,41
24315,2021,Kyrgyzstan,Rep. of Korea,0,101,0,101
24316,2021,Liberia,Rep. of Korea,12,164,0,176
24317,2021,Libya,Rep. of Korea,15,60,0,75
24318,2021,Sri Lanka,Rep. of Korea,8,191,0,199
24319,2021,Mali,Rep. of Korea,8,78,0,86
24320,2021,Malaysia,Rep. of Korea,0,875,0,875
24321,2021,Mongolia,Rep. of Korea,0,177,0,177
24322,2021,Morocco,Rep. of Korea,5,176,0,181
24323,2021,Mozambique,Rep. of Korea,0,7,0,7
24324,2021,Myanmar,Rep. of Korea,396,107,0,503
24325,2021,Nepal,Rep. of Korea,5,391,0,396
24326,2021,Nigeria,Rep. of Korea,13,343,0,356
24327,2021,Pakistan,Rep. of Korea,118,938,0,1056
24328,2021,Peru,Rep. of Korea,0,9,0,9
24329,2021,Philippines,Rep. of Korea,0,331,0,331
24330,2021,South Africa,Rep. of Korea,0,50,0,50
24331,2021,Russian Federation,Rep. of Korea,13,1000,0,1013
24332,2021,Rwanda,Rep. of Korea,0,30,0,30
24333,2021,Saudi Arabia,Rep. of Korea,0,5,0,5
24334,2021,Senegal,Rep. of Korea,0,50,0,50
24335,2021,Sierra Leone,Rep. of Korea,0,26,0,26
24336,2021,Somalia,Rep. of Korea,5,0,0,5
24337,2021,Viet Nam,Rep. of Korea,0,63,0,63
24338,2021,Sudan,Rep. of Korea,32,46,0,78
24339,2021,Syrian Arab Rep.,Rep. of Korea,1250,28,0,1278
24340,2021,United Rep. of Tanzania,Rep. of Korea,5,34,0,39
24341,2021,Thailand,Rep. of Korea,10,179,0,189
24342,2021,Tajikistan,Rep. of Korea,0,24,0,24
24343,2021,Togo,Rep. of Korea,0,14,0,14
24344,2021,Tunisia,Rep. of Korea,0,55,0,55
24345,2021,Türkiye,Rep. of Korea,0,186,0,186
24346,2021,Uganda,Rep. of Korea,38,50,0,88
24347,2021,Ukraine,Rep. of Korea,14,24,0,38
24348,2021,United States of America,Rep. of Korea,0,5,0,5
24349,2021,Uzbekistan,Rep. of Korea,9,201,0,210
24350,2021,Venezuela (Bolivarian Republic of),Rep. of Korea,0,12,0,12
24351,2021,Yemen,Rep. of Korea,813,18,0,831
24352,2021,Zimbabwe,Rep. of Korea,0,6,0,6
24355,2021,Afghanistan,Kuwait,0,17,0,17
24356,2021,Egypt,Kuwait,6,19,0,25
24357,2021,Djibouti,Kuwait,0,5,0,5
24358,2021,Eritrea,Kuwait,5,28,0,33
24359,2021,Ethiopia,Kuwait,0,7,0,7
24360,2021,Palestinian,Kuwait,5,5,0,10
24361,2021,Iran (Islamic Rep. of),Kuwait,9,83,0,92
24362,2021,Iraq,Kuwait,334,308,0,642
24363,2021,Jordan,Kuwait,0,6,0,6
24364,2021,Lebanon,Kuwait,0,5,0,5
24365,2021,Sri Lanka,Kuwait,0,6,0,6
24366,2021,Pakistan,Kuwait,0,12,0,12
24367,2021,Philippines,Kuwait,0,5,0,5
24368,2021,Somalia,Kuwait,202,443,0,645
24369,2021,Sudan,Kuwait,0,17,0,17
24370,2021,Syrian Arab Rep.,Kuwait,150,104,0,254
24371,2021,Ukraine,Kuwait,0,5,0,5
24372,2021,Yemen,Kuwait,9,10,0,19
24375,2021,Burkina Faso,Liberia,0,5,0,5
24376,2021,Central African Rep.,Liberia,5,0,0,5
24377,2021,Cameroon,Liberia,5,0,0,5
24378,2021,Dem. Rep. of the Congo,Liberia,28,5,0,33
24379,2021,Guinea,Liberia,0,5,0,5
24380,2021,Cote d'Ivoire,Liberia,8018,9779,0,17797
24381,2021,Mali,Liberia,19,0,0,19
24382,2021,Nigeria,Liberia,0,6,0,6
24383,2021,Pakistan,Liberia,5,0,0,5
24384,2021,Rwanda,Liberia,5,0,0,5
24385,2021,Sierra Leone,Liberia,15,0,0,15
24386,2021,Somalia,Liberia,5,0,0,5
24387,2021,Sudan,Liberia,11,0,0,11
24388,2021,South Sudan,Liberia,5,0,0,5
24389,2021,Syrian Arab Rep.,Liberia,27,18,0,45
24390,2021,Togo,Liberia,5,0,0,5
24391,2021,Türkiye,Liberia,16,0,0,16
24392,2021,Afghanistan,Libya,0,5,0,5
24393,2021,Burkina Faso,Libya,0,5,0,5
24394,2021,Chad,Libya,0,12,0,12
24395,2021,Dem. Rep. of the Congo,Libya,0,5,0,5
24396,2021,Eritrea,Libya,344,3992,0,4336
24397,2021,Ethiopia,Libya,32,939,0,971
24398,2021,Palestinian,Libya,560,1487,0,2047
24399,2021,Cote d'Ivoire,Libya,0,9,0,9
24400,2021,Iran (Islamic Rep. of),Libya,0,5,0,5
24401,2021,Iraq,Libya,333,187,0,520
24402,2021,Libya,Libya,0,0,179047,0
24403,2021,Mali,Libya,0,25,0,25
24404,2021,Niger,Libya,0,5,0,5
24405,2021,Nigeria,Libya,0,41,0,41
24406,2021,Somalia,Libya,24,1275,0,1299
24407,2021,Sudan,Libya,1336,15707,0,17043
24408,2021,South Sudan,Libya,8,309,0,317
24409,2021,Syrian Arab Rep.,Libya,492,12632,0,13124
24410,2021,Yemen,Libya,12,101,0,113
24411,2021,Afghanistan,Lebanon,24,11,0,35
24412,2021,Algeria,Lebanon,6,6,0,12
24413,2021,Egypt,Lebanon,121,370,0,491
24414,2021,Armenia,Lebanon,0,11,0,11
24415,2021,Bahrain,Lebanon,14,5,0,19
24416,2021,Bangladesh,Lebanon,0,101,0,101
24417,2021,Cameroon,Lebanon,8,26,0,34
24418,2021,Congo,Lebanon,0,5,0,5
24419,2021,Dem. Rep. of the Congo,Lebanon,0,11,0,11
24420,2021,Eritrea,Lebanon,19,18,0,37
24421,2021,Ethiopia,Lebanon,46,907,0,953
24422,2021,Gambia,Lebanon,0,8,0,8
24423,2021,Palestinian,Lebanon,0,0,0,0
24424,2021,Ghana,Lebanon,0,8,0,8
24425,2021,Cote d'Ivoire,Lebanon,0,10,0,10
24426,2021,India,Lebanon,0,12,0,12
24427,2021,Iran (Islamic Rep. of),Lebanon,35,46,0,81
24428,2021,Iraq,Lebanon,3750,5233,0,8983
24429,2021,Jordan,Lebanon,36,87,0,123
24430,2021,Kenya,Lebanon,5,13,0,18
24431,2021,Kuwait,Lebanon,9,0,0,9
24432,2021,Libya,Lebanon,11,17,0,28
24433,2021,Lebanon,Lebanon,0,0,0,0
24434,2021,Sri Lanka,Lebanon,0,19,0,19
24435,2021,Madagascar,Lebanon,0,15,0,15
24436,2021,Morocco,Lebanon,5,8,0,13
24437,2021,Nigeria,Lebanon,5,68,0,73
24438,2021,Pakistan,Lebanon,6,14,0,20
24439,2021,Philippines,Lebanon,0,39,0,39
24440,2021,Saudi Arabia,Lebanon,7,7,0,14
24441,2021,Somalia,Lebanon,11,0,0,11
24442,2021,Sudan,Lebanon,728,1524,0,2252
24443,2021,South Sudan,Lebanon,38,0,0,38
24444,2021,Syrian Arab Rep.,Lebanon,840929,0,0,840929
24445,2021,Togo,Lebanon,0,10,0,10
24446,2021,Tunisia,Lebanon,11,0,0,11
24447,2021,Türkiye,Lebanon,7,6,0,13
24448,2021,Ukraine,Lebanon,0,0,0,0
24449,2021,Venezuela (Bolivarian Republic of),Lebanon,0,5,0,5
24450,2021,Yemen,Lebanon,34,97,0,131
24451,2021,Cameroon,Lesotho,0,5,0,5
24452,2021,Dem. Rep. of the Congo,Lesotho,205,145,0,350
24453,2021,Eritrea,Lesotho,43,44,0,87
24454,2021,Ethiopia,Lesotho,24,16,0,40
24455,2021,Nigeria,Lesotho,0,5,0,5
24456,2021,Somalia,Lesotho,5,6,0,11
24457,2021,Uganda,Lesotho,9,5,0,14
24458,2021,Zambia,Lesotho,5,0,0,5
24459,2021,Zimbabwe,Lesotho,5,0,0,5
24460,2021,Afghanistan,Liechtenstein,5,0,0,5
24461,2021,Albania,Liechtenstein,0,5,0,5
24462,2021,Belarus,Liechtenstein,0,5,0,5
24463,2021,China,Liechtenstein,35,0,0,35
24464,2021,Eritrea,Liechtenstein,12,0,0,12
24465,2021,Iran (Islamic Rep. of),Liechtenstein,11,0,0,11
24466,2021,Iraq,Liechtenstein,7,5,0,12
24467,2021,Somalia,Liechtenstein,26,0,0,26
24468,2021,Sudan,Liechtenstein,0,7,0,7
24469,2021,Syrian Arab Rep.,Liechtenstein,32,0,0,32
24470,2021,Ukraine,Liechtenstein,5,0,0,5
24471,2021,Afghanistan,Sri Lanka,113,27,0,140
24472,2021,Palestinian,Sri Lanka,6,5,0,11
24473,2021,Iran (Islamic Rep. of),Sri Lanka,24,0,0,24
24474,2021,Sri Lanka,Sri Lanka,0,0,8767,0
24475,2021,Myanmar,Sri Lanka,35,0,0,35
24476,2021,Nigeria,Sri Lanka,0,10,0,10
24477,2021,Pakistan,Sri Lanka,709,149,0,858
24478,2021,Sudan,Sri Lanka,5,5,0,10
24479,2021,Yemen,Sri Lanka,15,5,0,20
24481,2021,Afghanistan,Lithuania,230,9,0,239
24482,2021,Azerbaijan,Lithuania,17,0,0,17
24483,2021,Belarus,Lithuania,35,65,0,100
24484,2021,Chile,Lithuania,0,5,0,5
24485,2021,Cameroon,Lithuania,6,0,0,6
24486,2021,Cuba,Lithuania,5,0,0,5
24487,2021,Eritrea,Lithuania,40,0,0,40
24488,2021,Ethiopia,Lithuania,5,0,0,5
24489,2021,Georgia,Lithuania,5,0,0,5
24490,2021,Iran (Islamic Rep. of),Lithuania,13,0,0,13
24491,2021,Iraq,Lithuania,65,15,0,80
24492,2021,Sri Lanka,Lithuania,10,5,0,15
24493,2021,Nigeria,Lithuania,5,0,0,5
24494,2021,Pakistan,Lithuania,5,0,0,5
24495,2021,Russian Federation,Lithuania,688,8,0,696
24496,2021,Somalia,Lithuania,22,0,0,22
24497,2021,Syrian Arab Rep.,Lithuania,463,5,0,468
24498,2021,Tajikistan,Lithuania,85,5,0,90
24499,2021,Türkiye,Lithuania,63,0,0,63
24500,2021,Ukraine,Lithuania,64,5,0,69
24501,2021,Uzbekistan,Lithuania,17,0,0,17
24503,2021,Afghanistan,Luxembourg,427,200,0,627
24504,2021,Albania,Luxembourg,38,5,0,43
24505,2021,Algeria,Luxembourg,0,20,0,20
24506,2021,Angola,Luxembourg,9,10,0,19
24507,2021,Egypt,Luxembourg,0,5,0,5
24508,2021,Armenia,Luxembourg,5,0,0,5
24509,2021,Azerbaijan,Luxembourg,13,0,0,13
24510,2021,Burundi,Luxembourg,5,0,0,5
24511,2021,Bhutan,Luxembourg,5,0,0,5
24512,2021,Burkina Faso,Luxembourg,0,5,0,5
24513,2021,Belarus,Luxembourg,0,10,0,10
24514,2021,Bosnia and Herzegovina,Luxembourg,5,0,0,5
24515,2021,China,Luxembourg,7,0,0,7
24516,2021,Cameroon,Luxembourg,17,35,0,52
24517,2021,Dem. Rep. of the Congo,Luxembourg,43,10,0,53
24518,2021,Colombia,Luxembourg,0,20,0,20
24519,2021,Eritrea,Luxembourg,1329,330,0,1659
24520,2021,Ethiopia,Luxembourg,63,40,0,103
24521,2021,Gabon,Luxembourg,5,0,0,5
24522,2021,Gambia,Luxembourg,6,10,0,16
24523,2021,Georgia,Luxembourg,0,5,0,5
24524,2021,Guinea,Luxembourg,12,15,0,27
24525,2021,Cote d'Ivoire,Luxembourg,5,15,0,20
24526,2021,Iran (Islamic Rep. of),Luxembourg,211,85,0,296
24527,2021,Iraq,Luxembourg,788,105,0,893
24528,2021,Dem. People's Rep. of Korea,Luxembourg,11,0,0,11
24529,2021,Kuwait,Luxembourg,5,0,0,5
24530,2021,Libya,Luxembourg,5,25,0,30
24531,2021,Lebanon,Luxembourg,5,15,0,20
24532,2021,Sri Lanka,Luxembourg,5,0,0,5
24533,2021,Mali,Luxembourg,0,5,0,5
24534,2021,Morocco,Luxembourg,0,15,0,15
24535,2021,Montenegro,Luxembourg,6,0,0,6
24536,2021,Niger,Luxembourg,0,5,0,5
24537,2021,Nigeria,Luxembourg,9,10,0,19
24538,2021,Pakistan,Luxembourg,0,5,0,5
24539,2021,Russian Federation,Luxembourg,17,10,0,27
24540,2021,Rwanda,Luxembourg,13,5,0,18
24541,2021,Serbia and Kosovo: S/RES/1244 (1999),Luxembourg,130,0,0,130
24542,2021,Senegal,Luxembourg,5,10,0,15
24543,2021,Somalia,Luxembourg,57,35,0,92
24544,2021,Sudan,Luxembourg,56,45,0,101
24545,2021,Syrian Arab Rep.,Luxembourg,2409,415,0,2824
24546,2021,United Rep. of Tanzania,Luxembourg,0,5,0,5
24547,2021,Tajikistan,Luxembourg,0,5,0,5
24548,2021,Turkmenistan,Luxembourg,5,0,0,5
24549,2021,Togo,Luxembourg,8,5,0,13
24550,2021,Tunisia,Luxembourg,0,10,0,10
24551,2021,Türkiye,Luxembourg,103,70,0,173
24552,2021,Uganda,Luxembourg,5,0,0,5
24553,2021,Ukraine,Luxembourg,5,10,0,15
24554,2021,Venezuela (Bolivarian Republic of),Luxembourg,8,100,0,108
24555,2021,Yemen,Luxembourg,30,5,0,35
24558,2021,Afghanistan,Latvia,81,46,0,127
24559,2021,Egypt,Latvia,5,5,0,10
24560,2021,Azerbaijan,Latvia,11,6,0,17
24561,2021,Belarus,Latvia,61,33,0,94
24562,2021,China,Latvia,5,0,0,5
24563,2021,Cuba,Latvia,0,5,0,5
24564,2021,Eritrea,Latvia,35,0,0,35
24565,2021,Palestinian,Latvia,7,0,0,7
24566,2021,Iran (Islamic Rep. of),Latvia,17,0,0,17
24567,2021,Iraq,Latvia,40,95,0,135
24568,2021,Kazakhstan,Latvia,5,0,0,5
24569,2021,Kyrgyzstan,Latvia,5,0,0,5
24570,2021,Lebanon,Latvia,5,0,0,5
24571,2021,Sri Lanka,Latvia,5,0,0,5
24572,2021,Russian Federation,Latvia,59,9,0,68
24573,2021,Somalia,Latvia,5,0,0,5
24574,2021,Syrian Arab Rep.,Latvia,312,5,0,317
24575,2021,Tajikistan,Latvia,5,0,0,5
24576,2021,Türkiye,Latvia,31,0,0,31
24577,2021,Ukraine,Latvia,0,5,0,5
24578,2021,Uzbekistan,Latvia,11,0,0,11
24580,2021,Afghanistan,Madagascar,20,0,0,20
24581,2021,Burundi,Madagascar,5,0,0,5
24582,2021,Congo,Madagascar,0,5,0,5
24583,2021,Dem. Rep. of the Congo,Madagascar,11,0,0,11
24584,2021,Comoros,Madagascar,5,0,0,5
24585,2021,Guinea,Madagascar,6,0,0,6
24586,2021,Madagascar,Madagascar,0,0,0,0
24587,2021,Pakistan,Madagascar,99,106,0,205
24588,2021,Syrian Arab Rep.,Madagascar,5,0,0,5
24589,2021,Yemen,Madagascar,14,11,0,25
24590,2021,Benin,Mauritania,0,10,0,10
24591,2021,Burkina Faso,Mauritania,18,70,0,88
24592,2021,Central African Rep.,Mauritania,653,94,0,747
24593,2021,Chad,Mauritania,5,5,0,10
24594,2021,China,Mauritania,5,0,0,5
24595,2021,Cameroon,Mauritania,19,131,0,150
24596,2021,Congo,Mauritania,7,14,0,21
24597,2021,Dem. Rep. of the Congo,Mauritania,31,29,0,60
24598,2021,Ethiopia,Mauritania,8,8,0,16
24599,2021,Gambia,Mauritania,0,11,0,11
24600,2021,Palestinian,Mauritania,78,43,0,121
24601,2021,Ghana,Mauritania,0,11,0,11
24602,2021,Guinea,Mauritania,17,162,0,179
24603,2021,Cote d'Ivoire,Mauritania,277,221,0,498
24604,2021,Iraq,Mauritania,24,0,0,24
24605,2021,Liberia,Mauritania,7,17,0,24
24606,2021,Libya,Mauritania,8,16,0,24
24607,2021,Lebanon,Mauritania,0,14,0,14
24608,2021,Mali,Mauritania,74196,1716,0,75912
24609,2021,Niger,Mauritania,5,19,0,24
24610,2021,Nigeria,Mauritania,13,68,0,81
24611,2021,Russian Federation,Mauritania,11,0,0,11
24612,2021,Senegal,Mauritania,107,213,0,320
24613,2021,Sierra Leone,Mauritania,0,140,0,140
24614,2021,Somalia,Mauritania,5,5,0,10
24615,2021,Sudan,Mauritania,13,18,0,31
24616,2021,Syrian Arab Rep.,Mauritania,368,141,0,509
24617,2021,Togo,Mauritania,17,136,0,153
24618,2021,Türkiye,Mauritania,5,15,0,20
24619,2021,Western Sahara,Mauritania,26000,0,0,26000
24620,2021,Yemen,Mauritania,45,42,0,87
24621,2021,Afghanistan,North Macedonia,8,0,0,8
24622,2021,Congo,North Macedonia,5,0,0,5
24623,2021,Cuba,North Macedonia,0,5,0,5
24624,2021,Iraq,North Macedonia,5,0,0,5
24625,2021,North Macedonia,North Macedonia,0,0,116,0
24626,2021,Morocco,North Macedonia,0,5,0,5
24627,2021,Pakistan,North Macedonia,5,5,0,10
24628,2021,Russian Federation,North Macedonia,0,5,0,5
24629,2021,Serbia and Kosovo: S/RES/1244 (1999),North Macedonia,252,0,0,252
24630,2021,Syrian Arab Rep.,North Macedonia,17,0,0,17
24631,2021,Türkiye,North Macedonia,0,5,0,5
24633,2021,Iraq,Monaco,5,0,0,5
24634,2021,Viet Nam,Monaco,7,0,0,7
24635,2021,Syrian Arab Rep.,Monaco,5,0,0,5
24636,2021,Afghanistan,Rep. of Moldova,12,0,0,12
24637,2021,Armenia,Rep. of Moldova,11,0,0,11
24638,2021,Azerbaijan,Rep. of Moldova,5,0,0,5
24639,2021,Cuba,Rep. of Moldova,0,8,0,8
24640,2021,Palestinian,Rep. of Moldova,5,0,0,5
24641,2021,Georgia,Rep. of Moldova,0,6,0,6
24642,2021,Iraq,Rep. of Moldova,17,0,0,17
24643,2021,Kyrgyzstan,Rep. of Moldova,10,0,0,10
24644,2021,Libya,Rep. of Moldova,5,0,0,5
24645,2021,Russian Federation,Rep. of Moldova,5,5,0,10
24646,2021,Sudan,Rep. of Moldova,9,0,0,9
24647,2021,Syrian Arab Rep.,Rep. of Moldova,166,7,0,173
24648,2021,Tajikistan,Rep. of Moldova,6,0,0,6
24649,2021,Turkmenistan,Rep. of Moldova,5,0,0,5
24650,2021,Türkiye,Rep. of Moldova,61,23,0,84
24651,2021,Ukraine,Rep. of Moldova,18,7,0,25
24652,2021,Uzbekistan,Rep. of Moldova,8,0,0,8
24653,2021,Yemen,Rep. of Moldova,6,0,0,6
24655,2021,Afghanistan,Mexico,5,6,0,11
24656,2021,Albania,Mexico,8,0,0,8
24657,2021,Algeria,Mexico,5,5,0,10
24658,2021,Angola,Mexico,10,345,0,355
24659,2021,Egypt,Mexico,5,11,0,16
24660,2021,Argentina,Mexico,5,195,0,200
24661,2021,Burundi,Mexico,0,5,0,5
24662,2021,Benin,Mexico,5,14,0,19
24663,2021,Bangladesh,Mexico,10,37,0,47
24664,2021,Burkina Faso,Mexico,14,82,0,96
24665,2021,Belarus,Mexico,0,5,0,5
24666,2021,Bolivia (Plurinational State of),Mexico,0,37,0,37
24667,2021,Brazil,Mexico,161,4240,0,4401
24668,2021,Belize,Mexico,24,57,0,81
24669,2021,Cambodia,Mexico,24,46,0,70
24670,2021,Canada,Mexico,0,19,0,19
24671,2021,Central African Rep.,Mexico,0,5,0,5
24672,2021,Chad,Mexico,0,9,0,9
24673,2021,China,Mexico,5,16,0,21
24674,2021,Chile,Mexico,383,7104,0,7487
24675,2021,Cameroon,Mexico,30,430,0,460
24676,2021,Congo,Mexico,25,108,0,133
24677,2021,Dem. Rep. of the Congo,Mexico,73,457,0,530
24678,2021,Colombia,Mexico,530,1765,0,2295
24679,2021,Costa Rica,Mexico,33,119,0,152
24680,2021,Cuba,Mexico,3722,9837,0,13559
24681,2021,Dominica,Mexico,0,10,0,10
24682,2021,Dominican Rep.,Mexico,32,197,0,229
24683,2021,Ecuador,Mexico,43,297,0,340
24684,2021,Eritrea,Mexico,7,102,0,109
24685,2021,Ethiopia,Mexico,6,25,0,31
24686,2021,French Guiana,Mexico,0,72,0,72
24687,2021,France,Mexico,0,17,0,17
24688,2021,Gambia,Mexico,0,5,0,5
24689,2021,Palestinian,Mexico,5,7,0,12
24690,2021,Germany,Mexico,0,10,0,10
24691,2021,Ghana,Mexico,43,402,0,445
24692,2021,Guinea-Bissau,Mexico,0,5,0,5
24693,2021,Guatemala,Mexico,3113,6123,0,9236
24694,2021,Guinea,Mexico,42,162,0,204
24695,2021,Guyana,Mexico,0,23,0,23
24696,2021,Haiti,Mexico,3294,52404,0,55698
24697,2021,Honduras,Mexico,30787,46081,0,76868
24698,2021,Cote d'Ivoire,Mexico,6,37,0,43
24699,2021,India,Mexico,14,88,0,102
24700,2021,Iran (Islamic Rep. of),Mexico,41,11,0,52
24701,2021,Iraq,Mexico,44,7,0,51
24702,2021,Israel,Mexico,0,13,0,13
24703,2021,Italy,Mexico,0,8,0,8
24704,2021,Jamaica,Mexico,6,14,0,20
24705,2021,Kyrgyzstan,Mexico,8,9,0,17
24706,2021,Rep. of Korea,Mexico,0,5,0,5
24707,2021,Liberia,Mexico,0,5,0,5
24708,2021,Sri Lanka,Mexico,20,30,0,50
24709,2021,Mauritania,Mexico,6,71,0,77
24710,2021,Mali,Mexico,5,52,0,57
24711,2021,Morocco,Mexico,5,7,0,12
24712,2021,Nepal,Mexico,0,15,0,15
24713,2021,Nicaragua,Mexico,1619,3891,0,5510
24714,2021,Nigeria,Mexico,45,72,0,117
24715,2021,Pakistan,Mexico,12,28,0,40
24716,2021,Panama,Mexico,53,106,0,159
24717,2021,Paraguay,Mexico,0,5,0,5
24718,2021,Peru,Mexico,33,145,0,178
24719,2021,Portugal,Mexico,5,7,0,12
24720,2021,Romania,Mexico,7,0,0,7
24721,2021,South Africa,Mexico,0,12,0,12
24722,2021,Russian Federation,Mexico,44,31,0,75
24723,2021,Rwanda,Mexico,0,5,0,5
24724,2021,El Salvador,Mexico,12265,11443,0,23708
24725,2021,Senegal,Mexico,0,338,0,338
24726,2021,Sierra Leone,Mexico,11,92,0,103
24727,2021,Somalia,Mexico,5,50,0,55
24728,2021,Spain,Mexico,5,15,0,20
24729,2021,Sudan,Mexico,0,11,0,11
24730,2021,Syrian Arab Rep.,Mexico,34,35,0,69
24731,2021,Tajikistan,Mexico,0,5,0,5
24732,2021,Togo,Mexico,19,72,0,91
24733,2021,Türkiye,Mexico,8,7,0,15
24734,2021,Uganda,Mexico,0,45,0,45
24735,2021,Ukraine,Mexico,19,5,0,24
24736,2021,Uruguay,Mexico,13,42,0,55
24737,2021,United States of America,Mexico,38,110,0,148
24738,2021,Uzbekistan,Mexico,0,21,0,21
24739,2021,Venezuela (Bolivarian Republic of),Mexico,16585,9212,0,25797
24740,2021,Yemen,Mexico,24,77,0,101
24742,2021,Burundi,Mali,18,0,0,18
24743,2021,Bangladesh,Mali,0,32,0,32
24744,2021,Burkina Faso,Mali,14731,0,0,14731
24745,2021,Central African Rep.,Mali,1136,271,0,1407
24746,2021,Chad,Mali,0,5,0,5
24747,2021,Cameroon,Mali,6,6,0,12
24748,2021,Congo,Mali,34,5,0,39
24749,2021,Dem. Rep. of the Congo,Mali,293,45,0,338
24750,2021,Eritrea,Mali,5,0,0,5
24751,2021,Guinea,Mali,0,10,0,10
24752,2021,Cote d'Ivoire,Mali,427,40,0,467
24753,2021,Liberia,Mali,5,0,0,5
24754,2021,Mauritania,Mali,14965,0,0,14965
24755,2021,Mali,Mali,0,0,350110,0
24756,2021,Niger,Mali,18255,0,0,18255
24757,2021,Nigeria,Mali,0,5,0,5
24758,2021,Pakistan,Mali,11,0,0,11
24759,2021,Rwanda,Mali,15,5,0,20
24760,2021,Syrian Arab Rep.,Mali,24,433,0,457
24761,2021,Togo,Mali,29,0,0,29
24762,2021,Türkiye,Mali,21,6,0,27
24763,2021,Afghanistan,Malaysia,1604,1199,0,2803
24764,2021,Algeria,Malaysia,0,10,0,10
24765,2021,Egypt,Malaysia,18,83,0,101
24766,2021,Australia,Malaysia,5,0,0,5
24767,2021,Bangladesh,Malaysia,37,17,0,54
24768,2021,Cambodia,Malaysia,77,10,0,87
24769,2021,Central African Rep.,Malaysia,5,0,0,5
24770,2021,China,Malaysia,46,0,0,46
24771,2021,Cameroon,Malaysia,10,22,0,32
24772,2021,Dem. Rep. of the Congo,Malaysia,10,0,0,10
24773,2021,Eritrea,Malaysia,25,15,0,40
24774,2021,Ethiopia,Malaysia,12,11,0,23
24775,2021,Palestinian,Malaysia,249,526,0,775
24776,2021,United Kingdom of Great Britain and Northern Ireland,Malaysia,6,0,0,6
24777,2021,Guinea,Malaysia,7,25,0,32
24778,2021,Cote d'Ivoire,Malaysia,5,0,0,5
24779,2021,India,Malaysia,5,19,0,24
24780,2021,Indonesia,Malaysia,946,35,0,981
24781,2021,Iran (Islamic Rep. of),Malaysia,274,169,0,443
24782,2021,Iraq,Malaysia,420,788,0,1208
24783,2021,Jordan,Malaysia,10,0,0,10
24784,2021,Liberia,Malaysia,21,6,0,27
24785,2021,Libya,Malaysia,11,20,0,31
24786,2021,Lebanon,Malaysia,5,5,0,10
24787,2021,Sri Lanka,Malaysia,795,895,0,1690
24788,2021,Mali,Malaysia,5,0,0,5
24789,2021,Morocco,Malaysia,5,0,0,5
24790,2021,Myanmar,Malaysia,120598,34807,0,155405
24791,2021,Nepal,Malaysia,11,0,0,11
24792,2021,Nigeria,Malaysia,5,39,0,44
24793,2021,Pakistan,Malaysia,3632,3116,0,6748
24794,2021,Philippines,Malaysia,20,0,0,20
24795,2021,Russian Federation,Malaysia,6,0,0,6
24796,2021,Sierra Leone,Malaysia,9,36,0,45
24797,2021,Somalia,Malaysia,2168,1047,0,3215
24798,2021,Viet Nam,Malaysia,5,0,0,5
24799,2021,Sudan,Malaysia,182,127,0,309
24800,2021,South Sudan,Malaysia,24,40,0,64
24801,2021,Syrian Arab Rep.,Malaysia,449,2858,0,3307
24802,2021,Thailand,Malaysia,26,24,0,50
24803,2021,Uganda,Malaysia,5,11,0,16
24804,2021,United States of America,Malaysia,7,0,0,7
24805,2021,Uzbekistan,Malaysia,0,7,0,7
24806,2021,Yemen,Malaysia,321,3400,0,3721
24807,2021,Zimbabwe,Malaysia,5,5,0,10
24809,2021,Burundi,Malawi,3951,8288,0,12239
24810,2021,Dem. Rep. of the Congo,Malawi,14941,17502,0,32443
24811,2021,Eritrea,Malawi,0,8,0,8
24812,2021,Ethiopia,Malawi,11,68,0,79
24813,2021,Cote d'Ivoire,Malawi,5,0,0,5
24814,2021,Mozambique,Malawi,0,5,0,5
24815,2021,Rwanda,Malawi,2514,4916,0,7430
24816,2021,Somalia,Malawi,66,63,0,129
24817,2021,South Sudan,Malawi,5,0,0,5
24818,2021,United Rep. of Tanzania,Malawi,0,5,0,5
24819,2021,Türkiye,Malawi,31,25,0,56
24820,2021,Uganda,Malawi,5,16,0,21
24821,2021,Zimbabwe,Malawi,0,8,0,8
24822,2021,Afghanistan,Mongolia,0,5,0,5
24823,2021,Mongolia,Mongolia,0,0,0,0
24825,2021,Afghanistan,Morocco,12,5,0,17
24826,2021,Algeria,Morocco,10,14,0,24
24827,2021,Angola,Morocco,0,6,0,6
24828,2021,Egypt,Morocco,5,11,0,16
24829,2021,Burundi,Morocco,8,0,0,8
24830,2021,Benin,Morocco,0,5,0,5
24831,2021,Bangladesh,Morocco,0,72,0,72
24832,2021,Burkina Faso,Morocco,0,38,0,38
24833,2021,Central African Rep.,Morocco,594,394,0,988
24834,2021,Chad,Morocco,5,50,0,55
24835,2021,Cameroon,Morocco,176,1073,0,1249
24836,2021,Congo,Morocco,18,64,0,82
24837,2021,Dem. Rep. of the Congo,Morocco,194,190,0,384
24838,2021,Eritrea,Morocco,19,50,0,69
24839,2021,Ethiopia,Morocco,0,11,0,11
24840,2021,Gabon,Morocco,0,8,0,8
24841,2021,Gambia,Morocco,0,128,0,128
24842,2021,Palestinian,Morocco,89,169,0,258
24843,2021,Ghana,Morocco,0,12,0,12
24844,2021,Guinea-Bissau,Morocco,0,49,0,49
24845,2021,Guinea,Morocco,146,2508,0,2654
24846,2021,Cote d'Ivoire,Morocco,391,1047,0,1438
24847,2021,India,Morocco,0,5,0,5
24848,2021,Iraq,Morocco,127,7,0,134
24849,2021,Jordan,Morocco,0,5,0,5
24850,2021,Liberia,Morocco,7,61,0,68
24851,2021,Libya,Morocco,49,15,0,64
24852,2021,Lebanon,Morocco,5,37,0,42
24853,2021,Sri Lanka,Morocco,0,5,0,5
24854,2021,Mauritania,Morocco,7,14,0,21
24855,2021,Mali,Morocco,58,765,0,823
24856,2021,Niger,Morocco,0,13,0,13
24857,2021,Nigeria,Morocco,25,413,0,438
24858,2021,Pakistan,Morocco,16,7,0,23
24859,2021,Senegal,Morocco,106,1118,0,1224
24860,2021,Sierra Leone,Morocco,0,93,0,93
24861,2021,Somalia,Morocco,22,16,0,38
24862,2021,Sudan,Morocco,54,938,0,992
24863,2021,South Sudan,Morocco,28,411,0,439
24864,2021,Syrian Arab Rep.,Morocco,5082,0,0,5082
24865,2021,Togo,Morocco,0,13,0,13
24866,2021,Türkiye,Morocco,5,28,0,33
24867,2021,Yemen,Morocco,14,1088,0,1102
24868,2021,Angola,Mozambique,5,0,0,5
24869,2021,Burundi,Mozambique,908,8353,0,9261
24870,2021,Central African Rep.,Mozambique,0,12,0,12
24871,2021,Cameroon,Mozambique,0,5,0,5
24872,2021,Congo,Mozambique,16,37,0,53
24873,2021,Dem. Rep. of the Congo,Mozambique,2993,7700,0,10693
24874,2021,Comoros,Mozambique,0,511,0,511
24875,2021,Eritrea,Mozambique,0,26,0,26
24876,2021,Ethiopia,Mozambique,8,18,0,26
24877,2021,Guinea,Mozambique,0,5,0,5
24878,2021,Mozambique,Mozambique,0,0,744949,0
24879,2021,New Zealand,Mozambique,0,37,0,37
24880,2021,Rwanda,Mozambique,697,3241,0,3938
24881,2021,Somalia,Mozambique,160,4370,0,4530
24882,2021,Sudan,Mozambique,5,30,0,35
24883,2021,South Sudan,Mozambique,0,5,0,5
24884,2021,Uganda,Mozambique,5,36,0,41
24885,2021,Afghanistan,Malta,0,5,0,5
24886,2021,Algeria,Malta,0,27,0,27
24887,2021,Egypt,Malta,73,97,0,170
24888,2021,Armenia,Malta,0,5,0,5
24889,2021,Bangladesh,Malta,14,188,0,202
24890,2021,Burkina Faso,Malta,5,14,0,19
24891,2021,Belarus,Malta,9,0,0,9
24892,2021,Central African Rep.,Malta,0,5,0,5
24893,2021,Chad,Malta,9,48,0,57
24894,2021,China,Malta,17,0,0,17
24895,2021,Cameroon,Malta,10,55,0,65
24896,2021,Dem. Rep. of the Congo,Malta,5,8,0,13
24897,2021,Comoros,Malta,0,5,0,5
24898,2021,Colombia,Malta,0,26,0,26
24899,2021,Eritrea,Malta,867,325,0,1192
24900,2021,Ethiopia,Malta,175,43,0,218
24901,2021,Gambia,Malta,26,90,0,116
24902,2021,Palestinian,Malta,74,29,0,103
24903,2021,Georgia,Malta,5,33,0,38
24904,2021,Ghana,Malta,8,46,0,54
24905,2021,Guinea-Bissau,Malta,0,6,0,6
24906,2021,Guinea,Malta,0,93,0,93
24907,2021,Cote d'Ivoire,Malta,12,109,0,121
24908,2021,India,Malta,0,5,0,5
24909,2021,Iran (Islamic Rep. of),Malta,31,11,0,42
24910,2021,Iraq,Malta,81,0,0,81
24911,2021,Jordan,Malta,5,0,0,5
24912,2021,Liberia,Malta,6,0,0,6
24913,2021,Libya,Malta,2851,228,0,3079
24914,2021,Lebanon,Malta,0,5,0,5
24915,2021,Sri Lanka,Malta,7,5,0,12
24916,2021,North Macedonia,Malta,5,7,0,12
24917,2021,Mali,Malta,20,107,0,127
24918,2021,Morocco,Malta,30,97,0,127
24919,2021,Nepal,Malta,0,18,0,18
24920,2021,Niger,Malta,0,33,0,33
24921,2021,Nigeria,Malta,124,203,0,327
24922,2021,Pakistan,Malta,59,53,0,112
24923,2021,South Africa,Malta,0,5,0,5
24924,2021,Russian Federation,Malta,18,0,0,18
24925,2021,El Salvador,Malta,0,5,0,5
24926,2021,Saudi Arabia,Malta,5,0,0,5
24927,2021,Serbia and Kosovo: S/RES/1244 (1999),Malta,7,0,0,7
24928,2021,Senegal,Malta,5,71,0,76
24929,2021,Sierra Leone,Malta,5,40,0,45
24930,2021,Somalia,Malta,1776,160,0,1936
24931,2021,Sudan,Malta,224,733,0,957
24932,2021,South Sudan,Malta,22,63,0,85
24933,2021,Syrian Arab Rep.,Malta,1918,412,0,2330
24934,2021,Togo,Malta,5,8,0,13
24935,2021,Tunisia,Malta,13,10,0,23
24936,2021,Türkiye,Malta,7,11,0,18
24937,2021,Uganda,Malta,0,5,0,5
24938,2021,Ukraine,Malta,142,54,0,196
24939,2021,Uzbekistan,Malta,0,5,0,5
24940,2021,Venezuela (Bolivarian Republic of),Malta,24,58,0,82
24941,2021,Yemen,Malta,5,5,0,10
24942,2021,Zimbabwe,Malta,5,0,0,5
24945,2021,Afghanistan,Montenegro,0,5,0,5
24946,2021,Algeria,Montenegro,0,9,0,9
24947,2021,Belarus,Montenegro,5,0,0,5
24948,2021,Bosnia and Herzegovina,Montenegro,5,0,0,5
24949,2021,Cuba,Montenegro,0,54,0,54
24950,2021,Ecuador,Montenegro,0,5,0,5
24951,2021,Ghana,Montenegro,5,0,0,5
24952,2021,Croatia,Montenegro,5,0,0,5
24953,2021,Iran (Islamic Rep. of),Montenegro,17,14,0,31
24954,2021,Morocco,Montenegro,0,12,0,12
24955,2021,Pakistan,Montenegro,0,10,0,10
24956,2021,Russian Federation,Montenegro,6,13,0,19
24957,2021,Serbia and Kosovo: S/RES/1244 (1999),Montenegro,125,5,0,130
24958,2021,Venezuela (Bolivarian Republic of),Montenegro,0,5,0,5
24959,2021,Yemen,Montenegro,7,0,0,7
24962,2021,Pakistan,Mauritius,5,0,0,5
24963,2021,South Africa,Mauritius,5,0,0,5
24964,2021,Myanmar,Myanmar,0,0,671011,0
24966,2021,Angola,Namibia,5,0,0,5
24967,2021,Burundi,Namibia,310,135,0,445
24968,2021,Central African Rep.,Namibia,5,8,0,13
24969,2021,Cameroon,Namibia,24,18,0,42
24970,2021,Congo,Namibia,5,11,0,16
24971,2021,Dem. Rep. of the Congo,Namibia,3187,2484,0,5671
24972,2021,Kenya,Namibia,5,5,0,10
24973,2021,Namibia,Namibia,0,0,0,0
24974,2021,Nigeria,Namibia,0,5,0,5
24975,2021,Rwanda,Namibia,125,29,0,154
24976,2021,Somalia,Namibia,5,5,0,10
24977,2021,Sudan,Namibia,7,0,0,7
24978,2021,United Rep. of Tanzania,Namibia,0,5,0,5
24979,2021,Uganda,Namibia,7,6,0,13
24980,2021,Zimbabwe,Namibia,48,36,0,84
24981,2021,Afghanistan,Nepal,52,12,0,64
24982,2021,Bangladesh,Nepal,5,0,0,5
24983,2021,Bhutan,Nepal,6365,0,0,6365
24984,2021,India,Nepal,0,0,0,0
24985,2021,Iran (Islamic Rep. of),Nepal,9,0,0,9
24986,2021,Sri Lanka,Nepal,19,0,0,19
24987,2021,Myanmar,Nepal,377,101,0,478
24988,2021,Nepal,Nepal,0,0,0,0
24989,2021,Pakistan,Nepal,186,10,0,196
24990,2021,Somalia,Nepal,21,9,0,30
24991,2021,Yemen,Nepal,0,5,0,5
24994,2021,Afghanistan,Netherlands,6660,829,0,7489
24995,2021,Albania,Netherlands,6,5,0,11
24996,2021,Algeria,Netherlands,19,519,0,538
24997,2021,Angola,Netherlands,21,10,0,31
24998,2021,Egypt,Netherlands,342,141,0,483
24999,2021,Argentina,Netherlands,8,7,0,15
25000,2021,Armenia,Netherlands,141,20,0,161
25001,2021,Azerbaijan,Netherlands,172,72,0,244
25002,2021,Bahrain,Netherlands,12,0,0,12
25003,2021,Burundi,Netherlands,84,10,0,94
25004,2021,Bangladesh,Netherlands,43,6,0,49
25005,2021,Bhutan,Netherlands,42,0,0,42
25006,2021,Burkina Faso,Netherlands,12,5,0,17
25007,2021,Belarus,Netherlands,32,59,0,91
25008,2021,Brazil,Netherlands,0,9,0,9
25009,2021,Bosnia and Herzegovina,Netherlands,6,0,0,6
25010,2021,Cambodia,Netherlands,6,0,0,6
25011,2021,Central African Rep.,Netherlands,7,0,0,7
25012,2021,Chad,Netherlands,5,14,0,19
25013,2021,China,Netherlands,770,105,0,875
25014,2021,Chile,Netherlands,0,5,0,5
25015,2021,Cameroon,Netherlands,71,18,0,89
25016,2021,Congo,Netherlands,225,21,0,246
25017,2021,Dem. Rep. of the Congo,Netherlands,74,14,0,88
25018,2021,Colombia,Netherlands,118,162,0,280
25019,2021,Cuba,Netherlands,52,26,0,78
25020,2021,Eritrea,Netherlands,14699,582,0,15281
25021,2021,Ethiopia,Netherlands,348,152,0,500
25022,2021,Gambia,Netherlands,47,87,0,134
25023,2021,Palestinian,Netherlands,148,21,0,169
25024,2021,Georgia,Netherlands,25,16,0,41
25025,2021,Ghana,Netherlands,8,21,0,29
25026,2021,Guatemala,Netherlands,0,5,0,5
25027,2021,Guinea,Netherlands,393,81,0,474
25028,2021,Guyana,Netherlands,5,0,0,5
25029,2021,Haiti,Netherlands,0,11,0,11
25030,2021,Honduras,Netherlands,6,7,0,13
25031,2021,Cote d'Ivoire,Netherlands,146,8,0,154
25032,2021,India,Netherlands,6,42,0,48
25033,2021,Indonesia,Netherlands,11,0,0,11
25034,2021,Iran (Islamic Rep. of),Netherlands,5438,499,0,5937
25035,2021,Iraq,Netherlands,5998,799,0,6797
25036,2021,Jamaica,Netherlands,179,11,0,190
25037,2021,Jordan,Netherlands,72,41,0,113
25038,2021,Kazakhstan,Netherlands,48,10,0,58
25039,2021,Kenya,Netherlands,28,5,0,33
25040,2021,Kyrgyzstan,Netherlands,12,0,0,12
25041,2021,Rep. of Korea,Netherlands,0,5,0,5
25042,2021,Dem. People's Rep. of Korea,Netherlands,27,5,0,32
25043,2021,Kuwait,Netherlands,5,0,0,5
25044,2021,Liberia,Netherlands,34,13,0,47
25045,2021,Libya,Netherlands,268,76,0,344
25046,2021,Lebanon,Netherlands,118,73,0,191
25047,2021,Sri Lanka,Netherlands,290,44,0,334
25048,2021,Mauritania,Netherlands,6,5,0,11
25049,2021,Rep. of Moldova,Netherlands,5,20,0,25
25050,2021,Mexico,Netherlands,7,0,0,7
25051,2021,Mali,Netherlands,14,8,0,22
25052,2021,Malaysia,Netherlands,8,0,0,8
25053,2021,Mongolia,Netherlands,28,6,0,34
25054,2021,Morocco,Netherlands,75,341,0,416
25055,2021,Myanmar,Netherlands,203,20,0,223
25056,2021,Nepal,Netherlands,101,5,0,106
25057,2021,Niger,Netherlands,5,8,0,13
25058,2021,Nicaragua,Netherlands,40,5,0,45
25059,2021,Nigeria,Netherlands,332,273,0,605
25060,2021,Pakistan,Netherlands,768,310,0,1078
25061,2021,Peru,Netherlands,8,5,0,13
25062,2021,Philippines,Netherlands,6,5,0,11
25063,2021,South Africa,Netherlands,0,5,0,5
25064,2021,Russian Federation,Netherlands,467,121,0,588
25065,2021,Rwanda,Netherlands,32,11,0,43
25066,2021,El Salvador,Netherlands,38,30,0,68
25067,2021,Saudi Arabia,Netherlands,35,20,0,55
25068,2021,Serbia and Kosovo: S/RES/1244 (1999),Netherlands,19,11,0,30
25069,2021,Senegal,Netherlands,17,20,0,37
25070,2021,Sierra Leone,Netherlands,303,60,0,363
25071,2021,Somalia,Netherlands,7284,826,0,8110
25072,2021,Viet Nam,Netherlands,11,7,0,18
25073,2021,Sudan,Netherlands,676,100,0,776
25074,2021,South Sudan,Netherlands,0,8,0,8
25075,2021,Syrian Arab Rep.,Netherlands,39388,6362,0,45750
25076,2021,United Rep. of Tanzania,Netherlands,8,5,0,13
25077,2021,Tajikistan,Netherlands,28,9,0,37
25078,2021,Turkmenistan,Netherlands,18,10,0,28
25079,2021,Togo,Netherlands,14,0,0,14
25080,2021,Trinidad and Tobago,Netherlands,83,12,0,95
25081,2021,Tunisia,Netherlands,23,148,0,171
25082,2021,Türkiye,Netherlands,4394,1834,0,6228
25083,2021,Uganda,Netherlands,488,87,0,575
25084,2021,Ukraine,Netherlands,34,35,0,69
25085,2021,United States of America,Netherlands,32,11,0,43
25086,2021,Uzbekistan,Netherlands,9,15,0,24
25087,2021,Venezuela (Bolivarian Republic of),Netherlands,107,67,0,174
25088,2021,Yemen,Netherlands,1789,973,0,2762
25089,2021,Zambia,Netherlands,8,0,0,8
25090,2021,Zimbabwe,Netherlands,35,0,0,35
25093,2021,Burkina Faso,Niger,0,0,0,0
25094,2021,Central African Rep.,Niger,142,64,0,206
25095,2021,Chad,Niger,111,3408,0,3519
25096,2021,Cameroon,Niger,21,199,0,220
25097,2021,Congo,Niger,5,0,0,5
25098,2021,Dem. Rep. of the Congo,Niger,49,31,0,80
25099,2021,Eritrea,Niger,72,157,0,229
25100,2021,Ethiopia,Niger,30,19,0,49
25101,2021,Ghana,Niger,0,5,0,5
25102,2021,Guinea,Niger,0,21,0,21
25103,2021,Cote d'Ivoire,Niger,25,14,0,39
25104,2021,Liberia,Niger,0,9,0,9
25105,2021,Libya,Niger,6,0,0,6
25106,2021,Mali,Niger,61490,95,0,61585
25107,2021,Niger,Niger,0,0,224016,0
25108,2021,Nigeria,Niger,187065,11101,0,198166
25109,2021,Pakistan,Niger,0,6,0,6
25110,2021,Rwanda,Niger,12,0,0,12
25111,2021,Sierra Leone,Niger,0,5,0,5
25112,2021,Somalia,Niger,43,34,0,77
25113,2021,Sudan,Niger,850,1292,0,2142
25114,2021,South Sudan,Niger,9,10,0,19
25115,2021,Syrian Arab Rep.,Niger,5,0,0,5
25116,2021,Togo,Niger,5,19,0,24
25117,2021,Yemen,Niger,5,12,0,17
25118,2021,Colombia,Nicaragua,6,0,0,6
25119,2021,Cuba,Nicaragua,14,0,0,14
25120,2021,Guatemala,Nicaragua,7,0,0,7
25121,2021,Honduras,Nicaragua,74,26,0,100
25122,2021,El Salvador,Nicaragua,212,100,0,312
25124,2021,Afghanistan,Nigeria,5,0,0,5
25125,2021,Egypt,Nigeria,0,8,0,8
25126,2021,Benin,Nigeria,5,0,0,5
25127,2021,Central African Rep.,Nigeria,828,293,0,1121
25128,2021,Chad,Nigeria,87,10,0,97
25129,2021,Cameroon,Nigeria,72971,393,0,73364
25130,2021,Congo,Nigeria,5,5,0,10
25131,2021,Dem. Rep. of the Congo,Nigeria,653,111,0,764
25132,2021,Eritrea,Nigeria,40,10,0,50
25133,2021,Ethiopia,Nigeria,8,0,0,8
25134,2021,Palestinian,Nigeria,16,17,0,33
25135,2021,Ghana,Nigeria,5,5,0,10
25136,2021,Guinea-Bissau,Nigeria,5,0,0,5
25137,2021,Guinea,Nigeria,18,5,0,23
25138,2021,Cote d'Ivoire,Nigeria,137,7,0,144
25139,2021,Iran (Islamic Rep. of),Nigeria,5,0,0,5
25140,2021,Liberia,Nigeria,11,0,0,11
25141,2021,Libya,Nigeria,0,5,0,5
25142,2021,Lebanon,Nigeria,5,41,0,46
25143,2021,Mali,Nigeria,143,28,0,171
25144,2021,Niger,Nigeria,1439,0,0,1439
25145,2021,Nigeria,Nigeria,0,0,3084916,0
25146,2021,Sierra Leone,Nigeria,24,0,0,24
25147,2021,Sudan,Nigeria,47,9,0,56
25148,2021,Syrian Arab Rep.,Nigeria,422,482,0,904
25149,2021,Turkmenistan,Nigeria,0,5,0,5
25150,2021,Togo,Nigeria,27,9,0,36
25151,2021,Türkiye,Nigeria,226,210,0,436
25152,2021,Yemen,Nigeria,0,5,0,5
25153,2021,Afghanistan,Norway,3448,151,0,3599
25154,2021,Albania,Norway,18,6,0,24
25155,2021,Algeria,Norway,6,5,0,11
25156,2021,Angola,Norway,5,0,0,5
25157,2021,Egypt,Norway,44,0,0,44
25158,2021,Armenia,Norway,5,0,0,5
25159,2021,Azerbaijan,Norway,14,0,0,14
25160,2021,Burundi,Norway,30,0,0,30
25161,2021,Bangladesh,Norway,5,0,0,5
25162,2021,Belarus,Norway,5,0,0,5
25163,2021,Bulgaria,Norway,5,0,0,5
25164,2021,Central African Rep.,Norway,15,0,0,15
25165,2021,China,Norway,281,104,0,385
25166,2021,Cameroon,Norway,16,7,0,23
25167,2021,Congo,Norway,5,0,0,5
25168,2021,Dem. Rep. of the Congo,Norway,376,0,0,376
25169,2021,Colombia,Norway,8,40,0,48
25170,2021,Eritrea,Norway,11460,83,0,11543
25171,2021,Ethiopia,Norway,1301,67,0,1368
25172,2021,Gambia,Norway,13,0,0,13
25173,2021,Ghana,Norway,7,0,0,7
25174,2021,Guinea-Bissau,Norway,5,0,0,5
25175,2021,Guinea,Norway,30,0,0,30
25176,2021,Honduras,Norway,5,0,0,5
25177,2021,Cote d'Ivoire,Norway,13,0,0,13
25178,2021,Iran (Islamic Rep. of),Norway,1496,146,0,1642
25179,2021,Iraq,Norway,1021,84,0,1105
25180,2021,Israel,Norway,8,0,0,8
25181,2021,Jordan,Norway,5,0,0,5
25182,2021,Kazakhstan,Norway,10,0,0,10
25183,2021,Kenya,Norway,7,0,0,7
25184,2021,Kyrgyzstan,Norway,12,0,0,12
25185,2021,Liberia,Norway,5,0,0,5
25186,2021,Libya,Norway,56,5,0,61
25187,2021,Lebanon,Norway,24,5,0,29
25188,2021,Sri Lanka,Norway,45,5,0,50
25189,2021,Mauritania,Norway,5,0,0,5
25190,2021,Rep. of Moldova,Norway,5,5,0,10
25191,2021,Mali,Norway,8,0,0,8
25192,2021,Morocco,Norway,14,5,0,19
25193,2021,Myanmar,Norway,22,5,0,27
25194,2021,Nepal,Norway,5,0,0,5
25195,2021,Nicaragua,Norway,10,0,0,10
25196,2021,Nigeria,Norway,118,5,0,123
25197,2021,Pakistan,Norway,77,12,0,89
25198,2021,Russian Federation,Norway,311,16,0,327
25199,2021,Rwanda,Norway,15,5,0,20
25200,2021,El Salvador,Norway,9,0,0,9
25201,2021,Saudi Arabia,Norway,8,0,0,8
25202,2021,Serbia and Kosovo: S/RES/1244 (1999),Norway,26,0,0,26
25203,2021,Sierra Leone,Norway,9,0,0,9
25204,2021,Somalia,Norway,3984,29,0,4013
25205,2021,Viet Nam,Norway,38,0,0,38
25206,2021,Sudan,Norway,1703,11,0,1714
25207,2021,South Sudan,Norway,50,0,0,50
25208,2021,Syrian Arab Rep.,Norway,15865,315,0,16180
25209,2021,Tajikistan,Norway,5,0,0,5
25210,2021,Turkmenistan,Norway,5,0,0,5
25211,2021,Tunisia,Norway,5,5,0,10
25212,2021,Türkiye,Norway,1104,61,0,1165
25213,2021,Uganda,Norway,110,0,0,110
25214,2021,Ukraine,Norway,13,0,0,13
25215,2021,Uzbekistan,Norway,155,0,0,155
25216,2021,Venezuela (Bolivarian Republic of),Norway,19,22,0,41
25217,2021,Yemen,Norway,201,5,0,206
25218,2021,Zimbabwe,Norway,9,0,0,9
25221,2021,Afghanistan,Nauru,28,0,0,28
25222,2021,Bangladesh,Nauru,17,19,0,36
25223,2021,India,Nauru,7,5,0,12
25224,2021,Indonesia,Nauru,5,5,0,10
25225,2021,Iran (Islamic Rep. of),Nauru,508,7,0,515
25226,2021,Iraq,Nauru,42,0,0,42
25227,2021,Kuwait,Nauru,5,0,0,5
25228,2021,Lebanon,Nauru,12,0,0,12
25229,2021,Sri Lanka,Nauru,77,12,0,89
25230,2021,Malaysia,Nauru,5,0,0,5
25231,2021,Myanmar,Nauru,71,0,0,71
25232,2021,Nepal,Nauru,10,6,0,16
25233,2021,Pakistan,Nauru,29,17,0,46
25234,2021,Somalia,Nauru,73,0,0,73
25235,2021,Sudan,Nauru,5,0,0,5
25236,2021,Syrian Arab Rep.,Nauru,0,5,0,5
25238,2021,Afghanistan,New Zealand,65,9,0,74
25239,2021,Egypt,New Zealand,31,5,0,36
25240,2021,Bahrain,New Zealand,10,0,0,10
25241,2021,Burundi,New Zealand,0,5,0,5
25242,2021,Bangladesh,New Zealand,10,15,0,25
25243,2021,Brazil,New Zealand,0,5,0,5
25244,2021,China,New Zealand,255,87,0,342
25245,2021,Chile,New Zealand,5,5,0,10
25246,2021,Cameroon,New Zealand,5,0,0,5
25247,2021,Dem. Rep. of the Congo,New Zealand,5,0,0,5
25248,2021,Colombia,New Zealand,32,9,0,41
25249,2021,Czechia,New Zealand,12,0,0,12
25250,2021,Eritrea,New Zealand,6,0,0,6
25251,2021,Ethiopia,New Zealand,14,0,0,14
25252,2021,Fiji,New Zealand,16,23,0,39
25253,2021,Palestinian,New Zealand,12,5,0,17
25254,2021,Hungary,New Zealand,8,0,0,8
25255,2021,India,New Zealand,14,168,0,182
25256,2021,Indonesia,New Zealand,6,60,0,66
25257,2021,Ireland,New Zealand,0,5,0,5
25258,2021,Iran (Islamic Rep. of),New Zealand,107,13,0,120
25259,2021,Iraq,New Zealand,58,0,0,58
25260,2021,Jordan,New Zealand,8,0,0,8
25261,2021,Kiribati,New Zealand,0,5,0,5
25262,2021,Kuwait,New Zealand,5,0,0,5
25263,2021,Libya,New Zealand,21,0,0,21
25264,2021,Lebanon,New Zealand,0,5,0,5
25265,2021,Sri Lanka,New Zealand,46,52,0,98
25266,2021,Maldives,New Zealand,5,0,0,5
25267,2021,Malaysia,New Zealand,17,21,0,38
25268,2021,Mongolia,New Zealand,6,0,0,6
25269,2021,Myanmar,New Zealand,12,17,0,29
25270,2021,Nepal,New Zealand,5,0,0,5
25271,2021,Pakistan,New Zealand,54,5,0,59
25272,2021,Philippines,New Zealand,10,12,0,22
25273,2021,Papua New Guinea,New Zealand,5,0,0,5
25274,2021,South Africa,New Zealand,7,10,0,17
25275,2021,Russian Federation,New Zealand,32,15,0,47
25276,2021,Saudi Arabia,New Zealand,62,0,0,62
25277,2021,Somalia,New Zealand,10,0,0,10
25278,2021,Viet Nam,New Zealand,7,5,0,12
25279,2021,Sudan,New Zealand,6,5,0,11
25280,2021,Syrian Arab Rep.,New Zealand,72,0,0,72
25281,2021,Thailand,New Zealand,0,7,0,7
25282,2021,Tonga,New Zealand,0,5,0,5
25283,2021,Türkiye,New Zealand,58,6,0,64
25284,2021,Uganda,New Zealand,5,5,0,10
25285,2021,Uruguay,New Zealand,0,7,0,7
25286,2021,United States of America,New Zealand,0,8,0,8
25287,2021,Venezuela (Bolivarian Republic of),New Zealand,5,0,0,5
25288,2021,Yemen,New Zealand,9,0,0,9
25289,2021,Zimbabwe,New Zealand,13,5,0,18
25291,2021,Iran (Islamic Rep. of),Oman,0,5,0,5
25292,2021,Iraq,Oman,282,459,0,741
25293,2021,Pakistan,Oman,5,0,0,5
25294,2021,Sudan,Oman,0,6,0,6
25295,2021,Syrian Arab Rep.,Oman,8,27,0,35
25296,2021,Afghanistan,Pakistan,1490562,13260,0,1503822
25297,2021,Algeria,Pakistan,22,0,0,22
25298,2021,China,Pakistan,0,16,0,16
25299,2021,Palestinian,Pakistan,21,0,0,21
25300,2021,India,Pakistan,0,5,0,5
25301,2021,Iran (Islamic Rep. of),Pakistan,39,14,0,53
25302,2021,Iraq,Pakistan,21,7,0,28
25303,2021,Sri Lanka,Pakistan,0,11,0,11
25304,2021,Myanmar,Pakistan,23,31,0,54
25305,2021,Pakistan,Pakistan,0,0,98898,0
25306,2021,Russian Federation,Pakistan,6,0,0,6
25307,2021,Somalia,Pakistan,176,27,0,203
25308,2021,Syrian Arab Rep.,Pakistan,50,23,0,73
25309,2021,United Rep. of Tanzania,Pakistan,0,5,0,5
25310,2021,Tajikistan,Pakistan,7,0,0,7
25311,2021,Türkiye,Pakistan,6,0,0,6
25312,2021,Yemen,Pakistan,137,30,0,167
25314,2021,Afghanistan,Panama,5,6,0,11
25315,2021,Armenia,Panama,0,5,0,5
25316,2021,Bangladesh,Panama,0,15,0,15
25317,2021,Belarus,Panama,7,0,0,7
25318,2021,Bosnia and Herzegovina,Panama,5,0,0,5
25319,2021,Cameroon,Panama,9,5,0,14
25320,2021,Dem. Rep. of the Congo,Panama,5,0,0,5
25321,2021,Colombia,Panama,1683,1062,0,2745
25322,2021,Cuba,Panama,120,1554,0,1674
25323,2021,Dominican Rep.,Panama,5,0,0,5
25324,2021,Ecuador,Panama,0,15,0,15
25325,2021,Eritrea,Panama,0,38,0,38
25326,2021,Guatemala,Panama,12,8,0,20
25327,2021,Haiti,Panama,19,0,0,19
25328,2021,Honduras,Panama,6,88,0,94
25329,2021,Croatia,Panama,5,0,0,5
25330,2021,Cote d'Ivoire,Panama,0,5,0,5
25331,2021,India,Panama,0,7,0,7
25332,2021,Iran (Islamic Rep. of),Panama,5,0,0,5
25333,2021,Italy,Panama,0,5,0,5
25334,2021,Jamaica,Panama,0,5,0,5
25335,2021,Liberia,Panama,5,0,0,5
25336,2021,Sri Lanka,Panama,0,7,0,7
25337,2021,Mexico,Panama,5,0,0,5
25338,2021,Nepal,Panama,0,14,0,14
25339,2021,Nicaragua,Panama,179,5230,0,5409
25340,2021,Nigeria,Panama,10,34,0,44
25341,2021,Pakistan,Panama,0,16,0,16
25342,2021,Panama,Panama,0,0,0,0
25343,2021,Peru,Panama,23,0,0,23
25344,2021,El Salvador,Panama,363,952,0,1315
25345,2021,Sierra Leone,Panama,5,0,0,5
25346,2021,Somalia,Panama,0,101,0,101
25347,2021,Sudan,Panama,5,0,0,5
25348,2021,Ukraine,Panama,0,5,0,5
25349,2021,Venezuela (Bolivarian Republic of),Panama,61,2453,0,2514
25350,2021,Argentina,Paraguay,0,16,0,16
25351,2021,Bangladesh,Paraguay,0,5,0,5
25352,2021,Bolivia (Plurinational State of),Paraguay,16,16,0,32
25353,2021,Brazil,Paraguay,0,11,0,11
25354,2021,Cameroon,Paraguay,0,5,0,5
25355,2021,Colombia,Paraguay,17,214,0,231
25356,2021,Cuba,Paraguay,927,55,0,982
25357,2021,Dominican Rep.,Paraguay,0,10,0,10
25358,2021,Ecuador,Paraguay,0,5,0,5
25359,2021,Guatemala,Paraguay,0,6,0,6
25360,2021,Haiti,Paraguay,0,5,0,5
25361,2021,Iraq,Paraguay,6,0,0,6
25362,2021,Lebanon,Paraguay,0,6,0,6
25363,2021,Sri Lanka,Paraguay,5,0,0,5
25364,2021,Nigeria,Paraguay,0,5,0,5
25365,2021,Peru,Paraguay,0,23,0,23
25366,2021,South Africa,Paraguay,0,5,0,5
25367,2021,El Salvador,Paraguay,12,5,0,17
25368,2021,Syrian Arab Rep.,Paraguay,84,17,0,101
25369,2021,Türkiye,Paraguay,5,5,0,10
25370,2021,Uruguay,Paraguay,0,6,0,6
25371,2021,Venezuela (Bolivarian Republic of),Paraguay,3412,440,0,3852
25373,2021,Afghanistan,Peru,0,5,0,5
25374,2021,Angola,Peru,0,10,0,10
25375,2021,Argentina,Peru,0,15,0,15
25376,2021,Bangladesh,Peru,26,0,0,26
25377,2021,Bolivia (Plurinational State of),Peru,20,30,0,50
25378,2021,Brazil,Peru,5,12,0,17
25379,2021,China,Peru,0,13,0,13
25380,2021,Chile,Peru,0,12,0,12
25381,2021,Cameroon,Peru,20,0,0,20
25382,2021,Congo,Peru,0,9,0,9
25383,2021,Dem. Rep. of the Congo,Peru,8,0,0,8
25384,2021,Colombia,Peru,712,1666,0,2378
25385,2021,Costa Rica,Peru,0,5,0,5
25386,2021,Cuba,Peru,519,2739,0,3258
25387,2021,Dominica,Peru,0,5,0,5
25388,2021,Dominican Rep.,Peru,20,55,0,75
25389,2021,Ecuador,Peru,0,270,0,270
25390,2021,Ethiopia,Peru,5,0,0,5
25391,2021,Gambia,Peru,5,0,0,5
25392,2021,Palestinian,Peru,41,8,0,49
25393,2021,Germany,Peru,0,5,0,5
25394,2021,Ghana,Peru,5,0,0,5
25395,2021,Haiti,Peru,85,56,0,141
25396,2021,Honduras,Peru,0,7,0,7
25397,2021,India,Peru,6,5,0,11
25398,2021,Iran (Islamic Rep. of),Peru,6,0,0,6
25399,2021,Iraq,Peru,42,0,0,42
25400,2021,Italy,Peru,0,5,0,5
25401,2021,Jordan,Peru,0,5,0,5
25402,2021,Sri Lanka,Peru,0,7,0,7
25403,2021,Mexico,Peru,0,11,0,11
25404,2021,Nepal,Peru,0,5,0,5
25405,2021,Nicaragua,Peru,7,7,0,14
25406,2021,Nigeria,Peru,24,18,0,42
25407,2021,Pakistan,Peru,0,10,0,10
25408,2021,Panama,Peru,0,11,0,11
25409,2021,Paraguay,Peru,0,5,0,5
25410,2021,Peru,Peru,0,0,0,0
25411,2021,Philippines,Peru,0,21,0,21
25412,2021,Poland,Peru,0,5,0,5
25413,2021,Portugal,Peru,0,16,0,16
25414,2021,Russian Federation,Peru,0,5,0,5
25415,2021,El Salvador,Peru,10,5,0,15
25416,2021,Spain,Peru,0,19,0,19
25417,2021,Syrian Arab Rep.,Peru,47,11,0,58
25418,2021,Turkmenistan,Peru,0,8,0,8
25419,2021,Türkiye,Peru,46,40,0,86
25420,2021,Ukraine,Peru,17,0,0,17
25421,2021,Uruguay,Peru,0,5,0,5
25422,2021,United States of America,Peru,0,5,0,5
25423,2021,Venezuela (Bolivarian Republic of),Peru,4098,531822,0,535920
25424,2021,Yemen,Peru,0,63,0,63
25425,2021,Anguilla,Peru,0,5,0,5
25427,2021,Afghanistan,Philippines,9,5,0,14
25428,2021,Egypt,Philippines,0,5,0,5
25429,2021,Burundi,Philippines,13,0,0,13
25430,2021,Cambodia,Philippines,13,0,0,13
25431,2021,Chad,Philippines,0,6,0,6
25432,2021,China,Philippines,5,5,0,10
25433,2021,Cameroon,Philippines,34,76,0,110
25434,2021,Congo,Philippines,5,15,0,20
25435,2021,Dem. Rep. of the Congo,Philippines,10,16,0,26
25436,2021,Eritrea,Philippines,21,16,0,37
25437,2021,Ethiopia,Philippines,5,5,0,10
25438,2021,Palestinian,Philippines,59,15,0,74
25439,2021,Ghana,Philippines,5,0,0,5
25440,2021,Guinea,Philippines,0,12,0,12
25441,2021,Cote d'Ivoire,Philippines,28,29,0,57
25442,2021,Iran (Islamic Rep. of),Philippines,73,22,0,95
25443,2021,Iraq,Philippines,55,14,0,69
25444,2021,Liberia,Philippines,5,6,0,11
25445,2021,Libya,Philippines,0,5,0,5
25446,2021,Lebanon,Philippines,5,12,0,17
25447,2021,Sri Lanka,Philippines,18,0,0,18
25448,2021,Malaysia,Philippines,0,5,0,5
25449,2021,Morocco,Philippines,5,0,0,5
25450,2021,Myanmar,Philippines,10,0,0,10
25451,2021,Nigeria,Philippines,6,17,0,23
25452,2021,Pakistan,Philippines,103,25,0,128
25453,2021,Philippines,Philippines,0,0,105214,0
25454,2021,Russian Federation,Philippines,5,0,0,5
25455,2021,Rwanda,Philippines,18,0,0,18
25456,2021,Saudi Arabia,Philippines,0,21,0,21
25457,2021,Somalia,Philippines,30,31,0,61
25458,2021,Viet Nam,Philippines,18,6,0,24
25459,2021,Sudan,Philippines,7,47,0,54
25460,2021,Syrian Arab Rep.,Philippines,130,44,0,174
25461,2021,Thailand,Philippines,5,0,0,5
25462,2021,Türkiye,Philippines,55,21,0,76
25463,2021,United Arab Emirates,Philippines,6,6,0,12
25464,2021,Uganda,Philippines,5,0,0,5
25465,2021,United States of America,Philippines,0,5,0,5
25466,2021,Yemen,Philippines,30,86,0,116
25469,2021,Afghanistan,Papua New Guinea,30,0,0,30
25470,2021,Bangladesh,Papua New Guinea,15,5,0,20
25471,2021,India,Papua New Guinea,0,5,0,5
25472,2021,Indonesia,Papua New Guinea,11601,28,0,11629
25473,2021,Iran (Islamic Rep. of),Papua New Guinea,74,77,0,151
25474,2021,Iraq,Papua New Guinea,32,5,0,37
25475,2021,Sri Lanka,Papua New Guinea,6,0,0,6
25476,2021,Myanmar,Papua New Guinea,5,0,0,5
25477,2021,Pakistan,Papua New Guinea,27,5,0,32
25478,2021,Papua New Guinea,Papua New Guinea,0,0,24000,0
25479,2021,Somalia,Papua New Guinea,11,0,0,11
25480,2021,Sudan,Papua New Guinea,33,0,0,33
25482,2021,Afghanistan,Poland,846,305,0,1151
25483,2021,Angola,Poland,0,5,0,5
25484,2021,Egypt,Poland,40,16,0,56
25485,2021,Armenia,Poland,5,13,0,18
25486,2021,Azerbaijan,Poland,10,0,0,10
25487,2021,Bangladesh,Poland,6,0,0,6
25488,2021,Belarus,Poland,1264,1331,0,2595
25489,2021,Bosnia and Herzegovina,Poland,7,0,0,7
25490,2021,Central African Rep.,Poland,5,0,0,5
25491,2021,China,Poland,17,0,0,17
25492,2021,Cameroon,Poland,0,9,0,9
25493,2021,Congo,Poland,6,10,0,16
25494,2021,Dem. Rep. of the Congo,Poland,0,18,0,18
25495,2021,Cuba,Poland,8,26,0,34
25496,2021,Djibouti,Poland,0,5,0,5
25497,2021,Eritrea,Poland,5,0,0,5
25498,2021,Ethiopia,Poland,5,5,0,10
25499,2021,Palestinian,Poland,5,16,0,21
25500,2021,Georgia,Poland,5,22,0,27
25501,2021,Guinea,Poland,5,7,0,12
25502,2021,India,Poland,0,5,0,5
25503,2021,Iran (Islamic Rep. of),Poland,50,45,0,95
25504,2021,Iraq,Poland,113,1116,0,1229
25505,2021,Kazakhstan,Poland,40,10,0,50
25506,2021,Kyrgyzstan,Poland,32,6,0,38
25507,2021,Lao People's Dem. Rep.,Poland,5,0,0,5
25508,2021,Libya,Poland,21,16,0,37
25509,2021,Lebanon,Poland,5,0,0,5
25510,2021,Sri Lanka,Poland,11,0,0,11
25511,2021,Nepal,Poland,7,0,0,7
25512,2021,Nigeria,Poland,7,9,0,16
25513,2021,Pakistan,Poland,29,6,0,35
25514,2021,Russian Federation,Poland,1078,424,0,1502
25515,2021,Rwanda,Poland,5,0,0,5
25516,2021,Sierra Leone,Poland,7,0,0,7
25517,2021,Somalia,Poland,16,63,0,79
25518,2021,Viet Nam,Poland,5,0,0,5
25519,2021,Syrian Arab Rep.,Poland,254,62,0,316
25520,2021,Tajikistan,Poland,148,68,0,216
25521,2021,Turkmenistan,Poland,34,9,0,43
25522,2021,Türkiye,Poland,238,46,0,284
25523,2021,Ukraine,Poland,422,109,0,531
25524,2021,Uzbekistan,Poland,16,0,0,16
25525,2021,Venezuela (Bolivarian Republic of),Poland,17,0,0,17
25526,2021,Yemen,Poland,22,31,0,53
25529,2021,Afghanistan,Portugal,121,594,0,715
25530,2021,Albania,Portugal,0,5,0,5
25531,2021,Algeria,Portugal,0,19,0,19
25532,2021,Angola,Portugal,0,223,0,223
25533,2021,Egypt,Portugal,5,18,0,23
25534,2021,Armenia,Portugal,5,0,0,5
25535,2021,Azerbaijan,Portugal,0,5,0,5
25536,2021,Benin,Portugal,0,5,0,5
25537,2021,Bangladesh,Portugal,6,24,0,30
25538,2021,Belarus,Portugal,16,11,0,27
25539,2021,Brazil,Portugal,0,24,0,24
25540,2021,Bosnia and Herzegovina,Portugal,6,0,0,6
25541,2021,Central African Rep.,Portugal,8,0,0,8
25542,2021,China,Portugal,6,0,0,6
25543,2021,Cameroon,Portugal,15,39,0,54
25544,2021,Congo,Portugal,13,8,0,21
25545,2021,Dem. Rep. of the Congo,Portugal,43,51,0,94
25546,2021,Comoros,Portugal,0,5,0,5
25547,2021,Colombia,Portugal,24,21,0,45
25548,2021,Cuba,Portugal,5,10,0,15
25549,2021,Eritrea,Portugal,201,0,0,201
25550,2021,Ethiopia,Portugal,11,0,0,11
25551,2021,Gambia,Portugal,8,118,0,126
25552,2021,Palestinian,Portugal,5,5,0,10
25553,2021,Georgia,Portugal,0,7,0,7
25554,2021,Ghana,Portugal,0,33,0,33
25555,2021,Guinea-Bissau,Portugal,6,112,0,118
25556,2021,Guinea,Portugal,92,111,0,203
25557,2021,Cote d'Ivoire,Portugal,32,26,0,58
25558,2021,India,Portugal,0,67,0,67
25559,2021,Iran (Islamic Rep. of),Portugal,50,27,0,77
25560,2021,Iraq,Portugal,202,0,0,202
25561,2021,Jordan,Portugal,0,14,0,14
25562,2021,Kenya,Portugal,5,5,0,10
25563,2021,Libya,Portugal,15,0,0,15
25564,2021,Sri Lanka,Portugal,33,7,0,40
25565,2021,Mauritania,Portugal,0,5,0,5
25566,2021,Mali,Portugal,15,33,0,48
25567,2021,Morocco,Portugal,9,126,0,135
25568,2021,Mauritius,Portugal,0,5,0,5
25569,2021,Nepal,Portugal,0,5,0,5
25570,2021,Nigeria,Portugal,30,66,0,96
25571,2021,Pakistan,Portugal,80,42,0,122
25572,2021,Russian Federation,Portugal,22,0,0,22
25573,2021,Senegal,Portugal,5,71,0,76
25574,2021,Sierra Leone,Portugal,25,47,0,72
25575,2021,Somalia,Portugal,51,0,0,51
25576,2021,Sudan,Portugal,62,10,0,72
25577,2021,South Sudan,Portugal,30,0,0,30
25578,2021,Syrian Arab Rep.,Portugal,861,0,0,861
25579,2021,Togo,Portugal,7,14,0,21
25580,2021,Türkiye,Portugal,29,13,0,42
25581,2021,Uganda,Portugal,5,0,0,5
25582,2021,Ukraine,Portugal,447,40,0,487
25583,2021,United States of America,Portugal,0,5,0,5
25584,2021,Venezuela (Bolivarian Republic of),Portugal,0,76,0,76
25585,2021,Yemen,Portugal,9,0,0,9
25588,2021,Afghanistan,Qatar,0,7,0,7
25589,2021,Egypt,Qatar,13,22,0,35
25590,2021,Eritrea,Qatar,0,5,0,5
25591,2021,Palestinian,Qatar,0,7,0,7
25592,2021,Iraq,Qatar,136,126,0,262
25593,2021,Morocco,Qatar,0,5,0,5
25594,2021,Pakistan,Qatar,5,0,0,5
25595,2021,Somalia,Qatar,8,5,0,13
25596,2021,Sudan,Qatar,0,15,0,15
25597,2021,Syrian Arab Rep.,Qatar,30,109,0,139
25598,2021,Yemen,Qatar,5,9,0,14
25600,2021,Afghanistan,Romania,332,734,0,1066
25601,2021,Algeria,Romania,0,6,0,6
25602,2021,Angola,Romania,8,0,0,8
25603,2021,Egypt,Romania,16,7,0,23
25604,2021,Burundi,Romania,8,0,0,8
25605,2021,Bangladesh,Romania,11,72,0,83
25606,2021,Central African Rep.,Romania,5,0,0,5
25607,2021,China,Romania,5,0,0,5
25608,2021,Cameroon,Romania,26,11,0,37
25609,2021,Congo,Romania,5,0,0,5
25610,2021,Dem. Rep. of the Congo,Romania,17,5,0,22
25611,2021,Comoros,Romania,5,0,0,5
25612,2021,Cuba,Romania,5,0,0,5
25613,2021,Eritrea,Romania,77,23,0,100
25614,2021,Ethiopia,Romania,6,5,0,11
25615,2021,Gambia,Romania,5,0,0,5
25616,2021,Palestinian,Romania,58,12,0,70
25617,2021,Guinea-Bissau,Romania,0,5,0,5
25618,2021,Guinea,Romania,11,0,0,11
25619,2021,India,Romania,5,122,0,127
25620,2021,Iran (Islamic Rep. of),Romania,120,14,0,134
25621,2021,Iraq,Romania,529,71,0,600
25622,2021,Jordan,Romania,6,0,0,6
25623,2021,Kuwait,Romania,5,0,0,5
25624,2021,Libya,Romania,5,0,0,5
25625,2021,Lebanon,Romania,10,0,0,10
25626,2021,Sri Lanka,Romania,0,5,0,5
25627,2021,Mali,Romania,5,5,0,10
25628,2021,Morocco,Romania,5,9,0,14
25629,2021,Myanmar,Romania,30,0,0,30
25630,2021,Nepal,Romania,0,5,0,5
25631,2021,Nigeria,Romania,8,8,0,16
25632,2021,Pakistan,Romania,28,45,0,73
25633,2021,Rwanda,Romania,8,5,0,13
25634,2021,Sierra Leone,Romania,5,0,0,5
25635,2021,Somalia,Romania,270,48,0,318
25636,2021,Viet Nam,Romania,0,5,0,5
25637,2021,Sudan,Romania,24,11,0,35
25638,2021,Syrian Arab Rep.,Romania,2258,179,0,2437
25639,2021,Tunisia,Romania,5,20,0,25
25640,2021,Türkiye,Romania,55,59,0,114
25641,2021,Uganda,Romania,5,0,0,5
25642,2021,Ukraine,Romania,17,0,0,17
25643,2021,Yemen,Romania,65,5,0,70
25644,2021,Zimbabwe,Romania,5,0,0,5
25646,2021,Afghanistan,South Africa,5,20,0,25
25647,2021,Algeria,South Africa,5,184,0,189
25648,2021,Angola,South Africa,24,11,0,35
25649,2021,Egypt,South Africa,7,228,0,235
25650,2021,Bahrain,South Africa,0,5,0,5
25651,2021,Burundi,South Africa,2611,6752,0,9363
25652,2021,Benin,South Africa,5,36,0,41
25653,2021,Bangladesh,South Africa,200,24561,0,24761
25654,2021,Bahamas,South Africa,0,14,0,14
25655,2021,Burkina Faso,South Africa,0,40,0,40
25656,2021,Central African Rep.,South Africa,9,5,0,14
25657,2021,Chad,South Africa,5,5,0,10
25658,2021,China,South Africa,0,69,0,69
25659,2021,Cameroon,South Africa,323,1684,0,2007
25660,2021,Congo,South Africa,4385,7778,0,12163
25661,2021,Dem. Rep. of the Congo,South Africa,22658,34077,0,56735
25662,2021,Comoros,South Africa,0,14,0,14
25663,2021,Eritrea,South Africa,1395,1033,0,2428
25664,2021,Estonia,South Africa,5,6,0,11
25665,2021,Ethiopia,South Africa,15284,46123,0,61407
25666,2021,Gabon,South Africa,0,11,0,11
25667,2021,Gambia,South Africa,0,5,0,5
25668,2021,Palestinian,South Africa,39,10,0,49
25669,2021,Ghana,South Africa,7,1335,0,1342
25670,2021,Guinea-Bissau,South Africa,0,9,0,9
25671,2021,Guinea,South Africa,0,51,0,51
25672,2021,Cote d'Ivoire,South Africa,26,168,0,194
25673,2021,India,South Africa,5,3994,0,3999
25674,2021,Iraq,South Africa,14,6,0,20
25675,2021,Jordan,South Africa,5,5,0,10
25676,2021,Kenya,South Africa,141,950,0,1091
25677,2021,Liberia,South Africa,47,55,0,102
25678,2021,Lesotho,South Africa,0,18,0,18
25679,2021,Sri Lanka,South Africa,10,17,0,27
25680,2021,Mali,South Africa,5,120,0,125
25681,2021,Malawi,South Africa,8,1520,0,1528
25682,2021,Morocco,South Africa,5,6,0,11
25683,2021,Mozambique,South Africa,0,261,0,261
25684,2021,Nepal,South Africa,0,88,0,88
25685,2021,Niger,South Africa,0,688,0,688
25686,2021,Nigeria,South Africa,11,5207,0,5218
25687,2021,Pakistan,South Africa,11,8559,0,8570
25688,2021,Russian Federation,South Africa,10,0,0,10
25689,2021,Rwanda,South Africa,1014,1040,0,2054
25690,2021,Senegal,South Africa,5,779,0,784
25691,2021,Sierra Leone,South Africa,19,13,0,32
25692,2021,Solomon Islands,South Africa,7,0,0,7
25693,2021,Somalia,South Africa,22529,4551,0,27080
25694,2021,Sudan,South Africa,86,62,0,148
25695,2021,Eswatini,South Africa,7,18,0,25
25696,2021,Syrian Arab Rep.,South Africa,38,20,0,58
25697,2021,United Rep. of Tanzania,South Africa,31,497,0,528
25698,2021,Thailand,South Africa,0,49,0,49
25699,2021,Timor-Leste,South Africa,0,7,0,7
25700,2021,Togo,South Africa,11,30,0,41
25701,2021,Türkiye,South Africa,5,10,0,15
25702,2021,Uganda,South Africa,460,3927,0,4387
25703,2021,Ukraine,South Africa,5,0,0,5
25704,2021,Yemen,South Africa,5,10,0,15
25705,2021,Zambia,South Africa,60,202,0,262
25706,2021,Zimbabwe,South Africa,3965,10468,0,14433
25707,2021,Afghanistan,Russian Federation,921,193,0,1114
25708,2021,Egypt,Russian Federation,6,0,0,6
25709,2021,Armenia,Russian Federation,13,5,0,18
25710,2021,Azerbaijan,Russian Federation,24,0,0,24
25711,2021,Belgium,Russian Federation,0,15,0,15
25712,2021,Bangladesh,Russian Federation,5,0,0,5
25713,2021,China,Russian Federation,23,16,0,39
25714,2021,Cameroon,Russian Federation,5,5,0,10
25715,2021,Congo,Russian Federation,5,0,0,5
25716,2021,Dem. Rep. of the Congo,Russian Federation,14,0,0,14
25717,2021,Cuba,Russian Federation,7,5,0,12
25718,2021,Estonia,Russian Federation,5,0,0,5
25719,2021,Ethiopia,Russian Federation,0,5,0,5
25720,2021,Palestinian,Russian Federation,5,0,0,5
25721,2021,Georgia,Russian Federation,134,5,0,139
25722,2021,Germany,Russian Federation,15,0,0,15
25723,2021,Iran (Islamic Rep. of),Russian Federation,5,0,0,5
25724,2021,Iraq,Russian Federation,16,0,0,16
25725,2021,Israel,Russian Federation,5,0,0,5
25726,2021,Kazakhstan,Russian Federation,31,5,0,36
25727,2021,Kyrgyzstan,Russian Federation,35,5,0,40
25728,2021,Rep. of Korea,Russian Federation,5,0,0,5
25729,2021,Dem. People's Rep. of Korea,Russian Federation,43,5,0,48
25730,2021,Libya,Russian Federation,7,0,0,7
25731,2021,Lebanon,Russian Federation,5,0,0,5
25732,2021,Lithuania,Russian Federation,5,0,0,5
25733,2021,Latvia,Russian Federation,9,0,0,9
25734,2021,Rep. of Moldova,Russian Federation,22,0,0,22
25735,2021,Nigeria,Russian Federation,0,5,0,5
25736,2021,Pakistan,Russian Federation,6,0,0,6
25737,2021,Philippines,Russian Federation,5,0,0,5
25738,2021,Sudan,Russian Federation,5,0,0,5
25739,2021,Syrian Arab Rep.,Russian Federation,297,62,0,359
25740,2021,Tajikistan,Russian Federation,31,28,0,59
25741,2021,Turkmenistan,Russian Federation,51,5,0,56
25742,2021,Türkiye,Russian Federation,5,0,0,5
25743,2021,Ukraine,Russian Federation,8921,126,0,9047
25744,2021,United States of America,Russian Federation,5,0,0,5
25745,2021,Uzbekistan,Russian Federation,80,11,0,91
25746,2021,Yemen,Russian Federation,84,13,0,97
25749,2021,Angola,Rwanda,9,0,0,9
25750,2021,Burundi,Rwanda,47884,59,0,47943
25751,2021,Chad,Rwanda,6,0,0,6
25752,2021,Cameroon,Rwanda,0,7,0,7
25753,2021,Dem. Rep. of the Congo,Rwanda,73763,145,0,73908
25754,2021,Eritrea,Rwanda,131,108,0,239
25755,2021,Ethiopia,Rwanda,5,5,0,10
25756,2021,Rwanda,Rwanda,0,0,0,0
25757,2021,Somalia,Rwanda,13,7,0,20
25758,2021,Sudan,Rwanda,78,54,0,132
25759,2021,South Sudan,Rwanda,7,8,0,15
25761,2021,Colombia,El Salvador,18,7,0,25
25762,2021,Guatemala,El Salvador,0,8,0,8
25763,2021,Honduras,El Salvador,26,11,0,37
25764,2021,Iraq,El Salvador,5,0,0,5
25765,2021,Mexico,El Salvador,5,0,0,5
25766,2021,Nicaragua,El Salvador,22,27,0,49
25767,2021,El Salvador,El Salvador,0,0,71500,0
25768,2021,Syrian Arab Rep.,El Salvador,5,0,0,5
25769,2021,United States of America,El Salvador,5,0,0,5
25770,2021,Venezuela (Bolivarian Republic of),El Salvador,12,13,0,25
25771,2021,Afghanistan,Saudi Arabia,0,231,0,231
25772,2021,Egypt,Saudi Arabia,0,20,0,20
25773,2021,Burkina Faso,Saudi Arabia,0,11,0,11
25774,2021,Chad,Saudi Arabia,9,87,0,96
25775,2021,China,Saudi Arabia,14,25,0,39
25776,2021,Eritrea,Saudi Arabia,36,131,0,167
25777,2021,Ethiopia,Saudi Arabia,0,9,0,9
25778,2021,Palestinian,Saudi Arabia,7,434,0,441
25779,2021,Iran (Islamic Rep. of),Saudi Arabia,0,5,0,5
25780,2021,Iraq,Saudi Arabia,32,197,0,229
25781,2021,Jordan,Saudi Arabia,0,19,0,19
25782,2021,Liberia,Saudi Arabia,9,0,0,9
25783,2021,Libya,Saudi Arabia,0,8,0,8
25784,2021,Lebanon,Saudi Arabia,0,13,0,13
25785,2021,Mali,Saudi Arabia,0,5,0,5
25786,2021,Myanmar,Saudi Arabia,0,115,0,115
25787,2021,Nigeria,Saudi Arabia,0,9,0,9
25788,2021,Pakistan,Saudi Arabia,0,25,0,25
25789,2021,Somalia,Saudi Arabia,16,66,0,82
25790,2021,Sudan,Saudi Arabia,0,96,0,96
25791,2021,South Sudan,Saudi Arabia,0,7,0,7
25792,2021,Syrian Arab Rep.,Saudi Arabia,186,9884,0,10070
25793,2021,Turkmenistan,Saudi Arabia,0,5,0,5
25794,2021,Tunisia,Saudi Arabia,6,6,0,12
25795,2021,Yemen,Saudi Arabia,18,1016,0,1034
25798,2021,Afghanistan,Serbia and Kosovo: S/RES/1244 (1999),27,15,0,42
25799,2021,Algeria,Serbia and Kosovo: S/RES/1244 (1999),0,10,0,10
25800,2021,Burundi,Serbia and Kosovo: S/RES/1244 (1999),8,35,0,43
25801,2021,Bangladesh,Serbia and Kosovo: S/RES/1244 (1999),0,0,0,0
25802,2021,Bosnia and Herzegovina,Serbia and Kosovo: S/RES/1244 (1999),7996,0,0,7996
25803,2021,Bulgaria,Serbia and Kosovo: S/RES/1244 (1999),0,5,0,5
25804,2021,Cameroon,Serbia and Kosovo: S/RES/1244 (1999),0,6,0,6
25805,2021,Congo,Serbia and Kosovo: S/RES/1244 (1999),0,7,0,7
25806,2021,Dem. Rep. of the Congo,Serbia and Kosovo: S/RES/1244 (1999),0,7,0,7
25807,2021,Cuba,Serbia and Kosovo: S/RES/1244 (1999),7,0,0,7
25808,2021,Ethiopia,Serbia and Kosovo: S/RES/1244 (1999),5,0,0,5
25809,2021,Palestinian,Serbia and Kosovo: S/RES/1244 (1999),6,0,0,6
25810,2021,Guinea-Bissau,Serbia and Kosovo: S/RES/1244 (1999),0,7,0,7
25811,2021,Guinea,Serbia and Kosovo: S/RES/1244 (1999),0,5,0,5
25812,2021,Croatia,Serbia and Kosovo: S/RES/1244 (1999),17334,0,0,17334
25813,2021,Iran (Islamic Rep. of),Serbia and Kosovo: S/RES/1244 (1999),19,21,0,40
25814,2021,Iraq,Serbia and Kosovo: S/RES/1244 (1999),16,7,0,23
25815,2021,Jordan,Serbia and Kosovo: S/RES/1244 (1999),0,7,0,7
25816,2021,Libya,Serbia and Kosovo: S/RES/1244 (1999),46,0,0,46
25817,2021,North Macedonia,Serbia and Kosovo: S/RES/1244 (1999),0,0,0,0
25818,2021,Morocco,Serbia and Kosovo: S/RES/1244 (1999),0,26,0,26
25819,2021,Nigeria,Serbia and Kosovo: S/RES/1244 (1999),0,7,0,7
25820,2021,Pakistan,Serbia and Kosovo: S/RES/1244 (1999),5,5,0,10
25821,2021,Russian Federation,Serbia and Kosovo: S/RES/1244 (1999),5,6,0,11
25822,2021,Serbia and Kosovo: S/RES/1244 (1999),Serbia and Kosovo: S/RES/1244 (1999),0,0,211823,0
25823,2021,Somalia,Serbia and Kosovo: S/RES/1244 (1999),7,16,0,23
25824,2021,Sudan,Serbia and Kosovo: S/RES/1244 (1999),5,0,0,5
25825,2021,Syrian Arab Rep.,Serbia and Kosovo: S/RES/1244 (1999),45,9,0,54
25826,2021,Türkiye,Serbia and Kosovo: S/RES/1244 (1999),98,17,0,115
25827,2021,Ukraine,Serbia and Kosovo: S/RES/1244 (1999),15,0,0,15
25830,2021,Burundi,Senegal,11,8,0,19
25831,2021,Benin,Senegal,0,5,0,5
25832,2021,Burkina Faso,Senegal,0,6,0,6
25833,2021,Central African Rep.,Senegal,220,495,0,715
25834,2021,Chad,Senegal,5,33,0,38
25835,2021,Cameroon,Senegal,0,27,0,27
25836,2021,Congo,Senegal,0,102,0,102
25837,2021,Dem. Rep. of the Congo,Senegal,11,198,0,209
25838,2021,Eritrea,Senegal,0,14,0,14
25839,2021,Gambia,Senegal,31,384,0,415
25840,2021,Ghana,Senegal,0,5,0,5
25841,2021,Guinea-Bissau,Senegal,0,5,0,5
25842,2021,Guinea,Senegal,0,135,0,135
25843,2021,Haiti,Senegal,0,5,0,5
25844,2021,Cote d'Ivoire,Senegal,23,164,0,187
25845,2021,Liberia,Senegal,8,63,0,71
25846,2021,Sri Lanka,Senegal,0,6,0,6
25847,2021,Mauritania,Senegal,14148,77,0,14225
25848,2021,Mali,Senegal,0,71,0,71
25849,2021,Nigeria,Senegal,0,69,0,69
25850,2021,Pakistan,Senegal,0,12,0,12
25851,2021,Rwanda,Senegal,12,7,0,19
25852,2021,Sierra Leone,Senegal,0,51,0,51
25853,2021,Sudan,Senegal,5,8,0,13
25854,2021,Syrian Arab Rep.,Senegal,0,14,0,14
25855,2021,Togo,Senegal,0,32,0,32
25856,2021,Türkiye,Senegal,5,49,0,54
25858,2021,Cote d'Ivoire,Sierra Leone,10,0,0,10
25859,2021,Liberia,Sierra Leone,335,0,0,335
25860,2021,Solomon Islands,Solomon Islands,0,0,1000,0
25861,2021,Egypt,Somalia,0,5,0,5
25862,2021,Bangladesh,Somalia,6,0,0,6
25863,2021,Cameroon,Somalia,5,0,0,5
25864,2021,Djibouti,Somalia,0,7,0,7
25865,2021,Eritrea,Somalia,52,39,0,91
25866,2021,Ethiopia,Somalia,4400,15994,0,20394
25867,2021,Palestinian,Somalia,9,0,0,9
25868,2021,Mozambique,Somalia,0,5,0,5
25869,2021,Somalia,Somalia,0,0,2967500,0
25870,2021,Sudan,Somalia,0,8,0,8
25871,2021,Syrian Arab Rep.,Somalia,991,65,0,1056
25872,2021,United Rep. of Tanzania,Somalia,0,135,0,135
25873,2021,Yemen,Somalia,8341,0,0,8341
25874,2021,Afghanistan,Spain,1188,1060,0,2248
25875,2021,Albania,Spain,5,90,0,95
25876,2021,Algeria,Spain,110,1165,0,1275
25877,2021,Angola,Spain,38,15,0,53
25878,2021,Egypt,Spain,94,175,0,269
25879,2021,Argentina,Spain,18,670,0,688
25880,2021,Armenia,Spain,45,295,0,340
25881,2021,Azerbaijan,Spain,51,65,0,116
25882,2021,Burundi,Spain,8,0,0,8
25883,2021,Benin,Spain,5,15,0,20
25884,2021,Bangladesh,Spain,21,285,0,306
25885,2021,Burkina Faso,Spain,5,245,0,250
25886,2021,Belarus,Spain,9,210,0,219
25887,2021,Bolivia (Plurinational State of),Spain,9,220,0,229
25888,2021,Brazil,Spain,47,1170,0,1217
25889,2021,Bosnia and Herzegovina,Spain,0,5,0,5
25890,2021,Canada,Spain,0,5,0,5
25891,2021,Central African Rep.,Spain,136,40,0,176
25892,2021,Chad,Spain,30,5,0,35
25893,2021,China,Spain,32,900,0,932
25894,2021,Chile,Spain,18,330,0,348
25895,2021,Cameroon,Spain,122,710,0,832
25896,2021,Congo,Spain,69,25,0,94
25897,2021,Dem. Rep. of the Congo,Spain,84,75,0,159
25898,2021,Comoros,Spain,0,5,0,5
25899,2021,Colombia,Spain,2158,20320,0,22478
25900,2021,Costa Rica,Spain,5,70,0,75
25901,2021,Cuba,Spain,136,3065,0,3201
25902,2021,Djibouti,Spain,0,5,0,5
25903,2021,Dominican Rep.,Spain,11,230,0,241
25904,2021,Ecuador,Spain,13,485,0,498
25905,2021,Equatorial Guinea,Spain,30,110,0,140
25906,2021,Eritrea,Spain,309,55,0,364
25907,2021,Ethiopia,Spain,56,25,0,81
25908,2021,France,Spain,0,5,0,5
25909,2021,Gabon,Spain,5,5,0,10
25910,2021,Gambia,Spain,51,525,0,576
25911,2021,Palestinian,Spain,1351,410,0,1761
25912,2021,Georgia,Spain,40,1920,0,1960
25913,2021,Ghana,Spain,11,110,0,121
25914,2021,Guinea-Bissau,Spain,5,125,0,130
25915,2021,Guatemala,Spain,99,610,0,709
25916,2021,Guinea,Spain,187,1230,0,1417
25917,2021,Haiti,Spain,10,170,0,180
25918,2021,Honduras,Spain,1540,6750,0,8290
25919,2021,Cote d'Ivoire,Spain,383,805,0,1188
25920,2021,India,Spain,12,50,0,62
25921,2021,Iran (Islamic Rep. of),Spain,87,190,0,277
25922,2021,Iraq,Spain,296,145,0,441
25923,2021,Israel,Spain,0,15,0,15
25924,2021,Jamaica,Spain,61,20,0,81
25925,2021,Jordan,Spain,27,35,0,62
25926,2021,Kazakhstan,Spain,16,40,0,56
25927,2021,Kenya,Spain,15,5,0,20
25928,2021,Kyrgyzstan,Spain,6,30,0,36
25929,2021,Rep. of Korea,Spain,0,5,0,5
25930,2021,Kuwait,Spain,0,5,0,5
25931,2021,Liberia,Spain,7,45,0,52
25932,2021,Libya,Spain,167,30,0,197
25933,2021,Lebanon,Spain,30,80,0,110
25934,2021,Sri Lanka,Spain,67,30,0,97
25935,2021,Mauritania,Spain,18,195,0,213
25936,2021,North Macedonia,Spain,0,15,0,15
25937,2021,Rep. of Moldova,Spain,0,110,0,110
25938,2021,Mexico,Spain,40,135,0,175
25939,2021,Mali,Spain,1457,6040,0,7497
25940,2021,Mongolia,Spain,5,20,0,25
25941,2021,Morocco,Spain,722,6355,0,7077
25942,2021,Myanmar,Spain,8,5,0,13
25943,2021,Nepal,Spain,0,10,0,10
25944,2021,Niger,Spain,22,10,0,32
25945,2021,Nicaragua,Spain,1797,4805,0,6602
25946,2021,Nigeria,Spain,162,1395,0,1557
25947,2021,Oman,Spain,0,5,0,5
25948,2021,Pakistan,Spain,458,610,0,1068
25949,2021,Panama,Spain,19,120,0,139
25950,2021,Paraguay,Spain,57,750,0,807
25951,2021,Peru,Spain,285,3325,0,3610
25952,2021,Philippines,Spain,0,15,0,15
25953,2021,South Africa,Spain,5,0,0,5
25954,2021,Russian Federation,Spain,450,1870,0,2320
25955,2021,Rwanda,Spain,5,0,0,5
25956,2021,El Salvador,Spain,859,3540,0,4399
25957,2021,Saudi Arabia,Spain,5,5,0,10
25958,2021,Serbia and Kosovo: S/RES/1244 (1999),Spain,5,30,0,35
25959,2021,Senegal,Spain,41,3065,0,3106
25960,2021,Sierra Leone,Spain,28,40,0,68
25961,2021,Somalia,Spain,686,225,0,911
25962,2021,Viet Nam,Spain,7,30,0,37
25963,2021,Sudan,Spain,322,140,0,462
25964,2021,South Sudan,Spain,5,5,0,10
25965,2021,Syrian Arab Rep.,Spain,14987,1605,0,16592
25966,2021,Tajikistan,Spain,5,15,0,20
25967,2021,Turkmenistan,Spain,0,5,0,5
25968,2021,Togo,Spain,5,40,0,45
25969,2021,Trinidad and Tobago,Spain,5,5,0,10
25970,2021,Tunisia,Spain,65,440,0,505
25971,2021,Türkiye,Spain,167,475,0,642
25972,2021,United Arab Emirates,Spain,0,5,0,5
25973,2021,Uganda,Spain,7,5,0,12
25974,2021,Ukraine,Spain,1515,2820,0,4335
25975,2021,Uruguay,Spain,7,335,0,342
25976,2021,United States of America,Spain,19,85,0,104
25977,2021,Uzbekistan,Spain,13,10,0,23
25978,2021,Venezuela (Bolivarian Republic of),Spain,88492,19205,0,107697
25979,2021,Western Sahara,Spain,20,0,0,20
25980,2021,Yemen,Spain,392,325,0,717
25985,2021,Venezuela (Bolivarian Republic of),Saint Kitts and Nevis,0,0,0,0
25986,2021,Afghanistan,Sudan,0,0,0,0
25987,2021,Egypt,Sudan,17,11,0,28
25988,2021,Argentina,Sudan,0,0,0,0
25989,2021,Burundi,Sudan,11,7,0,18
25990,2021,Central African Rep.,Sudan,27613,6,0,27619
25991,2021,Chad,Sudan,3931,5,0,3936
25992,2021,Cameroon,Sudan,7,0,0,7
25993,2021,Congo,Sudan,18,5,0,23
25994,2021,Dem. Rep. of the Congo,Sudan,492,352,0,844
25995,2021,Eritrea,Sudan,115678,11063,0,126741
25996,2021,Ethiopia,Sudan,56806,14533,0,71339
25997,2021,Palestinian,Sudan,49,25,0,74
25998,2021,India,Sudan,0,5,0,5
25999,2021,Iraq,Sudan,9,13,0,22
26000,2021,Jordan,Sudan,0,0,0,0
26001,2021,Kuwait,Sudan,0,0,0,0
26002,2021,Nigeria,Sudan,12,0,0,12
26003,2021,Saudi Arabia,Sudan,0,0,0,0
26004,2021,Somalia,Sudan,354,205,0,559
26005,2021,Sudan,Sudan,0,0,3036590,0
26006,2021,South Sudan,Sudan,803634,0,0,803634
26007,2021,Syrian Arab Rep.,Sudan,93482,0,0,93482
26008,2021,Türkiye,Sudan,5,0,0,5
26009,2021,Uganda,Sudan,5,0,0,5
26010,2021,Yemen,Sudan,1795,389,0,2184
26011,2021,Colombia,Suriname,0,6,0,6
26012,2021,Cuba,Suriname,17,1777,0,1794
26013,2021,Dominican Rep.,Suriname,0,9,0,9
26014,2021,Guyana,Suriname,0,5,0,5
26015,2021,Nigeria,Suriname,0,5,0,5
26016,2021,Venezuela (Bolivarian Republic of),Suriname,12,331,0,343
26017,2021,Burundi,South Sudan,182,878,0,1060
26018,2021,Central African Rep.,South Sudan,2457,0,0,2457
26019,2021,Cameroon,South Sudan,0,5,0,5
26020,2021,Dem. Rep. of the Congo,South Sudan,17958,19,0,17977
26021,2021,Eritrea,South Sudan,365,2614,0,2979
26022,2021,Ethiopia,South Sudan,4532,749,0,5281
26023,2021,Somalia,South Sudan,5,30,0,35
26024,2021,Sudan,South Sudan,308174,19,0,308193
26025,2021,South Sudan,South Sudan,0,0,2017236,0
26027,2021,Afghanistan,Slovakia,319,23,0,342
26028,2021,Angola,Slovakia,24,0,0,24
26029,2021,Egypt,Slovakia,5,0,0,5
26030,2021,Armenia,Slovakia,34,0,0,34
26031,2021,Burundi,Slovakia,5,0,0,5
26032,2021,Bosnia and Herzegovina,Slovakia,36,0,0,36
26033,2021,Bulgaria,Slovakia,8,0,0,8
26034,2021,Cambodia,Slovakia,5,0,0,5
26035,2021,China,Slovakia,5,0,0,5
26036,2021,Cameroon,Slovakia,9,0,0,9
26037,2021,Dem. Rep. of the Congo,Slovakia,16,0,0,16
26038,2021,Cuba,Slovakia,32,0,0,32
26039,2021,Palestinian,Slovakia,7,0,0,7
26040,2021,Iran (Islamic Rep. of),Slovakia,39,0,0,39
26041,2021,Iraq,Slovakia,214,0,0,214
26042,2021,Liberia,Slovakia,5,0,0,5
26043,2021,Libya,Slovakia,7,0,0,7
26044,2021,Sri Lanka,Slovakia,0,9,0,9
26045,2021,Morocco,Slovakia,0,11,0,11
26046,2021,Pakistan,Slovakia,8,0,0,8
26047,2021,Romania,Slovakia,37,0,0,37
26048,2021,Russian Federation,Slovakia,38,0,0,38
26049,2021,Serbia and Kosovo: S/RES/1244 (1999),Slovakia,46,0,0,46
26050,2021,Somalia,Slovakia,34,0,0,34
26051,2021,Viet Nam,Slovakia,16,0,0,16
26052,2021,Syrian Arab Rep.,Slovakia,25,0,0,25
26053,2021,Türkiye,Slovakia,5,0,0,5
26054,2021,Uganda,Slovakia,5,0,0,5
26055,2021,Ukraine,Slovakia,24,0,0,24
26056,2021,Uzbekistan,Slovakia,5,0,0,5
26057,2021,Yemen,Slovakia,24,0,0,24
26059,2021,Afghanistan,Slovenia,60,339,0,399
26060,2021,Algeria,Slovenia,0,13,0,13
26061,2021,Bangladesh,Slovenia,0,23,0,23
26062,2021,Bosnia and Herzegovina,Slovenia,6,0,0,6
26063,2021,Cameroon,Slovenia,6,8,0,14
26064,2021,Dem. Rep. of the Congo,Slovenia,6,0,0,6
26065,2021,Cuba,Slovenia,0,24,0,24
26066,2021,Eritrea,Slovenia,86,0,0,86
26067,2021,Palestinian,Slovenia,26,5,0,31
26068,2021,India,Slovenia,0,8,0,8
26069,2021,Iran (Islamic Rep. of),Slovenia,80,19,0,99
26070,2021,Iraq,Slovenia,53,24,0,77
26071,2021,Kazakhstan,Slovenia,20,0,0,20
26072,2021,Morocco,Slovenia,0,12,0,12
26073,2021,Nepal,Slovenia,0,10,0,10
26074,2021,Nigeria,Slovenia,6,5,0,11
26075,2021,Pakistan,Slovenia,5,29,0,34
26076,2021,Russian Federation,Slovenia,21,0,0,21
26077,2021,Serbia and Kosovo: S/RES/1244 (1999),Slovenia,11,8,0,19
26078,2021,Somalia,Slovenia,51,0,0,51
26079,2021,Sudan,Slovenia,6,0,0,6
26080,2021,Syrian Arab Rep.,Slovenia,326,13,0,339
26081,2021,Tunisia,Slovenia,0,5,0,5
26082,2021,Türkiye,Slovenia,59,27,0,86
26083,2021,Ukraine,Slovenia,5,0,0,5
26084,2021,Yemen,Slovenia,6,0,0,6
26087,2021,Angola,Eswatini,12,0,0,12
26088,2021,Burundi,Eswatini,175,84,0,259
26089,2021,Cameroon,Eswatini,0,6,0,6
26090,2021,Congo,Eswatini,5,7,0,12
26091,2021,Dem. Rep. of the Congo,Eswatini,426,210,0,636
26092,2021,Eritrea,Eswatini,0,5,0,5
26093,2021,Ethiopia,Eswatini,12,40,0,52
26094,2021,Rwanda,Eswatini,145,91,0,236
26095,2021,Somalia,Eswatini,107,198,0,305
26096,2021,Eswatini,Eswatini,0,0,0,0
26097,2021,United Rep. of Tanzania,Eswatini,0,5,0,5
26098,2021,Uganda,Eswatini,6,0,0,6
26099,2021,Zimbabwe,Eswatini,7,0,0,7
26100,2021,Afghanistan,Sweden,27562,1824,0,29386
26101,2021,Albania,Sweden,290,155,0,445
26102,2021,Algeria,Sweden,55,69,0,124
26103,2021,Angola,Sweden,21,13,0,34
26104,2021,Egypt,Sweden,422,154,0,576
26105,2021,Argentina,Sweden,0,5,0,5
26106,2021,Armenia,Sweden,291,120,0,411
26107,2021,Azerbaijan,Sweden,585,216,0,801
26108,2021,Bahrain,Sweden,16,0,0,16
26109,2021,Burundi,Sweden,221,24,0,245
26110,2021,Benin,Sweden,10,0,0,10
26111,2021,Bangladesh,Sweden,250,152,0,402
26112,2021,Burkina Faso,Sweden,5,0,0,5
26113,2021,Belarus,Sweden,97,83,0,180
26114,2021,Bolivia (Plurinational State of),Sweden,51,5,0,56
26115,2021,Brazil,Sweden,6,19,0,25
26116,2021,Bosnia and Herzegovina,Sweden,58,56,0,114
26117,2021,Bulgaria,Sweden,5,0,0,5
26118,2021,Central African Rep.,Sweden,71,0,0,71
26119,2021,Chad,Sweden,18,0,0,18
26120,2021,China,Sweden,248,30,0,278
26121,2021,Chile,Sweden,9,17,0,26
26122,2021,Cameroon,Sweden,231,135,0,366
26123,2021,Congo,Sweden,28,18,0,46
26124,2021,Dem. Rep. of the Congo,Sweden,824,65,0,889
26125,2021,Comoros,Sweden,5,0,0,5
26126,2021,Colombia,Sweden,40,126,0,166
26127,2021,Cuba,Sweden,23,17,0,40
26128,2021,Djibouti,Sweden,30,17,0,47
26129,2021,Ecuador,Sweden,5,5,0,10
26130,2021,Equatorial Guinea,Sweden,5,0,0,5
26131,2021,Eritrea,Sweden,26428,349,0,26777
26132,2021,Ethiopia,Sweden,2500,399,0,2899
26133,2021,Gambia,Sweden,179,78,0,257
26134,2021,Palestinian,Sweden,1322,488,0,1810
26135,2021,United Kingdom of Great Britain and Northern Ireland,Sweden,5,0,0,5
26136,2021,Georgia,Sweden,88,135,0,223
26137,2021,Ghana,Sweden,57,50,0,107
26138,2021,Guinea-Bissau,Sweden,8,5,0,13
26139,2021,Greece,Sweden,18,0,0,18
26140,2021,Guatemala,Sweden,11,0,0,11
26141,2021,Guinea,Sweden,66,15,0,81
26142,2021,Honduras,Sweden,29,10,0,39
26143,2021,Croatia,Sweden,0,5,0,5
26144,2021,Hungary,Sweden,5,0,0,5
26145,2021,Cote d'Ivoire,Sweden,30,8,0,38
26146,2021,India,Sweden,20,36,0,56
26147,2021,Indonesia,Sweden,15,0,0,15
26148,2021,Iran (Islamic Rep. of),Sweden,7350,800,0,8150
26149,2021,Iraq,Sweden,10643,1242,0,11885
26150,2021,Israel,Sweden,22,5,0,27
26151,2021,Jamaica,Sweden,5,0,0,5
26152,2021,Jordan,Sweden,279,137,0,416
26153,2021,Kazakhstan,Sweden,203,101,0,304
26154,2021,Kenya,Sweden,82,38,0,120
26155,2021,Kyrgyzstan,Sweden,154,63,0,217
26156,2021,Rep. of Korea,Sweden,7,5,0,12
26157,2021,Kuwait,Sweden,32,0,0,32
26158,2021,Liberia,Sweden,10,5,0,15
26159,2021,Libya,Sweden,263,53,0,316
26160,2021,Lebanon,Sweden,509,227,0,736
26161,2021,Sri Lanka,Sweden,27,27,0,54
26162,2021,Lithuania,Sweden,0,7,0,7
26163,2021,Mauritania,Sweden,13,0,0,13
26164,2021,North Macedonia,Sweden,36,23,0,59
26165,2021,Rep. of Moldova,Sweden,8,13,0,21
26166,2021,Mexico,Sweden,0,5,0,5
26167,2021,Mali,Sweden,41,5,0,46
26168,2021,Malaysia,Sweden,14,0,0,14
26169,2021,Mongolia,Sweden,240,139,0,379
26170,2021,Morocco,Sweden,256,148,0,404
26171,2021,Mozambique,Sweden,0,5,0,5
26172,2021,Montenegro,Sweden,21,18,0,39
26173,2021,Myanmar,Sweden,6,5,0,11
26174,2021,Nepal,Sweden,9,5,0,14
26175,2021,Niger,Sweden,5,0,0,5
26176,2021,Nicaragua,Sweden,63,40,0,103
26177,2021,Nigeria,Sweden,598,327,0,925
26178,2021,Pakistan,Sweden,609,203,0,812
26179,2021,Peru,Sweden,7,38,0,45
26180,2021,Philippines,Sweden,6,12,0,18
26181,2021,Romania,Sweden,38,5,0,43
26182,2021,Russian Federation,Sweden,1314,354,0,1668
26183,2021,Rwanda,Sweden,55,31,0,86
26184,2021,El Salvador,Sweden,142,43,0,185
26185,2021,Saudi Arabia,Sweden,60,0,0,60
26186,2021,Serbia and Kosovo: S/RES/1244 (1999),Sweden,517,231,0,748
26187,2021,Senegal,Sweden,57,27,0,84
26188,2021,Sierra Leone,Sweden,68,10,0,78
26189,2021,Somalia,Sweden,10330,528,0,10858
26190,2021,Viet Nam,Sweden,19,40,0,59
26191,2021,Sudan,Sweden,1091,89,0,1180
26192,2021,South Sudan,Sweden,63,0,0,63
26193,2021,Eswatini,Sweden,5,0,0,5
26194,2021,Syrian Arab Rep.,Sweden,115233,1510,0,116743
26195,2021,United Rep. of Tanzania,Sweden,65,39,0,104
26196,2021,Thailand,Sweden,0,10,0,10
26197,2021,Tajikistan,Sweden,62,25,0,87
26198,2021,Turkmenistan,Sweden,16,10,0,26
26199,2021,Tunisia,Sweden,44,45,0,89
26200,2021,Türkiye,Sweden,2303,539,0,2842
26201,2021,United Arab Emirates,Sweden,5,0,0,5
26202,2021,Uganda,Sweden,748,79,0,827
26203,2021,Ukraine,Sweden,226,334,0,560
26204,2021,United States of America,Sweden,21,7,0,28
26205,2021,Uzbekistan,Sweden,495,453,0,948
26206,2021,Venezuela (Bolivarian Republic of),Sweden,41,41,0,82
26207,2021,Yemen,Sweden,1727,62,0,1789
26208,2021,Zambia,Sweden,13,0,0,13
26209,2021,Zimbabwe,Sweden,16,5,0,21
26212,2021,Afghanistan,Switzerland,15060,1500,0,16560
26213,2021,Albania,Switzerland,114,51,0,165
26214,2021,Algeria,Switzerland,173,211,0,384
26215,2021,Angola,Switzerland,703,46,0,749
26216,2021,Egypt,Switzerland,140,11,0,151
26217,2021,Armenia,Switzerland,163,24,0,187
26218,2021,Azerbaijan,Switzerland,207,70,0,277
26219,2021,Burundi,Switzerland,189,5,0,194
26220,2021,Benin,Switzerland,24,0,0,24
26221,2021,Bangladesh,Switzerland,43,7,0,50
26222,2021,Burkina Faso,Switzerland,22,0,0,22
26223,2021,Belarus,Switzerland,52,19,0,71
26224,2021,Brazil,Switzerland,14,0,0,14
26225,2021,Bosnia and Herzegovina,Switzerland,1483,12,0,1495
26226,2021,Bulgaria,Switzerland,5,0,0,5
26227,2021,Cambodia,Switzerland,279,0,0,279
26228,2021,Central African Rep.,Switzerland,19,0,0,19
26229,2021,Chad,Switzerland,35,14,0,49
26230,2021,China,Switzerland,2443,76,0,2519
26231,2021,Chile,Switzerland,9,0,0,9
26232,2021,Cameroon,Switzerland,201,39,0,240
26233,2021,Congo,Switzerland,49,5,0,54
26234,2021,Dem. Rep. of the Congo,Switzerland,1204,65,0,1269
26235,2021,Colombia,Switzerland,288,98,0,386
26236,2021,Cuba,Switzerland,41,7,0,48
26237,2021,Czechia,Switzerland,5,0,0,5
26238,2021,Djibouti,Switzerland,17,0,0,17
26239,2021,Ecuador,Switzerland,5,0,0,5
26240,2021,Equatorial Guinea,Switzerland,5,0,0,5
26241,2021,Eritrea,Switzerland,38588,278,0,38866
26242,2021,Ethiopia,Switzerland,1781,146,0,1927
26243,2021,France,Switzerland,8,0,0,8
26244,2021,Gabon,Switzerland,5,0,0,5
26245,2021,Gambia,Switzerland,53,12,0,65
26246,2021,United Kingdom of Great Britain and Northern Ireland,Switzerland,5,0,0,5
26247,2021,Georgia,Switzerland,243,192,0,435
26248,2021,Germany,Switzerland,5,0,0,5
26249,2021,Ghana,Switzerland,23,15,0,38
26250,2021,Guinea-Bissau,Switzerland,47,0,0,47
26251,2021,Guatemala,Switzerland,7,0,0,7
26252,2021,Guinea,Switzerland,188,27,0,215
26253,2021,Honduras,Switzerland,5,7,0,12
26254,2021,Croatia,Switzerland,16,0,0,16
26255,2021,Hungary,Switzerland,5,0,0,5
26256,2021,Cote d'Ivoire,Switzerland,198,17,0,215
26257,2021,India,Switzerland,33,9,0,42
26258,2021,Indonesia,Switzerland,0,5,0,5
26259,2021,Iran (Islamic Rep. of),Switzerland,2246,675,0,2921
26260,2021,Iraq,Switzerland,4488,445,0,4933
26261,2021,Israel,Switzerland,5,0,0,5
26262,2021,Italy,Switzerland,6,5,0,11
26263,2021,Jamaica,Switzerland,7,0,0,7
26264,2021,Jordan,Switzerland,57,7,0,64
26265,2021,Kazakhstan,Switzerland,28,9,0,37
26266,2021,Kenya,Switzerland,42,0,0,42
26267,2021,Kyrgyzstan,Switzerland,16,11,0,27
26268,2021,Lao People's Dem. Rep.,Switzerland,107,0,0,107
26269,2021,Liberia,Switzerland,32,0,0,32
26270,2021,Libya,Switzerland,304,33,0,337
26271,2021,Lebanon,Switzerland,47,23,0,70
26272,2021,Sri Lanka,Switzerland,6059,659,0,6718
26273,2021,Madagascar,Switzerland,5,0,0,5
26274,2021,Mauritania,Switzerland,9,0,0,9
26275,2021,North Macedonia,Switzerland,155,31,0,186
26276,2021,Rep. of Moldova,Switzerland,10,0,0,10
26277,2021,Mali,Switzerland,33,5,0,38
26278,2021,Mongolia,Switzerland,176,9,0,185
26279,2021,Morocco,Switzerland,85,96,0,181
26280,2021,Montenegro,Switzerland,51,9,0,60
26281,2021,Myanmar,Switzerland,41,5,0,46
26282,2021,Nepal,Switzerland,18,5,0,23
26283,2021,Netherlands,Switzerland,5,0,0,5
26284,2021,Niger,Switzerland,8,0,0,8
26285,2021,Nicaragua,Switzerland,7,8,0,15
26286,2021,Nigeria,Switzerland,282,71,0,353
26287,2021,Pakistan,Switzerland,296,95,0,391
26288,2021,Paraguay,Switzerland,5,0,0,5
26289,2021,Peru,Switzerland,5,5,0,10
26290,2021,Philippines,Switzerland,12,0,0,12
26291,2021,Portugal,Switzerland,5,0,0,5
26292,2021,Romania,Switzerland,14,0,0,14
26293,2021,South Africa,Switzerland,7,0,0,7
26294,2021,Russian Federation,Switzerland,738,77,0,815
26295,2021,Rwanda,Switzerland,103,11,0,114
26296,2021,El Salvador,Switzerland,8,5,0,13
26297,2021,Saudi Arabia,Switzerland,18,5,0,23
26298,2021,Serbia and Kosovo: S/RES/1244 (1999),Switzerland,2110,44,0,2154
26299,2021,Senegal,Switzerland,66,11,0,77
26300,2021,Sierra Leone,Switzerland,39,5,0,44
26301,2021,Somalia,Switzerland,4459,150,0,4609
26302,2021,Spain,Switzerland,5,0,0,5
26303,2021,Viet Nam,Switzerland,760,0,0,760
26304,2021,Sudan,Switzerland,525,13,0,538
26305,2021,South Sudan,Switzerland,53,0,0,53
26306,2021,Syrian Arab Rep.,Switzerland,20146,255,0,20401
26307,2021,United Rep. of Tanzania,Switzerland,14,0,0,14
26308,2021,Tajikistan,Switzerland,26,5,0,31
26309,2021,Turkmenistan,Switzerland,5,0,0,5
26310,2021,Togo,Switzerland,527,12,0,539
26311,2021,Tunisia,Switzerland,177,38,0,215
26312,2021,Türkiye,Switzerland,7234,1118,0,8352
26313,2021,Uganda,Switzerland,58,20,0,78
26314,2021,Ukraine,Switzerland,91,29,0,120
26315,2021,Uzbekistan,Switzerland,57,0,0,57
26316,2021,Venezuela (Bolivarian Republic of),Switzerland,53,45,0,98
26317,2021,Western Sahara,Switzerland,8,0,0,8
26318,2021,Yemen,Switzerland,345,13,0,358
26319,2021,Zimbabwe,Switzerland,9,6,0,15
26322,2021,Afghanistan,Syrian Arab Rep.,1119,30,0,1149
26323,2021,Algeria,Syrian Arab Rep.,5,0,0,5
26324,2021,Egypt,Syrian Arab Rep.,32,10,0,42
26325,2021,Bahrain,Syrian Arab Rep.,0,5,0,5
26326,2021,Burkina Faso,Syrian Arab Rep.,0,5,0,5
26327,2021,Chad,Syrian Arab Rep.,9,6,0,15
26328,2021,Eritrea,Syrian Arab Rep.,19,0,0,19
26329,2021,Ethiopia,Syrian Arab Rep.,12,0,0,12
26330,2021,Guinea,Syrian Arab Rep.,54,5,0,59
26331,2021,Iran (Islamic Rep. of),Syrian Arab Rep.,43,12,0,55
26332,2021,Iraq,Syrian Arab Rep.,11394,8406,0,19800
26333,2021,Jordan,Syrian Arab Rep.,19,0,0,19
26334,2021,Libya,Syrian Arab Rep.,9,10,0,19
26335,2021,Lebanon,Syrian Arab Rep.,24,10,0,34
26336,2021,Sri Lanka,Syrian Arab Rep.,0,5,0,5
26337,2021,Morocco,Syrian Arab Rep.,0,5,0,5
26338,2021,Pakistan,Syrian Arab Rep.,221,5,0,226
26339,2021,Saudi Arabia,Syrian Arab Rep.,6,0,0,6
26340,2021,Sierra Leone,Syrian Arab Rep.,20,0,0,20
26341,2021,Somalia,Syrian Arab Rep.,345,22,0,367
26342,2021,Sudan,Syrian Arab Rep.,726,82,0,808
26343,2021,South Sudan,Syrian Arab Rep.,74,0,0,74
26344,2021,Syrian Arab Rep.,Syrian Arab Rep.,0,0,6865308,0
26345,2021,United Rep. of Tanzania,Syrian Arab Rep.,0,7,0,7
26346,2021,Tunisia,Syrian Arab Rep.,5,5,0,10
26347,2021,Türkiye,Syrian Arab Rep.,6,8,0,14
26348,2021,Yemen,Syrian Arab Rep.,161,127,0,288
26351,2021,Burundi,United Rep. of Tanzania,155172,8893,0,164065
26352,2021,Dem. Rep. of the Congo,United Rep. of Tanzania,51647,18746,0,70393
26353,2021,Iran (Islamic Rep. of),United Rep. of Tanzania,5,5,0,10
26354,2021,Lebanon,United Rep. of Tanzania,5,0,0,5
26355,2021,Rwanda,United Rep. of Tanzania,69,30,0,99
26356,2021,Somalia,United Rep. of Tanzania,162,0,0,162
26357,2021,Sudan,United Rep. of Tanzania,0,6,0,6
26358,2021,South Sudan,United Rep. of Tanzania,6,0,0,6
26359,2021,Syrian Arab Rep.,United Rep. of Tanzania,5,19,0,24
26360,2021,United Rep. of Tanzania,United Rep. of Tanzania,6,0,0,6
26361,2021,Türkiye,United Rep. of Tanzania,0,10,0,10
26362,2021,Uganda,United Rep. of Tanzania,15,5,0,20
26363,2021,Yemen,United Rep. of Tanzania,9,55,0,64
26364,2021,Sri Lanka,Turks and Caicos Islands,7,0,0,7
26365,2021,Afghanistan,Thailand,168,5,0,173
26366,2021,Egypt,Thailand,17,0,0,17
26367,2021,Cambodia,Thailand,317,85,0,402
26368,2021,China,Thailand,181,13,0,194
26369,2021,Cameroon,Thailand,53,15,0,68
26370,2021,Dem. Rep. of the Congo,Thailand,20,0,0,20
26371,2021,Ethiopia,Thailand,12,5,0,17
26372,2021,Palestinian,Thailand,265,5,0,270
26373,2021,Guinea,Thailand,0,5,0,5
26374,2021,Cote d'Ivoire,Thailand,18,0,0,18
26375,2021,Iran (Islamic Rep. of),Thailand,87,14,0,101
26376,2021,Iraq,Thailand,157,0,0,157
26377,2021,Jordan,Thailand,5,0,0,5
26378,2021,Lao People's Dem. Rep.,Thailand,8,0,0,8
26379,2021,Sri Lanka,Thailand,106,19,0,125
26380,2021,Morocco,Thailand,0,5,0,5
26381,2021,Myanmar,Thailand,96086,0,0,96086
26382,2021,Nepal,Thailand,5,0,0,5
26383,2021,Nigeria,Thailand,5,11,0,16
26384,2021,Pakistan,Thailand,1578,84,0,1662
26385,2021,Somalia,Thailand,196,10,0,206
26386,2021,Viet Nam,Thailand,961,396,0,1357
26387,2021,Syrian Arab Rep.,Thailand,215,5,0,220
26388,2021,United Rep. of Tanzania,Thailand,5,0,0,5
26389,2021,Yemen,Thailand,36,0,0,36
26390,2021,Zimbabwe,Thailand,9,0,0,9
26392,2021,Afghanistan,Tajikistan,10719,3046,0,13765
26393,2021,Iran (Islamic Rep. of),Tajikistan,5,0,0,5
26395,2021,Afghanistan,Turkmenistan,10,0,0,10
26396,2021,Azerbaijan,Turkmenistan,6,0,0,6
26398,2021,Burundi,Togo,5,0,0,5
26399,2021,Benin,Togo,21,30,0,51
26400,2021,Central African Rep.,Togo,251,268,0,519
26401,2021,Chad,Togo,13,14,0,27
26402,2021,Cameroon,Togo,7,17,0,24
26403,2021,Congo,Togo,32,51,0,83
26404,2021,Dem. Rep. of the Congo,Togo,108,94,0,202
26405,2021,Gabon,Togo,0,6,0,6
26406,2021,Palestinian,Togo,0,5,0,5
26407,2021,Ghana,Togo,8513,0,0,8513
26408,2021,Cote d'Ivoire,Togo,1428,212,0,1640
26409,2021,Iraq,Togo,5,0,0,5
26410,2021,Liberia,Togo,0,6,0,6
26411,2021,Lebanon,Togo,11,16,0,27
26412,2021,Sri Lanka,Togo,0,5,0,5
26413,2021,Mali,Togo,76,42,0,118
26414,2021,Niger,Togo,10,0,0,10
26415,2021,Nigeria,Togo,9,14,0,23
26416,2021,Rwanda,Togo,113,12,0,125
26417,2021,Syrian Arab Rep.,Togo,18,8,0,26
26418,2021,Türkiye,Togo,63,10,0,73
26419,2021,Bangladesh,Trinidad and Tobago,8,91,0,99
26420,2021,China,Trinidad and Tobago,0,127,0,127
26421,2021,Cameroon,Trinidad and Tobago,0,9,0,9
26422,2021,Colombia,Trinidad and Tobago,11,64,0,75
26423,2021,Cuba,Trinidad and Tobago,174,2339,0,2513
26424,2021,Dominican Rep.,Trinidad and Tobago,0,139,0,139
26425,2021,Ghana,Trinidad and Tobago,0,46,0,46
26426,2021,Grenada,Trinidad and Tobago,0,5,0,5
26427,2021,Guyana,Trinidad and Tobago,21,64,0,85
26428,2021,Haiti,Trinidad and Tobago,0,15,0,15
26429,2021,India,Trinidad and Tobago,0,5,0,5
26430,2021,Jamaica,Trinidad and Tobago,42,160,0,202
26431,2021,Sri Lanka,Trinidad and Tobago,5,0,0,5
26432,2021,Mexico,Trinidad and Tobago,6,0,0,6
26433,2021,Nicaragua,Trinidad and Tobago,0,5,0,5
26434,2021,Nigeria,Trinidad and Tobago,5,154,0,159
26435,2021,Pakistan,Trinidad and Tobago,9,17,0,26
26436,2021,Peru,Trinidad and Tobago,0,5,0,5
26437,2021,Philippines,Trinidad and Tobago,0,5,0,5
26438,2021,Viet Nam,Trinidad and Tobago,0,7,0,7
26439,2021,Syrian Arab Rep.,Trinidad and Tobago,64,38,0,102
26440,2021,Tajikistan,Trinidad and Tobago,0,5,0,5
26441,2021,Trinidad and Tobago,Trinidad and Tobago,0,0,0,0
26442,2021,Saint Vincent and the Grenadines,Trinidad and Tobago,5,0,0,5
26443,2021,Venezuela (Bolivarian Republic of),Trinidad and Tobago,3221,18322,0,21543
26444,2021,Algeria,Tunisia,10,12,0,22
26445,2021,Egypt,Tunisia,0,15,0,15
26446,2021,Burundi,Tunisia,0,7,0,7
26447,2021,Benin,Tunisia,0,7,0,7
26448,2021,Bangladesh,Tunisia,0,6,0,6
26449,2021,Burkina Faso,Tunisia,11,63,0,74
26450,2021,Central African Rep.,Tunisia,16,27,0,43
26451,2021,Chad,Tunisia,5,27,0,32
26452,2021,Cameroon,Tunisia,42,434,0,476
26453,2021,Congo,Tunisia,0,8,0,8
26454,2021,Dem. Rep. of the Congo,Tunisia,0,106,0,106
26455,2021,Comoros,Tunisia,0,7,0,7
26456,2021,Eritrea,Tunisia,142,168,0,310
26457,2021,Ethiopia,Tunisia,5,46,0,51
26458,2021,Gambia,Tunisia,0,20,0,20
26459,2021,Palestinian,Tunisia,34,38,0,72
26460,2021,Ghana,Tunisia,0,6,0,6
26461,2021,Guinea,Tunisia,10,488,0,498
26462,2021,Cote d'Ivoire,Tunisia,60,3488,0,3548
26463,2021,Iran (Islamic Rep. of),Tunisia,8,0,0,8
26464,2021,Iraq,Tunisia,21,11,0,32
26465,2021,Liberia,Tunisia,5,72,0,77
26466,2021,Libya,Tunisia,46,139,0,185
26467,2021,Lebanon,Tunisia,6,23,0,29
26468,2021,Mali,Tunisia,14,106,0,120
26469,2021,Morocco,Tunisia,0,5,0,5
26470,2021,Niger,Tunisia,0,7,0,7
26471,2021,Nigeria,Tunisia,0,115,0,115
26472,2021,Rwanda,Tunisia,6,5,0,11
26473,2021,Senegal,Tunisia,0,37,0,37
26474,2021,Sierra Leone,Tunisia,5,133,0,138
26475,2021,Somalia,Tunisia,26,116,0,142
26476,2021,Sudan,Tunisia,172,344,0,516
26477,2021,South Sudan,Tunisia,5,21,0,26
26478,2021,Syrian Arab Rep.,Tunisia,2523,0,0,2523
26479,2021,Togo,Tunisia,0,13,0,13
26480,2021,Yemen,Tunisia,14,20,0,34
26481,2021,Afghanistan,Türkiye,7647,133062,0,140709
26482,2021,Iran (Islamic Rep. of),Türkiye,3942,18933,0,22875
26483,2021,Iraq,Türkiye,9258,144376,0,153634
26484,2021,Syrian Arab Rep.,Türkiye,3737369,0,0,3737369
26486,2021,Afghanistan,United Arab Emirates,5,30,0,35
26487,2021,Algeria,United Arab Emirates,0,0,0,0
26488,2021,Egypt,United Arab Emirates,5,8,0,13
26489,2021,Chad,United Arab Emirates,7,0,0,7
26490,2021,Eritrea,United Arab Emirates,0,7,0,7
26491,2021,Ethiopia,United Arab Emirates,8,5,0,13
26492,2021,Palestinian,United Arab Emirates,16,5,0,21
26493,2021,Iran (Islamic Rep. of),United Arab Emirates,5,7,0,12
26494,2021,Iraq,United Arab Emirates,800,544,0,1344
26495,2021,Jordan,United Arab Emirates,6,0,0,6
26496,2021,Kuwait,United Arab Emirates,5,0,0,5
26497,2021,Lebanon,United Arab Emirates,16,10,0,26
26498,2021,Morocco,United Arab Emirates,0,0,0,0
26499,2021,Pakistan,United Arab Emirates,5,0,0,5
26500,2021,Philippines,United Arab Emirates,0,0,0,0
26501,2021,Russian Federation,United Arab Emirates,0,5,0,5
26502,2021,Somalia,United Arab Emirates,19,0,0,19
26503,2021,Sudan,United Arab Emirates,13,6,0,19
26504,2021,Syrian Arab Rep.,United Arab Emirates,439,6526,0,6965
26505,2021,Yemen,United Arab Emirates,6,50,0,56
26506,2021,Egypt,Uganda,8,0,0,8
26507,2021,Burundi,Uganda,46109,1891,0,48000
26508,2021,Central African Rep.,Uganda,29,14,0,43
26509,2021,Chad,Uganda,7,5,0,12
26510,2021,Cameroon,Uganda,5,8,0,13
26511,2021,Congo,Uganda,31,0,0,31
26512,2021,Dem. Rep. of the Congo,Uganda,447540,8997,0,456537
26513,2021,Eritrea,Uganda,11201,10220,0,21421
26514,2021,Ethiopia,Uganda,2691,1504,0,4195
26515,2021,Palestinian,Uganda,5,0,0,5
26516,2021,Guinea,Uganda,5,0,0,5
26517,2021,Iran (Islamic Rep. of),Uganda,5,0,0,5
26518,2021,Kenya,Uganda,239,20,0,259
26519,2021,Mali,Uganda,0,5,0,5
26520,2021,Pakistan,Uganda,227,0,0,227
26521,2021,Rwanda,Uganda,17537,8235,0,25772
26522,2021,Senegal,Uganda,10,0,0,10
26523,2021,Somalia,Uganda,42202,11790,0,53992
26524,2021,Sudan,Uganda,3003,632,0,3635
26525,2021,South Sudan,Uganda,958927,41,0,958968
26526,2021,Syrian Arab Rep.,Uganda,18,8,0,26
26527,2021,United Rep. of Tanzania,Uganda,15,0,0,15
26528,2021,Türkiye,Uganda,63,13,0,76
26529,2021,Uganda,Uganda,0,0,0,0
26530,2021,Yemen,Uganda,26,5,0,31
26532,2021,Afghanistan,Ukraine,890,1068,0,1958
26533,2021,Algeria,Ukraine,0,12,0,12
26534,2021,Angola,Ukraine,24,5,0,29
26535,2021,Egypt,Ukraine,5,15,0,20
26536,2021,Armenia,Ukraine,52,0,0,52
26537,2021,Azerbaijan,Ukraine,70,29,0,99
26538,2021,Bangladesh,Ukraine,5,140,0,145
26539,2021,Belarus,Ukraine,43,55,0,98
26540,2021,China,Ukraine,0,5,0,5
26541,2021,Cameroon,Ukraine,5,32,0,37
26542,2021,Congo,Ukraine,26,12,0,38
26543,2021,Dem. Rep. of the Congo,Ukraine,26,36,0,62
26544,2021,Eritrea,Ukraine,11,27,0,38
26545,2021,Ethiopia,Ukraine,26,10,0,36
26546,2021,Palestinian,Ukraine,10,41,0,51
26547,2021,Georgia,Ukraine,25,0,0,25
26548,2021,Ghana,Ukraine,0,11,0,11
26549,2021,Guinea,Ukraine,5,20,0,25
26550,2021,Haiti,Ukraine,0,5,0,5
26551,2021,Cote d'Ivoire,Ukraine,0,16,0,16
26552,2021,India,Ukraine,7,26,0,33
26553,2021,Iran (Islamic Rep. of),Ukraine,74,53,0,127
26554,2021,Iraq,Ukraine,74,68,0,142
26555,2021,Jordan,Ukraine,5,5,0,10
26556,2021,Kazakhstan,Ukraine,9,9,0,18
26557,2021,Kyrgyzstan,Ukraine,11,28,0,39
26558,2021,Libya,Ukraine,5,14,0,19
26559,2021,Lebanon,Ukraine,9,13,0,22
26560,2021,Sri Lanka,Ukraine,8,30,0,38
26561,2021,Rep. of Moldova,Ukraine,0,5,0,5
26562,2021,Morocco,Ukraine,0,10,0,10
26563,2021,Myanmar,Ukraine,0,6,0,6
26564,2021,Nigeria,Ukraine,7,33,0,40
26565,2021,Pakistan,Ukraine,10,65,0,75
26566,2021,Russian Federation,Ukraine,175,167,0,342
26567,2021,Rwanda,Ukraine,5,0,0,5
26568,2021,Serbia and Kosovo: S/RES/1244 (1999),Ukraine,5,0,0,5
26569,2021,Senegal,Ukraine,0,5,0,5
26570,2021,Sierra Leone,Ukraine,5,0,0,5
26571,2021,Somalia,Ukraine,83,102,0,185
26572,2021,Viet Nam,Ukraine,0,13,0,13
26573,2021,Sudan,Ukraine,27,25,0,52
26574,2021,Syrian Arab Rep.,Ukraine,512,147,0,659
26575,2021,Tajikistan,Ukraine,23,187,0,210
26576,2021,Turkmenistan,Ukraine,7,0,0,7
26577,2021,Tunisia,Ukraine,0,5,0,5
26578,2021,Türkiye,Ukraine,6,14,0,20
26579,2021,Ukraine,Ukraine,0,0,854000,0
26580,2021,Uzbekistan,Ukraine,40,93,0,133
26581,2021,Yemen,Ukraine,5,47,0,52
26583,2021,Afghanistan,Uruguay,5,6,0,11
26584,2021,Angola,Uruguay,14,0,0,14
26585,2021,Egypt,Uruguay,0,5,0,5
26586,2021,Argentina,Uruguay,0,11,0,11
26587,2021,Bangladesh,Uruguay,0,149,0,149
26588,2021,Bolivia (Plurinational State of),Uruguay,5,6,0,11
26589,2021,Brazil,Uruguay,0,23,0,23
26590,2021,Chile,Uruguay,0,5,0,5
26591,2021,Cameroon,Uruguay,12,5,0,17
26592,2021,Congo,Uruguay,5,0,0,5
26593,2021,Colombia,Uruguay,162,85,0,247
26594,2021,Cuba,Uruguay,28,10313,0,10341
26595,2021,Dominican Rep.,Uruguay,0,317,0,317
26596,2021,Ecuador,Uruguay,8,24,0,32
26597,2021,Palestinian,Uruguay,0,5,0,5
26598,2021,Ghana,Uruguay,0,26,0,26
26599,2021,Guinea-Bissau,Uruguay,0,5,0,5
26600,2021,Guatemala,Uruguay,5,0,0,5
26601,2021,Guinea,Uruguay,0,11,0,11
26602,2021,Haiti,Uruguay,5,23,0,28
26603,2021,India,Uruguay,0,8,0,8
26604,2021,Libya,Uruguay,5,0,0,5
26605,2021,Latvia,Uruguay,5,0,0,5
26606,2021,Mexico,Uruguay,5,0,0,5
26607,2021,Morocco,Uruguay,0,17,0,17
26608,2021,Nicaragua,Uruguay,9,0,0,9
26609,2021,Nigeria,Uruguay,22,36,0,58
26610,2021,Pakistan,Uruguay,0,40,0,40
26611,2021,Paraguay,Uruguay,5,5,0,10
26612,2021,Peru,Uruguay,7,41,0,48
26613,2021,Russian Federation,Uruguay,13,5,0,18
26614,2021,El Salvador,Uruguay,48,7,0,55
26615,2021,Senegal,Uruguay,0,261,0,261
26616,2021,Somalia,Uruguay,5,0,0,5
26617,2021,Syrian Arab Rep.,Uruguay,66,5,0,71
26618,2021,Türkiye,Uruguay,13,5,0,18
26619,2021,Ukraine,Uruguay,11,6,0,17
26620,2021,Venezuela (Bolivarian Republic of),Uruguay,414,2064,0,2478
26623,2021,Afghanistan,United States of America,1649,1212,0,2861
26624,2021,Albania,United States of America,1272,2821,0,4093
26625,2021,Algeria,United States of America,147,541,0,688
26626,2021,Angola,United States of America,299,3361,0,3660
26627,2021,Antigua and Barbuda,United States of America,6,10,0,16
26628,2021,Egypt,United States of America,14248,9451,0,23699
26629,2021,Argentina,United States of America,23,499,0,522
26630,2021,Armenia,United States of America,1286,5344,0,6630
26631,2021,Australia,United States of America,0,14,0,14
26632,2021,Austria,United States of America,13,5,0,18
26633,2021,Azerbaijan,United States of America,521,1672,0,2193
26634,2021,Bahrain,United States of America,35,64,0,99
26635,2021,Burundi,United States of America,839,767,0,1606
26636,2021,Belgium,United States of America,13,54,0,67
26637,2021,Benin,United States of America,76,280,0,356
26638,2021,Bangladesh,United States of America,2344,10262,0,12606
26639,2021,Bahamas,United States of America,181,240,0,421
26640,2021,Bhutan,United States of America,27,435,0,462
26641,2021,Burkina Faso,United States of America,1373,3628,0,5001
26642,2021,Belarus,United States of America,1488,3591,0,5079
26643,2021,Bolivia (Plurinational State of),United States of America,81,845,0,926
26644,2021,Botswana,United States of America,0,10,0,10
26645,2021,Brazil,United States of America,1032,19429,0,20461
26646,2021,Bosnia and Herzegovina,United States of America,85,218,0,303
26647,2021,Bulgaria,United States of America,169,307,0,476
26648,2021,Belize,United States of America,38,296,0,334
26649,2021,Cambodia,United States of America,120,69,0,189
26650,2021,Canada,United States of America,15,82,0,97
26651,2021,Central African Rep.,United States of America,175,143,0,318
26652,2021,Cayman Islands,United States of America,5,0,0,5
26653,2021,Chad,United States of America,220,273,0,493
26654,2021,China,United States of America,68937,88722,0,157659
26655,2021,Chile,United States of America,23,874,0,897
26656,2021,Cameroon,United States of America,5081,5485,0,10566
26657,2021,Congo,United States of America,1038,2582,0,3620
26658,2021,Dem. Rep. of the Congo,United States of America,1460,2543,0,4003
26659,2021,Comoros,United States of America,5,5,0,10
26660,2021,Colombia,United States of America,2557,38168,0,40725
26661,2021,Costa Rica,United States of America,174,718,0,892
26662,2021,Cuba,United States of America,2689,18040,0,20729
26663,2021,Cabo Verde,United States of America,0,42,0,42
26664,2021,Czechia,United States of America,8,74,0,82
26665,2021,Denmark,United States of America,0,5,0,5
26666,2021,Djibouti,United States of America,359,649,0,1008
26667,2021,Dominica,United States of America,14,61,0,75
26668,2021,Dominican Rep.,United States of America,247,1359,0,1606
26669,2021,Ecuador,United States of America,1525,25743,0,27268
26670,2021,Equatorial Guinea,United States of America,17,97,0,114
26671,2021,Eritrea,United States of America,5271,1073,0,6344
26672,2021,Estonia,United States of America,250,37,0,287
26673,2021,Ethiopia,United States of America,7659,8671,0,16330
26674,2021,Fiji,United States of America,114,425,0,539
26675,2021,France,United States of America,17,132,0,149
26676,2021,Gabon,United States of America,48,344,0,392
26677,2021,Gambia,United States of America,1357,805,0,2162
26678,2021,Palestinian,United States of America,20,136,0,156
26679,2021,United Kingdom of Great Britain and Northern Ireland,United States of America,27,144,0,171
26680,2021,Georgia,United States of America,465,2573,0,3038
26681,2021,Germany,United States of America,29,176,0,205
26682,2021,Ghana,United States of America,499,1049,0,1548
26683,2021,Guinea-Bissau,United States of America,18,48,0,66
26684,2021,Greece,United States of America,14,88,0,102
26685,2021,Grenada,United States of America,18,40,0,58
26686,2021,Guatemala,United States of America,23180,152784,0,175964
26687,2021,Guinea,United States of America,1584,1218,0,2802
26688,2021,Guyana,United States of America,110,526,0,636
26689,2021,Haiti,United States of America,14695,38333,0,53028
26690,2021,"China, Hong Kong SAR",United States of America,11,182,0,193
26691,2021,Honduras,United States of America,17149,113713,0,130862
26692,2021,Croatia,United States of America,20,27,0,47
26693,2021,Hungary,United States of America,9,410,0,419
26694,2021,Cote d'Ivoire,United States of America,907,1449,0,2356
26695,2021,India,United States of America,9315,46602,0,55917
26696,2021,Indonesia,United States of America,930,3219,0,4149
26697,2021,Ireland,United States of America,0,33,0,33
26698,2021,Iran (Islamic Rep. of),United States of America,5331,3685,0,9016
26699,2021,Iraq,United States of America,5339,4510,0,9849
26700,2021,Israel,United States of America,97,637,0,734
26701,2021,Italy,United States of America,9,462,0,471
26702,2021,Jamaica,United States of America,892,1419,0,2311
26703,2021,Jordan,United States of America,670,3848,0,4518
26704,2021,Japan,United States of America,7,90,0,97
26705,2021,Kazakhstan,United States of America,1099,4551,0,5650
26706,2021,Kenya,United States of America,1617,6810,0,8427
26707,2021,Kyrgyzstan,United States of America,1590,2210,0,3800
26708,2021,Rep. of Korea,United States of America,21,290,0,311
26709,2021,Dem. People's Rep. of Korea,United States of America,6,36,0,42
26710,2021,Kuwait,United States of America,136,304,0,440
26711,2021,Lao People's Dem. Rep.,United States of America,61,186,0,247
26712,2021,Liberia,United States of America,1208,1207,0,2415
26713,2021,Libya,United States of America,385,1892,0,2277
26714,2021,Saint Lucia,United States of America,5,24,0,29
26715,2021,Lebanon,United States of America,381,1918,0,2299
26716,2021,Lesotho,United States of America,6,0,0,6
26717,2021,Sri Lanka,United States of America,1007,2252,0,3259
26718,2021,Lithuania,United States of America,15,87,0,102
26719,2021,Latvia,United States of America,16,110,0,126
26721,2021,Madagascar,United States of America,7,24,0,31
26722,2021,Mauritania,United States of America,916,1115,0,2031
26723,2021,North Macedonia,United States of America,102,245,0,347
26724,2021,Rep. of Moldova,United States of America,1344,3079,0,4423
26725,2021,Maldives,United States of America,5,5,0,10
26726,2021,Mexico,United States of America,12606,111313,0,123919
26727,2021,Marshall Islands,United States of America,7,0,0,7
26728,2021,Mali,United States of America,896,645,0,1541
26729,2021,Malaysia,United States of America,88,409,0,497
26730,2021,Malawi,United States of America,34,178,0,212
26731,2021,Mongolia,United States of America,635,3501,0,4136
26732,2021,Morocco,United States of America,132,312,0,444
26733,2021,Mozambique,United States of America,28,53,0,81
26734,2021,Montenegro,United States of America,100,537,0,637
26735,2021,Mauritius,United States of America,31,46,0,77
26736,2021,Myanmar,United States of America,1223,3096,0,4319
26737,2021,Namibia,United States of America,17,29,0,46
26738,2021,Nepal,United States of America,6271,7702,0,13973
26739,2021,Netherlands,United States of America,7,69,0,76
26740,2021,Niger,United States of America,144,414,0,558
26741,2021,Nicaragua,United States of America,2083,11762,0,13845
26742,2021,Nigeria,United States of America,2948,25904,0,28852
26743,2021,Niue,United States of America,11,0,0,11
26744,2021,Oman,United States of America,18,32,0,50
26745,2021,Pakistan,United States of America,3818,9467,0,13285
26746,2021,Panama,United States of America,11,186,0,197
26747,2021,Paraguay,United States of America,11,110,0,121
26748,2021,Peru,United States of America,480,3983,0,4463
26749,2021,Philippines,United States of America,168,1728,0,1896
26750,2021,Poland,United States of America,9,921,0,930
26751,2021,Portugal,United States of America,5,270,0,275
26752,2021,Qatar,United States of America,20,24,0,44
26753,2021,Romania,United States of America,447,4030,0,4477
26754,2021,South Africa,United States of America,59,1311,0,1370
26755,2021,Russian Federation,United States of America,6718,21873,0,28591
26756,2021,Rwanda,United States of America,1223,1456,0,2679
26757,2021,El Salvador,United States of America,28996,131244,0,160240
26758,2021,Saudi Arabia,United States of America,628,1064,0,1692
26759,2021,Serbia and Kosovo: S/RES/1244 (1999),United States of America,717,2008,0,2725
26760,2021,Senegal,United States of America,385,719,0,1104
26761,2021,Singapore,United States of America,6,48,0,54
26762,2021,Sierra Leone,United States of America,399,511,0,910
26763,2021,Somalia,United States of America,1515,331,0,1846
26764,2021,Spain,United States of America,8,262,0,270
26765,2021,Viet Nam,United States of America,406,1580,0,1986
26766,2021,Saint Kitts and Nevis,United States of America,5,5,0,10
26767,2021,Sudan,United States of America,1375,1254,0,2629
26768,2021,Suriname,United States of America,11,58,0,69
26769,2021,South Sudan,United States of America,54,71,0,125
26770,2021,Slovakia,United States of America,5,47,0,52
26771,2021,Slovenia,United States of America,5,5,0,10
26772,2021,Eswatini,United States of America,5,10,0,15
26773,2021,Sweden,United States of America,0,33,0,33
26774,2021,Switzerland,United States of America,0,16,0,16
26775,2021,Syrian Arab Rep.,United States of America,8799,3500,0,12299
26776,2021,United Rep. of Tanzania,United States of America,109,281,0,390
26777,2021,Turks and Caicos Islands,United States of America,14,0,0,14
26778,2021,Thailand,United States of America,35,512,0,547
26779,2021,Tajikistan,United States of America,298,710,0,1008
26780,2021,Turkmenistan,United States of America,204,474,0,678
26781,2021,Timor-Leste,United States of America,0,14,0,14
26782,2021,Togo,United States of America,524,708,0,1232
26783,2021,Trinidad and Tobago,United States of America,40,288,0,328
26784,2021,Tunisia,United States of America,97,377,0,474
26785,2021,Türkiye,United States of America,4181,6780,0,10961
26786,2021,United Arab Emirates,United States of America,70,163,0,233
26787,2021,Uganda,United States of America,1773,3646,0,5419
26788,2021,Ukraine,United States of America,2608,11404,0,14012
26789,2021,Uruguay,United States of America,5,189,0,194
26790,2021,Uzbekistan,United States of America,1219,3447,0,4666
26791,2021,Vanuatu,United States of America,0,23,0,23
26792,2021,Saint Vincent and the Grenadines,United States of America,30,19,0,49
26793,2021,Venezuela (Bolivarian Republic of),United States of America,18735,246745,0,265480
26794,2021,Samoa,United States of America,0,5,0,5
26795,2021,Yemen,United States of America,679,1121,0,1800
26796,2021,Zambia,United States of America,40,178,0,218
26797,2021,Zimbabwe,United States of America,691,1261,0,1952
26799,2021,Guadeloupe,United States of America,0,88,0,88
26800,2021,Curacao ,United States of America,35,0,0,35
26802,2021,Afghanistan,Uzbekistan,13032,0,0,13032
26804,2021,Bangladesh,Vanuatu,0,5,0,5
26805,2021,Venezuela (Bolivarian Republic of),Saint Vincent and the Grenadines,0,0,0,0
26806,2021,Afghanistan,Venezuela (Bolivarian Republic of),10,0,0,10
26807,2021,Chile,Venezuela (Bolivarian Republic of),10,0,0,10
26808,2021,Congo,Venezuela (Bolivarian Republic of),5,0,0,5
26809,2021,Colombia,Venezuela (Bolivarian Republic of),39168,516,0,39684
26810,2021,Palestinian,Venezuela (Bolivarian Republic of),7,0,0,7
26811,2021,Haiti,Venezuela (Bolivarian Republic of),12,0,0,12
26812,2021,Iraq,Venezuela (Bolivarian Republic of),18,0,0,18
26813,2021,Liberia,Venezuela (Bolivarian Republic of),9,0,0,9
26814,2021,Libya,Venezuela (Bolivarian Republic of),5,0,0,5
26815,2021,Lebanon,Venezuela (Bolivarian Republic of),12,0,0,12
26816,2021,Nigeria,Venezuela (Bolivarian Republic of),7,0,0,7
26817,2021,Peru,Venezuela (Bolivarian Republic of),5,0,0,5
26818,2021,Rwanda,Venezuela (Bolivarian Republic of),5,0,0,5
26819,2021,Sierra Leone,Venezuela (Bolivarian Republic of),5,0,0,5
26820,2021,Syrian Arab Rep.,Venezuela (Bolivarian Republic of),33,0,0,33
26821,2021,Türkiye,Venezuela (Bolivarian Republic of),6,0,0,6
26822,2021,Venezuela (Bolivarian Republic of),Venezuela (Bolivarian Republic of),0,0,0,0
26823,2021,Western Sahara,Venezuela (Bolivarian Republic of),11,0,0,11
26824,2021,Egypt,Yemen,16,10,0,26
26825,2021,Cameroon,Yemen,0,5,0,5
26826,2021,Congo,Yemen,5,5,0,10
26827,2021,Djibouti,Yemen,5,6,0,11
26828,2021,Eritrea,Yemen,1330,479,0,1809
26829,2021,Ethiopia,Yemen,6466,10593,0,17059
26830,2021,Palestinian,Yemen,576,311,0,887
26831,2021,Iran (Islamic Rep. of),Yemen,5,0,0,5
26832,2021,Iraq,Yemen,3163,71,0,3234
26833,2021,Jordan,Yemen,14,11,0,25
26834,2021,Mali,Yemen,0,5,0,5
26835,2021,Pakistan,Yemen,0,9,0,9
26836,2021,Somalia,Yemen,75250,155,0,75405
26837,2021,Viet Nam,Yemen,15,0,0,15
26838,2021,Sudan,Yemen,109,513,0,622
26839,2021,Syrian Arab Rep.,Yemen,2513,420,0,2933
26840,2021,United Rep. of Tanzania,Yemen,0,0,0,0
26841,2021,Yemen,Yemen,0,0,4288739,0
26842,2021,Angola,Zambia,0,0,0,0
26843,2021,Burundi,Zambia,8127,960,0,9087
26844,2021,Central African Rep.,Zambia,0,5,0,5
26845,2021,Cameroon,Zambia,17,28,0,45
26846,2021,Congo,Zambia,24,16,0,40
26847,2021,Dem. Rep. of the Congo,Zambia,62039,2736,0,64775
26848,2021,Eritrea,Zambia,86,6,0,92
26849,2021,Ethiopia,Zambia,44,6,0,50
26850,2021,Palestinian,Zambia,15,0,0,15
26851,2021,Ghana,Zambia,0,10,0,10
26852,2021,India,Zambia,0,5,0,5
26853,2021,Liberia,Zambia,8,0,0,8
26854,2021,Nigeria,Zambia,0,5,0,5
26855,2021,South Africa,Zambia,6,0,0,6
26856,2021,Rwanda,Zambia,812,18,0,830
26857,2021,Sierra Leone,Zambia,5,0,0,5
26858,2021,Somalia,Zambia,3540,567,0,4107
26859,2021,Sudan,Zambia,29,0,0,29
26860,2021,South Sudan,Zambia,5,0,0,5
26861,2021,Syrian Arab Rep.,Zambia,36,5,0,41
26862,2021,Türkiye,Zambia,82,0,0,82
26863,2021,Uganda,Zambia,208,27,0,235
26865,2021,Angola,Zimbabwe,0,6,0,6
26866,2021,Burundi,Zimbabwe,665,220,0,885
26867,2021,Central African Rep.,Zimbabwe,0,5,0,5
26868,2021,Cameroon,Zimbabwe,0,8,0,8
26869,2021,Congo,Zimbabwe,20,0,0,20
26870,2021,Dem. Rep. of the Congo,Zimbabwe,7994,3187,0,11181
26871,2021,Eritrea,Zimbabwe,20,5,0,25
26872,2021,Ethiopia,Zimbabwe,67,14,0,81
26873,2021,Cote d'Ivoire,Zimbabwe,12,25,0,37
26874,2021,Kenya,Zimbabwe,0,8,0,8
26875,2021,Mali,Zimbabwe,6,114,0,120
26876,2021,Mozambique,Zimbabwe,0,8240,0,8240
26877,2021,South Africa,Zimbabwe,0,0,0,0
26878,2021,Rwanda,Zimbabwe,660,66,0,726
26879,2021,Sierra Leone,Zimbabwe,0,6,0,6
26880,2021,Somalia,Zimbabwe,13,22,0,35
26881,2021,Sudan,Zimbabwe,8,0,0,8
26882,2021,South Sudan,Zimbabwe,8,25,0,33
26883,2021,Uganda,Zimbabwe,10,0,0,10
26884,2021,Zambia,Zimbabwe,0,0,0,0
26885,2021,Zimbabwe,Zimbabwe,0,0,0,0
26886,2021,Venezuela (Bolivarian Republic of),Anguilla,0,0,0,0
26887,2021,Venezuela (Bolivarian Republic of),Aruba,0,0,0,0
26888,2021,Aruba,Aruba,0,0,0,0
26889,2021,Venezuela (Bolivarian Republic of),Curacao ,0,0,0,0
26890,2021,Curacao ,Curacao ,0,0,0,0
26891,2021,Venezuela (Bolivarian Republic of),Sint Maarten (Dutch part),0,41,0,41
26892,2022,Afghanistan,Afghanistan,0,0,3393176,0
26893,2022,Bangladesh,Afghanistan,0,5,0,5
26894,2022,Iran (Islamic Rep. of),Afghanistan,38,26,0,64
26895,2022,Pakistan,Afghanistan,59486,220,0,59706
26896,2022,Tajikistan,Afghanistan,0,6,0,6
26897,2022,Afghanistan,Albania,5,0,0,5
26898,2022,Bangladesh,Albania,0,0,0,0
26899,2022,China,Albania,14,0,0,14
26900,2022,Palestinian,Albania,8,0,0,8
26901,2022,Iraq,Albania,0,0,0,0
26902,2022,Serbia and Kosovo: S/RES/1244 (1999),Albania,57,0,0,57
26903,2022,Syrian Arab Rep.,Albania,20,6,0,26
26904,2022,Ukraine,Albania,2192,0,0,2192
26905,2022,Uzbekistan,Albania,5,0,0,5
26906,2022,Venezuela (Bolivarian Republic of),Albania,5,0,0,5
26907,2022,Yemen,Albania,0,0,0,0
26909,2022,Benin,Algeria,0,151,0,151
26910,2022,Burkina Faso,Algeria,6,50,0,56
26911,2022,Central African Rep.,Algeria,105,65,0,170
26912,2022,Chad,Algeria,5,31,0,36
26913,2022,Cameroon,Algeria,152,527,0,679
26914,2022,Congo,Algeria,0,11,0,11
26915,2022,Dem. Rep. of the Congo,Algeria,80,116,0,196
26916,2022,Eritrea,Algeria,5,0,0,5
26917,2022,Gambia,Algeria,0,5,0,5
26918,2022,Palestinian,Algeria,225,0,0,225
26919,2022,Ghana,Algeria,0,10,0,10
26920,2022,Guinea-Bissau,Algeria,0,5,0,5
26921,2022,Guinea,Algeria,50,561,0,611
26922,2022,Cote d'Ivoire,Algeria,84,237,0,321
26923,2022,India,Algeria,0,5,0,5
26924,2022,Iraq,Algeria,16,0,0,16
26925,2022,Liberia,Algeria,0,84,0,84
26926,2022,Libya,Algeria,21,13,0,34
26927,2022,Lebanon,Algeria,0,9,0,9
26928,2022,Mali,Algeria,231,603,0,834
26929,2022,Niger,Algeria,9,169,0,178
26930,2022,Nigeria,Algeria,5,342,0,347
26931,2022,Senegal,Algeria,0,6,0,6
26932,2022,Sierra Leone,Algeria,0,41,0,41
26933,2022,Sudan,Algeria,31,69,0,100
26934,2022,Syrian Arab Rep.,Algeria,7345,0,0,7345
26935,2022,Togo,Algeria,0,20,0,20
26936,2022,Türkiye,Algeria,0,11,0,11
26937,2022,Western Sahara,Algeria,90000,0,0,90000
26938,2022,Yemen,Algeria,309,0,0,309
26939,2022,Angola,Angola,0,0,0,0
26940,2022,Burundi,Angola,17,99,0,116
26941,2022,Central African Rep.,Angola,7,77,0,84
26942,2022,Chad,Angola,189,779,0,968
26943,2022,Congo,Angola,65,58,0,123
26944,2022,Dem. Rep. of the Congo,Angola,23274,500,0,23774
26945,2022,Eritrea,Angola,83,1791,0,1874
26946,2022,Ethiopia,Angola,0,57,0,57
26947,2022,Guinea-Bissau,Angola,7,268,0,275
26948,2022,Guinea,Angola,126,9146,0,9272
26949,2022,Cote d'Ivoire,Angola,417,5940,0,6357
26950,2022,Liberia,Angola,164,478,0,642
26951,2022,Mauritania,Angola,323,5402,0,5725
26952,2022,Rwanda,Angola,495,141,0,636
26953,2022,Sierra Leone,Angola,413,1497,0,1910
26954,2022,Somalia,Angola,271,1731,0,2002
26955,2022,Sudan,Angola,279,1670,0,1949
26956,2022,Syrian Arab Rep.,Angola,0,5,0,5
26957,2022,United Rep. of Tanzania,Angola,5,0,0,5
26958,2022,Türkiye,Angola,0,34,0,34
26959,2022,Uganda,Angola,0,6,0,6
26960,2022,Western Sahara,Angola,16,596,0,612
26961,2022,Haiti,Antigua and Barbuda,0,0,0,0
26962,2022,Venezuela (Bolivarian Republic of),Antigua and Barbuda,0,0,0,0
26963,2022,Afghanistan,Egypt,43,161,0,204
26964,2022,Burundi,Egypt,56,62,0,118
26965,2022,Bangladesh,Egypt,0,10,0,10
26966,2022,Central African Rep.,Egypt,45,31,0,76
26967,2022,Chad,Egypt,63,59,0,122
26968,2022,China,Egypt,0,76,0,76
26969,2022,Cameroon,Egypt,18,46,0,64
26970,2022,Congo,Egypt,14,24,0,38
26971,2022,Dem. Rep. of the Congo,Egypt,49,23,0,72
26972,2022,Djibouti,Egypt,22,21,0,43
26973,2022,Eritrea,Egypt,15436,7158,0,22594
26974,2022,Ethiopia,Egypt,5674,10550,0,16224
26975,2022,Palestinian,Egypt,70021,0,0,70021
26976,2022,Ghana,Egypt,0,10,0,10
26977,2022,Guinea,Egypt,11,70,0,81
26978,2022,Cote d'Ivoire,Egypt,36,5,0,41
26979,2022,Iraq,Egypt,4545,2252,0,6797
26980,2022,Jordan,Egypt,9,8,0,17
26981,2022,Kenya,Egypt,9,9,0,18
26982,2022,Liberia,Egypt,0,5,0,5
26983,2022,Libya,Egypt,6,0,0,6
26984,2022,Lebanon,Egypt,0,6,0,6
26985,2022,Sri Lanka,Egypt,0,5,0,5
26986,2022,Mali,Egypt,0,9,0,9
26987,2022,Nigeria,Egypt,27,156,0,183
26988,2022,Russian Federation,Egypt,9,10,0,19
26989,2022,Rwanda,Egypt,5,0,0,5
26990,2022,Saudi Arabia,Egypt,16,5,0,21
26991,2022,Sierra Leone,Egypt,5,7,0,12
26992,2022,Somalia,Egypt,4713,2171,0,6884
26993,2022,Sudan,Egypt,25706,32742,0,58448
26994,2022,South Sudan,Egypt,19649,2642,0,22291
26995,2022,Syrian Arab Rep.,Egypt,143803,0,0,143803
26996,2022,United Rep. of Tanzania,Egypt,5,0,0,5
26997,2022,Tajikistan,Egypt,12,11,0,23
26998,2022,Turkmenistan,Egypt,5,0,0,5
26999,2022,Togo,Egypt,0,10,0,10
27000,2022,Tunisia,Egypt,5,0,0,5
27001,2022,Türkiye,Egypt,0,356,0,356
27002,2022,Uganda,Egypt,14,15,0,29
27003,2022,Uzbekistan,Egypt,0,12,0,12
27004,2022,Yemen,Egypt,163,10482,0,10645
27005,2022,Zimbabwe,Egypt,42,14,0,56
27008,2022,Afghanistan,Argentina,12,0,0,12
27009,2022,Albania,Argentina,18,0,0,18
27010,2022,Algeria,Argentina,30,23,0,53
27011,2022,Angola,Argentina,14,15,0,29
27012,2022,Egypt,Argentina,5,22,0,27
27013,2022,Armenia,Argentina,77,187,0,264
27014,2022,Burundi,Argentina,5,0,0,5
27015,2022,Bangladesh,Argentina,5,92,0,97
27016,2022,Belarus,Argentina,0,6,0,6
27017,2022,Bolivia (Plurinational State of),Argentina,60,65,0,125
27018,2022,Brazil,Argentina,0,23,0,23
27019,2022,Bosnia and Herzegovina,Argentina,6,0,0,6
27020,2022,China,Argentina,0,121,0,121
27021,2022,Chile,Argentina,34,8,0,42
27022,2022,Cameroon,Argentina,11,39,0,50
27023,2022,Dem. Rep. of the Congo,Argentina,26,28,0,54
27024,2022,Colombia,Argentina,562,294,0,856
27025,2022,Costa Rica,Argentina,5,0,0,5
27026,2022,Cuba,Argentina,262,847,0,1109
27027,2022,Cabo Verde,Argentina,0,5,0,5
27028,2022,Czechia,Argentina,0,5,0,5
27029,2022,Dominican Rep.,Argentina,10,578,0,588
27030,2022,Ecuador,Argentina,16,31,0,47
27031,2022,Eritrea,Argentina,6,5,0,11
27032,2022,Ethiopia,Argentina,5,0,0,5
27033,2022,Gambia,Argentina,0,10,0,10
27034,2022,Palestinian,Argentina,25,9,0,34
27035,2022,Georgia,Argentina,5,0,0,5
27036,2022,Ghana,Argentina,37,152,0,189
27037,2022,Guinea-Bissau,Argentina,8,5,0,13
27038,2022,Guatemala,Argentina,8,0,0,8
27039,2022,Guinea,Argentina,10,9,0,19
27040,2022,Haiti,Argentina,79,766,0,845
27041,2022,Honduras,Argentina,6,10,0,16
27042,2022,Hungary,Argentina,0,5,0,5
27043,2022,Cote d'Ivoire,Argentina,20,5,0,25
27044,2022,India,Argentina,23,130,0,153
27045,2022,Iran (Islamic Rep. of),Argentina,30,6,0,36
27046,2022,Iraq,Argentina,22,0,0,22
27047,2022,Jamaica,Argentina,13,0,0,13
27048,2022,Jordan,Argentina,5,5,0,10
27049,2022,Kazakhstan,Argentina,18,16,0,34
27050,2022,Kyrgyzstan,Argentina,5,0,0,5
27051,2022,Liberia,Argentina,42,0,0,42
27052,2022,Libya,Argentina,5,5,0,10
27053,2022,Sri Lanka,Argentina,36,0,0,36
27054,2022,North Macedonia,Argentina,9,0,0,9
27055,2022,Mexico,Argentina,0,6,0,6
27056,2022,Mali,Argentina,9,0,0,9
27057,2022,Morocco,Argentina,0,14,0,14
27058,2022,Nepal,Argentina,0,5,0,5
27059,2022,Nicaragua,Argentina,16,15,0,31
27060,2022,Nigeria,Argentina,42,75,0,117
27061,2022,Pakistan,Argentina,39,22,0,61
27062,2022,Paraguay,Argentina,20,17,0,37
27063,2022,Peru,Argentina,548,92,0,640
27064,2022,Philippines,Argentina,0,5,0,5
27065,2022,Romania,Argentina,51,0,0,51
27066,2022,South Africa,Argentina,0,17,0,17
27067,2022,Russian Federation,Argentina,81,98,0,179
27068,2022,El Salvador,Argentina,47,40,0,87
27069,2022,Senegal,Argentina,43,1386,0,1429
27070,2022,Sierra Leone,Argentina,37,10,0,47
27071,2022,Somalia,Argentina,5,0,0,5
27072,2022,Spain,Argentina,0,5,0,5
27073,2022,Sudan,Argentina,5,0,0,5
27074,2022,Syrian Arab Rep.,Argentina,440,100,0,540
27075,2022,Tunisia,Argentina,0,5,0,5
27076,2022,Türkiye,Argentina,7,0,0,7
27077,2022,Ukraine,Argentina,121,84,0,205
27078,2022,United States of America,Argentina,5,12,0,17
27079,2022,Venezuela (Bolivarian Republic of),Argentina,316,5632,0,5948
27080,2022,Yemen,Argentina,21,7,0,28
27082,2022,Afghanistan,Armenia,6,0,0,6
27083,2022,Egypt,Armenia,5,0,0,5
27084,2022,Azerbaijan,Armenia,27929,0,0,27929
27085,2022,Congo,Armenia,5,0,0,5
27086,2022,Cuba,Armenia,5,45,0,50
27087,2022,Palestinian,Armenia,7,0,0,7
27088,2022,Georgia,Armenia,8,5,0,13
27089,2022,Cote d'Ivoire,Armenia,6,0,0,6
27090,2022,Iran (Islamic Rep. of),Armenia,144,72,0,216
27091,2022,Iraq,Armenia,1103,26,0,1129
27092,2022,Lebanon,Armenia,26,5,0,31
27093,2022,Nigeria,Armenia,6,0,0,6
27094,2022,Russian Federation,Armenia,0,6,0,6
27095,2022,Syrian Arab Rep.,Armenia,4855,9,0,4864
27096,2022,Türkiye,Armenia,17,10,0,27
27097,2022,Ukraine,Armenia,131,217,0,348
27098,2022,Yemen,Armenia,21,0,0,21
27100,2022,Afghanistan,Australia,8741,3264,0,12005
27101,2022,Albania,Australia,37,97,0,134
27102,2022,Algeria,Australia,8,22,0,30
27103,2022,Egypt,Australia,1214,224,0,1438
27104,2022,Argentina,Australia,0,27,0,27
27105,2022,Azerbaijan,Australia,10,12,0,22
27106,2022,Bahrain,Australia,44,5,0,49
27107,2022,Burundi,Australia,53,27,0,80
27108,2022,Belgium,Australia,0,5,0,5
27109,2022,Bangladesh,Australia,393,1314,0,1707
27110,2022,Bhutan,Australia,5,17,0,22
27111,2022,Belarus,Australia,7,0,0,7
27112,2022,Brazil,Australia,9,183,0,192
27113,2022,Brunei Darussalam,Australia,0,6,0,6
27114,2022,Bosnia and Herzegovina,Australia,0,5,0,5
27115,2022,Cambodia,Australia,67,493,0,560
27116,2022,Canada,Australia,0,5,0,5
27117,2022,China,Australia,1576,15082,0,16658
27118,2022,Chile,Australia,6,61,0,67
27119,2022,Cameroon,Australia,29,62,0,91
27120,2022,Congo,Australia,36,20,0,56
27121,2022,Dem. Rep. of the Congo,Australia,61,45,0,106
27122,2022,Colombia,Australia,81,320,0,401
27123,2022,Eritrea,Australia,99,11,0,110
27124,2022,Ethiopia,Australia,409,179,0,588
27125,2022,Fiji,Australia,248,2662,0,2910
27126,2022,France,Australia,0,25,0,25
27127,2022,Gambia,Australia,10,6,0,16
27128,2022,Palestinian,Australia,457,204,0,661
27129,2022,United Kingdom of Great Britain and Northern Ireland,Australia,6,97,0,103
27130,2022,Georgia,Australia,12,27,0,39
27131,2022,Germany,Australia,9,10,0,19
27132,2022,Ghana,Australia,44,178,0,222
27133,2022,Greece,Australia,6,50,0,56
27134,2022,Guinea,Australia,8,5,0,13
27135,2022,"China, Hong Kong SAR",Australia,6,472,0,478
27136,2022,Honduras,Australia,5,5,0,10
27137,2022,India,Australia,469,7273,0,7742
27138,2022,Indonesia,Australia,241,2377,0,2618
27139,2022,Ireland,Australia,0,83,0,83
27140,2022,Iran (Islamic Rep. of),Australia,12180,3429,0,15609
27141,2022,Iraq,Australia,4286,1195,0,5481
27142,2022,Israel,Australia,6,17,0,23
27143,2022,Italy,Australia,5,58,0,63
27144,2022,Jamaica,Australia,5,0,0,5
27145,2022,Jordan,Australia,144,179,0,323
27146,2022,Japan,Australia,10,20,0,30
27147,2022,Kazakhstan,Australia,5,0,0,5
27148,2022,Kenya,Australia,105,338,0,443
27149,2022,Kyrgyzstan,Australia,11,0,0,11
27150,2022,Kiribati,Australia,0,5,0,5
27151,2022,Rep. of Korea,Australia,21,326,0,347
27152,2022,Dem. People's Rep. of Korea,Australia,0,9,0,9
27153,2022,Kuwait,Australia,23,0,0,23
27154,2022,Lao People's Dem. Rep.,Australia,5,304,0,309
27155,2022,Liberia,Australia,43,18,0,61
27156,2022,Libya,Australia,1212,37,0,1249
27157,2022,Lebanon,Australia,481,952,0,1433
27158,2022,Sri Lanka,Australia,3809,3136,0,6945
27159,2022,North Macedonia,Australia,5,78,0,83
27160,2022,Maldives,Australia,19,10,0,29
27161,2022,Mexico,Australia,19,26,0,45
27162,2022,Malaysia,Australia,734,18884,0,19618
27163,2022,Mongolia,Australia,13,391,0,404
27164,2022,Morocco,Australia,10,19,0,29
27165,2022,Mozambique,Australia,0,7,0,7
27166,2022,Mauritius,Australia,11,132,0,143
27167,2022,Myanmar,Australia,413,972,0,1385
27168,2022,Nepal,Australia,94,707,0,801
27169,2022,Nigeria,Australia,265,530,0,795
27170,2022,Nauru,Australia,5,16,0,21
27171,2022,New Zealand,Australia,34,26,0,60
27172,2022,Oman,Australia,5,0,0,5
27173,2022,Pakistan,Australia,5042,2578,0,7620
27174,2022,Peru,Australia,26,74,0,100
27175,2022,Philippines,Australia,41,1640,0,1681
27176,2022,Papua New Guinea,Australia,526,618,0,1144
27177,2022,Poland,Australia,0,19,0,19
27178,2022,Portugal,Australia,0,12,0,12
27179,2022,Romania,Australia,0,10,0,10
27180,2022,South Africa,Australia,26,468,0,494
27181,2022,Russian Federation,Australia,53,96,0,149
27182,2022,Rwanda,Australia,87,56,0,143
27183,2022,El Salvador,Australia,12,32,0,44
27184,2022,Saudi Arabia,Australia,209,66,0,275
27185,2022,Serbia and Kosovo: S/RES/1244 (1999),Australia,0,20,0,20
27186,2022,Singapore,Australia,6,44,0,50
27187,2022,Sierra Leone,Australia,33,122,0,155
27188,2022,Solomon Islands,Australia,30,447,0,477
27189,2022,Somalia,Australia,558,126,0,684
27190,2022,Viet Nam,Australia,327,3524,0,3851
27191,2022,Sudan,Australia,580,253,0,833
27192,2022,South Sudan,Australia,22,37,0,59
27193,2022,Eswatini,Australia,0,21,0,21
27194,2022,Syrian Arab Rep.,Australia,595,52,0,647
27195,2022,United Rep. of Tanzania,Australia,8,32,0,40
27196,2022,Thailand,Australia,21,1979,0,2000
27197,2022,Timor-Leste,Australia,6,363,0,369
27198,2022,Tonga,Australia,29,973,0,1002
27199,2022,Tunisia,Australia,0,10,0,10
27200,2022,Türkiye,Australia,817,471,0,1288
27201,2022,United Arab Emirates,Australia,5,0,0,5
27202,2022,Uganda,Australia,66,85,0,151
27203,2022,Ukraine,Australia,26,267,0,293
27204,2022,Uruguay,Australia,0,7,0,7
27205,2022,United States of America,Australia,17,58,0,75
27206,2022,Uzbekistan,Australia,21,51,0,72
27207,2022,Vanuatu,Australia,0,336,0,336
27208,2022,Venezuela (Bolivarian Republic of),Australia,191,297,0,488
27209,2022,Samoa,Australia,7,214,0,221
27210,2022,Yemen,Australia,241,44,0,285
27211,2022,Zambia,Australia,18,24,0,42
27212,2022,Zimbabwe,Australia,285,196,0,481
27216,2022,Afghanistan,Austria,43725,5499,0,49224
27217,2022,Albania,Austria,49,19,0,68
27218,2022,Algeria,Austria,26,190,0,216
27219,2022,Angola,Austria,34,10,0,44
27220,2022,Egypt,Austria,212,340,0,552
27221,2022,Armenia,Austria,288,126,0,414
27222,2022,Azerbaijan,Austria,145,73,0,218
27223,2022,Burundi,Austria,15,29,0,44
27224,2022,Benin,Austria,5,8,0,13
27225,2022,Bangladesh,Austria,369,268,0,637
27226,2022,Burkina Faso,Austria,5,7,0,12
27227,2022,Belarus,Austria,30,22,0,52
27228,2022,Bosnia and Herzegovina,Austria,53,13,0,66
27229,2022,Chad,Austria,5,0,0,5
27230,2022,China,Austria,655,60,0,715
27231,2022,Cameroon,Austria,185,63,0,248
27232,2022,Congo,Austria,75,8,0,83
27233,2022,Dem. Rep. of the Congo,Austria,310,65,0,375
27234,2022,Colombia,Austria,5,20,0,25
27235,2022,Cuba,Austria,14,14,0,28
27236,2022,Eritrea,Austria,492,31,0,523
27237,2022,Ethiopia,Austria,247,50,0,297
27238,2022,Gabon,Austria,5,0,0,5
27239,2022,Gambia,Austria,110,51,0,161
27240,2022,United Kingdom of Great Britain and Northern Ireland,Austria,5,5,0,10
27241,2022,Georgia,Austria,310,232,0,542
27242,2022,Germany,Austria,0,5,0,5
27243,2022,Ghana,Austria,15,29,0,44
27244,2022,Guinea-Bissau,Austria,5,5,0,10
27245,2022,Guatemala,Austria,6,0,0,6
27246,2022,Guinea,Austria,123,31,0,154
27247,2022,Cote d'Ivoire,Austria,44,9,0,53
27248,2022,India,Austria,36,1530,0,1566
27249,2022,Iran (Islamic Rep. of),Austria,7294,905,0,8199
27250,2022,Iraq,Austria,10110,1100,0,11210
27251,2022,Israel,Austria,10,5,0,15
27252,2022,Jordan,Austria,81,53,0,134
27253,2022,Kazakhstan,Austria,108,20,0,128
27254,2022,Kenya,Austria,15,9,0,24
27255,2022,Kyrgyzstan,Austria,115,21,0,136
27256,2022,Kuwait,Austria,9,5,0,14
27257,2022,Liberia,Austria,10,0,0,10
27258,2022,Libya,Austria,146,66,0,212
27259,2022,Lebanon,Austria,120,95,0,215
27260,2022,Sri Lanka,Austria,72,24,0,96
27261,2022,Mauritania,Austria,5,0,0,5
27262,2022,North Macedonia,Austria,17,39,0,56
27263,2022,Rep. of Moldova,Austria,18,103,0,121
27264,2022,Mali,Austria,13,13,0,26
27265,2022,Mongolia,Austria,107,53,0,160
27266,2022,Morocco,Austria,46,1046,0,1092
27267,2022,Montenegro,Austria,5,0,0,5
27268,2022,Myanmar,Austria,32,10,0,42
27269,2022,Namibia,Austria,0,5,0,5
27270,2022,Nepal,Austria,17,47,0,64
27271,2022,Nicaragua,Austria,5,0,0,5
27272,2022,Nigeria,Austria,435,266,0,701
27273,2022,Pakistan,Austria,386,2599,0,2985
27274,2022,Philippines,Austria,19,10,0,29
27275,2022,South Africa,Austria,0,6,0,6
27276,2022,Russian Federation,Austria,6124,597,0,6721
27277,2022,Rwanda,Austria,13,5,0,18
27278,2022,Saudi Arabia,Austria,7,5,0,12
27279,2022,Serbia and Kosovo: S/RES/1244 (1999),Austria,406,93,0,499
27280,2022,Senegal,Austria,12,11,0,23
27281,2022,Sierra Leone,Austria,18,7,0,25
27282,2022,Somalia,Austria,8684,1817,0,10501
27283,2022,Viet Nam,Austria,0,8,0,8
27284,2022,Sudan,Austria,293,47,0,340
27285,2022,South Sudan,Austria,6,0,0,6
27286,2022,Syrian Arab Rep.,Austria,67588,11589,0,79177
27287,2022,United Rep. of Tanzania,Austria,5,5,0,10
27288,2022,Tajikistan,Austria,255,79,0,334
27289,2022,Turkmenistan,Austria,8,0,0,8
27290,2022,Togo,Austria,6,5,0,11
27291,2022,Tunisia,Austria,17,2389,0,2406
27292,2022,Türkiye,Austria,706,1327,0,2033
27293,2022,Uganda,Austria,34,9,0,43
27294,2022,Ukraine,Austria,74689,321,0,75010
27295,2022,United States of America,Austria,5,5,0,10
27296,2022,Uzbekistan,Austria,46,70,0,116
27297,2022,Venezuela (Bolivarian Republic of),Austria,95,51,0,146
27298,2022,Yemen,Austria,504,157,0,661
27299,2022,Zambia,Austria,5,0,0,5
27302,2022,Afghanistan,Azerbaijan,1179,35,0,1214
27303,2022,Azerbaijan,Azerbaijan,0,0,654839,0
27304,2022,Palestinian,Azerbaijan,5,0,0,5
27305,2022,Iran (Islamic Rep. of),Azerbaijan,51,0,0,51
27306,2022,Iraq,Azerbaijan,10,0,0,10
27307,2022,Libya,Azerbaijan,5,0,0,5
27308,2022,Nigeria,Azerbaijan,0,6,0,6
27309,2022,Pakistan,Azerbaijan,53,34,0,87
27310,2022,Russian Federation,Azerbaijan,325,0,0,325
27311,2022,Syrian Arab Rep.,Azerbaijan,34,0,0,34
27312,2022,Turkmenistan,Azerbaijan,0,5,0,5
27313,2022,Ukraine,Azerbaijan,4788,41,0,4829
27314,2022,Uzbekistan,Azerbaijan,5,0,0,5
27315,2022,Yemen,Azerbaijan,11,0,0,11
27317,2022,Egypt,Bahrain,0,5,0,5
27318,2022,Palestinian,Bahrain,0,15,0,15
27319,2022,Iraq,Bahrain,241,117,0,358
27320,2022,Jordan,Bahrain,0,6,0,6
27321,2022,Syrian Arab Rep.,Bahrain,5,40,0,45
27322,2022,Tunisia,Bahrain,0,6,0,6
27323,2022,Yemen,Bahrain,9,5,0,14
27324,2022,Burundi,Burundi,0,0,7631,0
27325,2022,Dem. Rep. of the Congo,Burundi,81501,3314,0,84815
27326,2022,Kenya,Burundi,0,0,0,0
27327,2022,Mali,Burundi,12,0,0,12
27328,2022,Oman,Burundi,0,0,0,0
27329,2022,Pakistan,Burundi,0,0,0,0
27330,2022,South Africa,Burundi,0,5,0,5
27331,2022,Rwanda,Burundi,667,338,0,1005
27332,2022,Somalia,Burundi,5,0,0,5
27333,2022,United Rep. of Tanzania,Burundi,0,0,0,0
27334,2022,Uganda,Burundi,11,5,0,16
27335,2022,Afghanistan,Belgium,7049,5302,0,12351
27336,2022,Albania,Belgium,693,154,0,847
27337,2022,Algeria,Belgium,98,172,0,270
27338,2022,Angola,Belgium,98,164,0,262
27339,2022,Egypt,Belgium,113,84,0,197
27340,2022,Armenia,Belgium,325,238,0,563
27341,2022,Azerbaijan,Belgium,131,61,0,192
27342,2022,Burundi,Belgium,2408,354,0,2762
27343,2022,Benin,Belgium,40,51,0,91
27344,2022,Bangladesh,Belgium,21,6,0,27
27345,2022,Burkina Faso,Belgium,120,72,0,192
27346,2022,Belarus,Belgium,77,67,0,144
27347,2022,Brazil,Belgium,18,28,0,46
27348,2022,Bosnia and Herzegovina,Belgium,44,5,0,49
27349,2022,Bulgaria,Belgium,17,0,0,17
27350,2022,Cambodia,Belgium,13,0,0,13
27351,2022,Central African Rep.,Belgium,74,23,0,97
27352,2022,Chad,Belgium,47,42,0,89
27353,2022,China,Belgium,1226,45,0,1271
27354,2022,Chile,Belgium,44,5,0,49
27355,2022,Cameroon,Belgium,690,650,0,1340
27356,2022,Congo,Belgium,25,36,0,61
27357,2022,Dem. Rep. of the Congo,Belgium,1632,634,0,2266
27358,2022,Colombia,Belgium,143,252,0,395
27359,2022,Cuba,Belgium,10,5,0,15
27360,2022,Czechia,Belgium,5,0,0,5
27361,2022,Djibouti,Belgium,385,58,0,443
27362,2022,Ecuador,Belgium,0,6,0,6
27363,2022,Equatorial Guinea,Belgium,0,5,0,5
27364,2022,Eritrea,Belgium,4540,661,0,5201
27365,2022,Ethiopia,Belgium,187,144,0,331
27366,2022,Gabon,Belgium,30,40,0,70
27367,2022,Gambia,Belgium,37,73,0,110
27368,2022,Palestinian,Belgium,3655,1313,0,4968
27369,2022,Georgia,Belgium,249,360,0,609
27370,2022,Ghana,Belgium,19,67,0,86
27371,2022,Guinea-Bissau,Belgium,7,5,0,12
27372,2022,Guatemala,Belgium,41,33,0,74
27373,2022,Guinea,Belgium,3764,915,0,4679
27374,2022,Guyana,Belgium,5,0,0,5
27375,2022,Haiti,Belgium,5,5,0,10
27376,2022,Honduras,Belgium,21,15,0,36
27377,2022,Croatia,Belgium,5,0,0,5
27378,2022,Hungary,Belgium,29,0,0,29
27379,2022,Cote d'Ivoire,Belgium,260,171,0,431
27380,2022,India,Belgium,14,7,0,21
27381,2022,Iran (Islamic Rep. of),Belgium,1902,256,0,2158
27382,2022,Iraq,Belgium,5769,699,0,6468
27383,2022,Israel,Belgium,0,5,0,5
27384,2022,Jamaica,Belgium,5,0,0,5
27385,2022,Jordan,Belgium,28,41,0,69
27386,2022,Kazakhstan,Belgium,67,18,0,85
27387,2022,Kenya,Belgium,15,7,0,22
27388,2022,Kyrgyzstan,Belgium,93,29,0,122
27389,2022,Dem. People's Rep. of Korea,Belgium,32,0,0,32
27390,2022,Kuwait,Belgium,8,5,0,13
27391,2022,Lao People's Dem. Rep.,Belgium,10,0,0,10
27392,2022,Liberia,Belgium,16,25,0,41
27393,2022,Libya,Belgium,156,116,0,272
27394,2022,Lebanon,Belgium,140,87,0,227
27395,2022,Sri Lanka,Belgium,311,33,0,344
27396,2022,Lithuania,Belgium,10,0,0,10
27397,2022,Madagascar,Belgium,0,5,0,5
27398,2022,Mauritania,Belgium,278,131,0,409
27399,2022,North Macedonia,Belgium,133,28,0,161
27400,2022,Rep. of Moldova,Belgium,98,0,0,98
27401,2022,Maldives,Belgium,0,89,0,89
27402,2022,Mali,Belgium,105,37,0,142
27403,2022,Mongolia,Belgium,0,7,0,7
27404,2022,Morocco,Belgium,205,328,0,533
27405,2022,Mozambique,Belgium,0,5,0,5
27406,2022,Montenegro,Belgium,13,0,0,13
27407,2022,Myanmar,Belgium,8,0,0,8
27408,2022,Nepal,Belgium,6,0,0,6
27409,2022,Niger,Belgium,139,97,0,236
27410,2022,Nicaragua,Belgium,26,11,0,37
27411,2022,Nigeria,Belgium,72,300,0,372
27412,2022,Pakistan,Belgium,359,71,0,430
27413,2022,Peru,Belgium,10,23,0,33
27414,2022,Philippines,Belgium,0,16,0,16
27415,2022,Poland,Belgium,98,0,0,98
27416,2022,Romania,Belgium,52,0,0,52
27417,2022,South Africa,Belgium,5,0,0,5
27418,2022,Russian Federation,Belgium,2848,405,0,3253
27419,2022,Rwanda,Belgium,846,224,0,1070
27420,2022,El Salvador,Belgium,591,304,0,895
27421,2022,Saudi Arabia,Belgium,8,5,0,13
27422,2022,Serbia and Kosovo: S/RES/1244 (1999),Belgium,914,62,0,976
27423,2022,Senegal,Belgium,421,231,0,652
27424,2022,Sierra Leone,Belgium,29,39,0,68
27425,2022,Somalia,Belgium,2746,1041,0,3787
27426,2022,Spain,Belgium,0,7,0,7
27427,2022,Viet Nam,Belgium,23,18,0,41
27428,2022,Sudan,Belgium,316,116,0,432
27429,2022,Suriname,Belgium,0,5,0,5
27430,2022,South Sudan,Belgium,12,25,0,37
27431,2022,Syrian Arab Rep.,Belgium,20086,1089,0,21175
27432,2022,United Rep. of Tanzania,Belgium,43,21,0,64
27433,2022,Tajikistan,Belgium,21,18,0,39
27434,2022,Turkmenistan,Belgium,7,0,0,7
27435,2022,Togo,Belgium,164,97,0,261
27436,2022,Trinidad and Tobago,Belgium,0,5,0,5
27437,2022,Tunisia,Belgium,83,78,0,161
27438,2022,Türkiye,Belgium,3362,815,0,4177
27439,2022,Uganda,Belgium,26,23,0,49
27440,2022,Ukraine,Belgium,48238,160,0,48398
27441,2022,United States of America,Belgium,0,8,0,8
27442,2022,Uzbekistan,Belgium,67,14,0,81
27443,2022,Venezuela (Bolivarian Republic of),Belgium,515,180,0,695
27444,2022,Yemen,Belgium,311,91,0,402
27445,2022,Zambia,Belgium,0,5,0,5
27449,2022,Burundi,Benin,5,0,0,5
27450,2022,Burkina Faso,Benin,194,5,0,199
27451,2022,Central African Rep.,Benin,1144,174,0,1318
27452,2022,Chad,Benin,20,49,0,69
27453,2022,Cameroon,Benin,94,85,0,179
27454,2022,Congo,Benin,0,14,0,14
27455,2022,Dem. Rep. of the Congo,Benin,28,60,0,88
27456,2022,Eritrea,Benin,5,0,0,5
27457,2022,Guinea,Benin,0,14,0,14
27458,2022,Cote d'Ivoire,Benin,117,29,0,146
27459,2022,Liberia,Benin,0,5,0,5
27460,2022,Sri Lanka,Benin,5,5,0,10
27461,2022,Mali,Benin,48,15,0,63
27462,2022,Niger,Benin,22,10,0,32
27463,2022,Nigeria,Benin,0,43,0,43
27464,2022,Pakistan,Benin,5,0,0,5
27465,2022,Rwanda,Benin,0,5,0,5
27466,2022,Sudan,Benin,21,14,0,35
27467,2022,Syrian Arab Rep.,Benin,36,16,0,52
27468,2022,Togo,Benin,0,28,0,28
27469,2022,Türkiye,Benin,10,0,0,10
27470,2022,Yemen,Benin,17,0,0,17
27471,2022,Afghanistan,Bangladesh,5,0,0,5
27472,2022,Myanmar,Bangladesh,929662,5,0,929667
27473,2022,Somalia,Bangladesh,14,22,0,36
27475,2022,Cameroon,Bahamas,5,0,0,5
27476,2022,Jamaica,Bahamas,5,0,0,5
27477,2022,Afghanistan,Burkina Faso,0,10,0,10
27478,2022,Burundi,Burkina Faso,26,5,0,31
27479,2022,Benin,Burkina Faso,7,0,0,7
27480,2022,Burkina Faso,Burkina Faso,0,0,1902150,0
27481,2022,Central African Rep.,Burkina Faso,180,122,0,302
27482,2022,Chad,Burkina Faso,71,0,0,71
27483,2022,Cameroon,Burkina Faso,8,0,0,8
27484,2022,Congo,Burkina Faso,26,0,0,26
27485,2022,Dem. Rep. of the Congo,Burkina Faso,30,0,0,30
27486,2022,Cote d'Ivoire,Burkina Faso,5,0,0,5
27487,2022,Mali,Burkina Faso,26603,6273,0,32876
27488,2022,Niger,Burkina Faso,0,1029,0,1029
27489,2022,Rwanda,Burkina Faso,15,0,0,15
27490,2022,South Sudan,Burkina Faso,5,0,0,5
27491,2022,Syrian Arab Rep.,Burkina Faso,5,5,0,10
27492,2022,Togo,Burkina Faso,15,0,0,15
27493,2022,Türkiye,Burkina Faso,48,81,0,129
27494,2022,Afghanistan,Belarus,96,5,0,101
27495,2022,Egypt,Belarus,0,5,0,5
27496,2022,Armenia,Belarus,5,0,0,5
27497,2022,Azerbaijan,Belarus,5,0,0,5
27498,2022,Cuba,Belarus,0,5,0,5
27499,2022,Ethiopia,Belarus,5,0,0,5
27500,2022,Palestinian,Belarus,7,0,0,7
27501,2022,Georgia,Belarus,48,0,0,48
27502,2022,Iran (Islamic Rep. of),Belarus,5,0,0,5
27503,2022,Iraq,Belarus,11,0,0,11
27504,2022,Libya,Belarus,7,0,0,7
27505,2022,Lebanon,Belarus,5,0,0,5
27506,2022,Russian Federation,Belarus,9,0,0,9
27507,2022,Slovakia,Belarus,0,5,0,5
27508,2022,Syrian Arab Rep.,Belarus,59,12,0,71
27509,2022,Tajikistan,Belarus,10,0,0,10
27510,2022,Türkiye,Belarus,21,0,0,21
27511,2022,Ukraine,Belarus,12231,743,0,12974
27512,2022,Yemen,Belarus,23,5,0,28
27514,2022,Argentina,Bolivia (Plurinational State of),13,0,0,13
27515,2022,Colombia,Bolivia (Plurinational State of),200,21,0,221
27516,2022,Cuba,Bolivia (Plurinational State of),48,0,0,48
27517,2022,Ecuador,Bolivia (Plurinational State of),5,6,0,11
27518,2022,Cote d'Ivoire,Bolivia (Plurinational State of),5,0,0,5
27519,2022,Iraq,Bolivia (Plurinational State of),16,0,0,16
27520,2022,Niger,Bolivia (Plurinational State of),5,0,0,5
27521,2022,Pakistan,Bolivia (Plurinational State of),5,0,0,5
27522,2022,Peru,Bolivia (Plurinational State of),525,0,0,525
27523,2022,Russian Federation,Bolivia (Plurinational State of),14,0,0,14
27524,2022,Syrian Arab Rep.,Bolivia (Plurinational State of),22,0,0,22
27525,2022,Ukraine,Bolivia (Plurinational State of),5,0,0,5
27526,2022,Uruguay,Bolivia (Plurinational State of),10,0,0,10
27527,2022,Venezuela (Bolivarian Republic of),Bolivia (Plurinational State of),243,0,0,243
27528,2022,Angola,Botswana,0,0,0,0
27529,2022,Burundi,Botswana,59,0,0,59
27530,2022,Botswana,Botswana,0,0,0,0
27531,2022,Dem. Rep. of the Congo,Botswana,261,89,0,350
27532,2022,Ethiopia,Botswana,5,0,0,5
27533,2022,Kenya,Botswana,5,0,0,5
27534,2022,Namibia,Botswana,6,0,0,6
27535,2022,Rwanda,Botswana,18,0,0,18
27536,2022,Somalia,Botswana,325,0,0,325
27537,2022,Sudan,Botswana,5,0,0,5
27538,2022,South Sudan,Botswana,5,0,0,5
27539,2022,Uganda,Botswana,19,0,0,19
27540,2022,Zimbabwe,Botswana,15,0,0,15
27541,2022,Afghanistan,Brazil,170,490,0,660
27542,2022,Albania,Brazil,0,7,0,7
27543,2022,Algeria,Brazil,8,34,0,42
27544,2022,Andorra,Brazil,0,6,0,6
27545,2022,Angola,Brazil,1173,6444,0,7617
27546,2022,Egypt,Brazil,70,453,0,523
27547,2022,Argentina,Brazil,6,153,0,159
27548,2022,Armenia,Brazil,5,10,0,15
27549,2022,Burundi,Brazil,48,21,0,69
27550,2022,Belgium,Brazil,0,6,0,6
27551,2022,Benin,Brazil,5,265,0,270
27552,2022,Bangladesh,Brazil,33,4918,0,4951
27553,2022,Bhutan,Brazil,31,35,0,66
27554,2022,Burkina Faso,Brazil,96,241,0,337
27555,2022,Belarus,Brazil,0,8,0,8
27556,2022,Bolivia (Plurinational State of),Brazil,154,461,0,615
27557,2022,Bosnia and Herzegovina,Brazil,5,0,0,5
27558,2022,Bulgaria,Brazil,0,5,0,5
27559,2022,Cambodia,Brazil,0,5,0,5
27560,2022,Canada,Brazil,0,6,0,6
27561,2022,Central African Rep.,Brazil,5,7,0,12
27562,2022,China,Brazil,24,4903,0,4927
27563,2022,Chile,Brazil,21,135,0,156
27564,2022,Cameroon,Brazil,102,566,0,668
27565,2022,Congo,Brazil,20,128,0,148
27566,2022,Dem. Rep. of the Congo,Brazil,1696,2506,0,4202
27567,2022,Colombia,Brazil,1312,2072,0,3384
27568,2022,Costa Rica,Brazil,5,15,0,20
27569,2022,Cuba,Brazil,930,14954,0,15884
27570,2022,Cabo Verde,Brazil,0,195,0,195
27571,2022,Cyprus,Brazil,0,5,0,5
27572,2022,Czechia,Brazil,0,5,0,5
27573,2022,Denmark,Brazil,0,12,0,12
27574,2022,Djibouti,Brazil,0,7,0,7
27575,2022,Dominica,Brazil,0,18,0,18
27576,2022,Dominican Rep.,Brazil,7,1240,0,1247
27577,2022,Ecuador,Brazil,59,114,0,173
27578,2022,Equatorial Guinea,Brazil,0,17,0,17
27579,2022,Eritrea,Brazil,25,75,0,100
27580,2022,Ethiopia,Brazil,29,72,0,101
27581,2022,French Guiana,Brazil,0,20,0,20
27582,2022,Fiji,Brazil,0,21,0,21
27583,2022,France,Brazil,0,40,0,40
27584,2022,Gambia,Brazil,9,313,0,322
27585,2022,Palestinian,Brazil,578,343,0,921
27586,2022,United Kingdom of Great Britain and Northern Ireland,Brazil,0,13,0,13
27587,2022,Georgia,Brazil,11,5,0,16
27588,2022,Germany,Brazil,5,18,0,23
27589,2022,Ghana,Brazil,48,2462,0,2510
27590,2022,Guinea-Bissau,Brazil,26,1556,0,1582
27591,2022,Greece,Brazil,0,5,0,5
27592,2022,Guatemala,Brazil,5,26,0,31
27593,2022,Guinea,Brazil,116,843,0,959
27594,2022,Guyana,Brazil,5,171,0,176
27595,2022,Haiti,Brazil,9,37226,0,37235
27596,2022,Honduras,Brazil,6,14,0,20
27597,2022,Croatia,Brazil,6,5,0,11
27598,2022,Hungary,Brazil,5,0,0,5
27599,2022,Cote d'Ivoire,Brazil,58,180,0,238
27600,2022,India,Brazil,16,892,0,908
27601,2022,Indonesia,Brazil,0,7,0,7
27602,2022,Iran (Islamic Rep. of),Brazil,68,198,0,266
27603,2022,Iraq,Brazil,362,359,0,721
27604,2022,Israel,Brazil,0,33,0,33
27605,2022,Italy,Brazil,0,36,0,36
27606,2022,Jamaica,Brazil,0,13,0,13
27607,2022,Jordan,Brazil,13,100,0,113
27608,2022,Japan,Brazil,0,5,0,5
27609,2022,Kazakhstan,Brazil,0,16,0,16
27610,2022,Kenya,Brazil,10,75,0,85
27611,2022,Rep. of Korea,Brazil,0,261,0,261
27612,2022,Kuwait,Brazil,0,7,0,7
27613,2022,Liberia,Brazil,259,31,0,290
27614,2022,Libya,Brazil,7,67,0,74
27615,2022,Lebanon,Brazil,413,1947,0,2360
27616,2022,Lesotho,Brazil,0,5,0,5
27617,2022,Sri Lanka,Brazil,19,121,0,140
27618,2022,Lithuania,Brazil,0,7,0,7
27620,2022,Mauritania,Brazil,61,229,0,290
27621,2022,North Macedonia,Brazil,6,0,0,6
27622,2022,Mexico,Brazil,8,48,0,56
27623,2022,Mali,Brazil,147,394,0,541
27624,2022,Malaysia,Brazil,0,5,0,5
27625,2022,Mongolia,Brazil,0,7,0,7
27626,2022,Morocco,Brazil,38,796,0,834
27627,2022,Mozambique,Brazil,5,92,0,97
27628,2022,Malta,Brazil,0,5,0,5
27629,2022,Myanmar,Brazil,0,5,0,5
27630,2022,Namibia,Brazil,0,39,0,39
27631,2022,Nepal,Brazil,12,415,0,427
27632,2022,Netherlands,Brazil,0,8,0,8
27633,2022,Niger,Brazil,0,7,0,7
27634,2022,Nicaragua,Brazil,24,18,0,42
27635,2022,Nigeria,Brazil,164,3276,0,3440
27636,2022,Norway,Brazil,0,5,0,5
27637,2022,New Zealand,Brazil,0,5,0,5
27638,2022,Pakistan,Brazil,392,1518,0,1910
27639,2022,Panama,Brazil,0,9,0,9
27640,2022,Paraguay,Brazil,5,165,0,170
27641,2022,Peru,Brazil,53,312,0,365
27642,2022,Philippines,Brazil,12,525,0,537
27643,2022,Poland,Brazil,0,16,0,16
27644,2022,Portugal,Brazil,0,115,0,115
27645,2022,Romania,Brazil,0,17,0,17
27646,2022,South Africa,Brazil,6,426,0,432
27647,2022,Russian Federation,Brazil,23,103,0,126
27648,2022,Rwanda,Brazil,18,7,0,25
27649,2022,El Salvador,Brazil,59,9,0,68
27650,2022,Saudi Arabia,Brazil,0,22,0,22
27651,2022,Serbia and Kosovo: S/RES/1244 (1999),Brazil,92,9,0,101
27652,2022,Senegal,Brazil,15,6256,0,6271
27653,2022,Sierra Leone,Brazil,167,319,0,486
27654,2022,Somalia,Brazil,53,524,0,577
27655,2022,Spain,Brazil,0,57,0,57
27656,2022,Viet Nam,Brazil,5,5,0,10
27657,2022,Sao Tome and Principe,Brazil,0,19,0,19
27658,2022,Sudan,Brazil,83,129,0,212
27659,2022,Suriname,Brazil,0,21,0,21
27660,2022,Slovenia,Brazil,0,5,0,5
27661,2022,Sweden,Brazil,0,5,0,5
27662,2022,Switzerland,Brazil,0,5,0,5
27663,2022,Syrian Arab Rep.,Brazil,3971,3832,0,7803
27664,2022,United Rep. of Tanzania,Brazil,9,110,0,119
27665,2022,Thailand,Brazil,0,46,0,46
27666,2022,Togo,Brazil,68,572,0,640
27667,2022,Trinidad and Tobago,Brazil,0,8,0,8
27668,2022,Tunisia,Brazil,8,166,0,174
27669,2022,Türkiye,Brazil,14,274,0,288
27670,2022,Uganda,Brazil,8,33,0,41
27671,2022,Ukraine,Brazil,34,70,0,104
27672,2022,Uruguay,Brazil,0,29,0,29
27673,2022,United States of America,Brazil,0,59,0,59
27674,2022,Vanuatu,Brazil,0,71,0,71
27675,2022,Holy See,Brazil,0,13,0,13
27676,2022,Venezuela (Bolivarian Republic of),Brazil,49964,94524,0,144488
27677,2022,Yemen,Brazil,19,135,0,154
27678,2022,Zambia,Brazil,0,5,0,5
27679,2022,Zimbabwe,Brazil,5,12,0,17
27683,2022,Afghanistan,Bosnia and Herzegovina,5,5,0,10
27684,2022,Algeria,Bosnia and Herzegovina,0,0,0,0
27685,2022,Egypt,Bosnia and Herzegovina,0,0,0,0
27686,2022,Azerbaijan,Bosnia and Herzegovina,5,0,0,5
27687,2022,Burundi,Bosnia and Herzegovina,0,0,0,0
27688,2022,Bangladesh,Bosnia and Herzegovina,0,0,0,0
27689,2022,Bosnia and Herzegovina,Bosnia and Herzegovina,0,0,96305,0
27690,2022,Cameroon,Bosnia and Herzegovina,0,0,0,0
27691,2022,Congo,Bosnia and Herzegovina,0,0,0,0
27692,2022,Cuba,Bosnia and Herzegovina,0,19,0,19
27693,2022,Eritrea,Bosnia and Herzegovina,0,0,0,0
27694,2022,Gambia,Bosnia and Herzegovina,0,0,0,0
27695,2022,Palestinian,Bosnia and Herzegovina,0,0,0,0
27696,2022,Ghana,Bosnia and Herzegovina,0,0,0,0
27697,2022,Guinea,Bosnia and Herzegovina,0,0,0,0
27698,2022,Cote d'Ivoire,Bosnia and Herzegovina,0,0,0,0
27699,2022,India,Bosnia and Herzegovina,0,0,0,0
27700,2022,Iran (Islamic Rep. of),Bosnia and Herzegovina,5,14,0,19
27701,2022,Iraq,Bosnia and Herzegovina,0,0,0,0
27702,2022,Libya,Bosnia and Herzegovina,0,0,0,0
27703,2022,Mali,Bosnia and Herzegovina,0,0,0,0
27704,2022,Morocco,Bosnia and Herzegovina,0,5,0,5
27705,2022,Nepal,Bosnia and Herzegovina,0,0,0,0
27706,2022,Pakistan,Bosnia and Herzegovina,5,9,0,14
27707,2022,Russian Federation,Bosnia and Herzegovina,0,12,0,12
27708,2022,Serbia and Kosovo: S/RES/1244 (1999),Bosnia and Herzegovina,36,5,0,41
27709,2022,Senegal,Bosnia and Herzegovina,0,0,0,0
27710,2022,Somalia,Bosnia and Herzegovina,0,0,0,0
27711,2022,Syrian Arab Rep.,Bosnia and Herzegovina,25,5,0,30
27712,2022,Togo,Bosnia and Herzegovina,0,0,0,0
27713,2022,Türkiye,Bosnia and Herzegovina,34,35,0,69
27714,2022,Ukraine,Bosnia and Herzegovina,234,25,0,259
27717,2022,Afghanistan,Bulgaria,313,6244,0,6557
27718,2022,Albania,Bulgaria,0,6,0,6
27719,2022,Algeria,Bulgaria,5,82,0,87
27720,2022,Egypt,Bulgaria,19,34,0,53
27721,2022,Armenia,Bulgaria,61,5,0,66
27722,2022,Azerbaijan,Bulgaria,11,0,0,11
27723,2022,Bangladesh,Bulgaria,8,16,0,24
27724,2022,Belarus,Bulgaria,28,0,0,28
27725,2022,Canada,Bulgaria,5,0,0,5
27726,2022,Congo,Bulgaria,9,0,0,9
27727,2022,Dem. Rep. of the Congo,Bulgaria,0,5,0,5
27728,2022,Dominican Rep.,Bulgaria,0,6,0,6
27729,2022,Eritrea,Bulgaria,13,7,0,20
27730,2022,Ethiopia,Bulgaria,10,0,0,10
27731,2022,United Kingdom of Great Britain and Northern Ireland,Bulgaria,5,0,0,5
27732,2022,Georgia,Bulgaria,27,5,0,32
27733,2022,Guinea,Bulgaria,5,0,0,5
27734,2022,Cote d'Ivoire,Bulgaria,5,5,0,10
27735,2022,India,Bulgaria,5,0,0,5
27736,2022,Iran (Islamic Rep. of),Bulgaria,80,52,0,132
27737,2022,Iraq,Bulgaria,1102,108,0,1210
27738,2022,Israel,Bulgaria,20,0,0,20
27739,2022,Jordan,Bulgaria,8,0,0,8
27740,2022,Kazakhstan,Bulgaria,6,0,0,6
27741,2022,Libya,Bulgaria,0,5,0,5
27742,2022,Lebanon,Bulgaria,22,5,0,27
27743,2022,Mauritania,Bulgaria,0,6,0,6
27744,2022,Rep. of Moldova,Bulgaria,45,0,0,45
27745,2022,Mali,Bulgaria,5,0,0,5
27746,2022,Morocco,Bulgaria,5,544,0,549
27747,2022,Nigeria,Bulgaria,0,5,0,5
27748,2022,Pakistan,Bulgaria,34,52,0,86
27749,2022,Russian Federation,Bulgaria,214,49,0,263
27750,2022,Senegal,Bulgaria,0,5,0,5
27751,2022,Somalia,Bulgaria,43,19,0,62
27752,2022,Sudan,Bulgaria,12,0,0,12
27753,2022,Syrian Arab Rep.,Bulgaria,22226,2451,0,24677
27754,2022,Turkmenistan,Bulgaria,34,0,0,34
27755,2022,Tunisia,Bulgaria,5,17,0,22
27756,2022,Türkiye,Bulgaria,12,26,0,38
27757,2022,Ukraine,Bulgaria,119450,325,0,119775
27758,2022,United States of America,Bulgaria,14,0,0,14
27759,2022,Uzbekistan,Bulgaria,5,0,0,5
27760,2022,Yemen,Bulgaria,29,5,0,34
27762,2022,Cuba,Belize,0,5,0,5
27763,2022,Guatemala,Belize,0,411,0,411
27764,2022,Honduras,Belize,14,441,0,455
27765,2022,Nicaragua,Belize,5,5,0,10
27766,2022,Peru,Belize,0,5,0,5
27767,2022,El Salvador,Belize,70,1204,0,1274
27769,2022,Myanmar,Cambodia,8,7,0,15
27770,2022,Pakistan,Cambodia,0,5,0,5
27771,2022,Viet Nam,Cambodia,16,0,0,16
27773,2022,Afghanistan,Canada,735,550,0,1285
27774,2022,Albania,Canada,202,224,0,426
27775,2022,Algeria,Canada,664,572,0,1236
27776,2022,Angola,Canada,467,971,0,1438
27777,2022,Antigua and Barbuda,Canada,36,28,0,64
27778,2022,Egypt,Canada,816,425,0,1241
27779,2022,Argentina,Canada,15,64,0,79
27780,2022,Armenia,Canada,6,18,0,24
27781,2022,Australia,Canada,0,12,0,12
27782,2022,Azerbaijan,Canada,135,33,0,168
27783,2022,Bahrain,Canada,11,11,0,22
27784,2022,Barbados,Canada,177,148,0,325
27785,2022,Burundi,Canada,888,228,0,1116
27786,2022,Belgium,Canada,5,17,0,22
27787,2022,Benin,Canada,28,68,0,96
27788,2022,Bangladesh,Canada,951,1040,0,1991
27789,2022,Bahamas,Canada,445,608,0,1053
27790,2022,Bhutan,Canada,5,0,0,5
27791,2022,Burkina Faso,Canada,80,99,0,179
27792,2022,Belarus,Canada,20,13,0,33
27793,2022,Bolivia (Plurinational State of),Canada,28,25,0,53
27794,2022,Botswana,Canada,9,7,0,16
27795,2022,Brazil,Canada,140,609,0,749
27796,2022,Bosnia and Herzegovina,Canada,5,5,0,10
27797,2022,Bulgaria,Canada,75,22,0,97
27798,2022,Cambodia,Canada,27,0,0,27
27799,2022,Central African Rep.,Canada,32,21,0,53
27800,2022,Chad,Canada,448,223,0,671
27801,2022,China,Canada,1984,1722,0,3706
27802,2022,Chile,Canada,119,859,0,978
27803,2022,Cameroon,Canada,579,430,0,1009
27804,2022,Congo,Canada,133,171,0,304
27805,2022,Dem. Rep. of the Congo,Canada,1075,1683,0,2758
27806,2022,Comoros,Canada,5,0,0,5
27807,2022,Colombia,Canada,3375,4477,0,7852
27808,2022,Costa Rica,Canada,11,51,0,62
27809,2022,Cuba,Canada,239,320,0,559
27810,2022,Cabo Verde,Canada,0,5,0,5
27811,2022,Cyprus,Canada,0,6,0,6
27812,2022,Czechia,Canada,186,75,0,261
27813,2022,Denmark,Canada,0,5,0,5
27814,2022,Djibouti,Canada,195,52,0,247
27815,2022,Dominica,Canada,5,5,0,10
27816,2022,Dominican Rep.,Canada,99,172,0,271
27817,2022,Ecuador,Canada,58,122,0,180
27818,2022,Equatorial Guinea,Canada,5,0,0,5
27819,2022,Eritrea,Canada,473,297,0,770
27820,2022,Ethiopia,Canada,966,485,0,1451
27821,2022,Fiji,Canada,0,6,0,6
27822,2022,France,Canada,0,100,0,100
27823,2022,Gabon,Canada,26,37,0,63
27824,2022,Gambia,Canada,48,88,0,136
27825,2022,Palestinian,Canada,671,264,0,935
27826,2022,United Kingdom of Great Britain and Northern Ireland,Canada,5,47,0,52
27827,2022,Georgia,Canada,187,182,0,369
27828,2022,Germany,Canada,0,20,0,20
27829,2022,Ghana,Canada,190,347,0,537
27830,2022,Guinea-Bissau,Canada,0,5,0,5
27831,2022,Greece,Canada,5,22,0,27
27832,2022,Grenada,Canada,11,8,0,19
27833,2022,Guatemala,Canada,206,261,0,467
27834,2022,Guinea,Canada,252,284,0,536
27835,2022,Guyana,Canada,33,55,0,88
27836,2022,Haiti,Canada,2487,4648,0,7135
27837,2022,"China, Hong Kong SAR",Canada,63,22,0,85
27838,2022,Honduras,Canada,348,342,0,690
27839,2022,Croatia,Canada,42,5,0,47
27840,2022,Hungary,Canada,1585,319,0,1904
27841,2022,Iceland,Canada,0,9,0,9
27842,2022,Cote d'Ivoire,Canada,159,175,0,334
27843,2022,India,Canada,3138,8652,0,11790
27844,2022,Indonesia,Canada,35,50,0,85
27845,2022,Ireland,Canada,0,31,0,31
27846,2022,Iran (Islamic Rep. of),Canada,5254,2441,0,7695
27847,2022,Iraq,Canada,511,241,0,752
27848,2022,Israel,Canada,33,59,0,92
27849,2022,Italy,Canada,17,93,0,110
27850,2022,Jamaica,Canada,252,530,0,782
27851,2022,Jordan,Canada,534,544,0,1078
27852,2022,Japan,Canada,5,5,0,10
27853,2022,Kazakhstan,Canada,66,29,0,95
27854,2022,Kenya,Canada,459,298,0,757
27855,2022,Kyrgyzstan,Canada,12,5,0,17
27856,2022,Rep. of Korea,Canada,21,16,0,37
27857,2022,Dem. People's Rep. of Korea,Canada,33,10,0,43
27858,2022,Kuwait,Canada,40,19,0,59
27859,2022,Liberia,Canada,94,88,0,182
27860,2022,Libya,Canada,368,137,0,505
27861,2022,Saint Lucia,Canada,51,20,0,71
27862,2022,Lebanon,Canada,486,715,0,1201
27863,2022,Lesotho,Canada,0,5,0,5
27864,2022,Sri Lanka,Canada,1371,780,0,2151
27865,2022,Lithuania,Canada,0,7,0,7
27866,2022,Latvia,Canada,10,5,0,15
27867,2022,Madagascar,Canada,20,13,0,33
27868,2022,Mauritania,Canada,150,98,0,248
27869,2022,North Macedonia,Canada,9,5,0,14
27870,2022,Rep. of Moldova,Canada,7,6,0,13
27871,2022,Mexico,Canada,3065,8079,0,11144
27872,2022,Mali,Canada,100,129,0,229
27873,2022,Malaysia,Canada,15,23,0,38
27874,2022,Malawi,Canada,48,30,0,78
27875,2022,Mongolia,Canada,43,38,0,81
27876,2022,Morocco,Canada,82,179,0,261
27877,2022,Mozambique,Canada,7,0,0,7
27878,2022,Malta,Canada,0,5,0,5
27879,2022,Mauritius,Canada,5,22,0,27
27880,2022,Myanmar,Canada,22,36,0,58
27881,2022,Namibia,Canada,26,17,0,43
27882,2022,Nepal,Canada,237,102,0,339
27883,2022,Netherlands,Canada,0,17,0,17
27884,2022,Niger,Canada,23,50,0,73
27885,2022,Nicaragua,Canada,464,308,0,772
27886,2022,Nigeria,Canada,3857,3402,0,7259
27887,2022,Norway,Canada,0,6,0,6
27888,2022,Oman,Canada,0,5,0,5
27889,2022,Pakistan,Canada,2506,1798,0,4304
27890,2022,Panama,Canada,5,21,0,26
27891,2022,Paraguay,Canada,7,0,0,7
27892,2022,Peru,Canada,144,357,0,501
27893,2022,Philippines,Canada,58,199,0,257
27894,2022,Poland,Canada,121,84,0,205
27895,2022,Portugal,Canada,7,77,0,84
27896,2022,Qatar,Canada,0,10,0,10
27897,2022,Romania,Canada,489,441,0,930
27898,2022,South Africa,Canada,120,103,0,223
27899,2022,Russian Federation,Canada,166,138,0,304
27900,2022,Rwanda,Canada,668,458,0,1126
27901,2022,El Salvador,Canada,590,410,0,1000
27902,2022,Saudi Arabia,Canada,222,107,0,329
27903,2022,Serbia and Kosovo: S/RES/1244 (1999),Canada,38,45,0,83
27904,2022,Senegal,Canada,158,195,0,353
27905,2022,Singapore,Canada,0,8,0,8
27906,2022,Sierra Leone,Canada,33,74,0,107
27907,2022,Somalia,Canada,660,391,0,1051
27908,2022,Spain,Canada,5,28,0,33
27909,2022,Viet Nam,Canada,75,220,0,295
27910,2022,Saint Kitts and Nevis,Canada,9,5,0,14
27911,2022,Sudan,Canada,624,275,0,899
27912,2022,Suriname,Canada,5,5,0,10
27913,2022,South Sudan,Canada,14,19,0,33
27914,2022,Slovakia,Canada,374,130,0,504
27915,2022,Slovenia,Canada,0,5,0,5
27916,2022,Eswatini,Canada,11,0,0,11
27917,2022,Sweden,Canada,0,13,0,13
27918,2022,Syrian Arab Rep.,Canada,411,246,0,657
27919,2022,United Rep. of Tanzania,Canada,146,113,0,259
27920,2022,Thailand,Canada,9,11,0,20
27921,2022,Tajikistan,Canada,28,5,0,33
27922,2022,Turkmenistan,Canada,11,0,0,11
27923,2022,Togo,Canada,59,77,0,136
27924,2022,Trinidad and Tobago,Canada,42,45,0,87
27925,2022,Tunisia,Canada,80,153,0,233
27926,2022,Türkiye,Canada,1739,2671,0,4410
27927,2022,United Arab Emirates,Canada,21,31,0,52
27928,2022,Uganda,Canada,699,244,0,943
27929,2022,Ukraine,Canada,149,217,0,366
27930,2022,Uruguay,Canada,6,20,0,26
27931,2022,United States of America,Canada,176,961,0,1137
27932,2022,Uzbekistan,Canada,21,21,0,42
27933,2022,Saint Vincent and the Grenadines,Canada,51,38,0,89
27934,2022,Venezuela (Bolivarian Republic of),Canada,1458,808,0,2266
27935,2022,Yemen,Canada,357,236,0,593
27936,2022,Zambia,Canada,21,10,0,31
27937,2022,Zimbabwe,Canada,296,151,0,447
27940,2022,Angola,Central African Rep.,12,0,0,12
27941,2022,Burundi,Central African Rep.,24,0,0,24
27942,2022,Central African Rep.,Central African Rep.,0,0,610265,0
27943,2022,Chad,Central African Rep.,1252,88,0,1340
27944,2022,Cameroon,Central African Rep.,44,29,0,73
27945,2022,Congo,Central African Rep.,15,9,0,24
27946,2022,Dem. Rep. of the Congo,Central African Rep.,6298,219,0,6517
27947,2022,Guinea,Central African Rep.,6,0,0,6
27948,2022,Cote d'Ivoire,Central African Rep.,7,0,0,7
27949,2022,Liberia,Central African Rep.,5,0,0,5
27950,2022,Rwanda,Central African Rep.,220,0,0,220
27951,2022,Sudan,Central African Rep.,447,22,0,469
27952,2022,South Sudan,Central African Rep.,2609,0,0,2609
27953,2022,Türkiye,Central African Rep.,8,0,0,8
27954,2022,Uganda,Central African Rep.,12,0,0,12
27955,2022,Cuba,Cayman Islands,59,166,0,225
27956,2022,Haiti,Cayman Islands,0,0,0,0
27957,2022,Venezuela (Bolivarian Republic of),Cayman Islands,0,0,0,0
27958,2022,Burundi,Chad,6,0,0,6
27959,2022,Central African Rep.,Chad,123359,2353,0,125712
27960,2022,Chad,Chad,0,0,381289,0
27961,2022,Cameroon,Chad,42518,21,0,42539
27962,2022,Congo,Chad,11,5,0,16
27963,2022,Dem. Rep. of the Congo,Chad,259,33,0,292
27964,2022,Eritrea,Chad,9,20,0,29
27965,2022,Ethiopia,Chad,20,17,0,37
27966,2022,Cote d'Ivoire,Chad,5,0,0,5
27967,2022,Iran (Islamic Rep. of),Chad,5,0,0,5
27968,2022,Libya,Chad,31,13,0,44
27969,2022,Mali,Chad,7,0,0,7
27970,2022,Niger,Chad,858,5,0,863
27971,2022,Nigeria,Chad,20021,340,0,20361
27972,2022,Rwanda,Chad,15,0,0,15
27973,2022,Senegal,Chad,5,0,0,5
27974,2022,Somalia,Chad,7,0,0,7
27975,2022,Sudan,Chad,393082,1927,0,395009
27976,2022,South Sudan,Chad,23,0,0,23
27977,2022,Syrian Arab Rep.,Chad,49,22,0,71
27978,2022,Yemen,Chad,5,10,0,15
27979,2022,Afghanistan,China,31,33,0,64
27980,2022,Central African Rep.,China,0,5,0,5
27981,2022,Cameroon,China,21,335,0,356
27982,2022,Congo,China,0,7,0,7
27983,2022,Dem. Rep. of the Congo,China,17,5,0,22
27984,2022,Eritrea,China,6,0,0,6
27985,2022,Ethiopia,China,0,8,0,8
27986,2022,Palestinian,China,11,5,0,16
27987,2022,Ghana,China,0,27,0,27
27988,2022,Guinea,China,0,5,0,5
27989,2022,Cote d'Ivoire,China,0,25,0,25
27990,2022,Iran (Islamic Rep. of),China,5,0,0,5
27991,2022,Iraq,China,14,0,0,14
27992,2022,Kenya,China,0,12,0,12
27993,2022,Liberia,China,0,7,0,7
27994,2022,Lesotho,China,0,5,0,5
27995,2022,Nigeria,China,0,71,0,71
27996,2022,Pakistan,China,33,5,0,38
27997,2022,Russian Federation,China,0,8,0,8
27998,2022,Rwanda,China,5,5,0,10
27999,2022,Somalia,China,104,0,0,104
28000,2022,Syrian Arab Rep.,China,39,6,0,45
28001,2022,Uganda,China,5,114,0,119
28002,2022,Uzbekistan,China,0,5,0,5
28003,2022,Yemen,China,31,13,0,44
28004,2022,Zambia,China,0,5,0,5
28005,2022,Zimbabwe,China,9,84,0,93
28006,2022,Afghanistan,Chile,19,136,0,155
28007,2022,Angola,Chile,0,5,0,5
28008,2022,Bangladesh,Chile,0,7,0,7
28009,2022,Bolivia (Plurinational State of),Chile,0,21,0,21
28010,2022,Congo,Chile,8,5,0,13
28011,2022,Dem. Rep. of the Congo,Chile,5,0,0,5
28012,2022,Colombia,Chile,1235,2413,0,3648
28013,2022,Costa Rica,Chile,5,0,0,5
28014,2022,Cuba,Chile,19,940,0,959
28015,2022,Dominican Rep.,Chile,0,95,0,95
28016,2022,Ecuador,Chile,23,29,0,52
28017,2022,Palestinian,Chile,15,6,0,21
28018,2022,Ghana,Chile,0,8,0,8
28019,2022,Guatemala,Chile,0,5,0,5
28020,2022,Haiti,Chile,0,185,0,185
28021,2022,Honduras,Chile,5,0,0,5
28022,2022,Iraq,Chile,0,14,0,14
28023,2022,Kenya,Chile,5,0,0,5
28024,2022,Rep. of Korea,Chile,0,5,0,5
28025,2022,Sri Lanka,Chile,5,0,0,5
28026,2022,Nicaragua,Chile,0,5,0,5
28027,2022,Pakistan,Chile,0,7,0,7
28028,2022,Peru,Chile,113,51,0,164
28029,2022,Russian Federation,Chile,5,34,0,39
28030,2022,El Salvador,Chile,9,27,0,36
28031,2022,Senegal,Chile,5,0,0,5
28032,2022,Sierra Leone,Chile,5,0,0,5
28033,2022,Syrian Arab Rep.,Chile,113,31,0,144
28034,2022,Türkiye,Chile,27,5,0,32
28035,2022,Ukraine,Chile,0,75,0,75
28036,2022,United States of America,Chile,0,5,0,5
28037,2022,Venezuela (Bolivarian Republic of),Chile,29,6526,0,6555
28039,2022,Angola,Cameroon,5,0,0,5
28040,2022,Burundi,Cameroon,50,20,0,70
28041,2022,Burkina Faso,Cameroon,0,24,0,24
28042,2022,Central African Rep.,Cameroon,338476,6041,0,344517
28043,2022,Chad,Cameroon,1467,494,0,1961
28044,2022,Cameroon,Cameroon,0,0,933138,0
28045,2022,Congo,Cameroon,40,13,0,53
28046,2022,Dem. Rep. of the Congo,Cameroon,455,155,0,610
28047,2022,Equatorial Guinea,Cameroon,0,5,0,5
28048,2022,Ethiopia,Cameroon,0,5,0,5
28049,2022,Gabon,Cameroon,0,5,0,5
28050,2022,Gambia,Cameroon,0,5,0,5
28051,2022,Guinea,Cameroon,7,207,0,214
28052,2022,Cote d'Ivoire,Cameroon,53,39,0,92
28053,2022,Iran (Islamic Rep. of),Cameroon,5,0,0,5
28054,2022,Iraq,Cameroon,0,6,0,6
28055,2022,Liberia,Cameroon,9,5,0,14
28056,2022,Mauritania,Cameroon,5,5,0,10
28057,2022,Mali,Cameroon,19,356,0,375
28058,2022,Morocco,Cameroon,7,0,0,7
28059,2022,Niger,Cameroon,0,921,0,921
28060,2022,Nigeria,Cameroon,134437,35,0,134472
28061,2022,Rwanda,Cameroon,260,156,0,416
28062,2022,Senegal,Cameroon,0,6,0,6
28063,2022,Sierra Leone,Cameroon,0,5,0,5
28064,2022,Sudan,Cameroon,64,36,0,100
28065,2022,South Sudan,Cameroon,5,8,0,13
28066,2022,Syrian Arab Rep.,Cameroon,5,10,0,15
28067,2022,Togo,Cameroon,18,15,0,33
28068,2022,Türkiye,Cameroon,0,5,0,5
28069,2022,Yemen,Cameroon,5,0,0,5
28070,2022,Angola,Congo,13,45,0,58
28071,2022,Egypt,Congo,0,0,0,0
28072,2022,Burundi,Congo,78,8,0,86
28073,2022,Central African Rep.,Congo,26173,3012,0,29185
28074,2022,Chad,Congo,27,27,0,54
28075,2022,Cameroon,Congo,5,27,0,32
28076,2022,Congo,Congo,0,0,134430,0
28077,2022,Dem. Rep. of the Congo,Congo,12125,10008,0,22133
28078,2022,Guinea,Congo,0,5,0,5
28079,2022,Cote d'Ivoire,Congo,5,5,0,10
28080,2022,Mauritania,Congo,5,45,0,50
28081,2022,Mali,Congo,5,0,0,5
28082,2022,Nigeria,Congo,5,0,0,5
28083,2022,Rwanda,Congo,2562,477,0,3039
28084,2022,Sudan,Congo,31,41,0,72
28085,2022,Syrian Arab Rep.,Congo,5,12,0,17
28086,2022,Angola,Dem. Rep. of the Congo,417,25,0,442
28087,2022,Burundi,Dem. Rep. of the Congo,41187,1434,0,42621
28088,2022,Central African Rep.,Dem. Rep. of the Congo,207054,64,0,207118
28089,2022,Chad,Dem. Rep. of the Congo,5,15,0,20
28090,2022,Cameroon,Dem. Rep. of the Congo,0,19,0,19
28091,2022,Congo,Dem. Rep. of the Congo,644,25,0,669
28092,2022,Dem. Rep. of the Congo,Dem. Rep. of the Congo,0,0,5338418,0
28093,2022,Eritrea,Dem. Rep. of the Congo,8,0,0,8
28094,2022,Ethiopia,Dem. Rep. of the Congo,0,5,0,5
28095,2022,Palestinian,Dem. Rep. of the Congo,0,6,0,6
28096,2022,Cote d'Ivoire,Dem. Rep. of the Congo,12,6,0,18
28097,2022,Liberia,Dem. Rep. of the Congo,5,10,0,15
28098,2022,Lebanon,Dem. Rep. of the Congo,0,5,0,5
28099,2022,Mali,Dem. Rep. of the Congo,0,11,0,11
28100,2022,Niger,Dem. Rep. of the Congo,0,5,0,5
28101,2022,Romania,Dem. Rep. of the Congo,0,5,0,5
28102,2022,Rwanda,Dem. Rep. of the Congo,210067,110,0,210177
28103,2022,Somalia,Dem. Rep. of the Congo,14,163,0,177
28104,2022,Sudan,Dem. Rep. of the Congo,47,7,0,54
28105,2022,South Sudan,Dem. Rep. of the Congo,56303,761,0,57064
28106,2022,Syrian Arab Rep.,Dem. Rep. of the Congo,12,14,0,26
28107,2022,Uganda,Dem. Rep. of the Congo,25,5,0,30
28108,2022,Zimbabwe,Dem. Rep. of the Congo,0,6,0,6
28109,2022,Dem. Rep. of the Congo,Comoros,19,0,0,19
28110,2022,Afghanistan,Colombia,9,5,0,14
28111,2022,Bolivia (Plurinational State of),Colombia,5,0,0,5
28112,2022,Colombia,Colombia,0,0,6746833,0
28113,2022,Cuba,Colombia,88,92,0,180
28114,2022,Ecuador,Colombia,5,11,0,16
28115,2022,Eritrea,Colombia,5,0,0,5
28116,2022,Ethiopia,Colombia,7,0,0,7
28117,2022,Ghana,Colombia,5,0,0,5
28118,2022,Haiti,Colombia,0,8,0,8
28119,2022,Honduras,Colombia,5,0,0,5
28120,2022,Hungary,Colombia,5,0,0,5
28121,2022,Iraq,Colombia,8,0,0,8
28122,2022,Liberia,Colombia,5,0,0,5
28123,2022,Nicaragua,Colombia,10,0,0,10
28124,2022,Russian Federation,Colombia,0,12,0,12
28125,2022,El Salvador,Colombia,7,5,0,12
28126,2022,Serbia and Kosovo: S/RES/1244 (1999),Colombia,5,0,0,5
28127,2022,Sierra Leone,Colombia,5,0,0,5
28128,2022,Somalia,Colombia,11,0,0,11
28129,2022,Syrian Arab Rep.,Colombia,11,7,0,18
28130,2022,Türkiye,Colombia,6,9,0,15
28131,2022,Ukraine,Colombia,0,10,0,10
28132,2022,Venezuela (Bolivarian Republic of),Colombia,1315,26755,0,28070
28133,2022,Yemen,Colombia,0,5,0,5
28136,2022,Angola,Costa Rica,0,63,0,63
28137,2022,Argentina,Costa Rica,0,50,0,50
28138,2022,Australia,Costa Rica,0,5,0,5
28139,2022,Burundi,Costa Rica,9,0,0,9
28140,2022,Bangladesh,Costa Rica,0,16,0,16
28141,2022,Burkina Faso,Costa Rica,0,5,0,5
28142,2022,Belarus,Costa Rica,0,5,0,5
28143,2022,Bolivia (Plurinational State of),Costa Rica,0,18,0,18
28144,2022,Brazil,Costa Rica,0,163,0,163
28145,2022,Belize,Costa Rica,0,5,0,5
28146,2022,China,Costa Rica,0,340,0,340
28147,2022,Chile,Costa Rica,0,61,0,61
28148,2022,Cameroon,Costa Rica,0,22,0,22
28149,2022,Congo,Costa Rica,0,57,0,57
28150,2022,Dem. Rep. of the Congo,Costa Rica,12,66,0,78
28151,2022,Colombia,Costa Rica,2315,2125,0,4440
28152,2022,Cuba,Costa Rica,481,3209,0,3690
28153,2022,Czechia,Costa Rica,0,5,0,5
28154,2022,Dominican Rep.,Costa Rica,0,146,0,146
28155,2022,Ecuador,Costa Rica,0,78,0,78
28156,2022,Eritrea,Costa Rica,0,7,0,7
28157,2022,Ethiopia,Costa Rica,5,0,0,5
28158,2022,French Guiana,Costa Rica,0,5,0,5
28159,2022,Gambia,Costa Rica,0,5,0,5
28160,2022,Germany,Costa Rica,0,13,0,13
28161,2022,Ghana,Costa Rica,0,61,0,61
28162,2022,Greece,Costa Rica,0,5,0,5
28163,2022,Guatemala,Costa Rica,25,131,0,156
28164,2022,Guyana,Costa Rica,0,9,0,9
28165,2022,Haiti,Costa Rica,12,886,0,898
28166,2022,Honduras,Costa Rica,223,1091,0,1314
28167,2022,Cote d'Ivoire,Costa Rica,0,6,0,6
28168,2022,India,Costa Rica,0,5,0,5
28169,2022,Indonesia,Costa Rica,5,0,0,5
28170,2022,Iran (Islamic Rep. of),Costa Rica,5,0,0,5
28171,2022,Iraq,Costa Rica,5,0,0,5
28172,2022,Israel,Costa Rica,0,6,0,6
28173,2022,Italy,Costa Rica,0,13,0,13
28174,2022,Jamaica,Costa Rica,0,44,0,44
28175,2022,Lebanon,Costa Rica,0,5,0,5
28176,2022,Latvia,Costa Rica,0,5,0,5
28177,2022,Mexico,Costa Rica,13,75,0,88
28178,2022,Nepal,Costa Rica,0,102,0,102
28179,2022,Niger,Costa Rica,0,5,0,5
28180,2022,Nicaragua,Costa Rica,4571,187304,0,191875
28181,2022,Nigeria,Costa Rica,17,7,0,24
28182,2022,Pakistan,Costa Rica,5,11,0,16
28183,2022,Panama,Costa Rica,6,76,0,82
28184,2022,Paraguay,Costa Rica,0,5,0,5
28185,2022,Peru,Costa Rica,13,70,0,83
28186,2022,Poland,Costa Rica,0,5,0,5
28187,2022,Romania,Costa Rica,0,7,0,7
28188,2022,South Africa,Costa Rica,0,7,0,7
28189,2022,Russian Federation,Costa Rica,27,158,0,185
28190,2022,El Salvador,Costa Rica,1611,114,0,1725
28191,2022,Senegal,Costa Rica,0,5,0,5
28192,2022,Somalia,Costa Rica,7,7,0,14
28193,2022,Spain,Costa Rica,0,10,0,10
28194,2022,Viet Nam,Costa Rica,0,7,0,7
28195,2022,Suriname,Costa Rica,0,5,0,5
28196,2022,Syrian Arab Rep.,Costa Rica,5,29,0,34
28197,2022,Türkiye,Costa Rica,0,6,0,6
28198,2022,Ukraine,Costa Rica,13,21,0,34
28199,2022,Uruguay,Costa Rica,0,6,0,6
28200,2022,United States of America,Costa Rica,5,43,0,48
28201,2022,Venezuela (Bolivarian Republic of),Costa Rica,1797,7893,0,9690
28202,2022,Zimbabwe,Costa Rica,0,5,0,5
28205,2022,Afghanistan,Cuba,14,0,0,14
28206,2022,Cuba,Cuba,0,0,0,0
28207,2022,Eritrea,Cuba,5,0,0,5
28208,2022,Ethiopia,Cuba,5,0,0,5
28209,2022,Haiti,Cuba,5,0,0,5
28210,2022,Iran (Islamic Rep. of),Cuba,7,5,0,12
28211,2022,Sudan,Cuba,11,0,0,11
28212,2022,Syrian Arab Rep.,Cuba,23,8,0,31
28213,2022,Yemen,Cuba,11,0,0,11
28215,2022,Afghanistan,Cyprus,20,804,0,824
28216,2022,Albania,Cyprus,0,5,0,5
28217,2022,Algeria,Cyprus,8,5,0,13
28218,2022,Angola,Cyprus,0,26,0,26
28219,2022,Egypt,Cyprus,125,394,0,519
28220,2022,Armenia,Cyprus,26,17,0,43
28221,2022,Azerbaijan,Cyprus,0,6,0,6
28222,2022,Burundi,Cyprus,0,28,0,28
28223,2022,Bangladesh,Cyprus,11,1977,0,1988
28224,2022,Burkina Faso,Cyprus,0,10,0,10
28225,2022,Belarus,Cyprus,0,6,0,6
28226,2022,Bosnia and Herzegovina,Cyprus,15,0,0,15
28227,2022,Central African Rep.,Cyprus,0,5,0,5
28228,2022,China,Cyprus,5,12,0,17
28229,2022,Cameroon,Cyprus,160,3288,0,3448
28230,2022,Congo,Cyprus,11,184,0,195
28231,2022,Dem. Rep. of the Congo,Cyprus,45,4194,0,4239
28232,2022,Comoros,Cyprus,0,10,0,10
28233,2022,Colombia,Cyprus,0,5,0,5
28234,2022,Djibouti,Cyprus,0,10,0,10
28235,2022,Eritrea,Cyprus,54,5,0,59
28236,2022,Ethiopia,Cyprus,10,21,0,31
28237,2022,Gabon,Cyprus,0,5,0,5
28238,2022,Gambia,Cyprus,6,65,0,71
28239,2022,Palestinian,Cyprus,2218,130,0,2348
28240,2022,Georgia,Cyprus,85,506,0,591
28241,2022,Ghana,Cyprus,0,47,0,47
28242,2022,Guinea-Bissau,Cyprus,0,5,0,5
28243,2022,Guinea,Cyprus,8,524,0,532
28244,2022,Haiti,Cyprus,0,10,0,10
28245,2022,Cote d'Ivoire,Cyprus,5,104,0,109
28246,2022,India,Cyprus,10,1716,0,1726
28247,2022,Iran (Islamic Rep. of),Cyprus,645,595,0,1240
28248,2022,Iraq,Cyprus,1006,104,0,1110
28249,2022,Israel,Cyprus,0,7,0,7
28250,2022,Jordan,Cyprus,55,74,0,129
28251,2022,Kazakhstan,Cyprus,5,0,0,5
28252,2022,Kenya,Cyprus,0,6,0,6
28253,2022,Kyrgyzstan,Cyprus,5,0,0,5
28254,2022,Liberia,Cyprus,0,327,0,327
28255,2022,Libya,Cyprus,12,5,0,17
28256,2022,Lebanon,Cyprus,61,92,0,153
28257,2022,Sri Lanka,Cyprus,29,387,0,416
28258,2022,Rep. of Moldova,Cyprus,18,19,0,37
28259,2022,Mali,Cyprus,0,6,0,6
28260,2022,Mongolia,Cyprus,0,46,0,46
28261,2022,Morocco,Cyprus,0,7,0,7
28262,2022,Nepal,Cyprus,0,1005,0,1005
28263,2022,Niger,Cyprus,0,6,0,6
28264,2022,Nigeria,Cyprus,28,3815,0,3843
28265,2022,Pakistan,Cyprus,27,1939,0,1966
28266,2022,Philippines,Cyprus,12,188,0,200
28267,2022,South Africa,Cyprus,0,5,0,5
28268,2022,Russian Federation,Cyprus,78,115,0,193
28269,2022,Rwanda,Cyprus,5,16,0,21
28270,2022,Serbia and Kosovo: S/RES/1244 (1999),Cyprus,59,9,0,68
28271,2022,Senegal,Cyprus,0,44,0,44
28272,2022,Sierra Leone,Cyprus,28,734,0,762
28273,2022,Somalia,Cyprus,408,1369,0,1777
28274,2022,Viet Nam,Cyprus,5,317,0,322
28275,2022,Sudan,Cyprus,14,10,0,24
28276,2022,Syrian Arab Rep.,Cyprus,10869,7229,0,18098
28277,2022,Tajikistan,Cyprus,0,5,0,5
28278,2022,Turkmenistan,Cyprus,0,6,0,6
28279,2022,Togo,Cyprus,0,23,0,23
28280,2022,Türkiye,Cyprus,253,329,0,582
28281,2022,Uganda,Cyprus,0,5,0,5
28282,2022,Ukraine,Cyprus,13707,94,0,13801
28283,2022,Uzbekistan,Cyprus,5,6,0,11
28284,2022,Yemen,Cyprus,47,32,0,79
28285,2022,Zimbabwe,Cyprus,0,26,0,26
28288,2022,Afghanistan,Czechia,173,18,0,191
28289,2022,Algeria,Czechia,0,6,0,6
28290,2022,Egypt,Czechia,8,8,0,16
28291,2022,Armenia,Czechia,19,6,0,25
28292,2022,Azerbaijan,Czechia,35,16,0,51
28293,2022,Burundi,Czechia,5,0,0,5
28294,2022,Belarus,Czechia,180,43,0,223
28295,2022,China,Czechia,65,5,0,70
28296,2022,Cameroon,Czechia,0,5,0,5
28297,2022,Dem. Rep. of the Congo,Czechia,7,0,0,7
28298,2022,Colombia,Czechia,0,5,0,5
28299,2022,Cuba,Czechia,41,0,0,41
28300,2022,Eritrea,Czechia,11,0,0,11
28301,2022,Ethiopia,Czechia,5,0,0,5
28302,2022,Georgia,Czechia,11,18,0,29
28303,2022,India,Czechia,0,13,0,13
28304,2022,Iran (Islamic Rep. of),Czechia,10,5,0,15
28305,2022,Iraq,Czechia,95,6,0,101
28306,2022,Kazakhstan,Czechia,110,17,0,127
28307,2022,Kyrgyzstan,Czechia,20,0,0,20
28308,2022,Libya,Czechia,21,6,0,27
28309,2022,Lebanon,Czechia,5,5,0,10
28310,2022,Sri Lanka,Czechia,7,0,0,7
28311,2022,Rep. of Moldova,Czechia,17,24,0,41
28312,2022,Mongolia,Czechia,9,10,0,19
28313,2022,Myanmar,Czechia,154,9,0,163
28314,2022,Nepal,Czechia,0,5,0,5
28315,2022,Nigeria,Czechia,7,22,0,29
28316,2022,Pakistan,Czechia,7,10,0,17
28317,2022,Russian Federation,Czechia,178,83,0,261
28318,2022,Saudi Arabia,Czechia,5,0,0,5
28319,2022,Serbia and Kosovo: S/RES/1244 (1999),Czechia,5,0,0,5
28320,2022,Sierra Leone,Czechia,5,0,0,5
28321,2022,Somalia,Czechia,26,0,0,26
28322,2022,Viet Nam,Czechia,15,28,0,43
28323,2022,Sudan,Czechia,9,0,0,9
28324,2022,Syrian Arab Rep.,Czechia,422,11,0,433
28325,2022,Tajikistan,Czechia,5,0,0,5
28326,2022,Turkmenistan,Czechia,7,0,0,7
28327,2022,Togo,Czechia,5,0,0,5
28328,2022,Tunisia,Czechia,0,5,0,5
28329,2022,Türkiye,Czechia,14,40,0,54
28330,2022,Uganda,Czechia,5,0,0,5
28331,2022,Ukraine,Czechia,386371,278,0,386649
28332,2022,Uzbekistan,Czechia,40,33,0,73
28333,2022,Venezuela (Bolivarian Republic of),Czechia,12,15,0,27
28334,2022,Yemen,Czechia,29,0,0,29
28337,2022,Afghanistan,Denmark,1620,561,0,2181
28338,2022,Algeria,Denmark,0,5,0,5
28339,2022,Egypt,Denmark,18,13,0,31
28340,2022,Armenia,Denmark,71,25,0,96
28341,2022,Azerbaijan,Denmark,30,9,0,39
28342,2022,Bahrain,Denmark,5,0,0,5
28343,2022,Burundi,Denmark,5,0,0,5
28344,2022,Bangladesh,Denmark,18,7,0,25
28345,2022,Belarus,Denmark,5,44,0,49
28346,2022,Bosnia and Herzegovina,Denmark,5,0,0,5
28347,2022,China,Denmark,18,16,0,34
28348,2022,Cameroon,Denmark,9,5,0,14
28349,2022,Dem. Rep. of the Congo,Denmark,63,12,0,75
28350,2022,Colombia,Denmark,5,19,0,24
28351,2022,Eritrea,Denmark,5885,142,0,6027
28352,2022,Ethiopia,Denmark,92,15,0,107
28353,2022,Gambia,Denmark,5,5,0,10
28354,2022,Georgia,Denmark,0,24,0,24
28355,2022,Ghana,Denmark,5,6,0,11
28356,2022,Guinea-Bissau,Denmark,5,0,0,5
28357,2022,Cote d'Ivoire,Denmark,10,0,0,10
28358,2022,India,Denmark,0,13,0,13
28359,2022,Iran (Islamic Rep. of),Denmark,2618,97,0,2715
28360,2022,Iraq,Denmark,269,61,0,330
28361,2022,Jordan,Denmark,0,9,0,9
28362,2022,Kenya,Denmark,6,0,0,6
28363,2022,Kyrgyzstan,Denmark,0,5,0,5
28364,2022,Libya,Denmark,0,5,0,5
28365,2022,Lebanon,Denmark,29,8,0,37
28366,2022,Sri Lanka,Denmark,34,0,0,34
28367,2022,North Macedonia,Denmark,0,5,0,5
28368,2022,Mongolia,Denmark,0,5,0,5
28369,2022,Morocco,Denmark,7,28,0,35
28370,2022,Myanmar,Denmark,13,10,0,23
28371,2022,Nicaragua,Denmark,13,0,0,13
28372,2022,Nigeria,Denmark,10,29,0,39
28373,2022,Pakistan,Denmark,60,18,0,78
28374,2022,Russian Federation,Denmark,565,63,0,628
28375,2022,Rwanda,Denmark,11,0,0,11
28376,2022,El Salvador,Denmark,5,0,0,5
28377,2022,Serbia and Kosovo: S/RES/1244 (1999),Denmark,5,5,0,10
28378,2022,Somalia,Denmark,1226,23,0,1249
28379,2022,Viet Nam,Denmark,0,23,0,23
28380,2022,Sudan,Denmark,48,10,0,58
28381,2022,Syrian Arab Rep.,Denmark,19424,203,0,19627
28382,2022,Thailand,Denmark,5,5,0,10
28383,2022,Tajikistan,Denmark,5,0,0,5
28384,2022,Tunisia,Denmark,5,10,0,15
28385,2022,Türkiye,Denmark,27,36,0,63
28386,2022,Uganda,Denmark,72,5,0,77
28387,2022,Ukraine,Denmark,27954,1191,0,29145
28388,2022,United States of America,Denmark,0,5,0,5
28389,2022,Uzbekistan,Denmark,6,40,0,46
28390,2022,Venezuela (Bolivarian Republic of),Denmark,5,5,0,10
28391,2022,Yemen,Denmark,7,0,0,7
28392,2022,Zambia,Denmark,5,0,0,5
28393,2022,Zimbabwe,Denmark,7,5,0,12
28396,2022,Dem. Rep. of the Congo,Djibouti,0,13,0,13
28397,2022,Eritrea,Djibouti,673,350,0,1023
28398,2022,Ethiopia,Djibouti,2961,10667,0,13628
28399,2022,Iraq,Djibouti,16,0,0,16
28400,2022,Mali,Djibouti,5,5,0,10
28401,2022,Somalia,Djibouti,14152,138,0,14290
28402,2022,Sudan,Djibouti,9,5,0,14
28403,2022,Syrian Arab Rep.,Djibouti,15,5,0,20
28404,2022,Yemen,Djibouti,6518,0,0,6518
28405,2022,Afghanistan,Dominican Rep.,0,8,0,8
28406,2022,Colombia,Dominican Rep.,0,7,0,7
28407,2022,Cuba,Dominican Rep.,0,79,0,79
28408,2022,Haiti,Dominican Rep.,185,586,0,771
28409,2022,Honduras,Dominican Rep.,0,5,0,5
28410,2022,Sri Lanka,Dominican Rep.,0,5,0,5
28411,2022,Nicaragua,Dominican Rep.,0,11,0,11
28412,2022,Syrian Arab Rep.,Dominican Rep.,5,0,0,5
28413,2022,Venezuela (Bolivarian Republic of),Dominican Rep.,0,297,0,297
28415,2022,Afghanistan,Ecuador,151,0,0,151
28416,2022,Albania,Ecuador,6,0,0,6
28417,2022,Angola,Ecuador,5,0,0,5
28418,2022,Egypt,Ecuador,5,8,0,13
28419,2022,Bangladesh,Ecuador,5,5,0,10
28420,2022,Brazil,Ecuador,5,5,0,10
28421,2022,China,Ecuador,12,0,0,12
28422,2022,Chile,Ecuador,7,5,0,12
28423,2022,Cameroon,Ecuador,19,5,0,24
28424,2022,Congo,Ecuador,10,5,0,15
28425,2022,Dem. Rep. of the Congo,Ecuador,8,5,0,13
28426,2022,Colombia,Ecuador,56295,4566,0,60861
28427,2022,Cuba,Ecuador,226,168,0,394
28428,2022,Dominican Rep.,Ecuador,5,5,0,10
28429,2022,Eritrea,Ecuador,11,5,0,16
28430,2022,Ethiopia,Ecuador,5,0,0,5
28431,2022,Palestinian,Ecuador,10,7,0,17
28432,2022,Ghana,Ecuador,5,0,0,5
28433,2022,Guinea,Ecuador,9,0,0,9
28434,2022,Haiti,Ecuador,26,10,0,36
28435,2022,Honduras,Ecuador,0,5,0,5
28436,2022,Cote d'Ivoire,Ecuador,5,0,0,5
28437,2022,India,Ecuador,5,6,0,11
28438,2022,Iran (Islamic Rep. of),Ecuador,69,7,0,76
28439,2022,Iraq,Ecuador,61,0,0,61
28440,2022,Liberia,Ecuador,6,0,0,6
28441,2022,Lebanon,Ecuador,16,12,0,28
28442,2022,Sri Lanka,Ecuador,18,5,0,23
28443,2022,Mali,Ecuador,5,0,0,5
28444,2022,Morocco,Ecuador,5,0,0,5
28445,2022,Nepal,Ecuador,5,0,0,5
28446,2022,Nicaragua,Ecuador,5,0,0,5
28447,2022,Nigeria,Ecuador,41,12,0,53
28448,2022,Pakistan,Ecuador,30,0,0,30
28449,2022,Panama,Ecuador,5,0,0,5
28450,2022,Peru,Ecuador,82,90,0,172
28451,2022,South Africa,Ecuador,0,5,0,5
28452,2022,Russian Federation,Ecuador,41,5,0,46
28453,2022,El Salvador,Ecuador,33,7,0,40
28454,2022,Saudi Arabia,Ecuador,8,0,0,8
28455,2022,Somalia,Ecuador,8,0,0,8
28456,2022,Spain,Ecuador,5,0,0,5
28457,2022,Viet Nam,Ecuador,5,0,0,5
28458,2022,Sudan,Ecuador,5,0,0,5
28459,2022,Syrian Arab Rep.,Ecuador,162,5,0,167
28460,2022,Togo,Ecuador,0,5,0,5
28461,2022,Türkiye,Ecuador,5,0,0,5
28462,2022,Uganda,Ecuador,7,0,0,7
28463,2022,Ukraine,Ecuador,44,16,0,60
28464,2022,United States of America,Ecuador,8,0,0,8
28465,2022,Uzbekistan,Ecuador,5,0,0,5
28466,2022,Venezuela (Bolivarian Republic of),Ecuador,1174,6642,0,7816
28467,2022,Western Sahara,Ecuador,5,0,0,5
28468,2022,Yemen,Ecuador,115,12,0,127
28469,2022,Zimbabwe,Ecuador,6,7,0,13
28471,2022,Eritrea,Eritrea,0,0,0,0
28472,2022,Ethiopia,Eritrea,15,0,0,15
28473,2022,Sudan,Eritrea,99,0,0,99
28474,2022,South Sudan,Eritrea,7,0,0,7
28475,2022,Afghanistan,Estonia,22,5,0,27
28476,2022,Egypt,Estonia,5,0,0,5
28477,2022,Azerbaijan,Estonia,15,0,0,15
28478,2022,Belarus,Estonia,18,6,0,24
28479,2022,Eritrea,Estonia,10,0,0,10
28480,2022,Georgia,Estonia,9,5,0,14
28481,2022,Iran (Islamic Rep. of),Estonia,5,0,0,5
28482,2022,Iraq,Estonia,17,0,0,17
28483,2022,Kazakhstan,Estonia,5,0,0,5
28484,2022,Rep. of Moldova,Estonia,10,0,0,10
28485,2022,Nigeria,Estonia,7,5,0,12
28486,2022,Pakistan,Estonia,5,0,0,5
28487,2022,Russian Federation,Estonia,118,79,0,197
28488,2022,Serbia and Kosovo: S/RES/1244 (1999),Estonia,7,0,0,7
28489,2022,Sudan,Estonia,13,0,0,13
28490,2022,Syrian Arab Rep.,Estonia,94,0,0,94
28491,2022,Turkmenistan,Estonia,5,0,0,5
28492,2022,Türkiye,Estonia,29,0,0,29
28493,2022,Ukraine,Estonia,28181,69,0,28250
28494,2022,United States of America,Estonia,5,0,0,5
28495,2022,Uzbekistan,Estonia,5,5,0,10
28496,2022,Yemen,Estonia,5,0,0,5
28498,2022,Egypt,Ethiopia,5,0,0,5
28499,2022,Burundi,Ethiopia,63,68,0,131
28500,2022,Chad,Ethiopia,0,5,0,5
28501,2022,Dem. Rep. of the Congo,Ethiopia,786,262,0,1048
28502,2022,Cuba,Ethiopia,5,0,0,5
28503,2022,Djibouti,Ethiopia,53,5,0,58
28504,2022,Eritrea,Ethiopia,161203,255,0,161458
28505,2022,Ethiopia,Ethiopia,0,0,4500000,0
28506,2022,Palestinian,Ethiopia,0,13,0,13
28507,2022,Cote d'Ivoire,Ethiopia,5,0,0,5
28508,2022,Iraq,Ethiopia,10,0,0,10
28509,2022,Jordan,Ethiopia,0,19,0,19
28510,2022,Kenya,Ethiopia,4023,0,0,4023
28511,2022,Lebanon,Ethiopia,0,18,0,18
28512,2022,Mali,Ethiopia,0,5,0,5
28513,2022,Nigeria,Ethiopia,5,5,0,10
28514,2022,Rwanda,Ethiopia,11,7,0,18
28515,2022,Somalia,Ethiopia,249104,51,0,249155
28516,2022,Sudan,Ethiopia,46989,605,0,47594
28517,2022,South Sudan,Ethiopia,403115,204,0,403319
28518,2022,Syrian Arab Rep.,Ethiopia,55,613,0,668
28519,2022,Uganda,Ethiopia,11,5,0,16
28520,2022,Yemen,Ethiopia,2356,107,0,2463
28521,2022,Afghanistan,Fiji,7,0,0,7
28522,2022,Bangladesh,Fiji,5,0,0,5
28523,2022,Afghanistan,Finland,3755,565,0,4320
28524,2022,Albania,Finland,5,15,0,20
28525,2022,Algeria,Finland,6,11,0,17
28526,2022,Angola,Finland,52,11,0,63
28527,2022,Egypt,Finland,41,22,0,63
28528,2022,Armenia,Finland,0,5,0,5
28529,2022,Azerbaijan,Finland,71,0,0,71
28530,2022,Burundi,Finland,6,0,0,6
28531,2022,Bangladesh,Finland,23,16,0,39
28532,2022,Burkina Faso,Finland,5,0,0,5
28533,2022,Belarus,Finland,19,22,0,41
28534,2022,Brazil,Finland,0,6,0,6
28535,2022,Cambodia,Finland,5,5,0,10
28536,2022,Central African Rep.,Finland,6,0,0,6
28537,2022,China,Finland,184,12,0,196
28538,2022,Cameroon,Finland,134,61,0,195
28539,2022,Congo,Finland,6,0,0,6
28540,2022,Dem. Rep. of the Congo,Finland,92,28,0,120
28541,2022,Colombia,Finland,5,37,0,42
28542,2022,Cuba,Finland,5,34,0,39
28543,2022,Dominican Rep.,Finland,5,0,0,5
28544,2022,Eritrea,Finland,871,7,0,878
28545,2022,Ethiopia,Finland,151,43,0,194
28546,2022,Gambia,Finland,28,28,0,56
28547,2022,United Kingdom of Great Britain and Northern Ireland,Finland,0,6,0,6
28548,2022,Georgia,Finland,0,67,0,67
28549,2022,Ghana,Finland,33,23,0,56
28550,2022,Guatemala,Finland,5,0,0,5
28551,2022,Guinea,Finland,24,5,0,29
28552,2022,Honduras,Finland,32,24,0,56
28553,2022,Cote d'Ivoire,Finland,7,5,0,12
28554,2022,India,Finland,5,6,0,11
28555,2022,Indonesia,Finland,5,0,0,5
28556,2022,Iran (Islamic Rep. of),Finland,958,192,0,1150
28557,2022,Iraq,Finland,9175,1508,0,10683
28558,2022,Jordan,Finland,6,5,0,11
28559,2022,Kazakhstan,Finland,8,0,0,8
28560,2022,Kenya,Finland,19,10,0,29
28561,2022,Kyrgyzstan,Finland,18,0,0,18
28562,2022,Liberia,Finland,5,0,0,5
28563,2022,Libya,Finland,33,12,0,45
28564,2022,Lebanon,Finland,12,5,0,17
28565,2022,Sri Lanka,Finland,31,17,0,48
28566,2022,Rep. of Moldova,Finland,6,11,0,17
28567,2022,Mexico,Finland,0,5,0,5
28568,2022,Mali,Finland,8,0,0,8
28569,2022,Malaysia,Finland,5,0,0,5
28570,2022,Morocco,Finland,40,26,0,66
28571,2022,Myanmar,Finland,31,9,0,40
28572,2022,Nepal,Finland,0,5,0,5
28573,2022,Niger,Finland,0,5,0,5
28574,2022,Nicaragua,Finland,73,0,0,73
28575,2022,Nigeria,Finland,139,139,0,278
28576,2022,Pakistan,Finland,80,36,0,116
28577,2022,Peru,Finland,0,5,0,5
28578,2022,Russian Federation,Finland,832,613,0,1445
28579,2022,Rwanda,Finland,49,37,0,86
28580,2022,El Salvador,Finland,10,12,0,22
28581,2022,Serbia and Kosovo: S/RES/1244 (1999),Finland,36,7,0,43
28582,2022,Senegal,Finland,5,5,0,10
28583,2022,Sierra Leone,Finland,5,13,0,18
28584,2022,Somalia,Finland,2483,467,0,2950
28585,2022,Viet Nam,Finland,7,5,0,12
28586,2022,Sudan,Finland,55,10,0,65
28587,2022,South Sudan,Finland,8,0,0,8
28588,2022,Syrian Arab Rep.,Finland,2610,100,0,2710
28589,2022,United Rep. of Tanzania,Finland,7,0,0,7
28590,2022,Tajikistan,Finland,9,5,0,14
28591,2022,Togo,Finland,5,0,0,5
28592,2022,Tunisia,Finland,5,10,0,15
28593,2022,Türkiye,Finland,876,201,0,1077
28594,2022,Uganda,Finland,36,16,0,52
28595,2022,Ukraine,Finland,29172,715,0,29887
28596,2022,United States of America,Finland,0,7,0,7
28597,2022,Uzbekistan,Finland,10,9,0,19
28598,2022,Venezuela (Bolivarian Republic of),Finland,5,12,0,17
28599,2022,Yemen,Finland,315,24,0,339
28600,2022,Zimbabwe,Finland,6,0,0,6
28603,2022,Afghanistan,France,55681,9066,0,64747
28604,2022,Albania,France,10236,2003,0,12239
28605,2022,Algeria,France,3278,407,0,3685
28606,2022,Angola,France,6808,484,0,7292
28607,2022,Egypt,France,1670,368,0,2038
28608,2022,Argentina,France,12,6,0,18
28609,2022,Armenia,France,6417,891,0,7308
28610,2022,Azerbaijan,France,4664,271,0,4935
28611,2022,Bahrain,France,21,0,0,21
28612,2022,Burundi,France,1953,331,0,2284
28613,2022,Benin,France,221,164,0,385
28614,2022,Bangladesh,France,8858,5013,0,13871
28615,2022,Bhutan,France,178,0,0,178
28616,2022,Burkina Faso,France,590,242,0,832
28617,2022,Belarus,France,844,52,0,896
28618,2022,Bolivia (Plurinational State of),France,65,5,0,70
28619,2022,Brazil,France,65,74,0,139
28620,2022,Bosnia and Herzegovina,France,6913,130,0,7043
28621,2022,Bulgaria,France,70,0,0,70
28622,2022,Cambodia,France,11012,12,0,11024
28623,2022,Canada,France,5,0,0,5
28624,2022,Central African Rep.,France,5318,126,0,5444
28625,2022,Chad,France,3237,1183,0,4420
28626,2022,China,France,10543,223,0,10766
28627,2022,Chile,France,153,13,0,166
28628,2022,Cameroon,France,2736,1054,0,3790
28629,2022,Congo,France,5744,726,0,6470
28630,2022,Dem. Rep. of the Congo,France,31935,2645,0,34580
28631,2022,Comoros,France,1721,806,0,2527
28632,2022,Colombia,France,1185,807,0,1992
28633,2022,Cuba,France,331,111,0,442
28634,2022,Cabo Verde,France,0,10,0,10
28635,2022,Djibouti,France,569,172,0,741
28636,2022,Dominica,France,5,0,0,5
28637,2022,Dominican Rep.,France,160,78,0,238
28638,2022,Ecuador,France,37,0,0,37
28639,2022,Equatorial Guinea,France,60,15,0,75
28640,2022,Eritrea,France,11489,482,0,11971
28641,2022,Estonia,France,5,0,0,5
28642,2022,Ethiopia,France,3208,376,0,3584
28643,2022,Gabon,France,520,194,0,714
28644,2022,Gambia,France,548,191,0,739
28645,2022,Palestinian,France,1981,51,0,2032
28646,2022,Georgia,France,5896,2615,0,8511
28647,2022,Ghana,France,600,58,0,658
28648,2022,Guinea-Bissau,France,1288,42,0,1330
28649,2022,Guatemala,France,21,9,0,30
28650,2022,Guinea,France,21225,2575,0,23800
28651,2022,Guyana,France,31,0,0,31
28652,2022,Haiti,France,6910,342,0,7252
28653,2022,Honduras,France,51,9,0,60
28654,2022,Croatia,France,63,0,0,63
28655,2022,Hungary,France,72,10,0,82
28656,2022,Cote d'Ivoire,France,12286,3014,0,15300
28657,2022,India,France,321,69,0,390
28658,2022,Indonesia,France,9,0,0,9
28659,2022,Iran (Islamic Rep. of),France,4070,294,0,4364
28660,2022,Iraq,France,13974,358,0,14332
28661,2022,Israel,France,9,0,0,9
28662,2022,Italy,France,0,5,0,5
28663,2022,Jamaica,France,38,9,0,47
28664,2022,Jordan,France,61,5,0,66
28665,2022,Kazakhstan,France,1052,43,0,1095
28666,2022,Kenya,France,199,10,0,209
28667,2022,Kyrgyzstan,France,530,32,0,562
28668,2022,Kuwait,France,511,30,0,541
28669,2022,Lao People's Dem. Rep.,France,6498,15,0,6513
28670,2022,Liberia,France,344,22,0,366
28671,2022,Libya,France,2343,156,0,2499
28672,2022,Saint Lucia,France,6,8,0,14
28673,2022,Lebanon,France,344,143,0,487
28674,2022,Sri Lanka,France,33834,896,0,34730
28675,2022,Lithuania,France,6,0,0,6
28676,2022,Latvia,France,38,0,0,38
28677,2022,Madagascar,France,429,437,0,866
28678,2022,Mauritania,France,8124,896,0,9020
28679,2022,North Macedonia,France,742,141,0,883
28680,2022,Rep. of Moldova,France,455,194,0,649
28681,2022,Maldives,France,6,0,0,6
28682,2022,Mexico,France,34,17,0,51
28683,2022,Mali,France,8101,1207,0,9308
28684,2022,Malaysia,France,28,0,0,28
28685,2022,Mongolia,France,835,43,0,878
28686,2022,Morocco,France,1328,201,0,1529
28687,2022,Mozambique,France,18,0,0,18
28688,2022,Montenegro,France,197,24,0,221
28689,2022,Mauritius,France,58,6,0,64
28690,2022,Myanmar,France,369,17,0,386
28691,2022,Nepal,France,220,41,0,261
28692,2022,Niger,France,214,56,0,270
28693,2022,Nicaragua,France,74,17,0,91
28694,2022,Nigeria,France,6111,2787,0,8898
28695,2022,Pakistan,France,2866,1208,0,4074
28696,2022,Paraguay,France,9,0,0,9
28697,2022,Peru,France,486,111,0,597
28698,2022,Philippines,France,7,0,0,7
28699,2022,Poland,France,134,0,0,134
28700,2022,Romania,France,170,0,0,170
28701,2022,South Africa,France,150,10,0,160
28702,2022,Russian Federation,France,33148,1168,0,34316
28703,2022,Rwanda,France,4480,369,0,4849
28704,2022,El Salvador,France,116,10,0,126
28705,2022,Saudi Arabia,France,42,0,0,42
28706,2022,Serbia and Kosovo: S/RES/1244 (1999),France,18008,596,0,18604
28707,2022,Senegal,France,2932,849,0,3781
28708,2022,Sierra Leone,France,1206,292,0,1498
28709,2022,Somalia,France,10210,2935,0,13145
28710,2022,Viet Nam,France,7991,15,0,8006
28711,2022,Sudan,France,24223,1104,0,25327
28712,2022,Suriname,France,11,21,0,32
28713,2022,South Sudan,France,245,7,0,252
28714,2022,Slovakia,France,140,0,0,140
28715,2022,Syrian Arab Rep.,France,39091,507,0,39598
28716,2022,United Rep. of Tanzania,France,28,19,0,47
28717,2022,Thailand,France,15,5,0,20
28718,2022,Tajikistan,France,135,19,0,154
28719,2022,Turkmenistan,France,41,6,0,47
28720,2022,Togo,France,1124,148,0,1272
28721,2022,Tunisia,France,572,115,0,687
28722,2022,Türkiye,France,17032,5350,0,22382
28723,2022,Uganda,France,225,14,0,239
28724,2022,Ukraine,France,94970,1334,0,96304
28725,2022,United States of America,France,9,5,0,14
28726,2022,Uzbekistan,France,300,24,0,324
28727,2022,Venezuela (Bolivarian Republic of),France,1400,549,0,1949
28728,2022,Western Sahara,France,858,64,0,922
28729,2022,Yemen,France,993,44,0,1037
28730,2022,Zimbabwe,France,86,5,0,91
28734,2022,Burundi,Gabon,6,0,0,6
28735,2022,Central African Rep.,Gabon,19,9,0,28
28736,2022,Chad,Gabon,65,13,0,78
28737,2022,Cameroon,Gabon,5,5,0,10
28738,2022,Congo,Gabon,60,0,0,60
28739,2022,Dem. Rep. of the Congo,Gabon,73,26,0,99
28740,2022,Mauritania,Gabon,6,0,0,6
28741,2022,Sao Tome and Principe,Gabon,6,0,0,6
28742,2022,Sudan,Gabon,5,0,0,5
28743,2022,Togo,Gabon,6,0,0,6
28744,2022,Central African Rep.,Gambia,10,8,0,18
28745,2022,Congo,Gambia,7,5,0,12
28746,2022,Dem. Rep. of the Congo,Gambia,63,5,0,68
28747,2022,Guinea-Bissau,Gambia,0,10,0,10
28748,2022,Guinea,Gambia,5,5,0,10
28749,2022,Cote d'Ivoire,Gambia,118,6,0,124
28750,2022,Liberia,Gambia,15,0,0,15
28751,2022,Rwanda,Gambia,5,0,0,5
28752,2022,Senegal,Gambia,4082,968,0,5050
28753,2022,Sierra Leone,Gambia,105,11,0,116
28754,2022,Syrian Arab Rep.,Gambia,5,0,0,5
28755,2022,Togo,Gambia,18,0,0,18
28756,2022,Afghanistan,United Kingdom of Great Britain and Northern Ireland,10259,7277,0,17536
28757,2022,Albania,United Kingdom of Great Britain and Northern Ireland,4485,15893,0,20378
28758,2022,Algeria,United Kingdom of Great Britain and Northern Ireland,306,612,0,918
28759,2022,Angola,United Kingdom of Great Britain and Northern Ireland,138,165,0,303
28760,2022,Antigua and Barbuda,United Kingdom of Great Britain and Northern Ireland,7,12,0,19
28761,2022,Egypt,United Kingdom of Great Britain and Northern Ireland,980,1379,0,2359
28762,2022,Argentina,United Kingdom of Great Britain and Northern Ireland,0,32,0,32
28763,2022,Armenia,United Kingdom of Great Britain and Northern Ireland,54,15,0,69
28764,2022,Australia,United Kingdom of Great Britain and Northern Ireland,5,0,0,5
28765,2022,Azerbaijan,United Kingdom of Great Britain and Northern Ireland,143,97,0,240
28766,2022,Bahrain,United Kingdom of Great Britain and Northern Ireland,101,20,0,121
28767,2022,Barbados,United Kingdom of Great Britain and Northern Ireland,15,16,0,31
28768,2022,Burundi,United Kingdom of Great Britain and Northern Ireland,53,19,0,72
28769,2022,Benin,United Kingdom of Great Britain and Northern Ireland,9,33,0,42
28770,2022,Bangladesh,United Kingdom of Great Britain and Northern Ireland,1851,4436,0,6287
28771,2022,Bhutan,United Kingdom of Great Britain and Northern Ireland,19,0,0,19
28772,2022,Burkina Faso,United Kingdom of Great Britain and Northern Ireland,11,14,0,25
28773,2022,Belarus,United Kingdom of Great Britain and Northern Ireland,92,104,0,196
28774,2022,Bolivia (Plurinational State of),United Kingdom of Great Britain and Northern Ireland,23,19,0,42
28775,2022,Botswana,United Kingdom of Great Britain and Northern Ireland,34,136,0,170
28776,2022,Brazil,United Kingdom of Great Britain and Northern Ireland,40,455,0,495
28777,2022,Bosnia and Herzegovina,United Kingdom of Great Britain and Northern Ireland,8,5,0,13
28778,2022,Belize,United Kingdom of Great Britain and Northern Ireland,0,5,0,5
28779,2022,Canada,United Kingdom of Great Britain and Northern Ireland,11,23,0,34
28780,2022,Central African Rep.,United Kingdom of Great Britain and Northern Ireland,11,17,0,28
28781,2022,Chad,United Kingdom of Great Britain and Northern Ireland,130,355,0,485
28782,2022,China,United Kingdom of Great Britain and Northern Ireland,963,2777,0,3740
28783,2022,Chile,United Kingdom of Great Britain and Northern Ireland,0,13,0,13
28784,2022,Cameroon,United Kingdom of Great Britain and Northern Ireland,803,447,0,1250
28785,2022,Congo,United Kingdom of Great Britain and Northern Ireland,88,98,0,186
28786,2022,Dem. Rep. of the Congo,United Kingdom of Great Britain and Northern Ireland,887,259,0,1146
28787,2022,Colombia,United Kingdom of Great Britain and Northern Ireland,14,63,0,77
28788,2022,Costa Rica,United Kingdom of Great Britain and Northern Ireland,0,9,0,9
28789,2022,Cuba,United Kingdom of Great Britain and Northern Ireland,15,23,0,38
28790,2022,Cabo Verde,United Kingdom of Great Britain and Northern Ireland,5,0,0,5
28791,2022,Cyprus,United Kingdom of Great Britain and Northern Ireland,0,9,0,9
28792,2022,Czechia,United Kingdom of Great Britain and Northern Ireland,0,5,0,5
28793,2022,Djibouti,United Kingdom of Great Britain and Northern Ireland,6,6,0,12
28794,2022,Dominica,United Kingdom of Great Britain and Northern Ireland,22,40,0,62
28795,2022,Dominican Rep.,United Kingdom of Great Britain and Northern Ireland,0,5,0,5
28796,2022,Ecuador,United Kingdom of Great Britain and Northern Ireland,5,29,0,34
28797,2022,Equatorial Guinea,United Kingdom of Great Britain and Northern Ireland,5,8,0,13
28798,2022,Eritrea,United Kingdom of Great Britain and Northern Ireland,15615,6886,0,22501
28799,2022,Ethiopia,United Kingdom of Great Britain and Northern Ireland,2015,1530,0,3545
28800,2022,Fiji,United Kingdom of Great Britain and Northern Ireland,5,0,0,5
28801,2022,France,United Kingdom of Great Britain and Northern Ireland,0,5,0,5
28802,2022,Gabon,United Kingdom of Great Britain and Northern Ireland,9,6,0,15
28803,2022,Gambia,United Kingdom of Great Britain and Northern Ireland,829,304,0,1133
28804,2022,Palestinian,United Kingdom of Great Britain and Northern Ireland,646,605,0,1251
28805,2022,United Kingdom of Great Britain and Northern Ireland,United Kingdom of Great Britain and Northern Ireland,20,0,0,20
28806,2022,Georgia,United Kingdom of Great Britain and Northern Ireland,77,1172,0,1249
28807,2022,Germany,United Kingdom of Great Britain and Northern Ireland,0,5,0,5
28808,2022,Ghana,United Kingdom of Great Britain and Northern Ireland,346,490,0,836
28809,2022,Guinea-Bissau,United Kingdom of Great Britain and Northern Ireland,6,8,0,14
28810,2022,Greece,United Kingdom of Great Britain and Northern Ireland,5,5,0,10
28811,2022,Grenada,United Kingdom of Great Britain and Northern Ireland,23,57,0,80
28812,2022,Guatemala,United Kingdom of Great Britain and Northern Ireland,9,35,0,44
28813,2022,Guinea,United Kingdom of Great Britain and Northern Ireland,206,168,0,374
28814,2022,Guyana,United Kingdom of Great Britain and Northern Ireland,19,5,0,24
28815,2022,Haiti,United Kingdom of Great Britain and Northern Ireland,0,10,0,10
28816,2022,"China, Hong Kong SAR",United Kingdom of Great Britain and Northern Ireland,20,30,0,50
28817,2022,Honduras,United Kingdom of Great Britain and Northern Ireland,124,1156,0,1280
28818,2022,Hungary,United Kingdom of Great Britain and Northern Ireland,0,5,0,5
28819,2022,Cote d'Ivoire,United Kingdom of Great Britain and Northern Ireland,188,118,0,306
28820,2022,India,United Kingdom of Great Britain and Northern Ireland,518,3445,0,3963
28821,2022,Indonesia,United Kingdom of Great Britain and Northern Ireland,46,104,0,150
28822,2022,Ireland,United Kingdom of Great Britain and Northern Ireland,13,11,0,24
28823,2022,Iran (Islamic Rep. of),United Kingdom of Great Britain and Northern Ireland,21904,15395,0,37299
28824,2022,Iraq,United Kingdom of Great Britain and Northern Ireland,7699,14033,0,21732
28825,2022,Israel,United Kingdom of Great Britain and Northern Ireland,121,25,0,146
28826,2022,Italy,United Kingdom of Great Britain and Northern Ireland,5,5,0,10
28827,2022,Jamaica,United Kingdom of Great Britain and Northern Ireland,251,204,0,455
28828,2022,Jordan,United Kingdom of Great Britain and Northern Ireland,112,153,0,265
28829,2022,Japan,United Kingdom of Great Britain and Northern Ireland,0,7,0,7
28830,2022,Kazakhstan,United Kingdom of Great Britain and Northern Ireland,49,76,0,125
28831,2022,Kenya,United Kingdom of Great Britain and Northern Ireland,319,372,0,691
28832,2022,Kyrgyzstan,United Kingdom of Great Britain and Northern Ireland,37,31,0,68
28833,2022,Rep. of Korea,United Kingdom of Great Britain and Northern Ireland,5,8,0,13
28834,2022,Dem. People's Rep. of Korea,United Kingdom of Great Britain and Northern Ireland,43,20,0,63
28835,2022,Kuwait,United Kingdom of Great Britain and Northern Ireland,716,1351,0,2067
28836,2022,Lao People's Dem. Rep.,United Kingdom of Great Britain and Northern Ireland,5,0,0,5
28837,2022,Liberia,United Kingdom of Great Britain and Northern Ireland,26,26,0,52
28838,2022,Libya,United Kingdom of Great Britain and Northern Ireland,4565,939,0,5504
28839,2022,Saint Lucia,United Kingdom of Great Britain and Northern Ireland,25,49,0,74
28840,2022,Lebanon,United Kingdom of Great Britain and Northern Ireland,223,199,0,422
28841,2022,Sri Lanka,United Kingdom of Great Britain and Northern Ireland,4418,1822,0,6240
28842,2022,Mauritania,United Kingdom of Great Britain and Northern Ireland,7,7,0,14
28843,2022,North Macedonia,United Kingdom of Great Britain and Northern Ireland,14,14,0,28
28844,2022,Rep. of Moldova,United Kingdom of Great Britain and Northern Ireland,5,6,0,11
28845,2022,Maldives,United Kingdom of Great Britain and Northern Ireland,44,0,0,44
28846,2022,Mexico,United Kingdom of Great Britain and Northern Ireland,14,102,0,116
28847,2022,Mali,United Kingdom of Great Britain and Northern Ireland,31,72,0,103
28848,2022,Malaysia,United Kingdom of Great Britain and Northern Ireland,310,546,0,856
28849,2022,Malawi,United Kingdom of Great Britain and Northern Ireland,267,96,0,363
28850,2022,Mongolia,United Kingdom of Great Britain and Northern Ireland,51,75,0,126
28851,2022,Morocco,United Kingdom of Great Britain and Northern Ireland,235,405,0,640
28852,2022,Mozambique,United Kingdom of Great Britain and Northern Ireland,6,5,0,11
28853,2022,Montenegro,United Kingdom of Great Britain and Northern Ireland,0,5,0,5
28854,2022,Mauritius,United Kingdom of Great Britain and Northern Ireland,64,120,0,184
28855,2022,Myanmar,United Kingdom of Great Britain and Northern Ireland,338,135,0,473
28856,2022,Namibia,United Kingdom of Great Britain and Northern Ireland,207,1009,0,1216
28857,2022,Nepal,United Kingdom of Great Britain and Northern Ireland,73,590,0,663
28858,2022,Netherlands,United Kingdom of Great Britain and Northern Ireland,5,0,0,5
28859,2022,Niger,United Kingdom of Great Britain and Northern Ireland,194,23,0,217
28860,2022,Nicaragua,United Kingdom of Great Britain and Northern Ireland,57,252,0,309
28861,2022,Nigeria,United Kingdom of Great Britain and Northern Ireland,3138,3393,0,6531
28862,2022,Norway,United Kingdom of Great Britain and Northern Ireland,5,5,0,10
28863,2022,Oman,United Kingdom of Great Britain and Northern Ireland,22,29,0,51
28864,2022,Pakistan,United Kingdom of Great Britain and Northern Ireland,8009,5163,0,13172
28865,2022,Panama,United Kingdom of Great Britain and Northern Ireland,0,5,0,5
28866,2022,Peru,United Kingdom of Great Britain and Northern Ireland,0,9,0,9
28867,2022,Philippines,United Kingdom of Great Britain and Northern Ireland,63,772,0,835
28868,2022,Poland,United Kingdom of Great Britain and Northern Ireland,0,11,0,11
28869,2022,Portugal,United Kingdom of Great Britain and Northern Ireland,0,5,0,5
28870,2022,Qatar,United Kingdom of Great Britain and Northern Ireland,17,14,0,31
28871,2022,Romania,United Kingdom of Great Britain and Northern Ireland,0,14,0,14
28872,2022,South Africa,United Kingdom of Great Britain and Northern Ireland,123,144,0,267
28873,2022,Russian Federation,United Kingdom of Great Britain and Northern Ireland,927,797,0,1724
28874,2022,Rwanda,United Kingdom of Great Britain and Northern Ireland,100,46,0,146
28875,2022,El Salvador,United Kingdom of Great Britain and Northern Ireland,979,3177,0,4156
28876,2022,Saudi Arabia,United Kingdom of Great Britain and Northern Ireland,309,258,0,567
28877,2022,Serbia and Kosovo: S/RES/1244 (1999),United Kingdom of Great Britain and Northern Ireland,72,72,0,144
28878,2022,Senegal,United Kingdom of Great Britain and Northern Ireland,94,77,0,171
28879,2022,Seychelles,United Kingdom of Great Britain and Northern Ireland,9,0,0,9
28880,2022,Singapore,United Kingdom of Great Britain and Northern Ireland,5,6,0,11
28881,2022,Sierra Leone,United Kingdom of Great Britain and Northern Ireland,328,325,0,653
28882,2022,Somalia,United Kingdom of Great Britain and Northern Ireland,2425,1311,0,3736
28883,2022,Viet Nam,United Kingdom of Great Britain and Northern Ireland,3107,3851,0,6958
28884,2022,Saint Kitts and Nevis,United Kingdom of Great Britain and Northern Ireland,6,25,0,31
28885,2022,Sudan,United Kingdom of Great Britain and Northern Ireland,11371,4513,0,15884
28886,2022,South Sudan,United Kingdom of Great Britain and Northern Ireland,92,165,0,257
28887,2022,Eswatini,United Kingdom of Great Britain and Northern Ireland,52,5,0,57
28888,2022,Sweden,United Kingdom of Great Britain and Northern Ireland,0,5,0,5
28889,2022,Syrian Arab Rep.,United Kingdom of Great Britain and Northern Ireland,12155,5898,0,18053
28890,2022,United Rep. of Tanzania,United Kingdom of Great Britain and Northern Ireland,111,92,0,203
28891,2022,Thailand,United Kingdom of Great Britain and Northern Ireland,35,131,0,166
28892,2022,Tajikistan,United Kingdom of Great Britain and Northern Ireland,14,56,0,70
28893,2022,Turkmenistan,United Kingdom of Great Britain and Northern Ireland,21,46,0,67
28894,2022,Timor-Leste,United Kingdom of Great Britain and Northern Ireland,0,8,0,8
28895,2022,Togo,United Kingdom of Great Britain and Northern Ireland,16,36,0,52
28896,2022,Trinidad and Tobago,United Kingdom of Great Britain and Northern Ireland,102,218,0,320
28897,2022,Tunisia,United Kingdom of Great Britain and Northern Ireland,69,133,0,202
28898,2022,Türkiye,United Kingdom of Great Britain and Northern Ireland,2802,2226,0,5028
28899,2022,United Arab Emirates,United Kingdom of Great Britain and Northern Ireland,22,15,0,37
28900,2022,Uganda,United Kingdom of Great Britain and Northern Ireland,1122,313,0,1435
28901,2022,Ukraine,United Kingdom of Great Britain and Northern Ireland,91223,709,0,91932
28902,2022,United States of America,United Kingdom of Great Britain and Northern Ireland,67,117,0,184
28903,2022,Uzbekistan,United Kingdom of Great Britain and Northern Ireland,67,107,0,174
28904,2022,Vanuatu,United Kingdom of Great Britain and Northern Ireland,0,6,0,6
28905,2022,Saint Vincent and the Grenadines,United Kingdom of Great Britain and Northern Ireland,39,49,0,88
28906,2022,Venezuela (Bolivarian Republic of),United Kingdom of Great Britain and Northern Ireland,66,44,0,110
28907,2022,Samoa,United Kingdom of Great Britain and Northern Ireland,0,5,0,5
28908,2022,Western Sahara,United Kingdom of Great Britain and Northern Ireland,11,6,0,17
28909,2022,Yemen,United Kingdom of Great Britain and Northern Ireland,1435,926,0,2361
28910,2022,Zambia,United Kingdom of Great Britain and Northern Ireland,82,55,0,137
28911,2022,Zimbabwe,United Kingdom of Great Britain and Northern Ireland,1038,456,0,1494
28914,2022,Afghanistan,Georgia,53,29,0,82
28915,2022,Egypt,Georgia,69,45,0,114
28916,2022,Azerbaijan,Georgia,0,5,0,5
28917,2022,Belarus,Georgia,0,12,0,12
28918,2022,Cameroon,Georgia,0,5,0,5
28919,2022,Dem. Rep. of the Congo,Georgia,5,5,0,10
28920,2022,Cuba,Georgia,0,5,0,5
28921,2022,Eritrea,Georgia,10,24,0,34
28922,2022,Ethiopia,Georgia,0,6,0,6
28923,2022,Palestinian,Georgia,0,10,0,10
28924,2022,Georgia,Georgia,0,0,291358,0
28925,2022,Ghana,Georgia,0,9,0,9
28926,2022,India,Georgia,0,5,0,5
28927,2022,Iran (Islamic Rep. of),Georgia,44,372,0,416
28928,2022,Iraq,Georgia,377,25,0,402
28929,2022,Jordan,Georgia,0,32,0,32
28930,2022,Kazakhstan,Georgia,5,10,0,15
28931,2022,Kyrgyzstan,Georgia,0,5,0,5
28932,2022,Lebanon,Georgia,11,29,0,40
28933,2022,Nigeria,Georgia,0,28,0,28
28934,2022,Pakistan,Georgia,12,0,0,12
28935,2022,South Africa,Georgia,0,8,0,8
28936,2022,Russian Federation,Georgia,222,97,0,319
28937,2022,Saudi Arabia,Georgia,0,5,0,5
28938,2022,Somalia,Georgia,7,10,0,17
28939,2022,Sudan,Georgia,6,0,0,6
28940,2022,Syrian Arab Rep.,Georgia,448,17,0,465
28941,2022,Thailand,Georgia,0,5,0,5
28942,2022,Tajikistan,Georgia,5,9,0,14
28943,2022,Turkmenistan,Georgia,0,8,0,8
28944,2022,Türkiye,Georgia,0,182,0,182
28945,2022,Ukraine,Georgia,22647,113,0,22760
28946,2022,Uzbekistan,Georgia,0,5,0,5
28947,2022,Yemen,Georgia,65,16,0,81
28950,2022,Afghanistan,Germany,183631,41300,0,224931
28951,2022,Albania,Germany,1309,1531,0,2840
28952,2022,Algeria,Germany,986,1102,0,2088
28953,2022,Angola,Germany,846,400,0,1246
28954,2022,Egypt,Germany,2621,1133,0,3754
28955,2022,Argentina,Germany,18,19,0,37
28956,2022,Armenia,Germany,4180,1894,0,6074
28957,2022,Australia,Germany,9,0,0,9
28958,2022,Austria,Germany,5,0,0,5
28959,2022,Azerbaijan,Germany,5532,2399,0,7931
28960,2022,Bahrain,Germany,68,0,0,68
28961,2022,Burundi,Germany,134,57,0,191
28962,2022,Belgium,Germany,7,0,0,7
28963,2022,Benin,Germany,113,139,0,252
28964,2022,Bangladesh,Germany,874,289,0,1163
28965,2022,Bhutan,Germany,21,0,0,21
28966,2022,Burkina Faso,Germany,120,158,0,278
28967,2022,Belarus,Germany,905,396,0,1301
28968,2022,Bolivia (Plurinational State of),Germany,7,11,0,18
28969,2022,Botswana,Germany,6,0,0,6
28970,2022,Brazil,Germany,36,55,0,91
28971,2022,Bosnia and Herzegovina,Germany,1356,873,0,2229
28972,2022,Bulgaria,Germany,81,5,0,86
28973,2022,Cambodia,Germany,34,31,0,65
28974,2022,Canada,Germany,41,0,0,41
28975,2022,Central African Rep.,Germany,54,6,0,60
28976,2022,Chad,Germany,121,190,0,311
28977,2022,China,Germany,2222,337,0,2559
28978,2022,Chile,Germany,156,13,0,169
28979,2022,Cameroon,Germany,1248,1382,0,2630
28980,2022,Congo,Germany,306,61,0,367
28981,2022,Dem. Rep. of the Congo,Germany,1562,535,0,2097
28982,2022,Comoros,Germany,0,13,0,13
28983,2022,Colombia,Germany,113,1386,0,1499
28984,2022,Costa Rica,Germany,0,5,0,5
28985,2022,Cuba,Germany,98,81,0,179
28986,2022,Cabo Verde,Germany,0,5,0,5
28987,2022,Czechia,Germany,397,5,0,402
28988,2022,Djibouti,Germany,45,28,0,73
28989,2022,Dominica,Germany,5,0,0,5
28990,2022,Dominican Rep.,Germany,10,5,0,15
28991,2022,Ecuador,Germany,23,5,0,28
28992,2022,Equatorial Guinea,Germany,28,5,0,33
28993,2022,Eritrea,Germany,64496,2746,0,67242
28994,2022,Ethiopia,Germany,6912,2975,0,9887
28995,2022,France,Germany,12,0,0,12
28996,2022,Gabon,Germany,21,22,0,43
28997,2022,Gambia,Germany,1492,1138,0,2630
28998,2022,Palestinian,Germany,2157,1099,0,3256
28999,2022,United Kingdom of Great Britain and Northern Ireland,Germany,35,0,0,35
29000,2022,Georgia,Germany,1883,5946,0,7829
29001,2022,Ghana,Germany,973,713,0,1686
29002,2022,Guinea-Bissau,Germany,123,74,0,197
29003,2022,Greece,Germany,45,5,0,50
29004,2022,Guatemala,Germany,5,13,0,18
29005,2022,Guinea,Germany,4460,2741,0,7201
29006,2022,Haiti,Germany,17,33,0,50
29007,2022,"China, Hong Kong SAR",Germany,5,7,0,12
29008,2022,Honduras,Germany,81,58,0,139
29009,2022,Croatia,Germany,264,5,0,269
29010,2022,Hungary,Germany,228,5,0,233
29011,2022,Iceland,Germany,92,0,0,92
29012,2022,Cote d'Ivoire,Germany,829,927,0,1756
29013,2022,India,Germany,700,536,0,1236
29014,2022,Indonesia,Germany,17,5,0,22
29015,2022,Iran (Islamic Rep. of),Germany,47658,12419,0,60077
29016,2022,Iraq,Germany,151254,29368,0,180622
29017,2022,Israel,Germany,40,28,0,68
29018,2022,Italy,Germany,35,10,0,45
29019,2022,Jamaica,Germany,80,42,0,122
29020,2022,Jordan,Germany,761,388,0,1149
29021,2022,Japan,Germany,28,5,0,33
29022,2022,Kazakhstan,Germany,309,162,0,471
29023,2022,Kenya,Germany,189,495,0,684
29024,2022,Kyrgyzstan,Germany,434,103,0,537
29025,2022,Rep. of Korea,Germany,25,5,0,30
29026,2022,Dem. People's Rep. of Korea,Germany,91,5,0,96
29027,2022,Kuwait,Germany,45,68,0,113
29028,2022,Lao People's Dem. Rep.,Germany,41,0,0,41
29029,2022,Liberia,Germany,156,238,0,394
29030,2022,Libya,Germany,2932,1044,0,3976
29031,2022,Lebanon,Germany,2514,1807,0,4321
29032,2022,Sri Lanka,Germany,3652,398,0,4050
29033,2022,Lithuania,Germany,10,0,0,10
29034,2022,Latvia,Germany,9,0,0,9
29035,2022,Madagascar,Germany,5,12,0,17
29036,2022,Mauritania,Germany,71,82,0,153
29037,2022,North Macedonia,Germany,624,2569,0,3193
29038,2022,Rep. of Moldova,Germany,1003,2285,0,3288
29039,2022,Mexico,Germany,29,10,0,39
29040,2022,Mali,Germany,404,310,0,714
29041,2022,Malaysia,Germany,19,7,0,26
29042,2022,Malawi,Germany,7,0,0,7
29043,2022,Mongolia,Germany,244,206,0,450
29044,2022,Morocco,Germany,2218,1080,0,3298
29045,2022,Mozambique,Germany,14,26,0,40
29046,2022,Montenegro,Germany,214,231,0,445
29047,2022,Mauritius,Germany,5,0,0,5
29048,2022,Myanmar,Germany,949,399,0,1348
29049,2022,Namibia,Germany,7,55,0,62
29050,2022,Nepal,Germany,67,18,0,85
29051,2022,Netherlands,Germany,32,5,0,37
29052,2022,Niger,Germany,77,99,0,176
29053,2022,Nicaragua,Germany,8,270,0,278
29054,2022,Nigeria,Germany,12155,9715,0,21870
29055,2022,Norway,Germany,5,0,0,5
29056,2022,New Zealand,Germany,7,0,0,7
29057,2022,Oman,Germany,8,10,0,18
29058,2022,Pakistan,Germany,9250,3585,0,12835
29059,2022,Panama,Germany,0,5,0,5
29060,2022,Paraguay,Germany,5,9,0,14
29061,2022,Peru,Germany,50,42,0,92
29062,2022,Philippines,Germany,50,29,0,79
29063,2022,Poland,Germany,569,5,0,574
29064,2022,Portugal,Germany,5,0,0,5
29065,2022,Qatar,Germany,5,0,0,5
29066,2022,Romania,Germany,146,5,0,151
29067,2022,South Africa,Germany,27,44,0,71
29068,2022,Russian Federation,Germany,13334,9445,0,22779
29069,2022,Rwanda,Germany,361,586,0,947
29070,2022,El Salvador,Germany,185,80,0,265
29071,2022,Saudi Arabia,Germany,199,30,0,229
29072,2022,Serbia and Kosovo: S/RES/1244 (1999),Germany,6257,2142,0,8399
29073,2022,Senegal,Germany,224,291,0,515
29074,2022,Singapore,Germany,7,0,0,7
29075,2022,Sierra Leone,Germany,864,558,0,1422
29076,2022,Solomon Islands,Germany,6,0,0,6
29077,2022,Somalia,Germany,32155,6004,0,38159
29078,2022,Spain,Germany,23,9,0,32
29079,2022,Viet Nam,Germany,2284,269,0,2553
29080,2022,Sudan,Germany,3191,905,0,4096
29081,2022,South Sudan,Germany,122,58,0,180
29082,2022,Slovakia,Germany,73,0,0,73
29083,2022,Slovenia,Germany,7,0,0,7
29084,2022,Eswatini,Germany,5,5,0,10
29085,2022,Sweden,Germany,11,0,0,11
29086,2022,Syrian Arab Rep.,Germany,664238,43628,0,707866
29087,2022,United Rep. of Tanzania,Germany,93,255,0,348
29088,2022,Thailand,Germany,35,18,0,53
29089,2022,Tajikistan,Germany,1775,977,0,2752
29090,2022,Turkmenistan,Germany,1096,138,0,1234
29091,2022,Togo,Germany,1023,336,0,1359
29092,2022,Trinidad and Tobago,Germany,7,5,0,12
29093,2022,Tunisia,Germany,478,840,0,1318
29094,2022,Türkiye,Germany,38755,17129,0,55884
29095,2022,United Arab Emirates,Germany,34,0,0,34
29096,2022,Uganda,Germany,286,345,0,631
29097,2022,Ukraine,Germany,876311,1512,0,877823
29098,2022,Uruguay,Germany,13,0,0,13
29099,2022,United States of America,Germany,207,37,0,244
29100,2022,Uzbekistan,Germany,687,128,0,815
29101,2022,Saint Vincent and the Grenadines,Germany,5,0,0,5
29102,2022,Venezuela (Bolivarian Republic of),Germany,1289,1338,0,2627
29103,2022,Yemen,Germany,3647,1180,0,4827
29104,2022,Zambia,Germany,12,9,0,21
29105,2022,Zimbabwe,Germany,347,205,0,552
29108,2022,Afghanistan,Ghana,7,0,0,7
29109,2022,Egypt,Ghana,0,16,0,16
29110,2022,Burundi,Ghana,14,15,0,29
29111,2022,Benin,Ghana,15,5,0,20
29112,2022,Central African Rep.,Ghana,199,90,0,289
29113,2022,Chad,Ghana,40,22,0,62
29114,2022,Cameroon,Ghana,436,267,0,703
29115,2022,Congo,Ghana,5,0,0,5
29116,2022,Dem. Rep. of the Congo,Ghana,69,19,0,88
29117,2022,Eritrea,Ghana,129,70,0,199
29118,2022,Ethiopia,Ghana,11,6,0,17
29119,2022,Palestinian,Ghana,19,10,0,29
29120,2022,Cote d'Ivoire,Ghana,859,679,0,1538
29121,2022,Iraq,Ghana,16,5,0,21
29122,2022,Liberia,Ghana,632,0,0,632
29123,2022,Libya,Ghana,7,6,0,13
29124,2022,Lebanon,Ghana,11,0,0,11
29125,2022,Mali,Ghana,0,5,0,5
29126,2022,Nigeria,Ghana,16,11,0,27
29127,2022,Pakistan,Ghana,60,10,0,70
29128,2022,Rwanda,Ghana,26,5,0,31
29129,2022,Sierra Leone,Ghana,89,16,0,105
29130,2022,Somalia,Ghana,79,24,0,103
29131,2022,Sudan,Ghana,601,107,0,708
29132,2022,South Sudan,Ghana,7,5,0,12
29133,2022,Syrian Arab Rep.,Ghana,246,75,0,321
29134,2022,Togo,Ghana,3263,69,0,3332
29135,2022,Türkiye,Ghana,72,8,0,80
29136,2022,Uganda,Ghana,11,0,0,11
29137,2022,Ukraine,Ghana,0,5,0,5
29138,2022,Uzbekistan,Ghana,9,0,0,9
29139,2022,Yemen,Ghana,17,9,0,26
29140,2022,Burundi,Guinea-Bissau,5,0,0,5
29141,2022,Cote d'Ivoire,Guinea-Bissau,6,6,0,12
29142,2022,Liberia,Guinea-Bissau,8,0,0,8
29143,2022,Nigeria,Guinea-Bissau,0,6,0,6
29144,2022,Senegal,Guinea-Bissau,0,8,0,8
29145,2022,Sierra Leone,Guinea-Bissau,10,5,0,15
29146,2022,Türkiye,Guinea-Bissau,0,5,0,5
29147,2022,Afghanistan,Greece,33549,3407,0,36956
29148,2022,Albania,Greece,184,803,0,987
29149,2022,Algeria,Greece,137,75,0,212
29150,2022,Angola,Greece,17,51,0,68
29151,2022,Egypt,Greece,432,1875,0,2307
29152,2022,Armenia,Greece,11,32,0,43
29153,2022,Azerbaijan,Greece,5,0,0,5
29154,2022,Burundi,Greece,77,21,0,98
29155,2022,Bangladesh,Greece,352,2794,0,3146
29156,2022,Burkina Faso,Greece,47,22,0,69
29157,2022,Belarus,Greece,6,6,0,12
29158,2022,Central African Rep.,Greece,22,5,0,27
29159,2022,Chad,Greece,13,0,0,13
29160,2022,China,Greece,114,112,0,226
29161,2022,Cameroon,Greece,1047,373,0,1420
29162,2022,Congo,Greece,168,48,0,216
29163,2022,Dem. Rep. of the Congo,Greece,2384,1678,0,4062
29164,2022,Comoros,Greece,8,34,0,42
29165,2022,Cuba,Greece,18,109,0,127
29166,2022,Djibouti,Greece,17,6,0,23
29167,2022,Dominican Rep.,Greece,10,5,0,15
29168,2022,Equatorial Guinea,Greece,5,0,0,5
29169,2022,Eritrea,Greece,1439,199,0,1638
29170,2022,Ethiopia,Greece,547,62,0,609
29171,2022,Gabon,Greece,5,7,0,12
29172,2022,Gambia,Greece,122,70,0,192
29173,2022,Palestinian,Greece,6366,234,0,6600
29174,2022,Georgia,Greece,259,450,0,709
29175,2022,Ghana,Greece,99,196,0,295
29176,2022,Guinea,Greece,230,85,0,315
29177,2022,Haiti,Greece,50,7,0,57
29178,2022,Cote d'Ivoire,Greece,114,31,0,145
29179,2022,India,Greece,49,276,0,325
29180,2022,Indonesia,Greece,14,21,0,35
29181,2022,Iran (Islamic Rep. of),Greece,3491,516,0,4007
29182,2022,Iraq,Greece,14228,846,0,15074
29183,2022,Jordan,Greece,43,6,0,49
29184,2022,Kazakhstan,Greece,5,0,0,5
29185,2022,Kenya,Greece,30,9,0,39
29186,2022,Kuwait,Greece,166,7,0,173
29187,2022,Liberia,Greece,5,0,0,5
29188,2022,Libya,Greece,71,13,0,84
29189,2022,Lebanon,Greece,95,24,0,119
29190,2022,Sri Lanka,Greece,55,23,0,78
29191,2022,Mauritania,Greece,67,5,0,72
29192,2022,North Macedonia,Greece,0,5,0,5
29193,2022,Rep. of Moldova,Greece,14,32,0,46
29194,2022,Mali,Greece,177,37,0,214
29195,2022,Morocco,Greece,234,92,0,326
29196,2022,Myanmar,Greece,103,6,0,109
29197,2022,Nepal,Greece,29,45,0,74
29198,2022,Niger,Greece,19,5,0,24
29199,2022,Nigeria,Greece,378,146,0,524
29200,2022,Pakistan,Greece,1340,2600,0,3940
29201,2022,Philippines,Greece,6,5,0,11
29202,2022,Russian Federation,Greece,21,35,0,56
29203,2022,Rwanda,Greece,9,0,0,9
29204,2022,El Salvador,Greece,12,0,0,12
29205,2022,Saudi Arabia,Greece,8,0,0,8
29206,2022,Serbia and Kosovo: S/RES/1244 (1999),Greece,23,6,0,29
29207,2022,Senegal,Greece,64,40,0,104
29208,2022,Sierra Leone,Greece,302,171,0,473
29209,2022,Somalia,Greece,4698,744,0,5442
29210,2022,Viet Nam,Greece,5,0,0,5
29211,2022,Sudan,Greece,594,50,0,644
29212,2022,South Sudan,Greece,56,9,0,65
29213,2022,Syrian Arab Rep.,Greece,41594,2188,0,43782
29214,2022,United Rep. of Tanzania,Greece,13,5,0,18
29215,2022,Tajikistan,Greece,5,0,0,5
29216,2022,Turkmenistan,Greece,7,5,0,12
29217,2022,Togo,Greece,93,52,0,145
29218,2022,Tunisia,Greece,30,15,0,45
29219,2022,Türkiye,Greece,1502,1026,0,2528
29220,2022,Uganda,Greece,79,37,0,116
29221,2022,Ukraine,Greece,16882,129,0,17011
29222,2022,Uzbekistan,Greece,12,0,0,12
29223,2022,Venezuela (Bolivarian Republic of),Greece,15,5,0,20
29224,2022,Western Sahara,Greece,10,5,0,15
29225,2022,Yemen,Greece,1041,39,0,1080
29226,2022,Zimbabwe,Greece,13,0,0,13
29229,2022,Venezuela (Bolivarian Republic of),Grenada,0,0,0,0
29230,2022,Brazil,Guatemala,0,5,0,5
29231,2022,Congo,Guatemala,0,5,0,5
29232,2022,Colombia,Guatemala,10,16,0,26
29233,2022,Cuba,Guatemala,11,15,0,26
29234,2022,Guatemala,Guatemala,0,0,0,0
29235,2022,Guinea,Guatemala,0,7,0,7
29236,2022,Haiti,Guatemala,0,0,0,0
29237,2022,Honduras,Guatemala,128,569,0,697
29238,2022,Sri Lanka,Guatemala,0,5,0,5
29239,2022,Mexico,Guatemala,0,9,0,9
29240,2022,Nicaragua,Guatemala,88,220,0,308
29241,2022,Russian Federation,Guatemala,5,0,0,5
29242,2022,El Salvador,Guatemala,317,513,0,830
29243,2022,Ukraine,Guatemala,0,5,0,5
29244,2022,Venezuela (Bolivarian Republic of),Guatemala,52,103,0,155
29245,2022,Burundi,Guinea,6,0,0,6
29246,2022,Central African Rep.,Guinea,31,0,0,31
29247,2022,Cameroon,Guinea,5,0,0,5
29248,2022,Congo,Guinea,9,0,0,9
29249,2022,Dem. Rep. of the Congo,Guinea,60,0,0,60
29250,2022,Eritrea,Guinea,14,0,0,14
29251,2022,Gambia,Guinea,5,0,0,5
29252,2022,Cote d'Ivoire,Guinea,2161,0,0,2161
29253,2022,Liberia,Guinea,335,20,0,355
29254,2022,Sri Lanka,Guinea,10,0,0,10
29255,2022,Mali,Guinea,9,0,0,9
29256,2022,Nigeria,Guinea,10,0,0,10
29257,2022,Rwanda,Guinea,10,0,0,10
29258,2022,Sierra Leone,Guinea,1651,33,0,1684
29259,2022,Somalia,Guinea,6,0,0,6
29260,2022,Syrian Arab Rep.,Guinea,14,0,0,14
29261,2022,Togo,Guinea,8,0,0,8
29262,2022,Afghanistan,Guyana,0,5,0,5
29263,2022,Cuba,Guyana,23,113,0,136
29264,2022,Haiti,Guyana,0,17,0,17
29265,2022,Venezuela (Bolivarian Republic of),Guyana,0,0,0,0
29266,2022,Afghanistan,"China, Hong Kong SAR",11,0,0,11
29267,2022,Egypt,"China, Hong Kong SAR",13,0,0,13
29268,2022,Burundi,"China, Hong Kong SAR",10,0,0,10
29269,2022,Bangladesh,"China, Hong Kong SAR",15,0,0,15
29270,2022,Central African Rep.,"China, Hong Kong SAR",5,0,0,5
29271,2022,Cameroon,"China, Hong Kong SAR",5,0,0,5
29272,2022,Dem. Rep. of the Congo,"China, Hong Kong SAR",7,0,0,7
29273,2022,Ethiopia,"China, Hong Kong SAR",7,0,0,7
29274,2022,Palestinian,"China, Hong Kong SAR",5,0,0,5
29275,2022,Indonesia,"China, Hong Kong SAR",13,0,0,13
29276,2022,Sri Lanka,"China, Hong Kong SAR",20,0,0,20
29277,2022,Nepal,"China, Hong Kong SAR",8,0,0,8
29278,2022,Pakistan,"China, Hong Kong SAR",25,0,0,25
29279,2022,Philippines,"China, Hong Kong SAR",8,0,0,8
29280,2022,Rwanda,"China, Hong Kong SAR",35,0,0,35
29281,2022,Somalia,"China, Hong Kong SAR",32,0,0,32
29282,2022,Sudan,"China, Hong Kong SAR",5,0,0,5
29283,2022,Uganda,"China, Hong Kong SAR",5,0,0,5
29284,2022,Yemen,"China, Hong Kong SAR",44,0,0,44
29285,2022,Zimbabwe,"China, Hong Kong SAR",5,0,0,5
29286,2022,Colombia,Honduras,5,0,0,5
29287,2022,Cuba,Honduras,0,5,0,5
29288,2022,Ecuador,Honduras,0,0,0,0
29289,2022,Haiti,Honduras,0,0,0,0
29290,2022,Honduras,Honduras,0,0,247090,0
29291,2022,Nicaragua,Honduras,124,101,0,225
29292,2022,El Salvador,Honduras,26,0,0,26
29293,2022,Venezuela (Bolivarian Republic of),Honduras,9,5,0,14
29295,2022,Afghanistan,Croatia,98,483,0,581
29296,2022,Algeria,Croatia,0,5,0,5
29297,2022,Egypt,Croatia,8,0,0,8
29298,2022,Azerbaijan,Croatia,5,0,0,5
29299,2022,Burundi,Croatia,0,33,0,33
29300,2022,Bangladesh,Croatia,7,7,0,14
29301,2022,Belarus,Croatia,5,0,0,5
29302,2022,Cameroon,Croatia,5,23,0,28
29303,2022,Congo,Croatia,5,0,0,5
29304,2022,Dem. Rep. of the Congo,Croatia,7,19,0,26
29305,2022,Cuba,Croatia,0,66,0,66
29306,2022,Eritrea,Croatia,27,0,0,27
29307,2022,Ethiopia,Croatia,0,5,0,5
29308,2022,Palestinian,Croatia,0,5,0,5
29309,2022,Georgia,Croatia,5,0,0,5
29310,2022,Ghana,Croatia,0,0,0,0
29311,2022,Guinea-Bissau,Croatia,0,0,0,0
29312,2022,Guinea,Croatia,0,12,0,12
29313,2022,India,Croatia,0,15,0,15
29314,2022,Iran (Islamic Rep. of),Croatia,42,49,0,91
29315,2022,Iraq,Croatia,119,101,0,220
29316,2022,Jordan,Croatia,0,8,0,8
29317,2022,Kazakhstan,Croatia,5,0,0,5
29318,2022,Libya,Croatia,5,0,0,5
29319,2022,Mauritania,Croatia,5,0,0,5
29320,2022,Montenegro,Croatia,0,5,0,5
29321,2022,Nepal,Croatia,0,15,0,15
29322,2022,Nigeria,Croatia,13,0,0,13
29323,2022,Pakistan,Croatia,11,71,0,82
29324,2022,Russian Federation,Croatia,15,48,0,63
29325,2022,Serbia and Kosovo: S/RES/1244 (1999),Croatia,5,5,0,10
29326,2022,Somalia,Croatia,29,5,0,34
29327,2022,Sudan,Croatia,5,5,0,10
29328,2022,Syrian Arab Rep.,Croatia,552,29,0,581
29329,2022,Tunisia,Croatia,0,8,0,8
29330,2022,Türkiye,Croatia,26,50,0,76
29331,2022,Ukraine,Croatia,15387,0,0,15387
29332,2022,Uzbekistan,Croatia,5,0,0,5
29333,2022,Yemen,Croatia,7,0,0,7
29335,2022,Afghanistan,Hungary,1451,5,0,1456
29336,2022,Algeria,Hungary,14,0,0,14
29337,2022,Angola,Hungary,5,0,0,5
29338,2022,Egypt,Hungary,11,0,0,11
29339,2022,Armenia,Hungary,39,0,0,39
29340,2022,Azerbaijan,Hungary,14,0,0,14
29341,2022,Bangladesh,Hungary,10,0,0,10
29342,2022,China,Hungary,6,0,0,6
29343,2022,Cameroon,Hungary,43,0,0,43
29344,2022,Congo,Hungary,12,0,0,12
29345,2022,Dem. Rep. of the Congo,Hungary,24,0,0,24
29346,2022,Cuba,Hungary,74,0,0,74
29347,2022,Eritrea,Hungary,46,0,0,46
29348,2022,Ethiopia,Hungary,42,0,0,42
29349,2022,Palestinian,Hungary,86,0,0,86
29350,2022,Georgia,Hungary,59,0,0,59
29351,2022,Ghana,Hungary,5,0,0,5
29352,2022,Guinea,Hungary,5,0,0,5
29353,2022,Cote d'Ivoire,Hungary,16,0,0,16
29354,2022,Iran (Islamic Rep. of),Hungary,197,5,0,202
29355,2022,Iraq,Hungary,592,0,0,592
29356,2022,Libya,Hungary,7,0,0,7
29357,2022,Lebanon,Hungary,5,0,0,5
29358,2022,Sri Lanka,Hungary,11,0,0,11
29359,2022,Rep. of Moldova,Hungary,5,0,0,5
29360,2022,Nepal,Hungary,9,0,0,9
29361,2022,Nigeria,Hungary,51,0,0,51
29362,2022,Pakistan,Hungary,91,0,0,91
29363,2022,Russian Federation,Hungary,36,5,0,41
29364,2022,Serbia and Kosovo: S/RES/1244 (1999),Hungary,40,0,0,40
29365,2022,Sierra Leone,Hungary,5,0,0,5
29366,2022,Somalia,Hungary,597,0,0,597
29367,2022,Sudan,Hungary,63,0,0,63
29368,2022,Syrian Arab Rep.,Hungary,826,0,0,826
29369,2022,Tunisia,Hungary,7,0,0,7
29370,2022,Türkiye,Hungary,33,0,0,33
29371,2022,Uganda,Hungary,7,0,0,7
29372,2022,Ukraine,Hungary,25982,5,0,25987
29373,2022,Uzbekistan,Hungary,6,0,0,6
29374,2022,Yemen,Hungary,17,0,0,17
29375,2022,Zimbabwe,Hungary,5,0,0,5
29378,2022,Afghanistan,Iceland,204,12,0,216
29379,2022,Albania,Iceland,5,0,0,5
29380,2022,Egypt,Iceland,10,0,0,10
29381,2022,Azerbaijan,Iceland,5,0,0,5
29382,2022,Bangladesh,Iceland,5,0,0,5
29383,2022,Belarus,Iceland,0,5,0,5
29384,2022,Chad,Iceland,5,0,0,5
29385,2022,China,Iceland,5,0,0,5
29386,2022,Cameroon,Iceland,5,0,0,5
29387,2022,Dem. Rep. of the Congo,Iceland,5,0,0,5
29388,2022,Eritrea,Iceland,9,0,0,9
29389,2022,Ethiopia,Iceland,11,0,0,11
29390,2022,Palestinian,Iceland,153,30,0,183
29391,2022,Georgia,Iceland,5,10,0,15
29392,2022,Ghana,Iceland,5,0,0,5
29393,2022,Honduras,Iceland,12,10,0,22
29394,2022,Cote d'Ivoire,Iceland,5,0,0,5
29395,2022,Iran (Islamic Rep. of),Iceland,100,0,0,100
29396,2022,Iraq,Iceland,315,30,0,345
29397,2022,Kazakhstan,Iceland,5,0,0,5
29398,2022,Kenya,Iceland,5,0,0,5
29399,2022,Libya,Iceland,13,5,0,18
29400,2022,Sri Lanka,Iceland,5,0,0,5
29401,2022,North Macedonia,Iceland,5,0,0,5
29402,2022,Mali,Iceland,5,0,0,5
29403,2022,Morocco,Iceland,8,0,0,8
29404,2022,Mozambique,Iceland,5,0,0,5
29405,2022,Nigeria,Iceland,66,27,0,93
29406,2022,Pakistan,Iceland,22,0,0,22
29407,2022,Peru,Iceland,5,0,0,5
29408,2022,Russian Federation,Iceland,20,15,0,35
29409,2022,El Salvador,Iceland,20,6,0,26
29410,2022,Senegal,Iceland,5,0,0,5
29411,2022,Somalia,Iceland,110,18,0,128
29412,2022,Sudan,Iceland,7,0,0,7
29413,2022,South Sudan,Iceland,5,0,0,5
29414,2022,Syrian Arab Rep.,Iceland,204,25,0,229
29415,2022,Tajikistan,Iceland,5,0,0,5
29416,2022,Tunisia,Iceland,5,0,0,5
29417,2022,Türkiye,Iceland,10,0,0,10
29418,2022,Uganda,Iceland,17,5,0,22
29419,2022,Ukraine,Iceland,1240,55,0,1295
29420,2022,Venezuela (Bolivarian Republic of),Iceland,590,409,0,999
29421,2022,Yemen,Iceland,12,8,0,20
29424,2022,Egypt,Cote d'Ivoire,5,5,0,10
29425,2022,Burundi,Cote d'Ivoire,34,0,0,34
29426,2022,Benin,Cote d'Ivoire,0,5,0,5
29427,2022,Burkina Faso,Cote d'Ivoire,3332,5,0,3337
29428,2022,Cambodia,Cote d'Ivoire,7,0,0,7
29429,2022,Central African Rep.,Cote d'Ivoire,570,33,0,603
29430,2022,Chad,Cote d'Ivoire,5,5,0,10
29431,2022,Cameroon,Cote d'Ivoire,16,20,0,36
29432,2022,Congo,Cote d'Ivoire,85,12,0,97
29433,2022,Dem. Rep. of the Congo,Cote d'Ivoire,123,17,0,140
29434,2022,Eritrea,Cote d'Ivoire,8,0,0,8
29435,2022,Ethiopia,Cote d'Ivoire,7,5,0,12
29436,2022,Iran (Islamic Rep. of),Cote d'Ivoire,7,0,0,7
29437,2022,Iraq,Cote d'Ivoire,5,0,0,5
29438,2022,Liberia,Cote d'Ivoire,1076,5,0,1081
29439,2022,Lebanon,Cote d'Ivoire,5,0,0,5
29440,2022,Mauritania,Cote d'Ivoire,5,5,0,10
29441,2022,Mali,Cote d'Ivoire,30,7,0,37
29442,2022,Niger,Cote d'Ivoire,5,0,0,5
29443,2022,Nigeria,Cote d'Ivoire,6,5,0,11
29444,2022,Rwanda,Cote d'Ivoire,50,6,0,56
29445,2022,Senegal,Cote d'Ivoire,0,5,0,5
29446,2022,Somalia,Cote d'Ivoire,5,5,0,10
29447,2022,Viet Nam,Cote d'Ivoire,5,0,0,5
29448,2022,Sudan,Cote d'Ivoire,9,0,0,9
29449,2022,Syrian Arab Rep.,Cote d'Ivoire,148,6,0,154
29450,2022,Togo,Cote d'Ivoire,18,5,0,23
29451,2022,Türkiye,Cote d'Ivoire,34,0,0,34
29452,2022,Yemen,Cote d'Ivoire,5,0,0,5
29454,2022,Afghanistan,India,10064,6255,0,16319
29455,2022,Egypt,India,0,11,0,11
29456,2022,Burundi,India,0,5,0,5
29457,2022,Bangladesh,India,8,0,0,8
29458,2022,China,India,72315,0,0,72315
29459,2022,Cameroon,India,24,237,0,261
29460,2022,Congo,India,11,28,0,39
29461,2022,Dem. Rep. of the Congo,India,67,140,0,207
29462,2022,Eritrea,India,13,13,0,26
29463,2022,Ethiopia,India,28,60,0,88
29464,2022,Palestinian,India,52,14,0,66
29465,2022,Ghana,India,0,63,0,63
29466,2022,Guinea,India,0,11,0,11
29467,2022,Cote d'Ivoire,India,5,198,0,203
29468,2022,Iran (Islamic Rep. of),India,57,48,0,105
29469,2022,Iraq,India,140,45,0,185
29470,2022,Kenya,India,0,35,0,35
29471,2022,Liberia,India,0,5,0,5
29472,2022,Libya,India,8,6,0,14
29473,2022,Sri Lanka,India,92131,0,0,92131
29474,2022,Maldives,India,5,0,0,5
29475,2022,Myanmar,India,57748,6632,0,64380
29476,2022,Nigeria,India,0,509,0,509
29477,2022,Russian Federation,India,0,25,0,25
29478,2022,Rwanda,India,5,10,0,15
29479,2022,Saudi Arabia,India,5,0,0,5
29480,2022,Senegal,India,0,28,0,28
29481,2022,Sierra Leone,India,0,8,0,8
29482,2022,Somalia,India,493,320,0,813
29483,2022,Sudan,India,73,159,0,232
29484,2022,South Sudan,India,5,107,0,112
29485,2022,Syrian Arab Rep.,India,71,65,0,136
29486,2022,United Rep. of Tanzania,India,0,12,0,12
29487,2022,Tajikistan,India,0,5,0,5
29488,2022,Türkiye,India,5,0,0,5
29489,2022,Uganda,India,0,34,0,34
29490,2022,Ukraine,India,0,32,0,32
29491,2022,Uzbekistan,India,0,12,0,12
29492,2022,Venezuela (Bolivarian Republic of),India,5,6,0,11
29493,2022,Yemen,India,15,975,0,990
29495,2022,Afghanistan,Indonesia,5684,1567,0,7251
29496,2022,Angola,Indonesia,7,0,0,7
29497,2022,Egypt,Indonesia,13,20,0,33
29498,2022,China,Indonesia,11,5,0,16
29499,2022,Cameroon,Indonesia,0,19,0,19
29500,2022,Dem. Rep. of the Congo,Indonesia,10,0,0,10
29501,2022,Eritrea,Indonesia,141,116,0,257
29502,2022,Ethiopia,Indonesia,120,35,0,155
29503,2022,Palestinian,Indonesia,161,88,0,249
29504,2022,Cote d'Ivoire,Indonesia,0,10,0,10
29505,2022,Indonesia,Indonesia,0,0,0,0
29506,2022,Iran (Islamic Rep. of),Indonesia,293,19,0,312
29507,2022,Iraq,Indonesia,433,190,0,623
29508,2022,Kuwait,Indonesia,5,0,0,5
29509,2022,Liberia,Indonesia,0,6,0,6
29510,2022,Libya,Indonesia,14,5,0,19
29511,2022,Sri Lanka,Indonesia,402,31,0,433
29512,2022,Mali,Indonesia,0,5,0,5
29513,2022,Mozambique,Indonesia,0,5,0,5
29514,2022,Myanmar,Indonesia,484,418,0,902
29515,2022,Nigeria,Indonesia,0,7,0,7
29516,2022,Pakistan,Indonesia,279,21,0,300
29517,2022,Russian Federation,Indonesia,5,5,0,10
29518,2022,Saudi Arabia,Indonesia,0,8,0,8
29519,2022,Sierra Leone,Indonesia,0,5,0,5
29520,2022,Somalia,Indonesia,1148,206,0,1354
29521,2022,Viet Nam,Indonesia,8,0,0,8
29522,2022,Sudan,Indonesia,401,108,0,509
29523,2022,Syrian Arab Rep.,Indonesia,19,25,0,44
29524,2022,United Rep. of Tanzania,Indonesia,0,6,0,6
29525,2022,Türkiye,Indonesia,0,10,0,10
29526,2022,Uganda,Indonesia,5,22,0,27
29527,2022,Venezuela (Bolivarian Republic of),Indonesia,0,5,0,5
29528,2022,Yemen,Indonesia,93,356,0,449
29530,2022,Afghanistan,Ireland,665,380,0,1045
29531,2022,Albania,Ireland,232,255,0,487
29532,2022,Algeria,Ireland,77,923,0,1000
29533,2022,Angola,Ireland,52,35,0,87
29534,2022,Egypt,Ireland,57,188,0,245
29535,2022,Argentina,Ireland,0,5,0,5
29536,2022,Armenia,Ireland,14,0,0,14
29537,2022,Azerbaijan,Ireland,5,0,0,5
29538,2022,Bahrain,Ireland,11,0,0,11
29539,2022,Burundi,Ireland,31,5,0,36
29540,2022,Benin,Ireland,5,5,0,10
29541,2022,Bangladesh,Ireland,118,158,0,276
29542,2022,Bhutan,Ireland,10,0,0,10
29543,2022,Belarus,Ireland,23,13,0,36
29544,2022,Bolivia (Plurinational State of),Ireland,25,42,0,67
29545,2022,Botswana,Ireland,13,249,0,262
29546,2022,Brazil,Ireland,37,104,0,141
29547,2022,Bosnia and Herzegovina,Ireland,5,0,0,5
29548,2022,Chad,Ireland,5,0,0,5
29549,2022,China,Ireland,77,39,0,116
29550,2022,Cameroon,Ireland,118,30,0,148
29551,2022,Congo,Ireland,16,0,0,16
29552,2022,Dem. Rep. of the Congo,Ireland,472,172,0,644
29553,2022,Colombia,Ireland,0,5,0,5
29554,2022,Cuba,Ireland,6,0,0,6
29555,2022,Dominica,Ireland,0,5,0,5
29556,2022,Dominican Rep.,Ireland,0,5,0,5
29557,2022,Eritrea,Ireland,110,18,0,128
29558,2022,Ethiopia,Ireland,81,43,0,124
29559,2022,Gambia,Ireland,0,6,0,6
29560,2022,Palestinian,Ireland,140,33,0,173
29561,2022,United Kingdom of Great Britain and Northern Ireland,Ireland,0,5,0,5
29562,2022,Georgia,Ireland,196,1681,0,1877
29563,2022,Ghana,Ireland,41,50,0,91
29564,2022,Guatemala,Ireland,10,12,0,22
29565,2022,Guinea,Ireland,19,9,0,28
29566,2022,Guyana,Ireland,0,5,0,5
29567,2022,Honduras,Ireland,5,6,0,11
29568,2022,Cote d'Ivoire,Ireland,18,5,0,23
29569,2022,India,Ireland,20,49,0,69
29570,2022,Indonesia,Ireland,5,0,0,5
29571,2022,Iran (Islamic Rep. of),Ireland,164,25,0,189
29572,2022,Iraq,Ireland,426,73,0,499
29573,2022,Israel,Ireland,12,5,0,17
29574,2022,Jordan,Ireland,15,23,0,38
29575,2022,Kazakhstan,Ireland,18,0,0,18
29576,2022,Kenya,Ireland,63,33,0,96
29577,2022,Kyrgyzstan,Ireland,5,0,0,5
29578,2022,Dem. People's Rep. of Korea,Ireland,10,5,0,15
29579,2022,Kuwait,Ireland,53,11,0,64
29580,2022,Liberia,Ireland,12,5,0,17
29581,2022,Libya,Ireland,244,7,0,251
29582,2022,Lebanon,Ireland,9,30,0,39
29583,2022,Lesotho,Ireland,5,9,0,14
29584,2022,Sri Lanka,Ireland,25,6,0,31
29585,2022,North Macedonia,Ireland,6,0,0,6
29586,2022,Rep. of Moldova,Ireland,51,0,0,51
29587,2022,Mexico,Ireland,9,6,0,15
29588,2022,Mali,Ireland,5,0,0,5
29589,2022,Malaysia,Ireland,10,34,0,44
29590,2022,Malawi,Ireland,163,110,0,273
29591,2022,Mongolia,Ireland,9,5,0,14
29592,2022,Morocco,Ireland,18,117,0,135
29593,2022,Mozambique,Ireland,5,5,0,10
29594,2022,Montenegro,Ireland,5,0,0,5
29595,2022,Mauritius,Ireland,22,28,0,50
29596,2022,Myanmar,Ireland,15,5,0,20
29597,2022,Nepal,Ireland,11,19,0,30
29598,2022,Niger,Ireland,5,0,0,5
29599,2022,Nicaragua,Ireland,22,23,0,45
29600,2022,Nigeria,Ireland,485,1132,0,1617
29601,2022,Pakistan,Ireland,431,331,0,762
29602,2022,Panama,Ireland,0,5,0,5
29603,2022,South Africa,Ireland,186,448,0,634
29604,2022,Russian Federation,Ireland,88,32,0,120
29605,2022,Rwanda,Ireland,35,0,0,35
29606,2022,El Salvador,Ireland,64,91,0,155
29607,2022,Saudi Arabia,Ireland,20,11,0,31
29608,2022,Serbia and Kosovo: S/RES/1244 (1999),Ireland,56,10,0,66
29609,2022,Senegal,Ireland,6,0,0,6
29610,2022,Sierra Leone,Ireland,77,58,0,135
29611,2022,Somalia,Ireland,634,1130,0,1764
29612,2022,Viet Nam,Ireland,13,26,0,39
29613,2022,Sudan,Ireland,246,50,0,296
29614,2022,South Sudan,Ireland,6,0,0,6
29615,2022,Eswatini,Ireland,26,32,0,58
29616,2022,Syrian Arab Rep.,Ireland,2954,69,0,3023
29617,2022,United Rep. of Tanzania,Ireland,5,6,0,11
29618,2022,Togo,Ireland,21,30,0,51
29619,2022,Tunisia,Ireland,6,16,0,22
29620,2022,Türkiye,Ireland,28,35,0,63
29621,2022,Uganda,Ireland,52,36,0,88
29622,2022,Ukraine,Ireland,41043,205,0,41248
29623,2022,United States of America,Ireland,0,20,0,20
29624,2022,Uzbekistan,Ireland,17,0,0,17
29625,2022,Venezuela (Bolivarian Republic of),Ireland,168,30,0,198
29626,2022,Yemen,Ireland,32,14,0,46
29627,2022,Zambia,Ireland,8,5,0,13
29628,2022,Zimbabwe,Ireland,797,828,0,1625
29630,2022,Afghanistan,Iran (Islamic Rep. of),820714,0,0,820714
29631,2022,Iraq,Iran (Islamic Rep. of),20000,0,0,20000
29632,2022,Kuwait,Iran (Islamic Rep. of),8,0,0,8
29633,2022,Myanmar,Iran (Islamic Rep. of),0,34,0,34
29634,2022,Pakistan,Iran (Islamic Rep. of),10,0,0,10
29635,2022,Uzbekistan,Iran (Islamic Rep. of),7,0,0,7
29636,2022,Afghanistan,Iraq,13,150,0,163
29637,2022,Egypt,Iraq,0,42,0,42
29638,2022,Bahrain,Iraq,0,25,0,25
29639,2022,Eritrea,Iraq,5,30,0,35
29640,2022,Ethiopia,Iraq,0,8,0,8
29641,2022,Palestinian,Iraq,7864,175,0,8039
29642,2022,Indonesia,Iraq,0,5,0,5
29643,2022,Iran (Islamic Rep. of),Iraq,4122,6038,0,10160
29644,2022,Iraq,Iraq,0,0,1177234,0
29645,2022,Kazakhstan,Iraq,0,5,0,5
29646,2022,Kyrgyzstan,Iraq,0,15,0,15
29647,2022,Kuwait,Iraq,0,330,0,330
29648,2022,Lebanon,Iraq,0,19,0,19
29649,2022,Pakistan,Iraq,0,57,0,57
29650,2022,Saudi Arabia,Iraq,0,6,0,6
29651,2022,Somalia,Iraq,6,5,0,11
29652,2022,Sudan,Iraq,94,705,0,799
29653,2022,South Sudan,Iraq,0,15,0,15
29654,2022,Syrian Arab Rep.,Iraq,262756,0,0,262756
29655,2022,Tunisia,Iraq,0,5,0,5
29656,2022,Türkiye,Iraq,13344,5134,0,18478
29657,2022,Ukraine,Iraq,0,5,0,5
29658,2022,Yemen,Iraq,0,166,0,166
29660,2022,Albania,Israel,0,17,0,17
29661,2022,Armenia,Israel,0,25,0,25
29662,2022,Azerbaijan,Israel,0,29,0,29
29663,2022,Benin,Israel,0,5,0,5
29664,2022,Burkina Faso,Israel,0,6,0,6
29665,2022,Belarus,Israel,5,614,0,619
29666,2022,Bolivia (Plurinational State of),Israel,0,5,0,5
29667,2022,Botswana,Israel,0,5,0,5
29668,2022,Brazil,Israel,0,5,0,5
29669,2022,Cambodia,Israel,0,5,0,5
29670,2022,Central African Rep.,Israel,0,15,0,15
29671,2022,Chad,Israel,5,5,0,10
29672,2022,China,Israel,0,578,0,578
29673,2022,Cameroon,Israel,0,48,0,48
29674,2022,Congo,Israel,0,24,0,24
29675,2022,Dem. Rep. of the Congo,Israel,0,214,0,214
29676,2022,Colombia,Israel,0,176,0,176
29677,2022,Ecuador,Israel,0,21,0,21
29678,2022,Eritrea,Israel,223,9972,0,10195
29679,2022,Ethiopia,Israel,109,837,0,946
29680,2022,Georgia,Israel,5,31,0,36
29681,2022,Ghana,Israel,0,273,0,273
29682,2022,Haiti,Israel,0,5,0,5
29683,2022,Honduras,Israel,0,6,0,6
29684,2022,Cote d'Ivoire,Israel,7,13,0,20
29685,2022,India,Israel,0,992,0,992
29686,2022,Iran (Islamic Rep. of),Israel,6,0,0,6
29687,2022,Iraq,Israel,10,0,0,10
29688,2022,Kazakhstan,Israel,0,93,0,93
29689,2022,Kenya,Israel,0,105,0,105
29690,2022,Kyrgyzstan,Israel,0,38,0,38
29691,2022,Dem. People's Rep. of Korea,Israel,5,0,0,5
29692,2022,Liberia,Israel,0,5,0,5
29693,2022,Lesotho,Israel,0,6,0,6
29694,2022,Sri Lanka,Israel,0,891,0,891
29695,2022,North Macedonia,Israel,0,23,0,23
29696,2022,Rep. of Moldova,Israel,0,273,0,273
29697,2022,Mexico,Israel,0,5,0,5
29698,2022,Mali,Israel,0,5,0,5
29699,2022,Malawi,Israel,0,72,0,72
29700,2022,Mozambique,Israel,0,5,0,5
29701,2022,Montenegro,Israel,0,18,0,18
29702,2022,Myanmar,Israel,0,172,0,172
29703,2022,Nepal,Israel,0,95,0,95
29704,2022,Nigeria,Israel,8,832,0,840
29705,2022,Peru,Israel,0,13,0,13
29706,2022,Philippines,Israel,0,69,0,69
29707,2022,Romania,Israel,0,18,0,18
29708,2022,South Africa,Israel,0,298,0,298
29709,2022,Russian Federation,Israel,5,2438,0,2443
29710,2022,Rwanda,Israel,0,41,0,41
29711,2022,Serbia and Kosovo: S/RES/1244 (1999),Israel,0,77,0,77
29712,2022,Sierra Leone,Israel,5,13,0,18
29713,2022,Somalia,Israel,0,11,0,11
29714,2022,Viet Nam,Israel,0,9,0,9
29715,2022,Sudan,Israel,590,4406,0,4996
29716,2022,South Sudan,Israel,72,58,0,130
29717,2022,United Rep. of Tanzania,Israel,0,6,0,6
29718,2022,Thailand,Israel,0,10,0,10
29719,2022,Tajikistan,Israel,0,5,0,5
29720,2022,Turkmenistan,Israel,0,5,0,5
29721,2022,Togo,Israel,0,6,0,6
29722,2022,Türkiye,Israel,5,148,0,153
29723,2022,Uganda,Israel,0,246,0,246
29724,2022,Ukraine,Israel,27,433,0,460
29725,2022,Uzbekistan,Israel,0,227,0,227
29726,2022,Zambia,Israel,0,5,0,5
29727,2022,Zimbabwe,Israel,0,17,0,17
29730,2022,Afghanistan,Italy,17706,1545,0,19251
29731,2022,Albania,Italy,1016,435,0,1451
29732,2022,Algeria,Italy,50,118,0,168
29733,2022,Angola,Italy,5,11,0,16
29734,2022,Egypt,Italy,937,4657,0,5594
29735,2022,Argentina,Italy,14,52,0,66
29736,2022,Armenia,Italy,225,107,0,332
29737,2022,Azerbaijan,Italy,5,29,0,34
29738,2022,Burundi,Italy,8,0,0,8
29739,2022,Benin,Italy,179,35,0,214
29740,2022,Bangladesh,Italy,5768,7148,0,12916
29741,2022,Burkina Faso,Italy,894,243,0,1137
29742,2022,Belarus,Italy,74,85,0,159
29743,2022,Bolivia (Plurinational State of),Italy,5,5,0,10
29744,2022,Brazil,Italy,412,228,0,640
29745,2022,Bosnia and Herzegovina,Italy,143,69,0,212
29746,2022,Central African Rep.,Italy,14,7,0,21
29747,2022,Chad,Italy,7,55,0,62
29748,2022,China,Italy,475,156,0,631
29749,2022,Chile,Italy,14,20,0,34
29750,2022,Cameroon,Italy,1762,494,0,2256
29751,2022,Congo,Italy,311,44,0,355
29752,2022,Dem. Rep. of the Congo,Italy,711,64,0,775
29753,2022,Comoros,Italy,0,5,0,5
29754,2022,Colombia,Italy,1114,948,0,2062
29755,2022,Costa Rica,Italy,0,13,0,13
29756,2022,Cuba,Italy,87,137,0,224
29757,2022,Cabo Verde,Italy,5,0,0,5
29758,2022,Dominican Rep.,Italy,16,18,0,34
29759,2022,Ecuador,Italy,26,23,0,49
29760,2022,Eritrea,Italy,3222,5210,0,8432
29761,2022,Ethiopia,Italy,979,85,0,1064
29762,2022,Gabon,Italy,0,6,0,6
29763,2022,Gambia,Italy,6324,736,0,7060
29764,2022,Palestinian,Italy,740,96,0,836
29765,2022,Georgia,Italy,887,2133,0,3020
29766,2022,Ghana,Italy,2713,408,0,3121
29767,2022,Guinea-Bissau,Italy,474,62,0,536
29768,2022,Guatemala,Italy,20,21,0,41
29769,2022,Guinea,Italy,2517,727,0,3244
29770,2022,Honduras,Italy,502,98,0,600
29771,2022,Cote d'Ivoire,Italy,4180,1330,0,5510
29772,2022,India,Italy,290,396,0,686
29773,2022,Indonesia,Italy,0,5,0,5
29774,2022,Iran (Islamic Rep. of),Italy,1261,150,0,1411
29775,2022,Iraq,Italy,5463,1152,0,6615
29776,2022,Israel,Italy,0,5,0,5
29777,2022,Jordan,Italy,5,6,0,11
29778,2022,Kazakhstan,Italy,6,12,0,18
29779,2022,Kenya,Italy,19,14,0,33
29780,2022,Kyrgyzstan,Italy,6,43,0,49
29781,2022,Liberia,Italy,349,37,0,386
29782,2022,Libya,Italy,1185,230,0,1415
29783,2022,Lebanon,Italy,27,63,0,90
29784,2022,Liechtenstein,Italy,5,0,0,5
29785,2022,Sri Lanka,Italy,384,296,0,680
29786,2022,Madagascar,Italy,0,5,0,5
29787,2022,Mauritania,Italy,257,7,0,264
29788,2022,North Macedonia,Italy,41,61,0,102
29789,2022,Rep. of Moldova,Italy,66,184,0,250
29790,2022,Mexico,Italy,5,10,0,15
29791,2022,Mali,Italy,11193,1036,0,12229
29792,2022,Malaysia,Italy,0,5,0,5
29793,2022,Morocco,Italy,1059,1368,0,2427
29794,2022,Montenegro,Italy,19,5,0,24
29795,2022,Mauritius,Italy,7,20,0,27
29796,2022,Myanmar,Italy,8,11,0,19
29797,2022,Nepal,Italy,26,87,0,113
29798,2022,Niger,Italy,472,36,0,508
29799,2022,Nicaragua,Italy,13,24,0,37
29800,2022,Nigeria,Italy,21441,4435,0,25876
29801,2022,Pakistan,Italy,17619,9967,0,27586
29802,2022,Panama,Italy,0,6,0,6
29803,2022,Paraguay,Italy,10,6,0,16
29804,2022,Peru,Italy,867,1427,0,2294
29805,2022,Philippines,Italy,25,53,0,78
29806,2022,South Africa,Italy,0,15,0,15
29807,2022,Russian Federation,Italy,258,287,0,545
29808,2022,Rwanda,Italy,5,0,0,5
29809,2022,El Salvador,Italy,4169,755,0,4924
29810,2022,Saudi Arabia,Italy,0,5,0,5
29811,2022,Serbia and Kosovo: S/RES/1244 (1999),Italy,1449,290,0,1739
29812,2022,Senegal,Italy,4820,626,0,5446
29813,2022,Sierra Leone,Italy,448,118,0,566
29814,2022,Somalia,Italy,8405,1077,0,9482
29815,2022,Viet Nam,Italy,0,5,0,5
29816,2022,Sudan,Italy,1159,383,0,1542
29817,2022,South Sudan,Italy,7,30,0,37
29818,2022,Syrian Arab Rep.,Italy,3525,903,0,4428
29819,2022,United Rep. of Tanzania,Italy,5,7,0,12
29820,2022,Thailand,Italy,0,5,0,5
29821,2022,Togo,Italy,757,94,0,851
29822,2022,Tunisia,Italy,706,1753,0,2459
29823,2022,Türkiye,Italy,1650,670,0,2320
29824,2022,Uganda,Italy,5,0,0,5
29825,2022,Ukraine,Italy,145593,1689,0,147282
29826,2022,Uruguay,Italy,5,5,0,10
29827,2022,United States of America,Italy,5,11,0,16
29828,2022,Uzbekistan,Italy,0,5,0,5
29829,2022,Venezuela (Bolivarian Republic of),Italy,3154,833,0,3987
29830,2022,Western Sahara,Italy,5,0,0,5
29831,2022,Yemen,Italy,16,41,0,57
29834,2022,Haiti,Jamaica,31,5,0,36
29835,2022,Venezuela (Bolivarian Republic of),Jamaica,0,0,0,0
29836,2022,Afghanistan,Jordan,8,10,0,18
29837,2022,Algeria,Jordan,0,5,0,5
29838,2022,Egypt,Jordan,126,482,0,608
29839,2022,Bangladesh,Jordan,0,5,0,5
29840,2022,Bosnia and Herzegovina,Jordan,9,0,0,9
29841,2022,Bulgaria,Jordan,0,0,0,0
29842,2022,Central African Rep.,Jordan,7,0,0,7
29843,2022,Chad,Jordan,10,17,0,27
29844,2022,Comoros,Jordan,0,5,0,5
29845,2022,Eritrea,Jordan,37,5,0,42
29846,2022,Ethiopia,Jordan,19,20,0,39
29847,2022,Palestinian,Jordan,0,0,0,0
29848,2022,Iran (Islamic Rep. of),Jordan,5,0,0,5
29849,2022,Iraq,Jordan,33951,31949,0,65900
29850,2022,Jordan,Jordan,0,0,0,0
29851,2022,Kenya,Jordan,5,5,0,10
29852,2022,Libya,Jordan,47,104,0,151
29853,2022,Lebanon,Jordan,5,105,0,110
29854,2022,Sri Lanka,Jordan,9,0,0,9
29855,2022,Morocco,Jordan,0,9,0,9
29856,2022,Niger,Jordan,0,5,0,5
29857,2022,Nigeria,Jordan,5,61,0,66
29858,2022,Pakistan,Jordan,5,20,0,25
29859,2022,Philippines,Jordan,5,0,0,5
29860,2022,Russian Federation,Jordan,24,7,0,31
29861,2022,Saudi Arabia,Jordan,0,0,0,0
29862,2022,Senegal,Jordan,0,5,0,5
29863,2022,Somalia,Jordan,602,54,0,656
29864,2022,Sudan,Jordan,3438,2146,0,5584
29865,2022,South Sudan,Jordan,11,8,0,19
29866,2022,Syrian Arab Rep.,Jordan,675433,0,0,675433
29867,2022,Tajikistan,Jordan,0,15,0,15
29868,2022,Tunisia,Jordan,11,8,0,19
29869,2022,Ukraine,Jordan,0,9,0,9
29870,2022,United States of America,Jordan,0,0,0,0
29871,2022,Venezuela (Bolivarian Republic of),Jordan,0,5,0,5
29872,2022,Yemen,Jordan,1668,11236,0,12904
29874,2022,Afghanistan,Japan,84,0,0,84
29875,2022,Burundi,Japan,9,0,0,9
29876,2022,Bangladesh,Japan,18,0,0,18
29877,2022,China,Japan,77,0,0,77
29878,2022,Cameroon,Japan,19,0,0,19
29879,2022,Dem. Rep. of the Congo,Japan,23,0,0,23
29880,2022,Ethiopia,Japan,32,0,0,32
29881,2022,Guinea,Japan,5,0,0,5
29882,2022,Iran (Islamic Rep. of),Japan,19,0,0,19
29883,2022,Iraq,Japan,17,0,0,17
29884,2022,Sri Lanka,Japan,59,0,0,59
29885,2022,Myanmar,Japan,583,0,0,583
29886,2022,Nigeria,Japan,5,0,0,5
29887,2022,Pakistan,Japan,34,0,0,34
29888,2022,Rwanda,Japan,5,0,0,5
29889,2022,Somalia,Japan,5,0,0,5
29890,2022,Sudan,Japan,16,0,0,16
29891,2022,Syrian Arab Rep.,Japan,93,0,0,93
29892,2022,Türkiye,Japan,46,0,0,46
29893,2022,Uganda,Japan,6,0,0,6
29894,2022,Yemen,Japan,15,0,0,15
29897,2022,Afghanistan,Kazakhstan,325,386,0,711
29898,2022,China,Kazakhstan,6,7,0,13
29899,2022,Iran (Islamic Rep. of),Kazakhstan,0,6,0,6
29900,2022,Kyrgyzstan,Kazakhstan,0,5,0,5
29901,2022,Russian Federation,Kazakhstan,0,5,0,5
29902,2022,Syrian Arab Rep.,Kazakhstan,14,5,0,19
29903,2022,Ukraine,Kazakhstan,0,228,0,228
29904,2022,Uzbekistan,Kazakhstan,5,0,0,5
29906,2022,Afghanistan,Kenya,11,36,0,47
29907,2022,Egypt,Kenya,0,17,0,17
29908,2022,Burundi,Kenya,7697,13121,0,20818
29909,2022,Central African Rep.,Kenya,0,13,0,13
29910,2022,Chad,Kenya,0,5,0,5
29911,2022,Cameroon,Kenya,0,59,0,59
29912,2022,Congo,Kenya,100,81,0,181
29913,2022,Dem. Rep. of the Congo,Kenya,31342,19920,0,51262
29914,2022,Eritrea,Kenya,905,1536,0,2441
29915,2022,Ethiopia,Kenya,21066,10433,0,31499
29916,2022,Cote d'Ivoire,Kenya,0,5,0,5
29917,2022,India,Kenya,0,5,0,5
29918,2022,Sri Lanka,Kenya,9,0,0,9
29919,2022,Mozambique,Kenya,8,0,0,8
29920,2022,Nigeria,Kenya,6,9,0,15
29921,2022,Pakistan,Kenya,10,11,0,21
29922,2022,Rwanda,Kenya,791,1321,0,2112
29923,2022,Somalia,Kenya,279200,8575,0,287775
29924,2022,Sudan,Kenya,5022,5194,0,10216
29925,2022,South Sudan,Kenya,144441,79,0,144520
29926,2022,Syrian Arab Rep.,Kenya,5,5,0,10
29927,2022,United Rep. of Tanzania,Kenya,11,118,0,129
29928,2022,Türkiye,Kenya,137,67,0,204
29929,2022,Uganda,Kenya,800,2664,0,3464
29930,2022,Yemen,Kenya,95,220,0,315
29931,2022,Zimbabwe,Kenya,6,6,0,12
29933,2022,Afghanistan,Kyrgyzstan,208,491,0,699
29934,2022,Palestinian,Kyrgyzstan,0,5,0,5
29935,2022,Iraq,Kyrgyzstan,5,0,0,5
29936,2022,Pakistan,Kyrgyzstan,0,5,0,5
29937,2022,Philippines,Kyrgyzstan,0,5,0,5
29938,2022,Syrian Arab Rep.,Kyrgyzstan,69,9,0,78
29939,2022,Turkmenistan,Kyrgyzstan,5,0,0,5
29940,2022,Türkiye,Kyrgyzstan,0,283,0,283
29941,2022,Ukraine,Kyrgyzstan,17,6,0,23
29942,2022,Venezuela (Bolivarian Republic of),Kyrgyzstan,0,5,0,5
29944,2022,Afghanistan,Rep. of Korea,46,59,0,105
29945,2022,Algeria,Rep. of Korea,6,73,0,79
29946,2022,Angola,Rep. of Korea,9,18,0,27
29947,2022,Egypt,Rep. of Korea,72,753,0,825
29948,2022,Argentina,Rep. of Korea,0,8,0,8
29949,2022,Azerbaijan,Rep. of Korea,0,8,0,8
29950,2022,Burundi,Rep. of Korea,47,15,0,62
29951,2022,Bangladesh,Rep. of Korea,129,1004,0,1133
29952,2022,Burkina Faso,Rep. of Korea,0,5,0,5
29953,2022,Bolivia (Plurinational State of),Rep. of Korea,0,5,0,5
29954,2022,Brazil,Rep. of Korea,0,13,0,13
29955,2022,Cambodia,Rep. of Korea,0,47,0,47
29956,2022,China,Rep. of Korea,50,1121,0,1171
29957,2022,Cameroon,Rep. of Korea,23,164,0,187
29958,2022,Congo,Rep. of Korea,0,8,0,8
29959,2022,Dem. Rep. of the Congo,Rep. of Korea,62,24,0,86
29960,2022,Colombia,Rep. of Korea,0,5,0,5
29961,2022,Eritrea,Rep. of Korea,10,0,0,10
29962,2022,Ethiopia,Rep. of Korea,171,164,0,335
29963,2022,Gambia,Rep. of Korea,0,44,0,44
29964,2022,Palestinian,Rep. of Korea,8,6,0,14
29965,2022,Ghana,Rep. of Korea,7,195,0,202
29966,2022,Guinea,Rep. of Korea,5,116,0,121
29967,2022,Haiti,Rep. of Korea,0,23,0,23
29968,2022,Cote d'Ivoire,Rep. of Korea,38,22,0,60
29969,2022,India,Rep. of Korea,0,1294,0,1294
29970,2022,Indonesia,Rep. of Korea,0,29,0,29
29971,2022,Iran (Islamic Rep. of),Rep. of Korea,62,54,0,116
29972,2022,Iraq,Rep. of Korea,28,84,0,112
29973,2022,Jordan,Rep. of Korea,7,16,0,23
29974,2022,Kazakhstan,Rep. of Korea,5,669,0,674
29975,2022,Kenya,Rep. of Korea,5,36,0,41
29976,2022,Kyrgyzstan,Rep. of Korea,0,101,0,101
29977,2022,Liberia,Rep. of Korea,12,164,0,176
29978,2022,Libya,Rep. of Korea,15,60,0,75
29979,2022,Sri Lanka,Rep. of Korea,8,191,0,199
29980,2022,Mali,Rep. of Korea,8,78,0,86
29981,2022,Malaysia,Rep. of Korea,0,875,0,875
29982,2022,Mongolia,Rep. of Korea,0,177,0,177
29983,2022,Morocco,Rep. of Korea,5,176,0,181
29984,2022,Mozambique,Rep. of Korea,0,7,0,7
29985,2022,Myanmar,Rep. of Korea,396,107,0,503
29986,2022,Nepal,Rep. of Korea,5,391,0,396
29987,2022,Nigeria,Rep. of Korea,13,343,0,356
29988,2022,Pakistan,Rep. of Korea,118,938,0,1056
29989,2022,Peru,Rep. of Korea,0,9,0,9
29990,2022,Philippines,Rep. of Korea,0,331,0,331
29991,2022,South Africa,Rep. of Korea,0,50,0,50
29992,2022,Russian Federation,Rep. of Korea,13,1000,0,1013
29993,2022,Rwanda,Rep. of Korea,0,30,0,30
29994,2022,Saudi Arabia,Rep. of Korea,0,5,0,5
29995,2022,Senegal,Rep. of Korea,0,50,0,50
29996,2022,Sierra Leone,Rep. of Korea,0,26,0,26
29997,2022,Somalia,Rep. of Korea,5,0,0,5
29998,2022,Viet Nam,Rep. of Korea,0,63,0,63
29999,2022,Sudan,Rep. of Korea,32,46,0,78
30000,2022,Syrian Arab Rep.,Rep. of Korea,1250,28,0,1278
30001,2022,United Rep. of Tanzania,Rep. of Korea,5,34,0,39
30002,2022,Thailand,Rep. of Korea,10,179,0,189
30003,2022,Tajikistan,Rep. of Korea,0,24,0,24
30004,2022,Togo,Rep. of Korea,0,14,0,14
30005,2022,Tunisia,Rep. of Korea,0,55,0,55
30006,2022,Türkiye,Rep. of Korea,0,186,0,186
30007,2022,Uganda,Rep. of Korea,38,50,0,88
30008,2022,Ukraine,Rep. of Korea,14,24,0,38
30009,2022,United States of America,Rep. of Korea,0,5,0,5
30010,2022,Uzbekistan,Rep. of Korea,9,201,0,210
30011,2022,Venezuela (Bolivarian Republic of),Rep. of Korea,0,12,0,12
30012,2022,Yemen,Rep. of Korea,813,18,0,831
30013,2022,Zimbabwe,Rep. of Korea,0,6,0,6
30016,2022,Afghanistan,Kuwait,0,17,0,17
30017,2022,Egypt,Kuwait,6,19,0,25
30018,2022,Djibouti,Kuwait,0,5,0,5
30019,2022,Eritrea,Kuwait,5,28,0,33
30020,2022,Ethiopia,Kuwait,0,7,0,7
30021,2022,Palestinian,Kuwait,5,5,0,10
30022,2022,Iran (Islamic Rep. of),Kuwait,9,83,0,92
30023,2022,Iraq,Kuwait,334,307,0,641
30024,2022,Jordan,Kuwait,0,6,0,6
30025,2022,Lebanon,Kuwait,0,5,0,5
30026,2022,Sri Lanka,Kuwait,0,6,0,6
30027,2022,Pakistan,Kuwait,0,12,0,12
30028,2022,Philippines,Kuwait,0,5,0,5
30029,2022,Somalia,Kuwait,189,444,0,633
30030,2022,Sudan,Kuwait,0,17,0,17
30031,2022,Syrian Arab Rep.,Kuwait,147,107,0,254
30032,2022,Ukraine,Kuwait,0,5,0,5
30033,2022,Yemen,Kuwait,9,10,0,19
30036,2022,Central African Rep.,Liberia,5,0,0,5
30037,2022,Cameroon,Liberia,6,0,0,6
30038,2022,Dem. Rep. of the Congo,Liberia,28,5,0,33
30039,2022,Guinea,Liberia,0,5,0,5
30040,2022,Cote d'Ivoire,Liberia,3114,1320,0,4434
30041,2022,Mali,Liberia,19,0,0,19
30042,2022,Nigeria,Liberia,0,6,0,6
30043,2022,Pakistan,Liberia,6,0,0,6
30044,2022,Rwanda,Liberia,5,0,0,5
30045,2022,Sierra Leone,Liberia,5,0,0,5
30046,2022,Somalia,Liberia,5,0,0,5
30047,2022,Sudan,Liberia,11,0,0,11
30048,2022,South Sudan,Liberia,5,0,0,5
30049,2022,Syrian Arab Rep.,Liberia,28,33,0,61
30050,2022,Togo,Liberia,5,0,0,5
30051,2022,Türkiye,Liberia,16,0,0,16
30052,2022,Afghanistan,Libya,0,5,0,5
30053,2022,Chad,Libya,0,5,0,5
30054,2022,Eritrea,Libya,355,4037,0,4392
30055,2022,Ethiopia,Libya,34,1293,0,1327
30056,2022,Palestinian,Libya,161,695,0,856
30057,2022,Cote d'Ivoire,Libya,0,7,0,7
30058,2022,Iraq,Libya,201,102,0,303
30059,2022,Libya,Libya,0,0,159996,0
30060,2022,Nigeria,Libya,0,25,0,25
30061,2022,Somalia,Libya,22,788,0,810
30062,2022,Sudan,Libya,1436,16078,0,17514
30063,2022,South Sudan,Libya,5,352,0,357
30064,2022,Syrian Arab Rep.,Libya,480,13682,0,14162
30065,2022,Yemen,Libya,11,115,0,126
30066,2022,Afghanistan,Lebanon,36,5,0,41
30067,2022,Algeria,Lebanon,5,6,0,11
30068,2022,Egypt,Lebanon,129,446,0,575
30069,2022,Armenia,Lebanon,0,11,0,11
30070,2022,Bahrain,Lebanon,14,5,0,19
30071,2022,Bangladesh,Lebanon,0,120,0,120
30072,2022,Cameroon,Lebanon,10,17,0,27
30073,2022,Congo,Lebanon,0,5,0,5
30074,2022,Dem. Rep. of the Congo,Lebanon,5,13,0,18
30075,2022,Eritrea,Lebanon,19,20,0,39
30076,2022,Ethiopia,Lebanon,93,1101,0,1194
30077,2022,Gambia,Lebanon,0,5,0,5
30078,2022,Palestinian,Lebanon,0,0,0,0
30079,2022,Ghana,Lebanon,0,7,0,7
30080,2022,Cote d'Ivoire,Lebanon,0,9,0,9
30081,2022,India,Lebanon,0,13,0,13
30082,2022,Iran (Islamic Rep. of),Lebanon,33,56,0,89
30083,2022,Iraq,Lebanon,3389,4756,0,8145
30084,2022,Jordan,Lebanon,38,90,0,128
30085,2022,Kenya,Lebanon,5,18,0,23
30086,2022,Kuwait,Lebanon,9,0,0,9
30087,2022,Libya,Lebanon,11,15,0,26
30088,2022,Lebanon,Lebanon,0,0,0,0
30089,2022,Sri Lanka,Lebanon,0,24,0,24
30090,2022,Madagascar,Lebanon,0,13,0,13
30091,2022,Morocco,Lebanon,5,9,0,14
30092,2022,Nigeria,Lebanon,5,75,0,80
30093,2022,Pakistan,Lebanon,6,14,0,20
30094,2022,Philippines,Lebanon,0,33,0,33
30095,2022,Saudi Arabia,Lebanon,7,7,0,14
30096,2022,Sierra Leone,Lebanon,0,5,0,5
30097,2022,Somalia,Lebanon,11,0,0,11
30098,2022,Sudan,Lebanon,745,1641,0,2386
30099,2022,South Sudan,Lebanon,38,0,0,38
30100,2022,Syrian Arab Rep.,Lebanon,831053,0,0,831053
30101,2022,Togo,Lebanon,0,10,0,10
30102,2022,Tunisia,Lebanon,9,0,0,9
30103,2022,Türkiye,Lebanon,8,6,0,14
30104,2022,Ukraine,Lebanon,0,12,0,12
30105,2022,Venezuela (Bolivarian Republic of),Lebanon,0,5,0,5
30106,2022,Yemen,Lebanon,31,98,0,129
30108,2022,Cambodia,Lesotho,5,0,0,5
30109,2022,Cameroon,Lesotho,0,13,0,13
30110,2022,Congo,Lesotho,0,5,0,5
30111,2022,Dem. Rep. of the Congo,Lesotho,178,173,0,351
30112,2022,Eritrea,Lesotho,31,45,0,76
30113,2022,Ethiopia,Lesotho,6,11,0,17
30114,2022,Lesotho,Lesotho,0,0,0,0
30115,2022,Nigeria,Lesotho,0,6,0,6
30116,2022,Pakistan,Lesotho,0,5,0,5
30117,2022,Somalia,Lesotho,0,5,0,5
30118,2022,Uganda,Lesotho,9,5,0,14
30119,2022,Zambia,Lesotho,5,0,0,5
30120,2022,Zimbabwe,Lesotho,0,10,0,10
30121,2022,Belarus,Liechtenstein,0,5,0,5
30122,2022,Bosnia and Herzegovina,Liechtenstein,5,0,0,5
30123,2022,China,Liechtenstein,54,0,0,54
30124,2022,Eritrea,Liechtenstein,22,0,0,22
30125,2022,Georgia,Liechtenstein,0,5,0,5
30126,2022,Iran (Islamic Rep. of),Liechtenstein,18,0,0,18
30127,2022,Iraq,Liechtenstein,14,0,0,14
30128,2022,Kazakhstan,Liechtenstein,0,5,0,5
30129,2022,Libya,Liechtenstein,0,5,0,5
30130,2022,North Macedonia,Liechtenstein,0,5,0,5
30131,2022,Morocco,Liechtenstein,0,9,0,9
30132,2022,Russian Federation,Liechtenstein,0,5,0,5
30133,2022,Somalia,Liechtenstein,46,0,0,46
30134,2022,Sudan,Liechtenstein,0,9,0,9
30135,2022,Syrian Arab Rep.,Liechtenstein,65,0,0,65
30136,2022,Tunisia,Liechtenstein,0,5,0,5
30137,2022,Ukraine,Liechtenstein,280,0,0,280
30139,2022,Afghanistan,Sri Lanka,111,5,0,116
30140,2022,Palestinian,Sri Lanka,5,0,0,5
30141,2022,India,Sri Lanka,0,5,0,5
30142,2022,Iran (Islamic Rep. of),Sri Lanka,15,0,0,15
30143,2022,Sri Lanka,Sri Lanka,0,0,8540,0
30144,2022,Maldives,Sri Lanka,0,5,0,5
30145,2022,Myanmar,Sri Lanka,35,0,0,35
30146,2022,Nigeria,Sri Lanka,0,10,0,10
30147,2022,Pakistan,Sri Lanka,551,134,0,685
30148,2022,Sudan,Sri Lanka,5,5,0,10
30149,2022,Yemen,Sri Lanka,14,5,0,19
30151,2022,Afghanistan,Lithuania,238,18,0,256
30152,2022,Azerbaijan,Lithuania,17,0,0,17
30153,2022,Belarus,Lithuania,121,210,0,331
30154,2022,Chile,Lithuania,0,5,0,5
30155,2022,Cameroon,Lithuania,6,0,0,6
30156,2022,Cuba,Lithuania,5,5,0,10
30157,2022,Eritrea,Lithuania,40,0,0,40
30158,2022,Ethiopia,Lithuania,5,0,0,5
30159,2022,Georgia,Lithuania,5,0,0,5
30160,2022,Iran (Islamic Rep. of),Lithuania,14,0,0,14
30161,2022,Iraq,Lithuania,74,0,0,74
30162,2022,Kazakhstan,Lithuania,0,5,0,5
30163,2022,Sri Lanka,Lithuania,10,12,0,22
30164,2022,Nigeria,Lithuania,5,0,0,5
30165,2022,Pakistan,Lithuania,5,0,0,5
30166,2022,Russian Federation,Lithuania,698,67,0,765
30167,2022,Somalia,Lithuania,24,0,0,24
30168,2022,South Sudan,Lithuania,5,0,0,5
30169,2022,Syrian Arab Rep.,Lithuania,479,35,0,514
30170,2022,Tajikistan,Lithuania,87,10,0,97
30171,2022,Türkiye,Lithuania,69,0,0,69
30172,2022,Ukraine,Lithuania,47569,9,0,47578
30173,2022,Uzbekistan,Lithuania,17,0,0,17
30174,2022,Yemen,Lithuania,5,5,0,10
30176,2022,Afghanistan,Luxembourg,413,189,0,602
30177,2022,Albania,Luxembourg,28,10,0,38
30178,2022,Algeria,Luxembourg,30,15,0,45
30179,2022,Angola,Luxembourg,9,11,0,20
30180,2022,Egypt,Luxembourg,5,5,0,10
30181,2022,Armenia,Luxembourg,5,0,0,5
30182,2022,Azerbaijan,Luxembourg,12,0,0,12
30183,2022,Bhutan,Luxembourg,5,0,0,5
30184,2022,Burkina Faso,Luxembourg,0,5,0,5
30185,2022,Belarus,Luxembourg,0,10,0,10
30186,2022,Bosnia and Herzegovina,Luxembourg,5,6,0,11
30187,2022,China,Luxembourg,7,0,0,7
30188,2022,Cameroon,Luxembourg,36,36,0,72
30189,2022,Dem. Rep. of the Congo,Luxembourg,42,11,0,53
30190,2022,Colombia,Luxembourg,0,30,0,30
30191,2022,Eritrea,Luxembourg,1440,200,0,1640
30192,2022,Ethiopia,Luxembourg,59,48,0,107
30193,2022,Gambia,Luxembourg,6,0,0,6
30194,2022,Georgia,Luxembourg,5,8,0,13
30195,2022,Guinea,Luxembourg,9,0,0,9
30196,2022,Cote d'Ivoire,Luxembourg,5,15,0,20
30197,2022,Iran (Islamic Rep. of),Luxembourg,196,76,0,272
30198,2022,Iraq,Luxembourg,652,97,0,749
30199,2022,Kyrgyzstan,Luxembourg,5,0,0,5
30200,2022,Rep. of Korea,Luxembourg,9,0,0,9
30201,2022,Kuwait,Luxembourg,0,6,0,6
30202,2022,Libya,Luxembourg,5,21,0,26
30203,2022,Lebanon,Luxembourg,0,15,0,15
30204,2022,Sri Lanka,Luxembourg,5,0,0,5
30205,2022,Mali,Luxembourg,0,5,0,5
30206,2022,Morocco,Luxembourg,5,5,0,10
30207,2022,Montenegro,Luxembourg,6,5,0,11
30208,2022,Myanmar,Luxembourg,0,5,0,5
30209,2022,Niger,Luxembourg,0,5,0,5
30210,2022,Nigeria,Luxembourg,10,8,0,18
30211,2022,Pakistan,Luxembourg,0,5,0,5
30212,2022,Russian Federation,Luxembourg,30,22,0,52
30213,2022,Rwanda,Luxembourg,8,5,0,13
30214,2022,El Salvador,Luxembourg,0,9,0,9
30215,2022,Serbia and Kosovo: S/RES/1244 (1999),Luxembourg,97,5,0,102
30216,2022,Senegal,Luxembourg,5,9,0,14
30217,2022,Somalia,Luxembourg,60,32,0,92
30218,2022,Sudan,Luxembourg,55,42,0,97
30219,2022,Syrian Arab Rep.,Luxembourg,2049,537,0,2586
30220,2022,United Rep. of Tanzania,Luxembourg,0,5,0,5
30221,2022,Tajikistan,Luxembourg,0,5,0,5
30222,2022,Turkmenistan,Luxembourg,5,0,0,5
30223,2022,Togo,Luxembourg,8,7,0,15
30224,2022,Tunisia,Luxembourg,7,18,0,25
30225,2022,Türkiye,Luxembourg,139,49,0,188
30226,2022,Uganda,Luxembourg,5,0,0,5
30227,2022,Ukraine,Luxembourg,4259,10,0,4269
30228,2022,Venezuela (Bolivarian Republic of),Luxembourg,5,151,0,156
30229,2022,Yemen,Luxembourg,28,7,0,35
30232,2022,Afghanistan,Latvia,147,46,0,193
30233,2022,Egypt,Latvia,5,0,0,5
30234,2022,Azerbaijan,Latvia,11,12,0,23
30235,2022,Belarus,Latvia,102,23,0,125
30236,2022,China,Latvia,5,0,0,5
30237,2022,Eritrea,Latvia,35,0,0,35
30238,2022,Palestinian,Latvia,7,0,0,7
30239,2022,Iran (Islamic Rep. of),Latvia,17,0,0,17
30240,2022,Iraq,Latvia,44,12,0,56
30241,2022,Kazakhstan,Latvia,5,0,0,5
30242,2022,Kyrgyzstan,Latvia,5,0,0,5
30243,2022,Lebanon,Latvia,5,0,0,5
30244,2022,Sri Lanka,Latvia,5,13,0,18
30245,2022,Morocco,Latvia,0,5,0,5
30246,2022,Pakistan,Latvia,0,5,0,5
30247,2022,Russian Federation,Latvia,62,38,0,100
30248,2022,Somalia,Latvia,5,0,0,5
30249,2022,Syrian Arab Rep.,Latvia,317,0,0,317
30250,2022,Tajikistan,Latvia,5,5,0,10
30251,2022,Türkiye,Latvia,31,0,0,31
30252,2022,Ukraine,Latvia,34256,5,0,34261
30253,2022,Uzbekistan,Latvia,12,6,0,18
30255,2022,Afghanistan,Madagascar,19,0,0,19
30256,2022,Burundi,Madagascar,5,0,0,5
30257,2022,Congo,Madagascar,0,5,0,5
30258,2022,Dem. Rep. of the Congo,Madagascar,11,0,0,11
30259,2022,Guinea,Madagascar,6,0,0,6
30260,2022,Madagascar,Madagascar,0,0,0,0
30261,2022,Pakistan,Madagascar,125,87,0,212
30262,2022,Syrian Arab Rep.,Madagascar,5,0,0,5
30263,2022,Yemen,Madagascar,14,12,0,26
30264,2022,Benin,Mauritania,0,8,0,8
30265,2022,Burkina Faso,Mauritania,17,92,0,109
30266,2022,Central African Rep.,Mauritania,651,109,0,760
30267,2022,Chad,Mauritania,0,13,0,13
30268,2022,China,Mauritania,5,0,0,5
30269,2022,Cameroon,Mauritania,18,150,0,168
30270,2022,Congo,Mauritania,7,19,0,26
30271,2022,Dem. Rep. of the Congo,Mauritania,31,30,0,61
30272,2022,Ethiopia,Mauritania,8,8,0,16
30273,2022,Gambia,Mauritania,0,8,0,8
30274,2022,Palestinian,Mauritania,78,35,0,113
30275,2022,Ghana,Mauritania,0,9,0,9
30276,2022,Guinea,Mauritania,18,198,0,216
30277,2022,Cote d'Ivoire,Mauritania,274,201,0,475
30278,2022,Iraq,Mauritania,24,0,0,24
30279,2022,Liberia,Mauritania,7,24,0,31
30280,2022,Libya,Mauritania,8,5,0,13
30281,2022,Lebanon,Mauritania,0,30,0,30
30282,2022,Mali,Mauritania,86315,2668,0,88983
30283,2022,Niger,Mauritania,5,37,0,42
30284,2022,Nigeria,Mauritania,13,100,0,113
30285,2022,Russian Federation,Mauritania,11,0,0,11
30286,2022,Rwanda,Mauritania,0,5,0,5
30287,2022,Senegal,Mauritania,118,229,0,347
30288,2022,Sierra Leone,Mauritania,0,189,0,189
30289,2022,Somalia,Mauritania,5,5,0,10
30290,2022,Sudan,Mauritania,13,36,0,49
30291,2022,Syrian Arab Rep.,Mauritania,381,183,0,564
30292,2022,Togo,Mauritania,17,157,0,174
30293,2022,Türkiye,Mauritania,5,15,0,20
30294,2022,Western Sahara,Mauritania,26000,0,0,26000
30295,2022,Yemen,Mauritania,45,29,0,74
30296,2022,Congo,North Macedonia,5,0,0,5
30297,2022,Iraq,North Macedonia,0,5,0,5
30298,2022,Morocco,North Macedonia,0,5,0,5
30299,2022,Serbia and Kosovo: S/RES/1244 (1999),North Macedonia,251,0,0,251
30300,2022,Syrian Arab Rep.,North Macedonia,0,0,0,0
30301,2022,Türkiye,North Macedonia,0,5,0,5
30302,2022,Ukraine,North Macedonia,1174,0,0,1174
30304,2022,Iraq,Monaco,5,0,0,5
30305,2022,Viet Nam,Monaco,7,0,0,7
30306,2022,Syrian Arab Rep.,Monaco,5,0,0,5
30307,2022,Afghanistan,Rep. of Moldova,17,9,0,26
30308,2022,Algeria,Rep. of Moldova,0,25,0,25
30309,2022,Egypt,Rep. of Moldova,5,5,0,10
30310,2022,Armenia,Rep. of Moldova,118,7,0,125
30311,2022,Australia,Rep. of Moldova,5,0,0,5
30312,2022,Austria,Rep. of Moldova,8,0,0,8
30313,2022,Azerbaijan,Rep. of Moldova,709,57,0,766
30314,2022,Belgium,Rep. of Moldova,5,0,0,5
30315,2022,Belarus,Rep. of Moldova,66,7,0,73
30316,2022,Bulgaria,Rep. of Moldova,175,0,0,175
30317,2022,Canada,Rep. of Moldova,13,0,0,13
30318,2022,China,Rep. of Moldova,72,5,0,77
30319,2022,Cameroon,Rep. of Moldova,0,5,0,5
30320,2022,Cuba,Rep. of Moldova,0,8,0,8
30321,2022,Ecuador,Rep. of Moldova,0,5,0,5
30322,2022,Finland,Rep. of Moldova,5,0,0,5
30323,2022,France,Rep. of Moldova,18,0,0,18
30324,2022,Palestinian,Rep. of Moldova,5,0,0,5
30325,2022,United Kingdom of Great Britain and Northern Ireland,Rep. of Moldova,21,0,0,21
30326,2022,Georgia,Rep. of Moldova,144,24,0,168
30327,2022,Germany,Rep. of Moldova,33,0,0,33
30328,2022,Greece,Rep. of Moldova,16,0,0,16
30329,2022,Hungary,Rep. of Moldova,8,0,0,8
30330,2022,India,Rep. of Moldova,0,33,0,33
30331,2022,Ireland,Rep. of Moldova,10,0,0,10
30332,2022,Iran (Islamic Rep. of),Rep. of Moldova,0,16,0,16
30333,2022,Iraq,Rep. of Moldova,17,24,0,41
30334,2022,Israel,Rep. of Moldova,86,19,0,105
30335,2022,Italy,Rep. of Moldova,33,0,0,33
30336,2022,Jordan,Rep. of Moldova,0,5,0,5
30337,2022,Japan,Rep. of Moldova,5,0,0,5
30338,2022,Kazakhstan,Rep. of Moldova,27,0,0,27
30339,2022,Kyrgyzstan,Rep. of Moldova,21,5,0,26
30340,2022,Libya,Rep. of Moldova,5,0,0,5
30341,2022,Lebanon,Rep. of Moldova,8,7,0,15
30342,2022,Lithuania,Rep. of Moldova,7,0,0,7
30343,2022,Latvia,Rep. of Moldova,13,0,0,13
30344,2022,Martinique,Rep. of Moldova,0,361,0,361
30345,2022,Netherlands,Rep. of Moldova,5,0,0,5
30346,2022,Nigeria,Rep. of Moldova,0,57,0,57
30347,2022,Pakistan,Rep. of Moldova,0,5,0,5
30348,2022,Philippines,Rep. of Moldova,0,5,0,5
30349,2022,Poland,Rep. of Moldova,13,0,0,13
30350,2022,Portugal,Rep. of Moldova,6,0,0,6
30351,2022,Romania,Rep. of Moldova,804,5,0,809
30352,2022,Russian Federation,Rep. of Moldova,664,56,0,720
30353,2022,Spain,Rep. of Moldova,10,0,0,10
30354,2022,Viet Nam,Rep. of Moldova,0,89,0,89
30355,2022,Sudan,Rep. of Moldova,9,0,0,9
30356,2022,Sweden,Rep. of Moldova,5,0,0,5
30357,2022,Switzerland,Rep. of Moldova,5,0,0,5
30358,2022,Syrian Arab Rep.,Rep. of Moldova,166,46,0,212
30359,2022,Tajikistan,Rep. of Moldova,23,5,0,28
30360,2022,Turkmenistan,Rep. of Moldova,23,9,0,32
30361,2022,Tunisia,Rep. of Moldova,0,56,0,56
30362,2022,Türkiye,Rep. of Moldova,182,30,0,212
30363,2022,Ukraine,Rep. of Moldova,75762,7108,0,82870
30364,2022,United States of America,Rep. of Moldova,69,0,0,69
30365,2022,Uzbekistan,Rep. of Moldova,45,11,0,56
30366,2022,Yemen,Rep. of Moldova,11,0,0,11
30367,2022,Zimbabwe,Rep. of Moldova,0,8,0,8
30369,2022,Afghanistan,Mexico,5,62,0,67
30370,2022,Albania,Mexico,8,0,0,8
30371,2022,Algeria,Mexico,5,5,0,10
30372,2022,Angola,Mexico,13,1054,0,1067
30373,2022,Egypt,Mexico,5,17,0,22
30374,2022,Argentina,Mexico,5,237,0,242
30375,2022,Benin,Mexico,5,31,0,36
30376,2022,Bangladesh,Mexico,10,119,0,129
30377,2022,Burkina Faso,Mexico,17,97,0,114
30378,2022,Belarus,Mexico,0,5,0,5
30379,2022,Bolivia (Plurinational State of),Mexico,0,43,0,43
30380,2022,Brazil,Mexico,264,4845,0,5109
30381,2022,Belize,Mexico,28,57,0,85
30382,2022,Cambodia,Mexico,24,47,0,71
30383,2022,Canada,Mexico,0,23,0,23
30384,2022,Central African Rep.,Mexico,0,5,0,5
30385,2022,Chad,Mexico,0,8,0,8
30386,2022,China,Mexico,5,32,0,37
30387,2022,Chile,Mexico,489,6623,0,7112
30388,2022,Cameroon,Mexico,30,568,0,598
30389,2022,Congo,Mexico,25,130,0,155
30390,2022,Dem. Rep. of the Congo,Mexico,75,662,0,737
30391,2022,Colombia,Mexico,560,2611,0,3171
30392,2022,Costa Rica,Mexico,41,153,0,194
30393,2022,Cuba,Mexico,4226,18011,0,22237
30394,2022,Cabo Verde,Mexico,0,5,0,5
30395,2022,Dominica,Mexico,0,14,0,14
30396,2022,Dominican Rep.,Mexico,37,749,0,786
30397,2022,Ecuador,Mexico,62,610,0,672
30398,2022,Equatorial Guinea,Mexico,0,9,0,9
30399,2022,Eritrea,Mexico,7,108,0,115
30400,2022,Ethiopia,Mexico,6,36,0,42
30401,2022,French Guiana,Mexico,7,81,0,88
30402,2022,Finland,Mexico,0,5,0,5
30403,2022,France,Mexico,0,21,0,21
30404,2022,Gambia,Mexico,0,29,0,29
30405,2022,Palestinian,Mexico,5,8,0,13
30406,2022,United Kingdom of Great Britain and Northern Ireland,Mexico,0,5,0,5
30407,2022,Germany,Mexico,0,13,0,13
30408,2022,Ghana,Mexico,45,599,0,644
30409,2022,Guinea-Bissau,Mexico,0,14,0,14
30410,2022,Guatemala,Mexico,3609,6421,0,10030
30411,2022,Guinea,Mexico,45,235,0,280
30412,2022,Guyana,Mexico,0,30,0,30
30413,2022,Haiti,Mexico,4465,50867,0,55332
30414,2022,Honduras,Mexico,35755,48563,0,84318
30415,2022,Cote d'Ivoire,Mexico,6,44,0,50
30416,2022,India,Mexico,14,87,0,101
30417,2022,Iran (Islamic Rep. of),Mexico,41,14,0,55
30418,2022,Iraq,Mexico,44,9,0,53
30419,2022,Israel,Mexico,0,19,0,19
30420,2022,Italy,Mexico,0,10,0,10
30421,2022,Jamaica,Mexico,7,22,0,29
30422,2022,Kazakhstan,Mexico,0,49,0,49
30423,2022,Kyrgyzstan,Mexico,8,24,0,32
30424,2022,Rep. of Korea,Mexico,0,5,0,5
30425,2022,Liberia,Mexico,0,5,0,5
30426,2022,Saint Lucia,Mexico,0,5,0,5
30427,2022,Lebanon,Mexico,0,7,0,7
30428,2022,Sri Lanka,Mexico,20,27,0,47
30429,2022,Mauritania,Mexico,7,86,0,93
30430,2022,Mali,Mexico,5,69,0,74
30431,2022,Morocco,Mexico,5,15,0,20
30432,2022,Mozambique,Mexico,0,5,0,5
30433,2022,Nepal,Mexico,0,17,0,17
30434,2022,Niger,Mexico,0,5,0,5
30435,2022,Nicaragua,Mexico,1850,7123,0,8973
30436,2022,Nigeria,Mexico,48,173,0,221
30437,2022,Pakistan,Mexico,12,53,0,65
30438,2022,Panama,Mexico,63,156,0,219
30439,2022,Paraguay,Mexico,0,7,0,7
30440,2022,Peru,Mexico,39,241,0,280
30441,2022,Poland,Mexico,0,7,0,7
30442,2022,Portugal,Mexico,5,7,0,12
30443,2022,Romania,Mexico,7,5,0,12
30444,2022,South Africa,Mexico,0,15,0,15
30445,2022,Russian Federation,Mexico,44,179,0,223
30446,2022,Rwanda,Mexico,0,5,0,5
30447,2022,El Salvador,Mexico,13531,12284,0,25815
30448,2022,Senegal,Mexico,0,1282,0,1282
30449,2022,Sierra Leone,Mexico,12,93,0,105
30450,2022,Somalia,Mexico,5,70,0,75
30451,2022,Spain,Mexico,5,23,0,28
30452,2022,Sudan,Mexico,0,19,0,19
30453,2022,Suriname,Mexico,0,8,0,8
30454,2022,Syrian Arab Rep.,Mexico,35,37,0,72
30455,2022,Tajikistan,Mexico,0,9,0,9
30456,2022,Togo,Mexico,19,110,0,129
30457,2022,Trinidad and Tobago,Mexico,5,5,0,10
30458,2022,Türkiye,Mexico,8,8,0,16
30459,2022,Uganda,Mexico,0,45,0,45
30460,2022,Ukraine,Mexico,20,114,0,134
30461,2022,Uruguay,Mexico,14,58,0,72
30462,2022,United States of America,Mexico,46,128,0,174
30463,2022,Uzbekistan,Mexico,0,64,0,64
30464,2022,Venezuela (Bolivarian Republic of),Mexico,18761,13468,0,32229
30465,2022,Yemen,Mexico,25,77,0,102
30467,2022,Burundi,Mali,17,0,0,17
30468,2022,Bangladesh,Mali,0,32,0,32
30469,2022,Burkina Faso,Mali,22052,0,0,22052
30470,2022,Central African Rep.,Mali,1172,228,0,1400
30471,2022,Chad,Mali,0,5,0,5
30472,2022,Cameroon,Mali,6,6,0,12
30473,2022,Congo,Mali,32,15,0,47
30474,2022,Dem. Rep. of the Congo,Mali,267,34,0,301
30475,2022,Eritrea,Mali,5,0,0,5
30476,2022,Guinea,Mali,0,12,0,12
30477,2022,Cote d'Ivoire,Mali,488,41,0,529
30478,2022,Mauritania,Mali,14950,0,0,14950
30479,2022,Mali,Mali,0,0,377519,0
30480,2022,Niger,Mali,13585,0,0,13585
30481,2022,Nigeria,Mali,0,5,0,5
30482,2022,Pakistan,Mali,11,0,0,11
30483,2022,Rwanda,Mali,19,0,0,19
30484,2022,Syrian Arab Rep.,Mali,24,433,0,457
30485,2022,Togo,Mali,30,0,0,30
30486,2022,Türkiye,Mali,22,5,0,27
30487,2022,Afghanistan,Malaysia,1858,1209,0,3067
30488,2022,Algeria,Malaysia,0,15,0,15
30489,2022,Egypt,Malaysia,18,83,0,101
30490,2022,Australia,Malaysia,0,5,0,5
30491,2022,Bangladesh,Malaysia,43,21,0,64
30492,2022,Cambodia,Malaysia,74,12,0,86
30493,2022,Central African Rep.,Malaysia,5,0,0,5
30494,2022,China,Malaysia,46,8,0,54
30495,2022,Cameroon,Malaysia,11,23,0,34
30496,2022,Dem. Rep. of the Congo,Malaysia,10,0,0,10
30497,2022,Eritrea,Malaysia,25,10,0,35
30498,2022,Ethiopia,Malaysia,12,12,0,24
30499,2022,Palestinian,Malaysia,249,538,0,787
30500,2022,United Kingdom of Great Britain and Northern Ireland,Malaysia,0,7,0,7
30501,2022,Guinea,Malaysia,12,19,0,31
30502,2022,Cote d'Ivoire,Malaysia,5,0,0,5
30503,2022,India,Malaysia,5,19,0,24
30504,2022,Indonesia,Malaysia,926,86,0,1012
30505,2022,Iran (Islamic Rep. of),Malaysia,273,146,0,419
30506,2022,Iraq,Malaysia,414,790,0,1204
30507,2022,Jordan,Malaysia,5,5,0,10
30508,2022,Liberia,Malaysia,22,8,0,30
30509,2022,Libya,Malaysia,14,13,0,27
30510,2022,Lebanon,Malaysia,5,0,0,5
30511,2022,Sri Lanka,Malaysia,797,864,0,1661
30512,2022,Mali,Malaysia,5,0,0,5
30513,2022,Myanmar,Malaysia,123282,37247,0,160529
30514,2022,Nepal,Malaysia,9,0,0,9
30515,2022,Nigeria,Malaysia,5,41,0,46
30516,2022,Pakistan,Malaysia,4059,2618,0,6677
30517,2022,Philippines,Malaysia,13,11,0,24
30518,2022,Russian Federation,Malaysia,6,0,0,6
30519,2022,Sierra Leone,Malaysia,9,30,0,39
30520,2022,Somalia,Malaysia,2273,1014,0,3287
30521,2022,Sudan,Malaysia,190,115,0,305
30522,2022,South Sudan,Malaysia,32,24,0,56
30523,2022,Syrian Arab Rep.,Malaysia,474,2868,0,3342
30524,2022,Thailand,Malaysia,26,24,0,50
30525,2022,Uganda,Malaysia,6,15,0,21
30526,2022,United States of America,Malaysia,0,8,0,8
30527,2022,Uzbekistan,Malaysia,0,7,0,7
30528,2022,Yemen,Malaysia,370,3473,0,3843
30529,2022,Zimbabwe,Malaysia,5,5,0,10
30531,2022,Burundi,Malawi,5760,6960,0,12720
30532,2022,Dem. Rep. of the Congo,Malawi,23629,10464,0,34093
30533,2022,Eritrea,Malawi,0,7,0,7
30534,2022,Ethiopia,Malawi,9,76,0,85
30535,2022,Cote d'Ivoire,Malawi,5,0,0,5
30536,2022,Mozambique,Malawi,0,5,0,5
30537,2022,Rwanda,Malawi,2687,4948,0,7635
30538,2022,Somalia,Malawi,90,70,0,160
30539,2022,South Sudan,Malawi,5,0,0,5
30540,2022,United Rep. of Tanzania,Malawi,0,6,0,6
30541,2022,Türkiye,Malawi,31,24,0,55
30542,2022,Uganda,Malawi,0,16,0,16
30543,2022,Zimbabwe,Malawi,0,8,0,8
30544,2022,Afghanistan,Mongolia,0,5,0,5
30545,2022,China,Mongolia,5,0,0,5
30546,2022,Mongolia,Mongolia,0,0,0,0
30548,2022,Afghanistan,Morocco,12,5,0,17
30549,2022,Algeria,Morocco,10,13,0,23
30550,2022,Angola,Morocco,0,6,0,6
30551,2022,Egypt,Morocco,5,11,0,16
30552,2022,Burundi,Morocco,8,0,0,8
30553,2022,Benin,Morocco,0,6,0,6
30554,2022,Bangladesh,Morocco,0,40,0,40
30555,2022,Burkina Faso,Morocco,7,37,0,44
30556,2022,Central African Rep.,Morocco,604,507,0,1111
30557,2022,Chad,Morocco,5,85,0,90
30558,2022,Cameroon,Morocco,178,816,0,994
30559,2022,Congo,Morocco,16,62,0,78
30560,2022,Dem. Rep. of the Congo,Morocco,187,169,0,356
30561,2022,Eritrea,Morocco,42,41,0,83
30562,2022,Ethiopia,Morocco,0,13,0,13
30563,2022,Gabon,Morocco,0,8,0,8
30564,2022,Gambia,Morocco,0,145,0,145
30565,2022,Palestinian,Morocco,90,177,0,267
30566,2022,Ghana,Morocco,0,11,0,11
30567,2022,Guinea-Bissau,Morocco,0,65,0,65
30568,2022,Guinea,Morocco,158,2484,0,2642
30569,2022,Cote d'Ivoire,Morocco,365,922,0,1287
30570,2022,Iraq,Morocco,128,8,0,136
30571,2022,Jordan,Morocco,0,5,0,5
30572,2022,Liberia,Morocco,6,47,0,53
30573,2022,Libya,Morocco,51,10,0,61
30574,2022,Lebanon,Morocco,5,38,0,43
30575,2022,Sri Lanka,Morocco,0,5,0,5
30576,2022,Mauritania,Morocco,7,15,0,22
30577,2022,Mali,Morocco,60,790,0,850
30578,2022,Niger,Morocco,5,13,0,18
30579,2022,Nigeria,Morocco,27,397,0,424
30580,2022,Pakistan,Morocco,16,5,0,21
30581,2022,Senegal,Morocco,111,1248,0,1359
30582,2022,Sierra Leone,Morocco,0,65,0,65
30583,2022,Somalia,Morocco,25,15,0,40
30584,2022,Sudan,Morocco,130,1197,0,1327
30585,2022,South Sudan,Morocco,42,392,0,434
30586,2022,Syrian Arab Rep.,Morocco,5250,0,0,5250
30587,2022,Togo,Morocco,0,13,0,13
30588,2022,Tunisia,Morocco,5,0,0,5
30589,2022,Türkiye,Morocco,5,30,0,35
30590,2022,Yemen,Morocco,19,1179,0,1198
30591,2022,Angola,Mozambique,5,0,0,5
30592,2022,Burundi,Mozambique,909,8306,0,9215
30593,2022,Central African Rep.,Mozambique,0,8,0,8
30594,2022,Congo,Mozambique,15,36,0,51
30595,2022,Dem. Rep. of the Congo,Mozambique,2984,7699,0,10683
30596,2022,Comoros,Mozambique,0,502,0,502
30597,2022,Eritrea,Mozambique,0,31,0,31
30598,2022,Ethiopia,Mozambique,9,15,0,24
30599,2022,Palestinian,Mozambique,0,9,0,9
30600,2022,Guinea,Mozambique,0,5,0,5
30601,2022,Mauritania,Mozambique,0,5,0,5
30602,2022,Mozambique,Mozambique,0,0,872188,0
30603,2022,New Zealand,Mozambique,0,6,0,6
30604,2022,Rwanda,Mozambique,707,3229,0,3936
30605,2022,Somalia,Mozambique,154,3978,0,4132
30606,2022,Sudan,Mozambique,5,30,0,35
30607,2022,South Sudan,Mozambique,0,5,0,5
30608,2022,Uganda,Mozambique,5,37,0,42
30609,2022,Afghanistan,Malta,0,10,0,10
30610,2022,Albania,Malta,0,5,0,5
30611,2022,Algeria,Malta,0,20,0,20
30612,2022,Egypt,Malta,74,94,0,168
30613,2022,Armenia,Malta,0,5,0,5
30614,2022,Bangladesh,Malta,15,182,0,197
30615,2022,Burkina Faso,Malta,5,12,0,17
30616,2022,Belarus,Malta,9,0,0,9
30617,2022,Central African Rep.,Malta,0,5,0,5
30618,2022,Chad,Malta,10,28,0,38
30619,2022,China,Malta,17,0,0,17
30620,2022,Cameroon,Malta,10,53,0,63
30621,2022,Dem. Rep. of the Congo,Malta,5,7,0,12
30622,2022,Colombia,Malta,0,37,0,37
30623,2022,Eritrea,Malta,903,254,0,1157
30624,2022,Ethiopia,Malta,173,40,0,213
30625,2022,Gambia,Malta,26,130,0,156
30626,2022,Palestinian,Malta,72,23,0,95
30627,2022,Georgia,Malta,5,31,0,36
30628,2022,Ghana,Malta,8,44,0,52
30629,2022,Guinea-Bissau,Malta,0,5,0,5
30630,2022,Guinea,Malta,0,89,0,89
30631,2022,Cote d'Ivoire,Malta,13,68,0,81
30632,2022,India,Malta,0,5,0,5
30633,2022,Iran (Islamic Rep. of),Malta,31,11,0,42
30634,2022,Iraq,Malta,81,5,0,86
30635,2022,Jordan,Malta,5,0,0,5
30636,2022,Liberia,Malta,6,0,0,6
30637,2022,Libya,Malta,2853,233,0,3086
30638,2022,Lebanon,Malta,0,5,0,5
30639,2022,Sri Lanka,Malta,7,5,0,12
30640,2022,North Macedonia,Malta,5,7,0,12
30641,2022,Mali,Malta,20,97,0,117
30642,2022,Morocco,Malta,30,88,0,118
30643,2022,Nepal,Malta,0,26,0,26
30644,2022,Niger,Malta,0,26,0,26
30645,2022,Nigeria,Malta,124,152,0,276
30646,2022,Pakistan,Malta,59,54,0,113
30647,2022,Russian Federation,Malta,18,9,0,27
30648,2022,Saudi Arabia,Malta,5,0,0,5
30649,2022,Serbia and Kosovo: S/RES/1244 (1999),Malta,7,5,0,12
30650,2022,Senegal,Malta,5,38,0,43
30651,2022,Sierra Leone,Malta,5,39,0,44
30652,2022,Somalia,Malta,1773,240,0,2013
30653,2022,Sudan,Malta,225,388,0,613
30654,2022,South Sudan,Malta,22,29,0,51
30655,2022,Syrian Arab Rep.,Malta,1920,417,0,2337
30656,2022,Togo,Malta,5,5,0,10
30657,2022,Tunisia,Malta,13,10,0,23
30658,2022,Türkiye,Malta,7,11,0,18
30659,2022,Ukraine,Malta,1337,112,0,1449
30660,2022,Venezuela (Bolivarian Republic of),Malta,24,96,0,120
30661,2022,Yemen,Malta,5,7,0,12
30662,2022,Zimbabwe,Malta,5,0,0,5
30665,2022,Afghanistan,Montenegro,0,6,0,6
30666,2022,Algeria,Montenegro,0,0,0,0
30667,2022,Bangladesh,Montenegro,0,0,0,0
30668,2022,Belarus,Montenegro,5,5,0,10
30669,2022,Bosnia and Herzegovina,Montenegro,5,0,0,5
30670,2022,Cuba,Montenegro,0,33,0,33
30671,2022,Ecuador,Montenegro,0,5,0,5
30672,2022,Ghana,Montenegro,5,0,0,5
30673,2022,Croatia,Montenegro,5,0,0,5
30674,2022,India,Montenegro,0,0,0,0
30675,2022,Iran (Islamic Rep. of),Montenegro,13,8,0,21
30676,2022,Libya,Montenegro,0,0,0,0
30677,2022,Morocco,Montenegro,0,6,0,6
30678,2022,Nepal,Montenegro,0,0,0,0
30679,2022,Pakistan,Montenegro,0,10,0,10
30680,2022,Russian Federation,Montenegro,9,38,0,47
30681,2022,Serbia and Kosovo: S/RES/1244 (1999),Montenegro,54,5,0,59
30682,2022,Syrian Arab Rep.,Montenegro,0,0,0,0
30683,2022,Türkiye,Montenegro,0,0,0,0
30684,2022,Ukraine,Montenegro,9133,0,0,9133
30685,2022,Venezuela (Bolivarian Republic of),Montenegro,0,5,0,5
30686,2022,Yemen,Montenegro,7,0,0,7
30689,2022,Pakistan,Mauritius,5,0,0,5
30690,2022,South Africa,Mauritius,5,0,0,5
30691,2022,Myanmar,Myanmar,0,0,1099103,0
30693,2022,Angola,Namibia,5,0,0,5
30694,2022,Burundi,Namibia,325,131,0,456
30695,2022,Central African Rep.,Namibia,5,8,0,13
30696,2022,Cameroon,Namibia,24,20,0,44
30697,2022,Congo,Namibia,5,10,0,15
30698,2022,Dem. Rep. of the Congo,Namibia,3467,2515,0,5982
30699,2022,Ethiopia,Namibia,0,5,0,5
30700,2022,Kenya,Namibia,5,5,0,10
30701,2022,Namibia,Namibia,0,0,0,0
30702,2022,Nigeria,Namibia,0,5,0,5
30703,2022,Rwanda,Namibia,135,34,0,169
30704,2022,Somalia,Namibia,5,5,0,10
30705,2022,Sudan,Namibia,7,0,0,7
30706,2022,Uganda,Namibia,8,7,0,15
30707,2022,Zimbabwe,Namibia,53,37,0,90
30708,2022,Afghanistan,Nepal,52,0,0,52
30709,2022,Bangladesh,Nepal,5,0,0,5
30710,2022,Bhutan,Nepal,6365,0,0,6365
30711,2022,India,Nepal,0,0,0,0
30712,2022,Iran (Islamic Rep. of),Nepal,9,0,0,9
30713,2022,Sri Lanka,Nepal,19,0,0,19
30714,2022,Myanmar,Nepal,375,123,0,498
30715,2022,Nepal,Nepal,0,0,0,0
30716,2022,Pakistan,Nepal,187,17,0,204
30717,2022,Somalia,Nepal,21,11,0,32
30718,2022,Yemen,Nepal,0,5,0,5
30721,2022,Afghanistan,Netherlands,7759,1067,0,8826
30722,2022,Albania,Netherlands,20,12,0,32
30723,2022,Algeria,Netherlands,390,609,0,999
30724,2022,Angola,Netherlands,215,8,0,223
30725,2022,Egypt,Netherlands,458,188,0,646
30726,2022,Argentina,Netherlands,10,5,0,15
30727,2022,Armenia,Netherlands,136,32,0,168
30728,2022,Azerbaijan,Netherlands,264,102,0,366
30729,2022,Bahrain,Netherlands,22,5,0,27
30730,2022,Burundi,Netherlands,255,5,0,260
30731,2022,Benin,Netherlands,0,9,0,9
30732,2022,Bangladesh,Netherlands,46,12,0,58
30733,2022,Bhutan,Netherlands,33,0,0,33
30734,2022,Burkina Faso,Netherlands,12,0,0,12
30735,2022,Belarus,Netherlands,51,94,0,145
30736,2022,Bolivia (Plurinational State of),Netherlands,5,0,0,5
30737,2022,Brazil,Netherlands,6,6,0,12
30738,2022,Bosnia and Herzegovina,Netherlands,1085,0,0,1085
30739,2022,Cambodia,Netherlands,17,0,0,17
30740,2022,Central African Rep.,Netherlands,24,5,0,29
30741,2022,Chad,Netherlands,9,13,0,22
30742,2022,China,Netherlands,960,104,0,1064
30743,2022,Chile,Netherlands,101,5,0,106
30744,2022,Cameroon,Netherlands,74,26,0,100
30745,2022,Congo,Netherlands,266,26,0,292
30746,2022,Dem. Rep. of the Congo,Netherlands,774,28,0,802
30747,2022,Colombia,Netherlands,246,304,0,550
30748,2022,Cuba,Netherlands,84,12,0,96
30749,2022,Czechia,Netherlands,5,0,0,5
30750,2022,Ecuador,Netherlands,5,0,0,5
30751,2022,Eritrea,Netherlands,19204,867,0,20071
30752,2022,Ethiopia,Netherlands,658,244,0,902
30753,2022,Gambia,Netherlands,87,121,0,208
30754,2022,Palestinian,Netherlands,0,21,0,21
30755,2022,Georgia,Netherlands,52,25,0,77
30756,2022,Germany,Netherlands,5,0,0,5
30757,2022,Ghana,Netherlands,24,21,0,45
30758,2022,Guinea-Bissau,Netherlands,6,5,0,11
30759,2022,Guatemala,Netherlands,5,0,0,5
30760,2022,Guinea,Netherlands,377,100,0,477
30761,2022,Guyana,Netherlands,8,0,0,8
30762,2022,Haiti,Netherlands,0,5,0,5
30763,2022,Honduras,Netherlands,13,7,0,20
30764,2022,Croatia,Netherlands,125,0,0,125
30765,2022,Cote d'Ivoire,Netherlands,96,15,0,111
30766,2022,India,Netherlands,0,35,0,35
30767,2022,Indonesia,Netherlands,33,0,0,33
30768,2022,Iran (Islamic Rep. of),Netherlands,5593,556,0,6149
30769,2022,Iraq,Netherlands,5152,760,0,5912
30770,2022,Jamaica,Netherlands,178,9,0,187
30771,2022,Jordan,Netherlands,188,60,0,248
30772,2022,Kazakhstan,Netherlands,66,25,0,91
30773,2022,Kenya,Netherlands,19,6,0,25
30774,2022,Kyrgyzstan,Netherlands,17,5,0,22
30775,2022,Rep. of Korea,Netherlands,5,0,0,5
30776,2022,Dem. People's Rep. of Korea,Netherlands,36,0,0,36
30777,2022,Kuwait,Netherlands,7,5,0,12
30778,2022,Lao People's Dem. Rep.,Netherlands,5,0,0,5
30779,2022,Liberia,Netherlands,96,6,0,102
30780,2022,Libya,Netherlands,245,81,0,326
30781,2022,Lebanon,Netherlands,228,71,0,299
30782,2022,Sri Lanka,Netherlands,328,47,0,375
30783,2022,Mauritania,Netherlands,16,5,0,21
30784,2022,North Macedonia,Netherlands,8,0,0,8
30785,2022,Rep. of Moldova,Netherlands,14,77,0,91
30786,2022,Mexico,Netherlands,9,16,0,25
30787,2022,Mali,Netherlands,8,18,0,26
30788,2022,Malaysia,Netherlands,12,5,0,17
30789,2022,Mongolia,Netherlands,38,7,0,45
30790,2022,Morocco,Netherlands,819,364,0,1183
30791,2022,Montenegro,Netherlands,6,0,0,6
30792,2022,Myanmar,Netherlands,450,45,0,495
30793,2022,Namibia,Netherlands,5,0,0,5
30794,2022,Nepal,Netherlands,96,5,0,101
30795,2022,Niger,Netherlands,10,17,0,27
30796,2022,Nicaragua,Netherlands,50,25,0,75
30797,2022,Nigeria,Netherlands,1638,480,0,2118
30798,2022,Oman,Netherlands,5,0,0,5
30799,2022,Pakistan,Netherlands,1426,662,0,2088
30800,2022,Peru,Netherlands,11,5,0,16
30801,2022,Philippines,Netherlands,17,5,0,22
30802,2022,Poland,Netherlands,5,0,0,5
30803,2022,Portugal,Netherlands,5,0,0,5
30804,2022,Romania,Netherlands,10,0,0,10
30805,2022,South Africa,Netherlands,7,15,0,22
30806,2022,Russian Federation,Netherlands,697,330,0,1027
30807,2022,Rwanda,Netherlands,88,6,0,94
30808,2022,El Salvador,Netherlands,75,51,0,126
30809,2022,Saudi Arabia,Netherlands,47,23,0,70
30810,2022,Serbia and Kosovo: S/RES/1244 (1999),Netherlands,81,12,0,93
30811,2022,Senegal,Netherlands,46,23,0,69
30812,2022,Sierra Leone,Netherlands,414,80,0,494
30813,2022,Somalia,Netherlands,3506,1138,0,4644
30814,2022,Viet Nam,Netherlands,86,5,0,91
30815,2022,Sudan,Netherlands,1098,171,0,1269
30816,2022,Suriname,Netherlands,9,0,0,9
30817,2022,South Sudan,Netherlands,99,10,0,109
30818,2022,Slovakia,Netherlands,10,0,0,10
30819,2022,Syrian Arab Rep.,Netherlands,53496,7271,0,60767
30820,2022,United Rep. of Tanzania,Netherlands,13,5,0,18
30821,2022,Thailand,Netherlands,9,0,0,9
30822,2022,Tajikistan,Netherlands,33,37,0,70
30823,2022,Turkmenistan,Netherlands,30,20,0,50
30824,2022,Togo,Netherlands,25,5,0,30
30825,2022,Trinidad and Tobago,Netherlands,94,19,0,113
30826,2022,Tunisia,Netherlands,41,162,0,203
30827,2022,Türkiye,Netherlands,7106,1455,0,8561
30828,2022,United Arab Emirates,Netherlands,7,0,0,7
30829,2022,Uganda,Netherlands,563,108,0,671
30830,2022,Ukraine,Netherlands,67612,96,0,67708
30831,2022,United States of America,Netherlands,66,11,0,77
30832,2022,Uzbekistan,Netherlands,33,42,0,75
30833,2022,Venezuela (Bolivarian Republic of),Netherlands,171,139,0,310
30834,2022,Yemen,Netherlands,3798,1534,0,5332
30835,2022,Zambia,Netherlands,9,6,0,15
30836,2022,Zimbabwe,Netherlands,44,6,0,50
30839,2022,Benin,Niger,0,5,0,5
30840,2022,Burkina Faso,Niger,0,17844,0,17844
30841,2022,Central African Rep.,Niger,141,79,0,220
30842,2022,Chad,Niger,110,3420,0,3530
30843,2022,Cameroon,Niger,20,206,0,226
30844,2022,Congo,Niger,5,0,0,5
30845,2022,Dem. Rep. of the Congo,Niger,48,38,0,86
30846,2022,Eritrea,Niger,39,204,0,243
30847,2022,Ethiopia,Niger,20,28,0,48
30848,2022,Ghana,Niger,0,5,0,5
30849,2022,Guinea,Niger,0,23,0,23
30850,2022,Cote d'Ivoire,Niger,26,14,0,40
30851,2022,Liberia,Niger,0,9,0,9
30852,2022,Libya,Niger,6,0,0,6
30853,2022,Mali,Niger,62904,97,0,63001
30854,2022,Niger,Niger,0,0,264257,0
30855,2022,Nigeria,Niger,187134,16463,0,203597
30856,2022,Pakistan,Niger,0,6,0,6
30857,2022,Rwanda,Niger,12,0,0,12
30858,2022,Somalia,Niger,38,31,0,69
30859,2022,Sudan,Niger,949,1818,0,2767
30860,2022,South Sudan,Niger,10,8,0,18
30861,2022,Syrian Arab Rep.,Niger,5,11,0,16
30862,2022,Togo,Niger,5,20,0,25
30863,2022,Yemen,Niger,0,20,0,20
30864,2022,Colombia,Nicaragua,6,0,0,6
30865,2022,Cuba,Nicaragua,14,0,0,14
30866,2022,Guatemala,Nicaragua,7,0,0,7
30867,2022,Honduras,Nicaragua,74,26,0,100
30868,2022,Mexico,Nicaragua,0,0,0,0
30869,2022,El Salvador,Nicaragua,210,100,0,310
30871,2022,Afghanistan,Nigeria,5,0,0,5
30872,2022,Egypt,Nigeria,0,7,0,7
30873,2022,Benin,Nigeria,5,0,0,5
30874,2022,Central African Rep.,Nigeria,915,233,0,1148
30875,2022,Chad,Nigeria,88,19,0,107
30876,2022,Cameroon,Nigeria,78321,245,0,78566
30877,2022,Congo,Nigeria,5,5,0,10
30878,2022,Dem. Rep. of the Congo,Nigeria,666,101,0,767
30879,2022,Eritrea,Nigeria,41,9,0,50
30880,2022,Ethiopia,Nigeria,8,5,0,13
30881,2022,Palestinian,Nigeria,21,20,0,41
30882,2022,Ghana,Nigeria,5,5,0,10
30883,2022,Guinea-Bissau,Nigeria,5,0,0,5
30884,2022,Guinea,Nigeria,18,5,0,23
30885,2022,Cote d'Ivoire,Nigeria,136,5,0,141
30886,2022,Iran (Islamic Rep. of),Nigeria,5,0,0,5
30887,2022,Liberia,Nigeria,11,0,0,11
30888,2022,Libya,Nigeria,5,5,0,10
30889,2022,Lebanon,Nigeria,13,40,0,53
30890,2022,Mali,Nigeria,150,29,0,179
30891,2022,Niger,Nigeria,1439,0,0,1439
30892,2022,Nigeria,Nigeria,0,0,3098404,0
30893,2022,Sierra Leone,Nigeria,23,0,0,23
30894,2022,Sudan,Nigeria,53,7,0,60
30895,2022,Syrian Arab Rep.,Nigeria,512,595,0,1107
30896,2022,Turkmenistan,Nigeria,5,0,0,5
30897,2022,Togo,Nigeria,27,10,0,37
30898,2022,Türkiye,Nigeria,286,176,0,462
30899,2022,Yemen,Nigeria,5,8,0,13
30900,2022,Afghanistan,Norway,3248,250,0,3498
30901,2022,Albania,Norway,18,5,0,23
30902,2022,Algeria,Norway,6,0,0,6
30903,2022,Angola,Norway,5,0,0,5
30904,2022,Egypt,Norway,43,0,0,43
30905,2022,Armenia,Norway,5,5,0,10
30906,2022,Azerbaijan,Norway,15,14,0,29
30907,2022,Burundi,Norway,31,0,0,31
30908,2022,Bangladesh,Norway,5,0,0,5
30909,2022,Belarus,Norway,5,15,0,20
30910,2022,Bulgaria,Norway,5,5,0,10
30911,2022,Central African Rep.,Norway,15,0,0,15
30912,2022,China,Norway,298,45,0,343
30913,2022,Cameroon,Norway,16,0,0,16
30914,2022,Congo,Norway,5,0,0,5
30915,2022,Dem. Rep. of the Congo,Norway,368,5,0,373
30916,2022,Colombia,Norway,27,84,0,111
30917,2022,Eritrea,Norway,10883,140,0,11023
30918,2022,Ethiopia,Norway,1192,76,0,1268
30919,2022,Gambia,Norway,13,0,0,13
30920,2022,Georgia,Norway,0,12,0,12
30921,2022,Ghana,Norway,6,0,0,6
30922,2022,Guinea-Bissau,Norway,5,0,0,5
30923,2022,Guinea,Norway,27,0,0,27
30924,2022,Honduras,Norway,6,0,0,6
30925,2022,Cote d'Ivoire,Norway,13,0,0,13
30926,2022,Iran (Islamic Rep. of),Norway,1429,130,0,1559
30927,2022,Iraq,Norway,984,77,0,1061
30928,2022,Israel,Norway,8,0,0,8
30929,2022,Jordan,Norway,5,0,0,5
30930,2022,Kazakhstan,Norway,10,5,0,15
30931,2022,Kenya,Norway,7,5,0,12
30932,2022,Kyrgyzstan,Norway,12,5,0,17
30933,2022,Liberia,Norway,5,0,0,5
30934,2022,Libya,Norway,55,11,0,66
30935,2022,Lebanon,Norway,25,0,0,25
30936,2022,Sri Lanka,Norway,43,10,0,53
30937,2022,Rep. of Moldova,Norway,5,5,0,10
30938,2022,Mali,Norway,8,0,0,8
30939,2022,Morocco,Norway,14,11,0,25
30940,2022,Myanmar,Norway,22,5,0,27
30941,2022,Nepal,Norway,5,0,0,5
30942,2022,Nicaragua,Norway,10,0,0,10
30943,2022,Nigeria,Norway,109,11,0,120
30944,2022,Pakistan,Norway,77,14,0,91
30945,2022,Poland,Norway,0,10,0,10
30946,2022,South Africa,Norway,0,5,0,5
30947,2022,Russian Federation,Norway,286,101,0,387
30948,2022,Rwanda,Norway,13,0,0,13
30949,2022,El Salvador,Norway,9,5,0,14
30950,2022,Saudi Arabia,Norway,8,6,0,14
30951,2022,Serbia and Kosovo: S/RES/1244 (1999),Norway,26,5,0,31
30952,2022,Sierra Leone,Norway,8,0,0,8
30953,2022,Somalia,Norway,3060,16,0,3076
30954,2022,Viet Nam,Norway,38,5,0,43
30955,2022,Sudan,Norway,1515,14,0,1529
30956,2022,South Sudan,Norway,49,0,0,49
30957,2022,Syrian Arab Rep.,Norway,15901,414,0,16315
30958,2022,Tajikistan,Norway,5,6,0,11
30959,2022,Turkmenistan,Norway,5,5,0,10
30960,2022,Türkiye,Norway,1149,70,0,1219
30961,2022,United Arab Emirates,Norway,0,5,0,5
30962,2022,Uganda,Norway,101,0,0,101
30963,2022,Ukraine,Norway,19916,2308,0,22224
30964,2022,Uzbekistan,Norway,145,14,0,159
30965,2022,Venezuela (Bolivarian Republic of),Norway,27,64,0,91
30966,2022,Yemen,Norway,199,10,0,209
30967,2022,Zimbabwe,Norway,11,0,0,11
30970,2022,Afghanistan,Nauru,26,0,0,26
30971,2022,Bangladesh,Nauru,17,21,0,38
30972,2022,India,Nauru,7,5,0,12
30973,2022,Indonesia,Nauru,5,5,0,10
30974,2022,Iran (Islamic Rep. of),Nauru,505,11,0,516
30975,2022,Iraq,Nauru,41,0,0,41
30976,2022,Kuwait,Nauru,5,0,0,5
30977,2022,Lebanon,Nauru,12,5,0,17
30978,2022,Sri Lanka,Nauru,80,10,0,90
30979,2022,Malaysia,Nauru,5,0,0,5
30980,2022,Myanmar,Nauru,71,0,0,71
30981,2022,Nepal,Nauru,11,5,0,16
30982,2022,Pakistan,Nauru,30,18,0,48
30983,2022,Somalia,Nauru,75,5,0,80
30984,2022,Sudan,Nauru,5,0,0,5
30985,2022,Syrian Arab Rep.,Nauru,0,5,0,5
30987,2022,Afghanistan,New Zealand,63,9,0,72
30988,2022,Egypt,New Zealand,23,5,0,28
30989,2022,Bahrain,New Zealand,8,6,0,14
30990,2022,Bangladesh,New Zealand,10,12,0,22
30991,2022,Brazil,New Zealand,0,5,0,5
30992,2022,China,New Zealand,262,88,0,350
30993,2022,Chile,New Zealand,5,5,0,10
30994,2022,Cameroon,New Zealand,5,0,0,5
30995,2022,Dem. Rep. of the Congo,New Zealand,5,0,0,5
30996,2022,Colombia,New Zealand,31,8,0,39
30997,2022,Czechia,New Zealand,10,0,0,10
30998,2022,Eritrea,New Zealand,6,5,0,11
30999,2022,Ethiopia,New Zealand,14,0,0,14
31000,2022,Fiji,New Zealand,15,17,0,32
31001,2022,Palestinian,New Zealand,10,0,0,10
31002,2022,Hungary,New Zealand,6,0,0,6
31003,2022,India,New Zealand,17,141,0,158
31004,2022,Indonesia,New Zealand,6,15,0,21
31005,2022,Ireland,New Zealand,0,5,0,5
31006,2022,Iran (Islamic Rep. of),New Zealand,96,7,0,103
31007,2022,Iraq,New Zealand,54,0,0,54
31008,2022,Jordan,New Zealand,7,0,0,7
31009,2022,Kiribati,New Zealand,0,5,0,5
31010,2022,Kuwait,New Zealand,5,0,0,5
31011,2022,Libya,New Zealand,20,0,0,20
31012,2022,Sri Lanka,New Zealand,45,56,0,101
31013,2022,Maldives,New Zealand,5,0,0,5
31014,2022,Malaysia,New Zealand,17,14,0,31
31015,2022,Mongolia,New Zealand,5,0,0,5
31016,2022,Myanmar,New Zealand,17,14,0,31
31017,2022,Nepal,New Zealand,5,0,0,5
31018,2022,Pakistan,New Zealand,49,6,0,55
31019,2022,Philippines,New Zealand,11,5,0,16
31020,2022,Papua New Guinea,New Zealand,5,0,0,5
31021,2022,South Africa,New Zealand,5,9,0,14
31022,2022,Russian Federation,New Zealand,34,18,0,52
31023,2022,Saudi Arabia,New Zealand,62,0,0,62
31024,2022,Somalia,New Zealand,9,0,0,9
31025,2022,Viet Nam,New Zealand,7,5,0,12
31026,2022,Sudan,New Zealand,6,5,0,11
31027,2022,Syrian Arab Rep.,New Zealand,66,0,0,66
31028,2022,Tonga,New Zealand,0,5,0,5
31029,2022,Türkiye,New Zealand,56,0,0,56
31030,2022,Uganda,New Zealand,5,5,0,10
31031,2022,Ukraine,New Zealand,0,6,0,6
31032,2022,Uruguay,New Zealand,0,7,0,7
31033,2022,United States of America,New Zealand,0,5,0,5
31034,2022,Venezuela (Bolivarian Republic of),New Zealand,5,0,0,5
31035,2022,Yemen,New Zealand,11,0,0,11
31036,2022,Zimbabwe,New Zealand,12,0,0,12
31039,2022,Iraq,Oman,282,459,0,741
31040,2022,Pakistan,Oman,5,0,0,5
31041,2022,Sudan,Oman,0,7,0,7
31042,2022,Syrian Arab Rep.,Oman,8,27,0,35
31043,2022,Afghanistan,Pakistan,1539046,24559,0,1563605
31044,2022,Algeria,Pakistan,22,0,0,22
31045,2022,China,Pakistan,0,16,0,16
31046,2022,Palestinian,Pakistan,21,0,0,21
31047,2022,India,Pakistan,0,5,0,5
31048,2022,Iran (Islamic Rep. of),Pakistan,39,14,0,53
31049,2022,Iraq,Pakistan,21,7,0,28
31050,2022,Sri Lanka,Pakistan,0,11,0,11
31051,2022,Myanmar,Pakistan,24,31,0,55
31052,2022,Pakistan,Pakistan,0,0,98898,0
31053,2022,Russian Federation,Pakistan,6,0,0,6
31054,2022,Somalia,Pakistan,175,27,0,202
31055,2022,Syrian Arab Rep.,Pakistan,50,23,0,73
31056,2022,United Rep. of Tanzania,Pakistan,0,5,0,5
31057,2022,Tajikistan,Pakistan,7,0,0,7
31058,2022,Türkiye,Pakistan,6,0,0,6
31059,2022,Yemen,Pakistan,137,31,0,168
31061,2022,Afghanistan,Panama,5,6,0,11
31062,2022,Armenia,Panama,0,5,0,5
31063,2022,Bangladesh,Panama,0,15,0,15
31064,2022,Belarus,Panama,7,0,0,7
31065,2022,Bosnia and Herzegovina,Panama,5,0,0,5
31066,2022,Cameroon,Panama,9,5,0,14
31067,2022,Dem. Rep. of the Congo,Panama,5,0,0,5
31068,2022,Colombia,Panama,1666,1064,0,2730
31069,2022,Cuba,Panama,120,1517,0,1637
31070,2022,Dominican Rep.,Panama,5,0,0,5
31071,2022,Ecuador,Panama,0,16,0,16
31072,2022,Eritrea,Panama,0,38,0,38
31073,2022,Guatemala,Panama,12,8,0,20
31074,2022,Haiti,Panama,19,0,0,19
31075,2022,Honduras,Panama,6,90,0,96
31076,2022,Croatia,Panama,5,0,0,5
31077,2022,Cote d'Ivoire,Panama,0,5,0,5
31078,2022,India,Panama,0,7,0,7
31079,2022,Iran (Islamic Rep. of),Panama,5,0,0,5
31080,2022,Italy,Panama,0,5,0,5
31081,2022,Jamaica,Panama,0,6,0,6
31082,2022,Liberia,Panama,5,0,0,5
31083,2022,Sri Lanka,Panama,0,7,0,7
31084,2022,Mexico,Panama,5,0,0,5
31085,2022,Nepal,Panama,0,14,0,14
31086,2022,Nicaragua,Panama,183,4987,0,5170
31087,2022,Nigeria,Panama,10,34,0,44
31088,2022,Pakistan,Panama,0,15,0,15
31089,2022,Peru,Panama,23,0,0,23
31090,2022,Russian Federation,Panama,0,5,0,5
31091,2022,El Salvador,Panama,393,945,0,1338
31092,2022,Sierra Leone,Panama,5,0,0,5
31093,2022,Somalia,Panama,0,101,0,101
31094,2022,Sudan,Panama,5,0,0,5
31095,2022,Ukraine,Panama,9,6,0,15
31096,2022,Venezuela (Bolivarian Republic of),Panama,61,2352,0,2413
31097,2022,Afghanistan,Paraguay,0,5,0,5
31098,2022,Argentina,Paraguay,0,17,0,17
31099,2022,Bangladesh,Paraguay,0,5,0,5
31100,2022,Bolivia (Plurinational State of),Paraguay,16,17,0,33
31101,2022,Brazil,Paraguay,0,11,0,11
31102,2022,Chile,Paraguay,0,5,0,5
31103,2022,Cameroon,Paraguay,0,5,0,5
31104,2022,Colombia,Paraguay,17,254,0,271
31105,2022,Cuba,Paraguay,926,134,0,1060
31106,2022,Dominican Rep.,Paraguay,0,11,0,11
31107,2022,Ecuador,Paraguay,0,8,0,8
31108,2022,Guatemala,Paraguay,0,6,0,6
31109,2022,Haiti,Paraguay,0,5,0,5
31110,2022,Iraq,Paraguay,6,0,0,6
31111,2022,Lebanon,Paraguay,0,6,0,6
31112,2022,Nigeria,Paraguay,0,5,0,5
31113,2022,Peru,Paraguay,0,41,0,41
31114,2022,South Africa,Paraguay,0,5,0,5
31115,2022,El Salvador,Paraguay,12,5,0,17
31116,2022,Syrian Arab Rep.,Paraguay,79,17,0,96
31117,2022,Türkiye,Paraguay,5,5,0,10
31118,2022,Ukraine,Paraguay,0,5,0,5
31119,2022,Uruguay,Paraguay,0,6,0,6
31120,2022,Venezuela (Bolivarian Republic of),Paraguay,3412,1016,0,4428
31121,2022,Afghanistan,Peru,0,5,0,5
31122,2022,Angola,Peru,0,10,0,10
31123,2022,Argentina,Peru,0,15,0,15
31124,2022,Bangladesh,Peru,26,0,0,26
31125,2022,Bolivia (Plurinational State of),Peru,20,31,0,51
31126,2022,Brazil,Peru,5,12,0,17
31127,2022,China,Peru,0,13,0,13
31128,2022,Chile,Peru,0,12,0,12
31129,2022,Cameroon,Peru,20,0,0,20
31130,2022,Congo,Peru,0,9,0,9
31131,2022,Dem. Rep. of the Congo,Peru,8,0,0,8
31132,2022,Colombia,Peru,714,1742,0,2456
31133,2022,Costa Rica,Peru,0,5,0,5
31134,2022,Cuba,Peru,520,2744,0,3264
31135,2022,Dominica,Peru,0,5,0,5
31136,2022,Dominican Rep.,Peru,20,55,0,75
31137,2022,Ecuador,Peru,5,270,0,275
31138,2022,Ethiopia,Peru,5,0,0,5
31139,2022,Gambia,Peru,5,0,0,5
31140,2022,Palestinian,Peru,41,8,0,49
31141,2022,Germany,Peru,0,5,0,5
31142,2022,Ghana,Peru,5,0,0,5
31143,2022,Haiti,Peru,85,57,0,142
31144,2022,Honduras,Peru,0,7,0,7
31145,2022,India,Peru,6,5,0,11
31146,2022,Iran (Islamic Rep. of),Peru,6,0,0,6
31147,2022,Iraq,Peru,42,0,0,42
31148,2022,Italy,Peru,0,5,0,5
31149,2022,Jordan,Peru,0,5,0,5
31150,2022,Sri Lanka,Peru,0,7,0,7
31151,2022,Mexico,Peru,0,11,0,11
31152,2022,Morocco,Peru,0,5,0,5
31153,2022,Nepal,Peru,0,5,0,5
31154,2022,Nicaragua,Peru,7,7,0,14
31155,2022,Nigeria,Peru,24,19,0,43
31156,2022,Pakistan,Peru,0,10,0,10
31157,2022,Panama,Peru,0,11,0,11
31158,2022,Paraguay,Peru,0,5,0,5
31159,2022,Philippines,Peru,0,21,0,21
31160,2022,Poland,Peru,0,5,0,5
31161,2022,Portugal,Peru,0,16,0,16
31162,2022,South Africa,Peru,0,5,0,5
31163,2022,Russian Federation,Peru,0,7,0,7
31164,2022,El Salvador,Peru,10,5,0,15
31165,2022,Spain,Peru,0,18,0,18
31166,2022,Syrian Arab Rep.,Peru,47,12,0,59
31167,2022,Turkmenistan,Peru,0,8,0,8
31168,2022,Türkiye,Peru,46,40,0,86
31169,2022,Ukraine,Peru,23,12,0,35
31170,2022,Uruguay,Peru,0,5,0,5
31171,2022,United States of America,Peru,0,5,0,5
31172,2022,Venezuela (Bolivarian Republic of),Peru,4250,531632,0,535882
31173,2022,Yemen,Peru,0,63,0,63
31174,2022,Anguilla,Peru,0,5,0,5
31176,2022,Afghanistan,Philippines,10,0,0,10
31177,2022,Egypt,Philippines,0,6,0,6
31178,2022,Burundi,Philippines,13,0,0,13
31179,2022,Cambodia,Philippines,13,0,0,13
31180,2022,Chad,Philippines,0,8,0,8
31181,2022,China,Philippines,5,5,0,10
31182,2022,Cameroon,Philippines,34,97,0,131
31183,2022,Congo,Philippines,5,17,0,22
31184,2022,Dem. Rep. of the Congo,Philippines,12,22,0,34
31185,2022,Eritrea,Philippines,21,20,0,41
31186,2022,Ethiopia,Philippines,5,6,0,11
31187,2022,France,Philippines,0,5,0,5
31188,2022,Palestinian,Philippines,63,16,0,79
31189,2022,Ghana,Philippines,5,0,0,5
31190,2022,Guinea,Philippines,0,11,0,11
31191,2022,Cote d'Ivoire,Philippines,30,37,0,67
31192,2022,Iran (Islamic Rep. of),Philippines,76,22,0,98
31193,2022,Iraq,Philippines,54,14,0,68
31194,2022,Kenya,Philippines,0,5,0,5
31195,2022,Liberia,Philippines,5,6,0,11
31196,2022,Libya,Philippines,0,5,0,5
31197,2022,Lebanon,Philippines,5,15,0,20
31198,2022,Sri Lanka,Philippines,18,0,0,18
31199,2022,Malaysia,Philippines,0,5,0,5
31200,2022,Morocco,Philippines,5,0,0,5
31201,2022,Myanmar,Philippines,10,0,0,10
31202,2022,Nigeria,Philippines,7,16,0,23
31203,2022,Pakistan,Philippines,103,26,0,129
31204,2022,Philippines,Philippines,0,0,99970,0
31205,2022,Russian Federation,Philippines,5,8,0,13
31206,2022,Rwanda,Philippines,18,0,0,18
31207,2022,Saudi Arabia,Philippines,0,13,0,13
31208,2022,Somalia,Philippines,30,33,0,63
31209,2022,Viet Nam,Philippines,18,7,0,25
31210,2022,Sudan,Philippines,7,58,0,65
31211,2022,Syrian Arab Rep.,Philippines,132,56,0,188
31212,2022,Thailand,Philippines,5,0,0,5
31213,2022,Türkiye,Philippines,56,19,0,75
31214,2022,United Arab Emirates,Philippines,6,7,0,13
31215,2022,Uganda,Philippines,5,0,0,5
31216,2022,Ukraine,Philippines,0,5,0,5
31217,2022,United States of America,Philippines,0,7,0,7
31218,2022,Yemen,Philippines,31,95,0,126
31221,2022,Afghanistan,Papua New Guinea,30,0,0,30
31222,2022,Bangladesh,Papua New Guinea,15,6,0,21
31223,2022,India,Papua New Guinea,0,5,0,5
31224,2022,Indonesia,Papua New Guinea,11432,340,0,11772
31225,2022,Iran (Islamic Rep. of),Papua New Guinea,74,73,0,147
31226,2022,Iraq,Papua New Guinea,32,5,0,37
31227,2022,Sri Lanka,Papua New Guinea,6,8,0,14
31228,2022,Myanmar,Papua New Guinea,5,5,0,10
31229,2022,Pakistan,Papua New Guinea,26,5,0,31
31230,2022,Papua New Guinea,Papua New Guinea,0,0,24000,0
31231,2022,Somalia,Papua New Guinea,12,0,0,12
31232,2022,Sudan,Papua New Guinea,34,0,0,34
31234,2022,Afghanistan,Poland,900,214,0,1114
31235,2022,Algeria,Poland,31,5,0,36
31236,2022,Angola,Poland,5,0,0,5
31237,2022,Egypt,Poland,91,28,0,119
31238,2022,Argentina,Poland,5,0,0,5
31239,2022,Armenia,Poland,155,23,0,178
31240,2022,Australia,Poland,5,0,0,5
31241,2022,Azerbaijan,Poland,234,26,0,260
31242,2022,Bangladesh,Poland,13,12,0,25
31243,2022,Belarus,Poland,3865,724,0,4589
31244,2022,Brazil,Poland,5,0,0,5
31245,2022,Bosnia and Herzegovina,Poland,7,0,0,7
31246,2022,Bulgaria,Poland,5,0,0,5
31247,2022,Canada,Poland,16,0,0,16
31248,2022,Central African Rep.,Poland,5,0,0,5
31249,2022,China,Poland,45,0,0,45
31250,2022,Cameroon,Poland,7,5,0,12
31251,2022,Congo,Poland,6,0,0,6
31252,2022,Dem. Rep. of the Congo,Poland,5,10,0,15
31253,2022,Comoros,Poland,0,5,0,5
31254,2022,Costa Rica,Poland,5,0,0,5
31255,2022,Cuba,Poland,15,9,0,24
31256,2022,Ecuador,Poland,5,0,0,5
31257,2022,Eritrea,Poland,5,0,0,5
31258,2022,Estonia,Poland,5,0,0,5
31259,2022,Ethiopia,Poland,8,6,0,14
31260,2022,France,Poland,5,0,0,5
31261,2022,Palestinian,Poland,11,11,0,22
31262,2022,United Kingdom of Great Britain and Northern Ireland,Poland,17,0,0,17
31263,2022,Georgia,Poland,274,40,0,314
31264,2022,Germany,Poland,8,0,0,8
31265,2022,Ghana,Poland,5,0,0,5
31266,2022,Guinea,Poland,5,15,0,20
31267,2022,India,Poland,48,5,0,53
31268,2022,Iran (Islamic Rep. of),Poland,80,13,0,93
31269,2022,Iraq,Poland,134,320,0,454
31270,2022,Israel,Poland,50,0,0,50
31271,2022,Italy,Poland,5,0,0,5
31272,2022,Jordan,Poland,9,5,0,14
31273,2022,Japan,Poland,5,0,0,5
31274,2022,Kazakhstan,Poland,96,17,0,113
31275,2022,Kyrgyzstan,Poland,46,24,0,70
31276,2022,Rep. of Korea,Poland,5,0,0,5
31277,2022,Lao People's Dem. Rep.,Poland,5,0,0,5
31278,2022,Libya,Poland,30,0,0,30
31279,2022,Lebanon,Poland,21,9,0,30
31280,2022,Sri Lanka,Poland,11,7,0,18
31281,2022,Lithuania,Poland,9,0,0,9
31282,2022,Rep. of Moldova,Poland,207,0,0,207
31283,2022,Mexico,Poland,5,0,0,5
31284,2022,Mongolia,Poland,5,0,0,5
31285,2022,Morocco,Poland,19,13,0,32
31286,2022,Nepal,Poland,7,5,0,12
31287,2022,Nigeria,Poland,37,13,0,50
31288,2022,Pakistan,Poland,39,38,0,77
31289,2022,Philippines,Poland,5,0,0,5
31290,2022,Romania,Poland,5,0,0,5
31291,2022,South Africa,Poland,5,0,0,5
31292,2022,Russian Federation,Poland,2303,684,0,2987
31293,2022,Rwanda,Poland,5,6,0,11
31294,2022,Serbia and Kosovo: S/RES/1244 (1999),Poland,5,0,0,5
31295,2022,Senegal,Poland,0,5,0,5
31296,2022,Sierra Leone,Poland,7,0,0,7
31297,2022,Somalia,Poland,19,11,0,30
31298,2022,Viet Nam,Poland,86,6,0,92
31299,2022,Sudan,Poland,5,11,0,16
31300,2022,Syrian Arab Rep.,Poland,273,36,0,309
31301,2022,Tajikistan,Poland,206,72,0,278
31302,2022,Turkmenistan,Poland,102,15,0,117
31303,2022,Tunisia,Poland,11,5,0,16
31304,2022,Türkiye,Poland,309,49,0,358
31305,2022,Ukraine,Poland,1200207,939,0,1201146
31306,2022,United States of America,Poland,87,0,0,87
31307,2022,Uzbekistan,Poland,136,26,0,162
31308,2022,Venezuela (Bolivarian Republic of),Poland,21,0,0,21
31309,2022,Yemen,Poland,27,16,0,43
31312,2022,Afghanistan,Portugal,174,771,0,945
31313,2022,Albania,Portugal,0,6,0,6
31314,2022,Algeria,Portugal,437,21,0,458
31315,2022,Angola,Portugal,110,225,0,335
31316,2022,Egypt,Portugal,38,18,0,56
31317,2022,Armenia,Portugal,14,0,0,14
31318,2022,Australia,Portugal,5,0,0,5
31319,2022,Azerbaijan,Portugal,10,5,0,15
31320,2022,Benin,Portugal,5,5,0,10
31321,2022,Bangladesh,Portugal,135,30,0,165
31322,2022,Belarus,Portugal,394,16,0,410
31323,2022,Brazil,Portugal,19,29,0,48
31324,2022,Bosnia and Herzegovina,Portugal,5,0,0,5
31325,2022,Canada,Portugal,13,5,0,18
31326,2022,Central African Rep.,Portugal,8,0,0,8
31327,2022,China,Portugal,47,0,0,47
31328,2022,Cameroon,Portugal,161,43,0,204
31329,2022,Congo,Portugal,37,10,0,47
31330,2022,Dem. Rep. of the Congo,Portugal,121,79,0,200
31331,2022,Comoros,Portugal,0,5,0,5
31332,2022,Colombia,Portugal,24,44,0,68
31333,2022,Cuba,Portugal,5,10,0,15
31334,2022,Dominican Rep.,Portugal,0,47,0,47
31335,2022,Ecuador,Portugal,24,0,0,24
31336,2022,Eritrea,Portugal,202,0,0,202
31337,2022,Ethiopia,Portugal,15,5,0,20
31338,2022,Gabon,Portugal,5,0,0,5
31339,2022,Gambia,Portugal,21,144,0,165
31340,2022,Palestinian,Portugal,6,13,0,19
31341,2022,United Kingdom of Great Britain and Northern Ireland,Portugal,7,0,0,7
31342,2022,Georgia,Portugal,20,9,0,29
31343,2022,Ghana,Portugal,445,39,0,484
31344,2022,Guinea-Bissau,Portugal,9,113,0,122
31345,2022,Guinea,Portugal,85,115,0,200
31346,2022,Haiti,Portugal,0,5,0,5
31347,2022,Cote d'Ivoire,Portugal,51,35,0,86
31348,2022,India,Portugal,684,136,0,820
31349,2022,Iran (Islamic Rep. of),Portugal,76,27,0,103
31350,2022,Iraq,Portugal,211,0,0,211
31351,2022,Israel,Portugal,20,0,0,20
31352,2022,Jamaica,Portugal,11,0,0,11
31353,2022,Jordan,Portugal,7,14,0,21
31354,2022,Kazakhstan,Portugal,13,0,0,13
31355,2022,Kenya,Portugal,15,0,0,15
31356,2022,Liberia,Portugal,18,0,0,18
31357,2022,Libya,Portugal,19,0,0,19
31358,2022,Lebanon,Portugal,9,0,0,9
31359,2022,Sri Lanka,Portugal,34,7,0,41
31360,2022,Mauritania,Portugal,0,5,0,5
31361,2022,Rep. of Moldova,Portugal,35,0,0,35
31362,2022,Mexico,Portugal,5,0,0,5
31363,2022,Mali,Portugal,23,25,0,48
31364,2022,Malawi,Portugal,5,0,0,5
31365,2022,Morocco,Portugal,627,168,0,795
31366,2022,Mauritius,Portugal,0,5,0,5
31367,2022,Namibia,Portugal,12,0,0,12
31368,2022,Nepal,Portugal,143,5,0,148
31369,2022,Nigeria,Portugal,3459,66,0,3525
31370,2022,Pakistan,Portugal,446,69,0,515
31371,2022,Philippines,Portugal,5,0,0,5
31372,2022,South Africa,Portugal,5,0,0,5
31373,2022,Russian Federation,Portugal,413,20,0,433
31374,2022,Rwanda,Portugal,6,0,0,6
31375,2022,Senegal,Portugal,5,81,0,86
31376,2022,Sierra Leone,Portugal,38,46,0,84
31377,2022,Somalia,Portugal,53,0,0,53
31378,2022,Sudan,Portugal,86,5,0,91
31379,2022,South Sudan,Portugal,31,0,0,31
31380,2022,Eswatini,Portugal,23,0,0,23
31381,2022,Syrian Arab Rep.,Portugal,906,0,0,906
31382,2022,United Rep. of Tanzania,Portugal,10,0,0,10
31383,2022,Turkmenistan,Portugal,5,0,0,5
31384,2022,Togo,Portugal,8,15,0,23
31385,2022,Tunisia,Portugal,24,5,0,29
31386,2022,Türkiye,Portugal,54,21,0,75
31387,2022,Uganda,Portugal,8,0,0,8
31388,2022,Ukraine,Portugal,38272,195,0,38467
31389,2022,United States of America,Portugal,55,5,0,60
31390,2022,Uzbekistan,Portugal,14,0,0,14
31391,2022,Venezuela (Bolivarian Republic of),Portugal,5,80,0,85
31392,2022,Yemen,Portugal,11,0,0,11
31393,2022,Zambia,Portugal,18,0,0,18
31394,2022,Zimbabwe,Portugal,45,0,0,45
31397,2022,Afghanistan,Qatar,0,9,0,9
31398,2022,Egypt,Qatar,13,18,0,31
31399,2022,Eritrea,Qatar,0,5,0,5
31400,2022,Palestinian,Qatar,0,7,0,7
31401,2022,Iraq,Qatar,136,126,0,262
31402,2022,Pakistan,Qatar,5,0,0,5
31403,2022,Somalia,Qatar,8,5,0,13
31404,2022,Sudan,Qatar,0,15,0,15
31405,2022,Syrian Arab Rep.,Qatar,30,117,0,147
31406,2022,Yemen,Qatar,5,9,0,14
31408,2022,Afghanistan,Romania,404,192,0,596
31409,2022,Angola,Romania,10,0,0,10
31410,2022,Egypt,Romania,19,15,0,34
31411,2022,Armenia,Romania,18,0,0,18
31412,2022,Burundi,Romania,6,0,0,6
31413,2022,Bangladesh,Romania,11,80,0,91
31414,2022,Belarus,Romania,31,7,0,38
31415,2022,Central African Rep.,Romania,5,0,0,5
31416,2022,China,Romania,41,5,0,46
31417,2022,Cameroon,Romania,23,5,0,28
31418,2022,Congo,Romania,5,0,0,5
31419,2022,Dem. Rep. of the Congo,Romania,17,0,0,17
31420,2022,Cuba,Romania,6,5,0,11
31421,2022,Eritrea,Romania,73,0,0,73
31422,2022,Ethiopia,Romania,6,0,0,6
31423,2022,Gambia,Romania,5,0,0,5
31424,2022,Palestinian,Romania,63,0,0,63
31425,2022,Georgia,Romania,14,0,0,14
31426,2022,Guinea,Romania,11,6,0,17
31427,2022,India,Romania,14,67,0,81
31428,2022,Iran (Islamic Rep. of),Romania,126,7,0,133
31429,2022,Iraq,Romania,497,29,0,526
31430,2022,Jordan,Romania,9,0,0,9
31431,2022,Kazakhstan,Romania,5,0,0,5
31432,2022,Kuwait,Romania,5,0,0,5
31433,2022,Libya,Romania,5,5,0,10
31434,2022,Lebanon,Romania,19,8,0,27
31435,2022,Sri Lanka,Romania,0,7,0,7
31436,2022,Rep. of Moldova,Romania,68,0,0,68
31437,2022,Mali,Romania,5,0,0,5
31438,2022,Mongolia,Romania,0,6,0,6
31439,2022,Morocco,Romania,9,13,0,22
31440,2022,Myanmar,Romania,31,0,0,31
31441,2022,Nepal,Romania,0,23,0,23
31442,2022,Nigeria,Romania,9,13,0,22
31443,2022,Pakistan,Romania,35,66,0,101
31444,2022,Russian Federation,Romania,146,13,0,159
31445,2022,Rwanda,Romania,12,0,0,12
31446,2022,Sierra Leone,Romania,5,0,0,5
31447,2022,Somalia,Romania,357,64,0,421
31448,2022,Sudan,Romania,24,16,0,40
31449,2022,Syrian Arab Rep.,Romania,2357,65,0,2422
31450,2022,United Rep. of Tanzania,Romania,0,5,0,5
31451,2022,Turkmenistan,Romania,11,0,0,11
31452,2022,Tunisia,Romania,6,11,0,17
31453,2022,Türkiye,Romania,80,65,0,145
31454,2022,Uganda,Romania,6,0,0,6
31455,2022,Ukraine,Romania,83326,65,0,83391
31456,2022,Uzbekistan,Romania,10,0,0,10
31457,2022,Yemen,Romania,68,5,0,73
31459,2022,Afghanistan,South Africa,5,16,0,21
31460,2022,Algeria,South Africa,5,181,0,186
31461,2022,Angola,South Africa,24,11,0,35
31462,2022,Egypt,South Africa,7,227,0,234
31463,2022,Bahrain,South Africa,0,5,0,5
31464,2022,Burundi,South Africa,2607,6669,0,9276
31465,2022,Benin,South Africa,5,35,0,40
31466,2022,Bangladesh,South Africa,200,24428,0,24628
31467,2022,Bahamas,South Africa,0,14,0,14
31468,2022,Burkina Faso,South Africa,0,39,0,39
31469,2022,Central African Rep.,South Africa,9,5,0,14
31470,2022,Chad,South Africa,5,5,0,10
31471,2022,China,South Africa,0,69,0,69
31472,2022,Cameroon,South Africa,324,1646,0,1970
31473,2022,Congo,South Africa,4369,7683,0,12052
31474,2022,Dem. Rep. of the Congo,South Africa,22471,33609,0,56080
31475,2022,Comoros,South Africa,0,13,0,13
31476,2022,Eritrea,South Africa,1347,1023,0,2370
31477,2022,Estonia,South Africa,5,7,0,12
31478,2022,Ethiopia,South Africa,15240,45365,0,60605
31479,2022,Gabon,South Africa,0,11,0,11
31480,2022,Gambia,South Africa,0,5,0,5
31481,2022,Palestinian,South Africa,33,10,0,43
31482,2022,Ghana,South Africa,7,1283,0,1290
31483,2022,Guinea-Bissau,South Africa,0,9,0,9
31484,2022,Guinea,South Africa,0,50,0,50
31485,2022,Hungary,South Africa,0,5,0,5
31486,2022,Cote d'Ivoire,South Africa,26,163,0,189
31487,2022,India,South Africa,5,3961,0,3966
31488,2022,Iraq,South Africa,14,6,0,20
31489,2022,Jordan,South Africa,5,5,0,10
31490,2022,Kenya,South Africa,140,946,0,1086
31491,2022,Liberia,South Africa,47,52,0,99
31492,2022,Lesotho,South Africa,0,16,0,16
31493,2022,Sri Lanka,South Africa,10,12,0,22
31494,2022,Mali,South Africa,5,113,0,118
31495,2022,Malawi,South Africa,8,1466,0,1474
31496,2022,Morocco,South Africa,5,6,0,11
31497,2022,Mozambique,South Africa,0,255,0,255
31498,2022,Nepal,South Africa,0,85,0,85
31499,2022,Niger,South Africa,0,675,0,675
31500,2022,Nigeria,South Africa,11,5061,0,5072
31501,2022,Pakistan,South Africa,11,8502,0,8513
31502,2022,Russian Federation,South Africa,10,0,0,10
31503,2022,Rwanda,South Africa,985,1026,0,2011
31504,2022,Senegal,South Africa,5,750,0,755
31505,2022,Sierra Leone,South Africa,19,13,0,32
31506,2022,Solomon Islands,South Africa,7,0,0,7
31507,2022,Somalia,South Africa,22388,4539,0,26927
31508,2022,Sudan,South Africa,86,60,0,146
31509,2022,Eswatini,South Africa,7,18,0,25
31510,2022,Syrian Arab Rep.,South Africa,38,20,0,58
31511,2022,United Rep. of Tanzania,South Africa,31,479,0,510
31512,2022,Thailand,South Africa,0,46,0,46
31513,2022,Timor-Leste,South Africa,0,7,0,7
31514,2022,Togo,South Africa,11,30,0,41
31515,2022,Türkiye,South Africa,5,10,0,15
31516,2022,Uganda,South Africa,456,3879,0,4335
31517,2022,Ukraine,South Africa,5,0,0,5
31518,2022,Yemen,South Africa,5,5,0,10
31519,2022,Zambia,South Africa,60,200,0,260
31520,2022,Zimbabwe,South Africa,3962,10218,0,14180
31521,2022,Afghanistan,Russian Federation,1084,109,0,1193
31522,2022,Egypt,Russian Federation,5,0,0,5
31523,2022,Armenia,Russian Federation,21,5,0,26
31524,2022,Azerbaijan,Russian Federation,28,5,0,33
31525,2022,Belgium,Russian Federation,0,8,0,8
31526,2022,Bangladesh,Russian Federation,5,0,0,5
31527,2022,China,Russian Federation,23,5,0,28
31528,2022,Dem. Rep. of the Congo,Russian Federation,14,0,0,14
31529,2022,Cuba,Russian Federation,6,5,0,11
31530,2022,Estonia,Russian Federation,5,0,0,5
31531,2022,Palestinian,Russian Federation,6,0,0,6
31532,2022,Georgia,Russian Federation,122,5,0,127
31533,2022,Germany,Russian Federation,15,5,0,20
31534,2022,Iran (Islamic Rep. of),Russian Federation,6,0,0,6
31535,2022,Iraq,Russian Federation,15,0,0,15
31536,2022,Israel,Russian Federation,5,0,0,5
31537,2022,Kazakhstan,Russian Federation,36,5,0,41
31538,2022,Kyrgyzstan,Russian Federation,38,0,0,38
31539,2022,Rep. of Korea,Russian Federation,5,0,0,5
31540,2022,Dem. People's Rep. of Korea,Russian Federation,40,10,0,50
31541,2022,Libya,Russian Federation,5,0,0,5
31542,2022,Lebanon,Russian Federation,5,0,0,5
31543,2022,Lithuania,Russian Federation,7,0,0,7
31544,2022,Latvia,Russian Federation,9,0,0,9
31545,2022,Rep. of Moldova,Russian Federation,21,5,0,26
31546,2022,Pakistan,Russian Federation,7,0,0,7
31547,2022,Philippines,Russian Federation,5,0,0,5
31548,2022,Sudan,Russian Federation,5,0,0,5
31549,2022,Syrian Arab Rep.,Russian Federation,280,42,0,322
31550,2022,Tajikistan,Russian Federation,34,17,0,51
31551,2022,Turkmenistan,Russian Federation,60,5,0,65
31552,2022,Türkiye,Russian Federation,6,0,0,6
31553,2022,Ukraine,Russian Federation,1456250,4400,0,1460650
31554,2022,United States of America,Russian Federation,6,7,0,13
31555,2022,Uzbekistan,Russian Federation,86,7,0,93
31556,2022,Yemen,Russian Federation,84,5,0,89
31559,2022,Angola,Rwanda,9,0,0,9
31560,2022,Burundi,Rwanda,48218,54,0,48272
31561,2022,Chad,Rwanda,6,0,0,6
31562,2022,Cameroon,Rwanda,0,7,0,7
31563,2022,Dem. Rep. of the Congo,Rwanda,73297,149,0,73446
31564,2022,Eritrea,Rwanda,210,77,0,287
31565,2022,Ethiopia,Rwanda,17,5,0,22
31566,2022,Rwanda,Rwanda,0,0,0,0
31567,2022,Somalia,Rwanda,12,7,0,19
31568,2022,Sudan,Rwanda,95,49,0,144
31569,2022,South Sudan,Rwanda,10,8,0,18
31571,2022,Colombia,El Salvador,15,5,0,20
31572,2022,Cuba,El Salvador,0,5,0,5
31573,2022,Guatemala,El Salvador,0,7,0,7
31574,2022,Honduras,El Salvador,24,8,0,32
31575,2022,Iraq,El Salvador,5,0,0,5
31576,2022,Nicaragua,El Salvador,23,21,0,44
31577,2022,El Salvador,El Salvador,0,0,71500,0
31578,2022,United States of America,El Salvador,5,0,0,5
31579,2022,Venezuela (Bolivarian Republic of),El Salvador,12,8,0,20
31580,2022,Afghanistan,Saudi Arabia,0,279,0,279
31581,2022,Egypt,Saudi Arabia,0,24,0,24
31582,2022,Burkina Faso,Saudi Arabia,0,11,0,11
31583,2022,Chad,Saudi Arabia,0,95,0,95
31584,2022,China,Saudi Arabia,14,24,0,38
31585,2022,Eritrea,Saudi Arabia,36,143,0,179
31586,2022,Ethiopia,Saudi Arabia,0,11,0,11
31587,2022,Palestinian,Saudi Arabia,14,474,0,488
31588,2022,Iraq,Saudi Arabia,32,197,0,229
31589,2022,Jordan,Saudi Arabia,0,19,0,19
31590,2022,Liberia,Saudi Arabia,9,0,0,9
31591,2022,Libya,Saudi Arabia,0,8,0,8
31592,2022,Lebanon,Saudi Arabia,0,13,0,13
31593,2022,Mali,Saudi Arabia,0,5,0,5
31594,2022,Myanmar,Saudi Arabia,0,131,0,131
31595,2022,Nigeria,Saudi Arabia,0,9,0,9
31596,2022,Pakistan,Saudi Arabia,0,27,0,27
31597,2022,Somalia,Saudi Arabia,16,74,0,90
31598,2022,Sudan,Saudi Arabia,0,122,0,122
31599,2022,South Sudan,Saudi Arabia,0,7,0,7
31600,2022,Syrian Arab Rep.,Saudi Arabia,194,10625,0,10819
31601,2022,Turkmenistan,Saudi Arabia,0,5,0,5
31602,2022,Tunisia,Saudi Arabia,6,0,0,6
31603,2022,Ukraine,Saudi Arabia,0,5,0,5
31604,2022,Yemen,Saudi Arabia,14,1150,0,1164
31607,2022,Afghanistan,Serbia and Kosovo: S/RES/1244 (1999),27,8,0,35
31608,2022,Algeria,Serbia and Kosovo: S/RES/1244 (1999),0,5,0,5
31609,2022,Armenia,Serbia and Kosovo: S/RES/1244 (1999),5,0,0,5
31610,2022,Burundi,Serbia and Kosovo: S/RES/1244 (1999),8,115,0,123
31611,2022,Bangladesh,Serbia and Kosovo: S/RES/1244 (1999),0,0,0,0
31612,2022,Bosnia and Herzegovina,Serbia and Kosovo: S/RES/1244 (1999),7997,0,0,7997
31613,2022,Cameroon,Serbia and Kosovo: S/RES/1244 (1999),0,5,0,5
31614,2022,Congo,Serbia and Kosovo: S/RES/1244 (1999),0,5,0,5
31615,2022,Dem. Rep. of the Congo,Serbia and Kosovo: S/RES/1244 (1999),0,7,0,7
31616,2022,Cuba,Serbia and Kosovo: S/RES/1244 (1999),7,16,0,23
31617,2022,Ethiopia,Serbia and Kosovo: S/RES/1244 (1999),5,0,0,5
31618,2022,Palestinian,Serbia and Kosovo: S/RES/1244 (1999),6,0,0,6
31619,2022,Guinea-Bissau,Serbia and Kosovo: S/RES/1244 (1999),0,5,0,5
31620,2022,Guinea,Serbia and Kosovo: S/RES/1244 (1999),0,5,0,5
31621,2022,Croatia,Serbia and Kosovo: S/RES/1244 (1999),17334,0,0,17334
31622,2022,India,Serbia and Kosovo: S/RES/1244 (1999),0,0,0,0
31623,2022,Iran (Islamic Rep. of),Serbia and Kosovo: S/RES/1244 (1999),19,20,0,39
31624,2022,Iraq,Serbia and Kosovo: S/RES/1244 (1999),16,5,0,21
31625,2022,Jordan,Serbia and Kosovo: S/RES/1244 (1999),0,7,0,7
31626,2022,Libya,Serbia and Kosovo: S/RES/1244 (1999),47,5,0,52
31627,2022,North Macedonia,Serbia and Kosovo: S/RES/1244 (1999),0,0,0,0
31628,2022,Morocco,Serbia and Kosovo: S/RES/1244 (1999),0,11,0,11
31629,2022,Nigeria,Serbia and Kosovo: S/RES/1244 (1999),0,6,0,6
31630,2022,Pakistan,Serbia and Kosovo: S/RES/1244 (1999),5,0,0,5
31631,2022,South Africa,Serbia and Kosovo: S/RES/1244 (1999),0,5,0,5
31632,2022,Russian Federation,Serbia and Kosovo: S/RES/1244 (1999),18,8,0,26
31633,2022,Serbia and Kosovo: S/RES/1244 (1999),Serbia and Kosovo: S/RES/1244 (1999),0,0,211740,0
31634,2022,Somalia,Serbia and Kosovo: S/RES/1244 (1999),7,15,0,22
31635,2022,Sudan,Serbia and Kosovo: S/RES/1244 (1999),5,0,0,5
31636,2022,Syrian Arab Rep.,Serbia and Kosovo: S/RES/1244 (1999),40,7,0,47
31637,2022,Tunisia,Serbia and Kosovo: S/RES/1244 (1999),0,5,0,5
31638,2022,Türkiye,Serbia and Kosovo: S/RES/1244 (1999),99,12,0,111
31639,2022,Ukraine,Serbia and Kosovo: S/RES/1244 (1999),772,5,0,777
31642,2022,Burundi,Senegal,5,0,0,5
31643,2022,Central African Rep.,Senegal,261,120,0,381
31644,2022,Chad,Senegal,5,12,0,17
31645,2022,Congo,Senegal,0,9,0,9
31646,2022,Dem. Rep. of the Congo,Senegal,7,16,0,23
31647,2022,Comoros,Senegal,0,10,0,10
31648,2022,Gambia,Senegal,7,49,0,56
31649,2022,Guinea,Senegal,5,16,0,21
31650,2022,Cote d'Ivoire,Senegal,5,0,0,5
31651,2022,Liberia,Senegal,0,5,0,5
31652,2022,Mauritania,Senegal,11474,7,0,11481
31653,2022,Mali,Senegal,0,5,0,5
31654,2022,Nigeria,Senegal,5,0,0,5
31655,2022,Rwanda,Senegal,5,0,0,5
31656,2022,Sierra Leone,Senegal,0,6,0,6
31657,2022,Togo,Senegal,0,7,0,7
31658,2022,Türkiye,Senegal,0,5,0,5
31660,2022,Cote d'Ivoire,Sierra Leone,10,0,0,10
31661,2022,Egypt,Somalia,0,5,0,5
31662,2022,Bangladesh,Somalia,6,0,0,6
31663,2022,Cameroon,Somalia,5,0,0,5
31664,2022,Djibouti,Somalia,0,7,0,7
31665,2022,Eritrea,Somalia,57,38,0,95
31666,2022,Ethiopia,Somalia,4816,17866,0,22682
31667,2022,Palestinian,Somalia,8,0,0,8
31668,2022,Jordan,Somalia,0,5,0,5
31669,2022,Mozambique,Somalia,0,5,0,5
31670,2022,Somalia,Somalia,0,0,2967500,0
31671,2022,Sudan,Somalia,0,12,0,12
31672,2022,Syrian Arab Rep.,Somalia,1018,98,0,1116
31673,2022,United Rep. of Tanzania,Somalia,0,139,0,139
31674,2022,Yemen,Somalia,9208,0,0,9208
31675,2022,Afghanistan,Spain,2111,685,0,2796
31676,2022,Albania,Spain,12,100,0,112
31677,2022,Algeria,Spain,159,1095,0,1254
31678,2022,Angola,Spain,39,25,0,64
31679,2022,Egypt,Spain,113,205,0,318
31680,2022,Argentina,Spain,45,790,0,835
31681,2022,Armenia,Spain,132,320,0,452
31682,2022,Australia,Spain,5,0,0,5
31683,2022,Azerbaijan,Spain,71,45,0,116
31684,2022,Burundi,Spain,8,0,0,8
31685,2022,Benin,Spain,5,10,0,15
31686,2022,Bangladesh,Spain,26,155,0,181
31687,2022,Burkina Faso,Spain,47,345,0,392
31688,2022,Belarus,Spain,193,260,0,453
31689,2022,Bolivia (Plurinational State of),Spain,12,75,0,87
31690,2022,Brazil,Spain,63,895,0,958
31691,2022,Bosnia and Herzegovina,Spain,5,5,0,10
31692,2022,Canada,Spain,11,5,0,16
31693,2022,Central African Rep.,Spain,143,30,0,173
31694,2022,Chad,Spain,34,20,0,54
31695,2022,China,Spain,62,845,0,907
31696,2022,Chile,Spain,41,365,0,406
31697,2022,Cameroon,Spain,136,580,0,716
31698,2022,Congo,Spain,69,25,0,94
31699,2022,Dem. Rep. of the Congo,Spain,88,80,0,168
31700,2022,Colombia,Spain,2641,29500,0,32141
31701,2022,Costa Rica,Spain,6,90,0,96
31702,2022,Cuba,Spain,199,3115,0,3314
31703,2022,Djibouti,Spain,0,5,0,5
31704,2022,Dominican Rep.,Spain,30,95,0,125
31705,2022,Ecuador,Spain,71,580,0,651
31706,2022,Equatorial Guinea,Spain,35,120,0,155
31707,2022,Eritrea,Spain,312,75,0,387
31708,2022,Estonia,Spain,5,0,0,5
31709,2022,Ethiopia,Spain,39,30,0,69
31710,2022,France,Spain,0,5,0,5
31711,2022,Gabon,Spain,5,5,0,10
31712,2022,Gambia,Spain,69,435,0,504
31713,2022,Palestinian,Spain,1381,345,0,1726
31714,2022,United Kingdom of Great Britain and Northern Ireland,Spain,15,0,0,15
31715,2022,Georgia,Spain,155,1755,0,1910
31716,2022,Ghana,Spain,22,130,0,152
31717,2022,Guinea-Bissau,Spain,9,55,0,64
31718,2022,Guatemala,Spain,111,570,0,681
31719,2022,Guinea,Spain,238,855,0,1093
31720,2022,Haiti,Spain,8,180,0,188
31721,2022,Honduras,Spain,1871,6385,0,8256
31722,2022,Cote d'Ivoire,Spain,385,820,0,1205
31723,2022,India,Spain,47,40,0,87
31724,2022,Iran (Islamic Rep. of),Spain,145,95,0,240
31725,2022,Iraq,Spain,298,110,0,408
31726,2022,Israel,Spain,36,20,0,56
31727,2022,Jamaica,Spain,61,20,0,81
31728,2022,Jordan,Spain,28,35,0,63
31729,2022,Kazakhstan,Spain,34,60,0,94
31730,2022,Kenya,Spain,15,5,0,20
31731,2022,Kyrgyzstan,Spain,11,15,0,26
31732,2022,Rep. of Korea,Spain,0,5,0,5
31733,2022,Kuwait,Spain,5,5,0,10
31734,2022,Liberia,Spain,7,40,0,47
31735,2022,Libya,Spain,171,25,0,196
31736,2022,Lebanon,Spain,35,40,0,75
31737,2022,Sri Lanka,Spain,66,20,0,86
31738,2022,Latvia,Spain,7,0,0,7
31739,2022,Mauritania,Spain,28,165,0,193
31740,2022,North Macedonia,Spain,0,15,0,15
31741,2022,Rep. of Moldova,Spain,100,110,0,210
31742,2022,Mexico,Spain,50,205,0,255
31743,2022,Mali,Spain,2650,5900,0,8550
31744,2022,Mongolia,Spain,17,0,0,17
31745,2022,Morocco,Spain,967,5965,0,6932
31746,2022,Mozambique,Spain,5,0,0,5
31747,2022,Myanmar,Spain,11,0,0,11
31748,2022,Nepal,Spain,0,5,0,5
31749,2022,Netherlands,Spain,0,5,0,5
31750,2022,Niger,Spain,25,5,0,30
31751,2022,Nicaragua,Spain,2049,4725,0,6774
31752,2022,Nigeria,Spain,255,1105,0,1360
31753,2022,Pakistan,Spain,490,600,0,1090
31754,2022,Panama,Spain,35,135,0,170
31755,2022,Paraguay,Spain,60,760,0,820
31756,2022,Peru,Spain,337,6755,0,7092
31757,2022,Philippines,Spain,6,5,0,11
31758,2022,Qatar,Spain,0,5,0,5
31759,2022,Romania,Spain,8,0,0,8
31760,2022,South Africa,Spain,5,0,0,5
31761,2022,Russian Federation,Spain,1185,1875,0,3060
31762,2022,Rwanda,Spain,5,0,0,5
31763,2022,El Salvador,Spain,992,3980,0,4972
31764,2022,Saudi Arabia,Spain,5,5,0,10
31765,2022,Serbia and Kosovo: S/RES/1244 (1999),Spain,13,30,0,43
31766,2022,Senegal,Spain,54,2940,0,2994
31767,2022,Sierra Leone,Spain,28,50,0,78
31768,2022,Somalia,Spain,705,205,0,910
31769,2022,Viet Nam,Spain,11,20,0,31
31770,2022,Saint Kitts and Nevis,Spain,0,5,0,5
31771,2022,Sudan,Spain,622,245,0,867
31772,2022,South Sudan,Spain,5,10,0,15
31773,2022,Syrian Arab Rep.,Spain,14994,1080,0,16074
31774,2022,United Rep. of Tanzania,Spain,0,5,0,5
31775,2022,Tajikistan,Spain,7,5,0,12
31776,2022,Turkmenistan,Spain,10,10,0,20
31777,2022,Togo,Spain,5,45,0,50
31778,2022,Trinidad and Tobago,Spain,5,10,0,15
31779,2022,Tunisia,Spain,75,110,0,185
31780,2022,Türkiye,Spain,217,430,0,647
31781,2022,Uganda,Spain,7,5,0,12
31782,2022,Ukraine,Spain,128129,1700,0,129829
31783,2022,Uruguay,Spain,16,215,0,231
31784,2022,United States of America,Spain,92,75,0,167
31785,2022,Uzbekistan,Spain,24,15,0,39
31786,2022,Venezuela (Bolivarian Republic of),Spain,96786,31490,0,128276
31787,2022,Western Sahara,Spain,17,0,0,17
31788,2022,Yemen,Spain,460,285,0,745
31793,2022,Venezuela (Bolivarian Republic of),Saint Kitts and Nevis,0,0,0,0
31794,2022,Afghanistan,Sudan,0,0,0,0
31795,2022,Andorra,Sudan,5,0,0,5
31796,2022,Egypt,Sudan,18,11,0,29
31797,2022,Burundi,Sudan,11,8,0,19
31798,2022,Central African Rep.,Sudan,28035,7,0,28042
31799,2022,Chad,Sudan,4628,5,0,4633
31800,2022,Cameroon,Sudan,7,0,0,7
31801,2022,Congo,Sudan,18,5,0,23
31802,2022,Dem. Rep. of the Congo,Sudan,425,342,0,767
31803,2022,Eritrea,Sudan,117955,13236,0,131191
31804,2022,Ethiopia,Sudan,57682,14533,0,72215
31805,2022,Palestinian,Sudan,49,24,0,73
31806,2022,India,Sudan,0,5,0,5
31807,2022,Iraq,Sudan,9,13,0,22
31808,2022,Jordan,Sudan,0,0,0,0
31809,2022,Kuwait,Sudan,0,0,0,0
31810,2022,Nigeria,Sudan,12,0,0,12
31811,2022,Saudi Arabia,Sudan,0,0,0,0
31812,2022,Somalia,Sudan,409,156,0,565
31813,2022,Sudan,Sudan,0,0,3036593,0
31814,2022,South Sudan,Sudan,807532,0,0,807532
31815,2022,Syrian Arab Rep.,Sudan,93480,0,0,93480
31816,2022,Türkiye,Sudan,5,0,0,5
31817,2022,Uganda,Sudan,5,0,0,5
31818,2022,Yemen,Sudan,1881,388,0,2269
31820,2022,Colombia,Suriname,0,10,0,10
31821,2022,Cuba,Suriname,17,2017,0,2034
31822,2022,Dominican Rep.,Suriname,0,6,0,6
31823,2022,Haiti,Suriname,0,5,0,5
31824,2022,Nigeria,Suriname,0,5,0,5
31825,2022,Venezuela (Bolivarian Republic of),Suriname,13,413,0,426
31826,2022,Burundi,South Sudan,306,882,0,1188
31827,2022,Central African Rep.,South Sudan,2409,0,0,2409
31828,2022,Dem. Rep. of the Congo,South Sudan,18854,20,0,18874
31829,2022,Eritrea,South Sudan,832,2396,0,3228
31830,2022,Ethiopia,South Sudan,4610,901,0,5511
31831,2022,Liberia,South Sudan,0,5,0,5
31832,2022,Somalia,South Sudan,5,31,0,36
31833,2022,Sudan,South Sudan,310104,21,0,310125
31834,2022,South Sudan,South Sudan,0,0,2229657,0
31836,2022,Afghanistan,Slovakia,366,0,0,366
31837,2022,Algeria,Slovakia,5,0,0,5
31838,2022,Angola,Slovakia,24,0,0,24
31839,2022,Egypt,Slovakia,18,0,0,18
31840,2022,Armenia,Slovakia,55,0,0,55
31841,2022,Azerbaijan,Slovakia,23,0,0,23
31842,2022,Burundi,Slovakia,5,0,0,5
31843,2022,Bangladesh,Slovakia,0,18,0,18
31844,2022,Belarus,Slovakia,39,5,0,44
31845,2022,Bosnia and Herzegovina,Slovakia,36,0,0,36
31846,2022,Bulgaria,Slovakia,8,0,0,8
31847,2022,Cambodia,Slovakia,5,0,0,5
31848,2022,China,Slovakia,16,0,0,16
31849,2022,Cameroon,Slovakia,11,0,0,11
31850,2022,Dem. Rep. of the Congo,Slovakia,17,0,0,17
31851,2022,Cuba,Slovakia,32,0,0,32
31852,2022,Palestinian,Slovakia,9,0,0,9
31853,2022,Georgia,Slovakia,12,0,0,12
31854,2022,India,Slovakia,11,0,0,11
31855,2022,Iran (Islamic Rep. of),Slovakia,43,0,0,43
31856,2022,Iraq,Slovakia,217,0,0,217
31857,2022,Israel,Slovakia,8,0,0,8
31858,2022,Jordan,Slovakia,7,0,0,7
31859,2022,Kazakhstan,Slovakia,9,0,0,9
31860,2022,Kyrgyzstan,Slovakia,6,0,0,6
31861,2022,Liberia,Slovakia,5,0,0,5
31862,2022,Libya,Slovakia,9,0,0,9
31863,2022,Sri Lanka,Slovakia,0,5,0,5
31864,2022,Rep. of Moldova,Slovakia,18,0,0,18
31865,2022,Morocco,Slovakia,10,0,0,10
31866,2022,Nigeria,Slovakia,19,5,0,24
31867,2022,Pakistan,Slovakia,8,0,0,8
31868,2022,Romania,Slovakia,37,0,0,37
31869,2022,Russian Federation,Slovakia,273,9,0,282
31870,2022,Serbia and Kosovo: S/RES/1244 (1999),Slovakia,47,0,0,47
31871,2022,Somalia,Slovakia,34,0,0,34
31872,2022,Viet Nam,Slovakia,24,0,0,24
31873,2022,Syrian Arab Rep.,Slovakia,26,0,0,26
31874,2022,Tajikistan,Slovakia,8,0,0,8
31875,2022,Tunisia,Slovakia,5,0,0,5
31876,2022,Türkiye,Slovakia,13,0,0,13
31877,2022,Uganda,Slovakia,5,0,0,5
31878,2022,Ukraine,Slovakia,83297,8,0,83305
31879,2022,United States of America,Slovakia,21,0,0,21
31880,2022,Uzbekistan,Slovakia,9,0,0,9
31881,2022,Yemen,Slovakia,25,0,0,25
31883,2022,Afghanistan,Slovenia,64,229,0,293
31884,2022,Albania,Slovenia,0,5,0,5
31885,2022,Algeria,Slovenia,0,7,0,7
31886,2022,Egypt,Slovenia,0,5,0,5
31887,2022,Azerbaijan,Slovenia,5,0,0,5
31888,2022,Burundi,Slovenia,0,83,0,83
31889,2022,Bangladesh,Slovenia,0,37,0,37
31890,2022,Burkina Faso,Slovenia,0,7,0,7
31891,2022,Belarus,Slovenia,5,0,0,5
31892,2022,Bosnia and Herzegovina,Slovenia,7,0,0,7
31893,2022,Cameroon,Slovenia,10,30,0,40
31894,2022,Congo,Slovenia,0,9,0,9
31895,2022,Dem. Rep. of the Congo,Slovenia,6,19,0,25
31896,2022,Cuba,Slovenia,0,86,0,86
31897,2022,Eritrea,Slovenia,86,0,0,86
31898,2022,Ethiopia,Slovenia,0,5,0,5
31899,2022,Gambia,Slovenia,0,7,0,7
31900,2022,Palestinian,Slovenia,27,0,0,27
31901,2022,Ghana,Slovenia,0,25,0,25
31902,2022,Guinea-Bissau,Slovenia,0,7,0,7
31903,2022,Guinea,Slovenia,0,20,0,20
31904,2022,India,Slovenia,0,49,0,49
31905,2022,Iran (Islamic Rep. of),Slovenia,83,22,0,105
31906,2022,Iraq,Slovenia,53,84,0,137
31907,2022,Jordan,Slovenia,0,5,0,5
31908,2022,Kazakhstan,Slovenia,21,0,0,21
31909,2022,Sri Lanka,Slovenia,0,5,0,5
31910,2022,Mali,Slovenia,0,9,0,9
31911,2022,Morocco,Slovenia,5,8,0,13
31912,2022,Nepal,Slovenia,0,36,0,36
31913,2022,Nigeria,Slovenia,8,5,0,13
31914,2022,Pakistan,Slovenia,5,69,0,74
31915,2022,Russian Federation,Slovenia,50,11,0,61
31916,2022,Serbia and Kosovo: S/RES/1244 (1999),Slovenia,11,0,0,11
31917,2022,Senegal,Slovenia,0,5,0,5
31918,2022,Somalia,Slovenia,52,5,0,57
31919,2022,Sudan,Slovenia,6,0,0,6
31920,2022,Syrian Arab Rep.,Slovenia,326,20,0,346
31921,2022,Tunisia,Slovenia,0,6,0,6
31922,2022,Türkiye,Slovenia,61,27,0,88
31923,2022,Ukraine,Slovenia,6652,38,0,6690
31924,2022,United States of America,Slovenia,5,5,0,10
31925,2022,Yemen,Slovenia,6,0,0,6
31927,2022,Angola,Eswatini,12,0,0,12
31928,2022,Burundi,Eswatini,186,76,0,262
31929,2022,Cameroon,Eswatini,0,6,0,6
31930,2022,Congo,Eswatini,16,23,0,39
31931,2022,Dem. Rep. of the Congo,Eswatini,467,206,0,673
31932,2022,Eritrea,Eswatini,5,15,0,20
31933,2022,Ethiopia,Eswatini,16,83,0,99
31934,2022,Rwanda,Eswatini,173,69,0,242
31935,2022,Somalia,Eswatini,145,291,0,436
31936,2022,Eswatini,Eswatini,0,0,0,0
31937,2022,United Rep. of Tanzania,Eswatini,0,5,0,5
31938,2022,Uganda,Eswatini,6,0,0,6
31939,2022,Zimbabwe,Eswatini,9,0,0,9
31940,2022,Afghanistan,Sweden,26857,1904,0,28761
31941,2022,Albania,Sweden,260,138,0,398
31942,2022,Algeria,Sweden,64,69,0,133
31943,2022,Angola,Sweden,22,10,0,32
31944,2022,Egypt,Sweden,424,127,0,551
31945,2022,Argentina,Sweden,0,5,0,5
31946,2022,Armenia,Sweden,344,135,0,479
31947,2022,Azerbaijan,Sweden,658,217,0,875
31948,2022,Bahrain,Sweden,16,5,0,21
31949,2022,Burundi,Sweden,223,5,0,228
31950,2022,Benin,Sweden,10,0,0,10
31951,2022,Bangladesh,Sweden,243,105,0,348
31952,2022,Burkina Faso,Sweden,5,0,0,5
31953,2022,Belarus,Sweden,114,113,0,227
31954,2022,Bolivia (Plurinational State of),Sweden,51,15,0,66
31955,2022,Brazil,Sweden,7,18,0,25
31956,2022,Bosnia and Herzegovina,Sweden,59,56,0,115
31957,2022,Bulgaria,Sweden,11,0,0,11
31958,2022,Canada,Sweden,5,5,0,10
31959,2022,Central African Rep.,Sweden,71,0,0,71
31960,2022,Chad,Sweden,18,0,0,18
31961,2022,China,Sweden,223,29,0,252
31962,2022,Chile,Sweden,9,11,0,20
31963,2022,Cameroon,Sweden,235,126,0,361
31964,2022,Congo,Sweden,30,17,0,47
31965,2022,Dem. Rep. of the Congo,Sweden,823,68,0,891
31966,2022,Comoros,Sweden,5,0,0,5
31967,2022,Colombia,Sweden,39,262,0,301
31968,2022,Cuba,Sweden,23,8,0,31
31969,2022,Djibouti,Sweden,30,19,0,49
31970,2022,Ecuador,Sweden,6,0,0,6
31971,2022,Equatorial Guinea,Sweden,5,0,0,5
31972,2022,Eritrea,Sweden,25849,309,0,26158
31973,2022,Ethiopia,Sweden,2530,314,0,2844
31974,2022,Gambia,Sweden,177,74,0,251
31975,2022,Palestinian,Sweden,1345,325,0,1670
31976,2022,United Kingdom of Great Britain and Northern Ireland,Sweden,5,5,0,10
31977,2022,Georgia,Sweden,131,92,0,223
31978,2022,Ghana,Sweden,67,35,0,102
31979,2022,Guinea-Bissau,Sweden,7,0,0,7
31980,2022,Greece,Sweden,18,0,0,18
31981,2022,Guatemala,Sweden,8,5,0,13
31982,2022,Guinea,Sweden,62,13,0,75
31983,2022,Haiti,Sweden,0,5,0,5
31984,2022,Honduras,Sweden,29,14,0,43
31985,2022,Croatia,Sweden,0,5,0,5
31986,2022,Hungary,Sweden,5,0,0,5
31987,2022,Cote d'Ivoire,Sweden,30,5,0,35
31988,2022,India,Sweden,25,31,0,56
31989,2022,Indonesia,Sweden,15,0,0,15
31990,2022,Iran (Islamic Rep. of),Sweden,7146,582,0,7728
31991,2022,Iraq,Sweden,10464,1391,0,11855
31992,2022,Israel,Sweden,22,10,0,32
31993,2022,Jamaica,Sweden,5,0,0,5
31994,2022,Jordan,Sweden,291,152,0,443
31995,2022,Kazakhstan,Sweden,206,81,0,287
31996,2022,Kenya,Sweden,84,18,0,102
31997,2022,Kyrgyzstan,Sweden,162,67,0,229
31998,2022,Rep. of Korea,Sweden,8,5,0,13
31999,2022,Kuwait,Sweden,31,5,0,36
32000,2022,Liberia,Sweden,11,0,0,11
32001,2022,Libya,Sweden,255,46,0,301
32002,2022,Lebanon,Sweden,528,216,0,744
32003,2022,Sri Lanka,Sweden,26,23,0,49
32004,2022,Lithuania,Sweden,0,7,0,7
32005,2022,Mauritania,Sweden,13,0,0,13
32006,2022,North Macedonia,Sweden,37,25,0,62
32007,2022,Rep. of Moldova,Sweden,26,19,0,45
32008,2022,Mexico,Sweden,0,5,0,5
32009,2022,Mali,Sweden,39,5,0,44
32010,2022,Malaysia,Sweden,13,0,0,13
32011,2022,Mongolia,Sweden,240,101,0,341
32012,2022,Morocco,Sweden,263,137,0,400
32013,2022,Montenegro,Sweden,21,10,0,31
32014,2022,Myanmar,Sweden,6,8,0,14
32015,2022,Nepal,Sweden,8,5,0,13
32016,2022,Niger,Sweden,5,0,0,5
32017,2022,Nicaragua,Sweden,62,99,0,161
32018,2022,Nigeria,Sweden,639,313,0,952
32019,2022,Pakistan,Sweden,595,175,0,770
32020,2022,Panama,Sweden,0,5,0,5
32021,2022,Paraguay,Sweden,0,5,0,5
32022,2022,Peru,Sweden,9,111,0,120
32023,2022,Philippines,Sweden,5,11,0,16
32024,2022,Poland,Sweden,5,0,0,5
32025,2022,Romania,Sweden,38,0,0,38
32026,2022,Russian Federation,Sweden,1439,515,0,1954
32027,2022,Rwanda,Sweden,54,34,0,88
32028,2022,El Salvador,Sweden,139,77,0,216
32029,2022,Saudi Arabia,Sweden,62,5,0,67
32030,2022,Serbia and Kosovo: S/RES/1244 (1999),Sweden,516,191,0,707
32031,2022,Senegal,Sweden,55,16,0,71
32032,2022,Sierra Leone,Sweden,65,13,0,78
32033,2022,Somalia,Sweden,9315,412,0,9727
32034,2022,Viet Nam,Sweden,51,49,0,100
32035,2022,Sudan,Sweden,1077,68,0,1145
32036,2022,South Sudan,Sweden,64,0,0,64
32037,2022,Eswatini,Sweden,5,0,0,5
32038,2022,Syrian Arab Rep.,Sweden,113213,1227,0,114440
32039,2022,United Rep. of Tanzania,Sweden,65,29,0,94
32040,2022,Thailand,Sweden,5,10,0,15
32041,2022,Tajikistan,Sweden,85,50,0,135
32042,2022,Turkmenistan,Sweden,36,21,0,57
32043,2022,Tunisia,Sweden,47,44,0,91
32044,2022,Türkiye,Sweden,2531,368,0,2899
32045,2022,United Arab Emirates,Sweden,5,0,0,5
32046,2022,Uganda,Sweden,722,70,0,792
32047,2022,Ukraine,Sweden,40129,1345,0,41474
32048,2022,United States of America,Sweden,34,7,0,41
32049,2022,Uzbekistan,Sweden,525,391,0,916
32050,2022,Venezuela (Bolivarian Republic of),Sweden,41,60,0,101
32051,2022,Yemen,Sweden,1715,69,0,1784
32052,2022,Zambia,Sweden,12,0,0,12
32053,2022,Zimbabwe,Sweden,15,5,0,20
32056,2022,Afghanistan,Switzerland,11441,1768,0,13209
32057,2022,Albania,Switzerland,89,60,0,149
32058,2022,Algeria,Switzerland,99,159,0,258
32059,2022,Angola,Switzerland,640,38,0,678
32060,2022,Egypt,Switzerland,22,12,0,34
32061,2022,Armenia,Switzerland,148,28,0,176
32062,2022,Azerbaijan,Switzerland,60,75,0,135
32063,2022,Burundi,Switzerland,71,20,0,91
32064,2022,Benin,Switzerland,9,5,0,14
32065,2022,Bangladesh,Switzerland,22,12,0,34
32066,2022,Burkina Faso,Switzerland,14,5,0,19
32067,2022,Belarus,Switzerland,32,30,0,62
32068,2022,Brazil,Switzerland,9,5,0,14
32069,2022,Bosnia and Herzegovina,Switzerland,302,13,0,315
32070,2022,Bulgaria,Switzerland,5,0,0,5
32071,2022,Canada,Switzerland,0,5,0,5
32072,2022,Central African Rep.,Switzerland,12,0,0,12
32073,2022,Chad,Switzerland,10,13,0,23
32074,2022,China,Switzerland,2723,85,0,2808
32075,2022,Cameroon,Switzerland,142,43,0,185
32076,2022,Congo,Switzerland,17,9,0,26
32077,2022,Dem. Rep. of the Congo,Switzerland,838,64,0,902
32078,2022,Colombia,Switzerland,41,111,0,152
32079,2022,Cuba,Switzerland,18,52,0,70
32080,2022,Ecuador,Switzerland,5,5,0,10
32081,2022,Equatorial Guinea,Switzerland,5,0,0,5
32082,2022,Eritrea,Switzerland,14726,284,0,15010
32083,2022,Ethiopia,Switzerland,1028,174,0,1202
32084,2022,France,Switzerland,5,0,0,5
32085,2022,Gambia,Switzerland,30,13,0,43
32086,2022,Georgia,Switzerland,230,265,0,495
32087,2022,Ghana,Switzerland,18,13,0,31
32088,2022,Guinea-Bissau,Switzerland,41,0,0,41
32089,2022,Greece,Switzerland,5,0,0,5
32090,2022,Guatemala,Switzerland,5,0,0,5
32091,2022,Guinea,Switzerland,139,27,0,166
32092,2022,Haiti,Switzerland,0,5,0,5
32093,2022,Honduras,Switzerland,5,10,0,15
32094,2022,Cote d'Ivoire,Switzerland,113,15,0,128
32095,2022,India,Switzerland,34,18,0,52
32096,2022,Indonesia,Switzerland,0,6,0,6
32097,2022,Iran (Islamic Rep. of),Switzerland,1221,661,0,1882
32098,2022,Iraq,Switzerland,2338,388,0,2726
32099,2022,Jordan,Switzerland,20,6,0,26
32100,2022,Kazakhstan,Switzerland,19,12,0,31
32101,2022,Kenya,Switzerland,22,0,0,22
32102,2022,Kyrgyzstan,Switzerland,5,15,0,20
32103,2022,Liberia,Switzerland,17,0,0,17
32104,2022,Libya,Switzerland,132,29,0,161
32105,2022,Lebanon,Switzerland,30,23,0,53
32106,2022,Sri Lanka,Switzerland,1341,637,0,1978
32107,2022,Mauritania,Switzerland,9,0,0,9
32108,2022,North Macedonia,Switzerland,137,41,0,178
32109,2022,Rep. of Moldova,Switzerland,8,0,0,8
32110,2022,Mali,Switzerland,23,0,0,23
32111,2022,Malawi,Switzerland,0,5,0,5
32112,2022,Mongolia,Switzerland,158,6,0,164
32113,2022,Morocco,Switzerland,53,52,0,105
32114,2022,Montenegro,Switzerland,46,15,0,61
32115,2022,Myanmar,Switzerland,34,13,0,47
32116,2022,Nepal,Switzerland,12,6,0,18
32117,2022,Niger,Switzerland,13,0,0,13
32118,2022,Nicaragua,Switzerland,0,10,0,10
32119,2022,Nigeria,Switzerland,272,87,0,359
32120,2022,Pakistan,Switzerland,171,87,0,258
32121,2022,Paraguay,Switzerland,5,0,0,5
32122,2022,Peru,Switzerland,0,5,0,5
32123,2022,Philippines,Switzerland,11,0,0,11
32124,2022,Romania,Switzerland,0,5,0,5
32125,2022,South Africa,Switzerland,6,0,0,6
32126,2022,Russian Federation,Switzerland,287,137,0,424
32127,2022,Rwanda,Switzerland,11,15,0,26
32128,2022,El Salvador,Switzerland,9,0,0,9
32129,2022,Saudi Arabia,Switzerland,15,5,0,20
32130,2022,Serbia and Kosovo: S/RES/1244 (1999),Switzerland,1531,61,0,1592
32131,2022,Senegal,Switzerland,44,11,0,55
32132,2022,Sierra Leone,Switzerland,34,6,0,40
32133,2022,Somalia,Switzerland,2608,179,0,2787
32134,2022,Spain,Switzerland,5,0,0,5
32135,2022,Viet Nam,Switzerland,7,0,0,7
32136,2022,Sudan,Switzerland,153,14,0,167
32137,2022,South Sudan,Switzerland,13,0,0,13
32138,2022,Syrian Arab Rep.,Switzerland,8039,272,0,8311
32139,2022,United Rep. of Tanzania,Switzerland,12,0,0,12
32140,2022,Tajikistan,Switzerland,0,6,0,6
32141,2022,Turkmenistan,Switzerland,0,5,0,5
32142,2022,Togo,Switzerland,60,13,0,73
32143,2022,Tunisia,Switzerland,34,53,0,87
32144,2022,Türkiye,Switzerland,1171,1623,0,2794
32145,2022,Uganda,Switzerland,32,24,0,56
32146,2022,Ukraine,Switzerland,57697,23,0,57720
32147,2022,Uzbekistan,Switzerland,17,5,0,22
32148,2022,Venezuela (Bolivarian Republic of),Switzerland,38,39,0,77
32149,2022,Western Sahara,Switzerland,5,0,0,5
32150,2022,Yemen,Switzerland,130,7,0,137
32151,2022,Zimbabwe,Switzerland,8,5,0,13
32154,2022,Afghanistan,Syrian Arab Rep.,1162,21,0,1183
32155,2022,Algeria,Syrian Arab Rep.,5,0,0,5
32156,2022,Egypt,Syrian Arab Rep.,31,16,0,47
32157,2022,Bahrain,Syrian Arab Rep.,5,0,0,5
32158,2022,Burkina Faso,Syrian Arab Rep.,0,5,0,5
32159,2022,Chad,Syrian Arab Rep.,9,0,0,9
32160,2022,Eritrea,Syrian Arab Rep.,16,0,0,16
32161,2022,Ethiopia,Syrian Arab Rep.,13,0,0,13
32162,2022,United Kingdom of Great Britain and Northern Ireland,Syrian Arab Rep.,0,5,0,5
32163,2022,Guinea,Syrian Arab Rep.,56,5,0,61
32164,2022,Iran (Islamic Rep. of),Syrian Arab Rep.,49,11,0,60
32165,2022,Iraq,Syrian Arab Rep.,11121,7269,0,18390
32166,2022,Jordan,Syrian Arab Rep.,18,7,0,25
32167,2022,Libya,Syrian Arab Rep.,10,10,0,20
32168,2022,Lebanon,Syrian Arab Rep.,23,19,0,42
32169,2022,Sri Lanka,Syrian Arab Rep.,0,5,0,5
32170,2022,Morocco,Syrian Arab Rep.,0,5,0,5
32171,2022,Nigeria,Syrian Arab Rep.,0,6,0,6
32172,2022,Pakistan,Syrian Arab Rep.,224,15,0,239
32173,2022,Saudi Arabia,Syrian Arab Rep.,5,0,0,5
32174,2022,Sierra Leone,Syrian Arab Rep.,17,0,0,17
32175,2022,Somalia,Syrian Arab Rep.,346,13,0,359
32176,2022,Sudan,Syrian Arab Rep.,736,95,0,831
32177,2022,South Sudan,Syrian Arab Rep.,77,0,0,77
32178,2022,Syrian Arab Rep.,Syrian Arab Rep.,0,0,6754277,0
32179,2022,Tunisia,Syrian Arab Rep.,5,5,0,10
32180,2022,Türkiye,Syrian Arab Rep.,5,8,0,13
32181,2022,Yemen,Syrian Arab Rep.,177,142,0,319
32184,2022,Burundi,United Rep. of Tanzania,155996,8957,0,164953
32185,2022,Dem. Rep. of the Congo,United Rep. of Tanzania,51987,19203,0,71190
32186,2022,Iran (Islamic Rep. of),United Rep. of Tanzania,5,0,0,5
32187,2022,Kenya,United Rep. of Tanzania,0,5,0,5
32188,2022,Lebanon,United Rep. of Tanzania,5,0,0,5
32189,2022,Rwanda,United Rep. of Tanzania,73,29,0,102
32190,2022,Somalia,United Rep. of Tanzania,162,0,0,162
32191,2022,Sudan,United Rep. of Tanzania,0,6,0,6
32192,2022,South Sudan,United Rep. of Tanzania,6,0,0,6
32193,2022,Syrian Arab Rep.,United Rep. of Tanzania,9,20,0,29
32194,2022,United Rep. of Tanzania,United Rep. of Tanzania,6,0,0,6
32195,2022,Türkiye,United Rep. of Tanzania,0,6,0,6
32196,2022,Uganda,United Rep. of Tanzania,14,6,0,20
32197,2022,Yemen,United Rep. of Tanzania,9,62,0,71
32198,2022,Sri Lanka,Turks and Caicos Islands,7,0,0,7
32199,2022,Afghanistan,Thailand,156,10,0,166
32200,2022,Egypt,Thailand,17,0,0,17
32201,2022,Cambodia,Thailand,247,87,0,334
32202,2022,China,Thailand,177,11,0,188
32203,2022,Cameroon,Thailand,62,17,0,79
32204,2022,Dem. Rep. of the Congo,Thailand,18,0,0,18
32205,2022,Ethiopia,Thailand,10,11,0,21
32206,2022,Palestinian,Thailand,237,5,0,242
32207,2022,Guinea,Thailand,0,5,0,5
32208,2022,Cote d'Ivoire,Thailand,18,0,0,18
32209,2022,Iran (Islamic Rep. of),Thailand,88,13,0,101
32210,2022,Iraq,Thailand,148,12,0,160
32211,2022,Lao People's Dem. Rep.,Thailand,6,0,0,6
32212,2022,Sri Lanka,Thailand,103,15,0,118
32213,2022,Morocco,Thailand,5,0,0,5
32214,2022,Myanmar,Thailand,92078,0,0,92078
32215,2022,Nepal,Thailand,5,0,0,5
32216,2022,Nigeria,Thailand,5,12,0,17
32217,2022,Pakistan,Thailand,1502,102,0,1604
32218,2022,Russian Federation,Thailand,5,0,0,5
32219,2022,Somalia,Thailand,162,5,0,167
32220,2022,Viet Nam,Thailand,998,362,0,1360
32221,2022,Sudan,Thailand,0,5,0,5
32222,2022,Syrian Arab Rep.,Thailand,212,8,0,220
32223,2022,United Rep. of Tanzania,Thailand,5,0,0,5
32224,2022,Yemen,Thailand,36,0,0,36
32225,2022,Zimbabwe,Thailand,9,0,0,9
32227,2022,Afghanistan,Tajikistan,9624,1638,0,11262
32228,2022,Iran (Islamic Rep. of),Tajikistan,5,0,0,5
32230,2022,Afghanistan,Turkmenistan,9,0,0,9
32231,2022,Azerbaijan,Turkmenistan,5,0,0,5
32233,2022,Burundi,Togo,5,0,0,5
32234,2022,Benin,Togo,36,15,0,51
32235,2022,Central African Rep.,Togo,244,232,0,476
32236,2022,Chad,Togo,13,16,0,29
32237,2022,Cameroon,Togo,7,18,0,25
32238,2022,Congo,Togo,32,40,0,72
32239,2022,Dem. Rep. of the Congo,Togo,94,94,0,188
32240,2022,Gabon,Togo,0,6,0,6
32241,2022,Palestinian,Togo,0,5,0,5
32242,2022,Ghana,Togo,8513,0,0,8513
32243,2022,Cote d'Ivoire,Togo,1290,125,0,1415
32244,2022,Iraq,Togo,5,0,0,5
32245,2022,Liberia,Togo,0,6,0,6
32246,2022,Lebanon,Togo,11,23,0,34
32247,2022,Sri Lanka,Togo,0,5,0,5
32248,2022,Mali,Togo,76,42,0,118
32249,2022,Niger,Togo,10,0,0,10
32250,2022,Nigeria,Togo,15,8,0,23
32251,2022,Rwanda,Togo,111,7,0,118
32252,2022,Syrian Arab Rep.,Togo,19,9,0,28
32253,2022,Türkiye,Togo,63,10,0,73
32254,2022,Bangladesh,Trinidad and Tobago,8,82,0,90
32255,2022,China,Trinidad and Tobago,0,126,0,126
32256,2022,Cameroon,Trinidad and Tobago,0,6,0,6
32257,2022,Colombia,Trinidad and Tobago,8,54,0,62
32258,2022,Cuba,Trinidad and Tobago,163,1221,0,1384
32259,2022,Dominican Rep.,Trinidad and Tobago,0,100,0,100
32260,2022,Ghana,Trinidad and Tobago,0,49,0,49
32261,2022,Guyana,Trinidad and Tobago,13,73,0,86
32262,2022,Haiti,Trinidad and Tobago,5,13,0,18
32263,2022,India,Trinidad and Tobago,0,5,0,5
32264,2022,Jamaica,Trinidad and Tobago,37,209,0,246
32265,2022,Sri Lanka,Trinidad and Tobago,5,0,0,5
32266,2022,Mexico,Trinidad and Tobago,6,0,0,6
32267,2022,Nigeria,Trinidad and Tobago,5,154,0,159
32268,2022,Pakistan,Trinidad and Tobago,9,20,0,29
32269,2022,Peru,Trinidad and Tobago,0,10,0,10
32270,2022,Philippines,Trinidad and Tobago,0,5,0,5
32271,2022,Viet Nam,Trinidad and Tobago,0,7,0,7
32272,2022,Syrian Arab Rep.,Trinidad and Tobago,53,35,0,88
32273,2022,Tajikistan,Trinidad and Tobago,0,5,0,5
32274,2022,Trinidad and Tobago,Trinidad and Tobago,0,0,0,0
32275,2022,Saint Vincent and the Grenadines,Trinidad and Tobago,5,0,0,5
32276,2022,Venezuela (Bolivarian Republic of),Trinidad and Tobago,3160,16320,0,19480
32277,2022,Algeria,Tunisia,11,10,0,21
32278,2022,Egypt,Tunisia,0,15,0,15
32279,2022,Burundi,Tunisia,0,7,0,7
32280,2022,Benin,Tunisia,0,7,0,7
32281,2022,Bangladesh,Tunisia,0,6,0,6
32282,2022,Burkina Faso,Tunisia,15,61,0,76
32283,2022,Central African Rep.,Tunisia,16,28,0,44
32284,2022,Chad,Tunisia,5,28,0,33
32285,2022,Cameroon,Tunisia,43,490,0,533
32286,2022,Congo,Tunisia,0,9,0,9
32287,2022,Dem. Rep. of the Congo,Tunisia,0,103,0,103
32288,2022,Comoros,Tunisia,0,7,0,7
32289,2022,Eritrea,Tunisia,135,162,0,297
32290,2022,Ethiopia,Tunisia,5,44,0,49
32291,2022,Gambia,Tunisia,0,20,0,20
32292,2022,Palestinian,Tunisia,34,35,0,69
32293,2022,Ghana,Tunisia,0,7,0,7
32294,2022,Guinea,Tunisia,10,483,0,493
32295,2022,Cote d'Ivoire,Tunisia,63,3416,0,3479
32296,2022,Iran (Islamic Rep. of),Tunisia,8,0,0,8
32297,2022,Iraq,Tunisia,18,12,0,30
32298,2022,Liberia,Tunisia,5,77,0,82
32299,2022,Libya,Tunisia,54,131,0,185
32300,2022,Lebanon,Tunisia,6,21,0,27
32301,2022,Mauritania,Tunisia,0,5,0,5
32302,2022,Mali,Tunisia,17,110,0,127
32303,2022,Morocco,Tunisia,0,5,0,5
32304,2022,Niger,Tunisia,0,6,0,6
32305,2022,Nigeria,Tunisia,0,113,0,113
32306,2022,Senegal,Tunisia,0,35,0,35
32307,2022,Sierra Leone,Tunisia,0,133,0,133
32308,2022,Somalia,Tunisia,21,131,0,152
32309,2022,Sudan,Tunisia,168,377,0,545
32310,2022,South Sudan,Tunisia,5,28,0,33
32311,2022,Syrian Arab Rep.,Tunisia,2669,0,0,2669
32312,2022,Togo,Tunisia,0,14,0,14
32313,2022,Yemen,Tunisia,14,26,0,40
32315,2022,Afghanistan,Türkiye,8384,135445,0,143829
32316,2022,Iran (Islamic Rep. of),Türkiye,4485,15135,0,19620
32317,2022,Iraq,Türkiye,10244,132166,0,142410
32318,2022,Syrian Arab Rep.,Türkiye,3648983,0,0,3648983
32320,2022,Afghanistan,United Arab Emirates,10,25,0,35
32321,2022,Algeria,United Arab Emirates,0,0,0,0
32322,2022,Egypt,United Arab Emirates,5,7,0,12
32323,2022,Chad,United Arab Emirates,7,0,0,7
32324,2022,Eritrea,United Arab Emirates,0,7,0,7
32325,2022,Ethiopia,United Arab Emirates,8,5,0,13
32326,2022,Palestinian,United Arab Emirates,16,0,0,16
32327,2022,Iran (Islamic Rep. of),United Arab Emirates,5,7,0,12
32328,2022,Iraq,United Arab Emirates,798,544,0,1342
32329,2022,Jordan,United Arab Emirates,7,0,0,7
32330,2022,Kuwait,United Arab Emirates,5,0,0,5
32331,2022,Lebanon,United Arab Emirates,16,10,0,26
32332,2022,Morocco,United Arab Emirates,0,0,0,0
32333,2022,Philippines,United Arab Emirates,0,0,0,0
32334,2022,Russian Federation,United Arab Emirates,0,5,0,5
32335,2022,Somalia,United Arab Emirates,21,0,0,21
32336,2022,Sudan,United Arab Emirates,14,6,0,20
32337,2022,Syrian Arab Rep.,United Arab Emirates,487,6486,0,6973
32338,2022,Yemen,United Arab Emirates,6,50,0,56
32339,2022,Afghanistan,Uganda,0,19,0,19
32340,2022,Egypt,Uganda,8,5,0,13
32341,2022,Burundi,Uganda,39663,1961,0,41624
32342,2022,Central African Rep.,Uganda,36,6,0,42
32343,2022,Chad,Uganda,6,6,0,12
32344,2022,Cameroon,Uganda,5,8,0,13
32345,2022,Congo,Uganda,36,0,0,36
32346,2022,Dem. Rep. of the Congo,Uganda,434413,6071,0,440484
32347,2022,Eritrea,Uganda,12228,12403,0,24631
32348,2022,Ethiopia,Uganda,2992,1904,0,4896
32349,2022,Palestinian,Uganda,5,0,0,5
32350,2022,Guinea,Uganda,5,0,0,5
32351,2022,Iran (Islamic Rep. of),Uganda,5,0,0,5
32352,2022,Kenya,Uganda,232,21,0,253
32353,2022,Mali,Uganda,5,0,0,5
32354,2022,Pakistan,Uganda,234,5,0,239
32355,2022,Romania,Uganda,5,0,0,5
32356,2022,Rwanda,Uganda,18679,7429,0,26108
32357,2022,Senegal,Uganda,9,0,0,9
32358,2022,Somalia,Uganda,50086,8992,0,59078
32359,2022,Sudan,Uganda,2985,808,0,3793
32360,2022,South Sudan,Uganda,927777,46,0,927823
32361,2022,Syrian Arab Rep.,Uganda,21,10,0,31
32362,2022,United Rep. of Tanzania,Uganda,18,0,0,18
32363,2022,Türkiye,Uganda,76,5,0,81
32364,2022,Yemen,Uganda,30,14,0,44
32366,2022,Afghanistan,Ukraine,893,483,0,1376
32367,2022,Algeria,Ukraine,0,8,0,8
32368,2022,Angola,Ukraine,23,0,0,23
32369,2022,Egypt,Ukraine,5,6,0,11
32370,2022,Armenia,Ukraine,52,0,0,52
32371,2022,Azerbaijan,Ukraine,70,17,0,87
32372,2022,Bangladesh,Ukraine,5,136,0,141
32373,2022,Belarus,Ukraine,45,13,0,58
32374,2022,China,Ukraine,0,5,0,5
32375,2022,Cameroon,Ukraine,0,21,0,21
32376,2022,Congo,Ukraine,26,7,0,33
32377,2022,Dem. Rep. of the Congo,Ukraine,18,0,0,18
32378,2022,Eritrea,Ukraine,11,21,0,32
32379,2022,Ethiopia,Ukraine,25,5,0,30
32380,2022,Palestinian,Ukraine,9,22,0,31
32381,2022,Georgia,Ukraine,25,0,0,25
32382,2022,Ghana,Ukraine,0,10,0,10
32383,2022,Guinea,Ukraine,5,5,0,10
32384,2022,Haiti,Ukraine,0,5,0,5
32385,2022,Cote d'Ivoire,Ukraine,0,13,0,13
32386,2022,India,Ukraine,7,17,0,24
32387,2022,Iran (Islamic Rep. of),Ukraine,74,5,0,79
32388,2022,Iraq,Ukraine,72,40,0,112
32389,2022,Jordan,Ukraine,5,5,0,10
32390,2022,Kazakhstan,Ukraine,8,5,0,13
32391,2022,Kyrgyzstan,Ukraine,11,18,0,29
32392,2022,Libya,Ukraine,5,0,0,5
32393,2022,Lebanon,Ukraine,9,5,0,14
32394,2022,Sri Lanka,Ukraine,8,26,0,34
32395,2022,Rep. of Moldova,Ukraine,0,5,0,5
32396,2022,Morocco,Ukraine,0,9,0,9
32397,2022,Myanmar,Ukraine,0,6,0,6
32398,2022,Nigeria,Ukraine,7,22,0,29
32399,2022,Pakistan,Ukraine,10,48,0,58
32400,2022,Russian Federation,Ukraine,167,115,0,282
32401,2022,Rwanda,Ukraine,5,0,0,5
32402,2022,Serbia and Kosovo: S/RES/1244 (1999),Ukraine,5,0,0,5
32403,2022,Senegal,Ukraine,0,5,0,5
32404,2022,Sierra Leone,Ukraine,5,0,0,5
32405,2022,Somalia,Ukraine,73,62,0,135
32406,2022,Viet Nam,Ukraine,0,13,0,13
32407,2022,Sudan,Ukraine,26,6,0,32
32408,2022,Syrian Arab Rep.,Ukraine,513,28,0,541
32409,2022,Tajikistan,Ukraine,18,39,0,57
32410,2022,Turkmenistan,Ukraine,7,0,0,7
32411,2022,Tunisia,Ukraine,0,5,0,5
32412,2022,Türkiye,Ukraine,6,0,0,6
32413,2022,Ukraine,Ukraine,0,0,6275000,0
32414,2022,Uzbekistan,Ukraine,40,31,0,71
32415,2022,Yemen,Ukraine,5,23,0,28
32417,2022,Afghanistan,Uruguay,5,6,0,11
32418,2022,Angola,Uruguay,14,0,0,14
32419,2022,Egypt,Uruguay,0,6,0,6
32420,2022,Argentina,Uruguay,0,11,0,11
32421,2022,Bangladesh,Uruguay,0,140,0,140
32422,2022,Bolivia (Plurinational State of),Uruguay,6,7,0,13
32423,2022,Brazil,Uruguay,0,24,0,24
32424,2022,Chile,Uruguay,0,7,0,7
32425,2022,Cameroon,Uruguay,12,5,0,17
32426,2022,Congo,Uruguay,5,0,0,5
32427,2022,Colombia,Uruguay,162,110,0,272
32428,2022,Cuba,Uruguay,33,9079,0,9112
32429,2022,Dominican Rep.,Uruguay,0,441,0,441
32430,2022,Ecuador,Uruguay,8,31,0,39
32431,2022,Palestinian,Uruguay,0,5,0,5
32432,2022,Ghana,Uruguay,0,24,0,24
32433,2022,Guinea-Bissau,Uruguay,0,5,0,5
32434,2022,Guatemala,Uruguay,5,0,0,5
32435,2022,Guinea,Uruguay,0,11,0,11
32436,2022,Haiti,Uruguay,5,26,0,31
32437,2022,India,Uruguay,0,6,0,6
32438,2022,Libya,Uruguay,5,0,0,5
32439,2022,Latvia,Uruguay,5,0,0,5
32440,2022,Mauritania,Uruguay,0,5,0,5
32441,2022,Mexico,Uruguay,5,5,0,10
32442,2022,Morocco,Uruguay,0,20,0,20
32443,2022,Nicaragua,Uruguay,9,5,0,14
32444,2022,Nigeria,Uruguay,22,34,0,56
32445,2022,Pakistan,Uruguay,0,39,0,39
32446,2022,Paraguay,Uruguay,5,5,0,10
32447,2022,Peru,Uruguay,8,54,0,62
32448,2022,South Africa,Uruguay,0,5,0,5
32449,2022,Russian Federation,Uruguay,13,5,0,18
32450,2022,El Salvador,Uruguay,48,8,0,56
32451,2022,Senegal,Uruguay,0,226,0,226
32452,2022,Somalia,Uruguay,5,0,0,5
32453,2022,Syrian Arab Rep.,Uruguay,66,5,0,71
32454,2022,Türkiye,Uruguay,13,5,0,18
32455,2022,Ukraine,Uruguay,15,5,0,20
32456,2022,Venezuela (Bolivarian Republic of),Uruguay,509,2738,0,3247
32458,2022,Afghanistan,United States of America,2478,3047,0,5525
32459,2022,Albania,United States of America,1351,2714,0,4065
32460,2022,Algeria,United States of America,138,537,0,675
32461,2022,Angola,United States of America,323,3644,0,3967
32462,2022,Antigua and Barbuda,United States of America,6,15,0,21
32463,2022,Egypt,United States of America,13909,9501,0,23410
32464,2022,Argentina,United States of America,21,579,0,600
32465,2022,Armenia,United States of America,1415,6351,0,7766
32466,2022,Australia,United States of America,0,19,0,19
32467,2022,Austria,United States of America,13,5,0,18
32468,2022,Azerbaijan,United States of America,540,1701,0,2241
32469,2022,Bahrain,United States of America,30,60,0,90
32470,2022,Barbados,United States of America,0,5,0,5
32471,2022,Burundi,United States of America,812,751,0,1563
32472,2022,Belgium,United States of America,10,60,0,70
32473,2022,Benin,United States of America,77,282,0,359
32474,2022,Bangladesh,United States of America,2667,10703,0,13370
32475,2022,Bahamas,United States of America,183,255,0,438
32476,2022,Bhutan,United States of America,32,417,0,449
32477,2022,Burkina Faso,United States of America,1425,3476,0,4901
32478,2022,Belarus,United States of America,1498,4160,0,5658
32479,2022,Bolivia (Plurinational State of),United States of America,80,935,0,1015
32480,2022,Botswana,United States of America,0,7,0,7
32481,2022,Brazil,United States of America,1131,27491,0,28622
32482,2022,Bosnia and Herzegovina,United States of America,86,216,0,302
32483,2022,Bulgaria,United States of America,154,306,0,460
32484,2022,Belize,United States of America,36,333,0,369
32485,2022,Cambodia,United States of America,116,82,0,198
32486,2022,Canada,United States of America,11,109,0,120
32487,2022,Central African Rep.,United States of America,172,145,0,317
32488,2022,Cayman Islands,United States of America,5,0,0,5
32489,2022,Chad,United States of America,221,265,0,486
32490,2022,China,United States of America,66603,87599,0,154202
32491,2022,Chile,United States of America,29,1760,0,1789
32492,2022,Cameroon,United States of America,5123,5383,0,10506
32493,2022,Congo,United States of America,990,2583,0,3573
32494,2022,Dem. Rep. of the Congo,United States of America,1487,2775,0,4262
32495,2022,Comoros,United States of America,0,10,0,10
32496,2022,Colombia,United States of America,2794,46881,0,49675
32497,2022,Costa Rica,United States of America,178,749,0,927
32498,2022,Cuba,United States of America,2810,48245,0,51055
32499,2022,Cabo Verde,United States of America,0,55,0,55
32500,2022,Cyprus,United States of America,0,7,0,7
32501,2022,Czechia,United States of America,8,52,0,60
32502,2022,Denmark,United States of America,0,10,0,10
32503,2022,Djibouti,United States of America,363,633,0,996
32504,2022,Dominica,United States of America,13,66,0,79
32505,2022,Dominican Rep.,United States of America,251,1411,0,1662
32506,2022,Ecuador,United States of America,1929,32665,0,34594
32507,2022,Equatorial Guinea,United States of America,17,112,0,129
32508,2022,Eritrea,United States of America,5165,1173,0,6338
32509,2022,Estonia,United States of America,137,45,0,182
32510,2022,Ethiopia,United States of America,7655,9120,0,16775
32511,2022,French Guiana,United States of America,0,8,0,8
32512,2022,Fiji,United States of America,100,467,0,567
32513,2022,Finland,United States of America,0,5,0,5
32514,2022,France,United States of America,17,138,0,155
32515,2022,Gabon,United States of America,48,371,0,419
32516,2022,Gambia,United States of America,1296,755,0,2051
32517,2022,Palestinian,United States of America,19,131,0,150
32518,2022,United Kingdom of Great Britain and Northern Ireland,United States of America,22,145,0,167
32519,2022,Georgia,United States of America,496,3044,0,3540
32520,2022,Germany,United States of America,27,191,0,218
32521,2022,Ghana,United States of America,507,1257,0,1764
32522,2022,Guinea-Bissau,United States of America,18,51,0,69
32523,2022,Greece,United States of America,13,98,0,111
32524,2022,Grenada,United States of America,18,34,0,52
32525,2022,Guatemala,United States of America,24298,154811,0,179109
32526,2022,Guinea,United States of America,1539,1266,0,2805
32527,2022,Guyana,United States of America,114,526,0,640
32528,2022,Haiti,United States of America,14566,51626,0,66192
32529,2022,"China, Hong Kong SAR",United States of America,14,230,0,244
32530,2022,Honduras,United States of America,18141,122064,0,140205
32531,2022,Croatia,United States of America,18,36,0,54
32532,2022,Hungary,United States of America,9,413,0,422
32533,2022,Cote d'Ivoire,United States of America,854,1389,0,2243
32534,2022,India,United States of America,10458,50090,0,60548
32535,2022,Indonesia,United States of America,880,3297,0,4177
32536,2022,Ireland,United States of America,0,43,0,43
32537,2022,Iran (Islamic Rep. of),United States of America,5290,3426,0,8716
32538,2022,Iraq,United States of America,5372,4192,0,9564
32539,2022,Israel,United States of America,96,637,0,733
32540,2022,Italy,United States of America,7,547,0,554
32541,2022,Jamaica,United States of America,900,1630,0,2530
32542,2022,Jordan,United States of America,702,3821,0,4523
32543,2022,Japan,United States of America,6,96,0,102
32544,2022,Kazakhstan,United States of America,1171,4806,0,5977
32545,2022,Kenya,United States of America,1576,7248,0,8824
32546,2022,Kyrgyzstan,United States of America,1619,2414,0,4033
32547,2022,Rep. of Korea,United States of America,20,281,0,301
32548,2022,Dem. People's Rep. of Korea,United States of America,5,45,0,50
32549,2022,Kuwait,United States of America,137,292,0,429
32550,2022,Lao People's Dem. Rep.,United States of America,60,176,0,236
32551,2022,Liberia,United States of America,1205,1124,0,2329
32552,2022,Libya,United States of America,418,1845,0,2263
32553,2022,Saint Lucia,United States of America,5,22,0,27
32554,2022,Lebanon,United States of America,406,2081,0,2487
32555,2022,Lesotho,United States of America,5,0,0,5
32556,2022,Sri Lanka,United States of America,984,2257,0,3241
32557,2022,Lithuania,United States of America,14,74,0,88
32558,2022,Latvia,United States of America,15,112,0,127
32560,2022,Madagascar,United States of America,6,21,0,27
32561,2022,Mauritania,United States of America,912,1136,0,2048
32562,2022,North Macedonia,United States of America,103,227,0,330
32563,2022,Rep. of Moldova,United States of America,1300,3054,0,4354
32564,2022,Maldives,United States of America,5,5,0,10
32565,2022,Mexico,United States of America,12943,107083,0,120026
32566,2022,Marshall Islands,United States of America,6,5,0,11
32567,2022,Mali,United States of America,843,643,0,1486
32568,2022,Malaysia,United States of America,85,382,0,467
32569,2022,Malawi,United States of America,33,196,0,229
32570,2022,Mongolia,United States of America,638,3474,0,4112
32571,2022,Morocco,United States of America,127,326,0,453
32572,2022,Mozambique,United States of America,31,57,0,88
32573,2022,Malta,United States of America,0,5,0,5
32574,2022,Montenegro,United States of America,84,547,0,631
32575,2022,Mauritius,United States of America,30,45,0,75
32576,2022,Myanmar,United States of America,1299,3373,0,4672
32577,2022,Namibia,United States of America,18,53,0,71
32578,2022,Nepal,United States of America,6242,7747,0,13989
32579,2022,Netherlands,United States of America,6,76,0,82
32580,2022,Niger,United States of America,141,442,0,583
32581,2022,Nicaragua,United States of America,2640,18916,0,21556
32582,2022,Nigeria,United States of America,3190,26632,0,29822
32583,2022,Niue,United States of America,9,5,0,14
32584,2022,Oman,United States of America,19,30,0,49
32585,2022,Pakistan,United States of America,3913,9668,0,13581
32586,2022,Panama,United States of America,10,308,0,318
32587,2022,Paraguay,United States of America,12,117,0,129
32588,2022,Peru,United States of America,494,4570,0,5064
32589,2022,Philippines,United States of America,162,1586,0,1748
32590,2022,Poland,United States of America,8,863,0,871
32591,2022,Portugal,United States of America,0,301,0,301
32592,2022,Qatar,United States of America,19,24,0,43
32593,2022,Romania,United States of America,461,4706,0,5167
32594,2022,South Africa,United States of America,53,1339,0,1392
32595,2022,Russian Federation,United States of America,7141,27011,0,34152
32596,2022,Rwanda,United States of America,1233,1515,0,2748
32597,2022,El Salvador,United States of America,30417,127505,0,157922
32598,2022,Saudi Arabia,United States of America,634,1042,0,1676
32599,2022,Serbia and Kosovo: S/RES/1244 (1999),United States of America,723,1780,0,2503
32600,2022,Senegal,United States of America,382,898,0,1280
32601,2022,Singapore,United States of America,5,47,0,52
32602,2022,Sierra Leone,United States of America,398,531,0,929
32603,2022,Somalia,United States of America,1463,418,0,1881
32604,2022,Spain,United States of America,6,330,0,336
32605,2022,Viet Nam,United States of America,415,1535,0,1950
32606,2022,Saint Kitts and Nevis,United States of America,5,6,0,11
32607,2022,Sudan,United States of America,1388,1203,0,2591
32608,2022,Suriname,United States of America,11,58,0,69
32609,2022,South Sudan,United States of America,59,91,0,150
32610,2022,Slovakia,United States of America,5,37,0,42
32611,2022,Slovenia,United States of America,5,10,0,15
32612,2022,Eswatini,United States of America,5,10,0,15
32613,2022,Sweden,United States of America,0,42,0,42
32614,2022,Switzerland,United States of America,0,16,0,16
32615,2022,Syrian Arab Rep.,United States of America,8843,3231,0,12074
32616,2022,United Rep. of Tanzania,United States of America,102,315,0,417
32617,2022,Turks and Caicos Islands,United States of America,14,0,0,14
32618,2022,Thailand,United States of America,31,500,0,531
32619,2022,Tajikistan,United States of America,305,835,0,1140
32620,2022,Turkmenistan,United States of America,208,486,0,694
32621,2022,Timor-Leste,United States of America,0,15,0,15
32622,2022,Togo,United States of America,525,743,0,1268
32623,2022,Trinidad and Tobago,United States of America,36,270,0,306
32624,2022,Tunisia,United States of America,99,425,0,524
32625,2022,Türkiye,United States of America,4893,7601,0,12494
32626,2022,United Arab Emirates,United States of America,80,148,0,228
32627,2022,Uganda,United States of America,1824,3654,0,5478
32628,2022,Ukraine,United States of America,2794,12142,0,14936
32629,2022,Uruguay,United States of America,5,241,0,246
32630,2022,Uzbekistan,United States of America,1282,4426,0,5708
32631,2022,Vanuatu,United States of America,0,27,0,27
32632,2022,Saint Vincent and the Grenadines,United States of America,29,19,0,48
32633,2022,Venezuela (Bolivarian Republic of),United States of America,20771,286058,0,306829
32634,2022,Samoa,United States of America,0,5,0,5
32635,2022,Yemen,United States of America,700,1118,0,1818
32636,2022,Zambia,United States of America,38,189,0,227
32637,2022,Zimbabwe,United States of America,682,1314,0,1996
32639,2022,Guadeloupe,United States of America,0,85,0,85
32640,2022,Curacao ,United States of America,35,0,0,35
32642,2022,Afghanistan,Uzbekistan,13031,0,0,13031
32644,2022,Venezuela (Bolivarian Republic of),Saint Vincent and the Grenadines,0,0,0,0
32645,2022,Afghanistan,Venezuela (Bolivarian Republic of),10,0,0,10
32646,2022,Chile,Venezuela (Bolivarian Republic of),10,0,0,10
32647,2022,Congo,Venezuela (Bolivarian Republic of),5,0,0,5
32648,2022,Colombia,Venezuela (Bolivarian Republic of),39185,1045,0,40230
32649,2022,Palestinian,Venezuela (Bolivarian Republic of),7,0,0,7
32650,2022,Haiti,Venezuela (Bolivarian Republic of),12,0,0,12
32651,2022,Iraq,Venezuela (Bolivarian Republic of),18,0,0,18
32652,2022,Liberia,Venezuela (Bolivarian Republic of),9,0,0,9
32653,2022,Libya,Venezuela (Bolivarian Republic of),5,0,0,5
32654,2022,Lebanon,Venezuela (Bolivarian Republic of),12,0,0,12
32655,2022,Nigeria,Venezuela (Bolivarian Republic of),7,0,0,7
32656,2022,Peru,Venezuela (Bolivarian Republic of),5,0,0,5
32657,2022,Rwanda,Venezuela (Bolivarian Republic of),5,0,0,5
32658,2022,Sierra Leone,Venezuela (Bolivarian Republic of),5,0,0,5
32659,2022,Syrian Arab Rep.,Venezuela (Bolivarian Republic of),33,0,0,33
32660,2022,Türkiye,Venezuela (Bolivarian Republic of),6,0,0,6
32661,2022,Venezuela (Bolivarian Republic of),Venezuela (Bolivarian Republic of),0,0,0,0
32662,2022,Western Sahara,Venezuela (Bolivarian Republic of),11,0,0,11
32663,2022,Egypt,Yemen,18,8,0,26
32664,2022,Cameroon,Yemen,0,5,0,5
32665,2022,Congo,Yemen,0,7,0,7
32666,2022,Djibouti,Yemen,5,6,0,11
32667,2022,Eritrea,Yemen,1306,483,0,1789
32668,2022,Ethiopia,Yemen,6514,11799,0,18313
32669,2022,Palestinian,Yemen,577,307,0,884
32670,2022,Iran (Islamic Rep. of),Yemen,5,0,0,5
32671,2022,Iraq,Yemen,3149,72,0,3221
32672,2022,Jordan,Yemen,14,12,0,26
32673,2022,Lebanon,Yemen,0,5,0,5
32674,2022,Mali,Yemen,0,5,0,5
32675,2022,Pakistan,Yemen,0,9,0,9
32676,2022,Somalia,Yemen,69230,155,0,69385
32677,2022,Viet Nam,Yemen,15,0,0,15
32678,2022,Sudan,Yemen,109,507,0,616
32679,2022,Syrian Arab Rep.,Yemen,2574,422,0,2996
32680,2022,United Rep. of Tanzania,Yemen,0,0,0,0
32681,2022,Yemen,Yemen,0,0,4288739,0
32682,2022,Angola,Zambia,0,0,0,0
32683,2022,Burundi,Zambia,7729,1187,0,8916
32684,2022,Cameroon,Zambia,19,26,0,45
32685,2022,Dem. Rep. of the Congo,Zambia,63062,4505,0,67567
32686,2022,Eritrea,Zambia,101,18,0,119
32687,2022,Ethiopia,Zambia,45,8,0,53
32688,2022,Palestinian,Zambia,15,0,0,15
32689,2022,Ghana,Zambia,0,9,0,9
32690,2022,Kenya,Zambia,5,0,0,5
32691,2022,Liberia,Zambia,7,0,0,7
32692,2022,South Africa,Zambia,6,0,0,6
32693,2022,Rwanda,Zambia,754,23,0,777
32694,2022,Sierra Leone,Zambia,5,0,0,5
32695,2022,Somalia,Zambia,3334,566,0,3900
32696,2022,Sudan,Zambia,28,0,0,28
32697,2022,South Sudan,Zambia,5,0,0,5
32698,2022,Syrian Arab Rep.,Zambia,38,7,0,45
32699,2022,Türkiye,Zambia,70,0,0,70
32700,2022,Uganda,Zambia,214,43,0,257
32702,2022,Angola,Zimbabwe,0,6,0,6
32703,2022,Burundi,Zimbabwe,701,209,0,910
32704,2022,Central African Rep.,Zimbabwe,0,5,0,5
32705,2022,Cameroon,Zimbabwe,0,10,0,10
32706,2022,Congo,Zimbabwe,20,0,0,20
32707,2022,Dem. Rep. of the Congo,Zimbabwe,8411,3047,0,11458
32708,2022,Eritrea,Zimbabwe,21,5,0,26
32709,2022,Ethiopia,Zimbabwe,70,18,0,88
32710,2022,Cote d'Ivoire,Zimbabwe,12,25,0,37
32711,2022,Kenya,Zimbabwe,0,8,0,8
32712,2022,Mali,Zimbabwe,6,118,0,124
32713,2022,Mozambique,Zimbabwe,0,8270,0,8270
32714,2022,South Africa,Zimbabwe,0,0,0,0
32715,2022,Rwanda,Zimbabwe,661,66,0,727
32716,2022,Sierra Leone,Zimbabwe,0,7,0,7
32717,2022,Somalia,Zimbabwe,13,21,0,34
32718,2022,Sudan,Zimbabwe,6,0,0,6
32719,2022,South Sudan,Zimbabwe,8,25,0,33
32720,2022,Uganda,Zimbabwe,10,0,0,10
32721,2022,Zambia,Zimbabwe,0,0,0,0
32722,2022,Zimbabwe,Zimbabwe,0,0,0,0
32723,2022,Haiti,Anguilla,0,0,0,0
32724,2022,Venezuela (Bolivarian Republic of),Anguilla,0,0,0,0
32725,2022,Venezuela (Bolivarian Republic of),Aruba,0,0,0,0
32726,2022,Venezuela (Bolivarian Republic of),Curacao ,0,0,0,0
32727,2022,Venezuela (Bolivarian Republic of),Sint Maarten (Dutch part),0,87,0,87
